Pos	A	C	G	T	Other	Total
0	0	0	0	0	0
1	0	0	0	0	0
2	0	0	0	0	0
3	0	0	0	0	0
4	0	0	0	0	0
5	0	0	0	0	0
6	0	0	0	0	0
7	0	0	0	0	0
8	0	0	0	0	0
9	0	0	0	0	0
10	0	0	0	0	0
11	0	0	0	0	0
12	0	0	0	0	0
13	0	0	0	0	0
14	0	0	0	0	0
15	0	0	0	0	0
16	0	0	0	0	0
17	0	0	0	0	0
18	0	0	0	0	0
19	0	0	0	0	0
20	0	0	0	0	0
21	0	0	0	0	0
22	0	0	0	0	0
23	0	0	0	0	0
24	0	0	0	0	0
25	0	0	0	0	0
26	0	0	0	0	0
27	0	0	0	0	0
28	0	0	0	0	0
29	0	0	0	0	0
30	0	0	0	0	0
31	0	0	0	0	0
32	0	0	0	0	0
33	0	0	0	0	0
34	0	0	0	0	0
35	0	0	0	0	0
36	0	0	0	0	0
37	0	0	0	0	0
38	0	0	0	0	0
39	0	0	0	0	0
40	0	0	0	0	0
41	0	0	0	0	0
42	0	0	0	0	0
43	0	0	0	0	0
44	0	0	2	0	0	2
45	7	0	0	0	0	7
46	0	0	0	8	0	8
47	6	4	0	0	0	10
48	0	0	0	28	0	28
49	0	31	0	0	0	31
50	0	0	0	36	0	36
51	0	0	0	37	0	37
52	0	0	40	0	0	40
53	0	0	0	39	0	39
54	26	6	6	2	0	40
55	0	0	35	8	0	43
56	51	0	0	0	0	51
57	0	0	0	49	0	49
58	0	48	0	0	0	48
59	0	0	0	50	0	50
60	0	0	50	0	0	50
61	0	0	0	45	0	45
62	0	4	0	47	0	51
63	0	54	0	0	0	54
64	0	4	0	51	0	55
65	0	60	0	0	0	60
66	0	0	0	59	0	59
67	52	0	0	0	0	52
68	55	0	2	0	0	57
69	54	0	0	0	0	54
70	0	60	0	0	0	60
71	0	0	58	0	0	58
72	56	0	0	0	0	56
73	55	0	0	0	0	55
74	0	76	0	0	0	76
75	0	0	0	72	0	72
76	0	0	0	74	0	74
77	0	0	0	76	0	76
78	72	0	0	0	0	72
79	72	0	0	0	0	72
80	69	0	0	0	0	69
81	82	0	0	0	0	82
82	0	0	0	85	0	85
83	0	87	0	0	0	87
84	0	0	0	81	0	81
85	0	0	85	2	0	87
86	0	0	0	86	0	86
87	0	0	87	0	0	87
88	2	2	0	84	0	88
89	1	0	82	0	0	83
90	0	0	88	0	0	88
91	0	92	0	0	0	92
92	0	0	0	90	0	90
93	0	0	91	0	0	91
94	0	0	0	91	0	91
95	0	91	0	0	0	91
96	89	0	0	0	0	89
97	0	92	0	0	0	92
98	0	0	0	91	0	91
99	0	88	0	0	0	88
100	0	0	85	0	0	85
101	4	0	85	0	0	89
102	0	95	0	0	0	95
103	0	1	0	90	0	91
104	0	0	93	0	0	93
105	0	96	0	0	0	96
106	90	0	2	0	0	92
107	0	0	0	98	0	98
108	0	0	95	0	0	95
109	0	103	0	0	0	103
110	0	0	0	94	0	94
111	0	0	0	100	0	100
112	102	0	0	0	0	102
113	0	0	104	0	0	104
114	0	0	0	109	0	109
115	0	0	101	0	0	101
116	0	106	0	0	0	106
117	98	0	4	0	0	102
118	0	104	0	0	0	104
119	0	0	0	103	0	103
120	0	104	0	0	0	104
121	97	0	1	0	0	98
122	0	105	0	0	0	105
123	0	0	99	0	0	99
124	0	105	0	0	0	105
125	90	0	0	0	0	90
126	2	0	113	0	0	115
127	0	0	0	103	0	103
128	110	0	0	0	0	110
129	0	0	0	112	0	112
130	111	0	0	0	0	111
131	106	0	0	0	0	106
132	0	0	0	110	0	110
133	0	0	0	109	0	109
134	99	0	0	2	0	101
135	72	0	2	0	0	74
136	0	0	0	82	0	82
137	76	0	0	0	0	76
138	87	0	0	1	0	88
139	0	92	0	0	0	92
140	0	1	0	89	0	90
141	90	0	0	0	0	90
142	86	0	0	0	0	86
143	0	0	0	89	0	89
144	0	0	0	93	0	93
145	83	0	0	0	0	83
146	0	92	0	0	0	92
147	0	0	0	93	0	93
148	0	0	93	0	0	93
149	0	0	0	94	0	94
150	0	92	0	1	0	93
151	0	0	90	0	0	90
152	0	0	0	88	0	88
153	0	0	0	89	0	89
154	0	0	88	0	0	88
155	91	0	0	0	0	91
156	0	94	0	0	0	94
157	86	0	0	0	0	86
158	0	1	94	0	0	95
159	0	0	94	0	0	94
160	93	0	0	1	0	94
161	0	95	0	0	0	95
162	92	0	0	0	0	92
163	0	101	0	0	0	101
164	0	0	97	0	0	97
165	102	0	0	0	0	102
166	0	0	101	0	0	101
167	0	1	0	92	0	93
168	99	0	0	0	0	99
169	85	0	0	1	0	86
170	0	107	0	0	0	107
171	0	1	0	102	0	103
172	0	110	0	0	0	110
173	0	0	102	0	0	102
174	0	0	0	107	0	107
175	0	114	0	0	0	114
176	0	0	0	112	0	112
177	113	0	0	1	0	114
178	0	0	0	109	0	109
179	0	119	0	1	0	120
180	0	1	0	113	0	114
181	0	0	0	128	0	128
182	0	123	0	0	0	123
183	4	3	0	126	0	133
184	0	0	132	0	0	132
185	0	131	0	0	0	131
186	117	0	2	0	0	119
187	0	0	133	0	0	133
188	0	0	131	0	0	131
189	0	132	0	0	0	132
190	0	1	0	127	0	128
191	0	0	142	0	0	142
192	0	151	0	0	0	151
193	0	0	0	148	0	148
194	0	0	0	149	0	149
195	145	0	0	0	0	145
196	0	158	0	0	0	158
197	1	0	148	0	0	149
198	0	0	161	0	0	161
199	0	0	0	157	0	157
200	0	2	0	163	0	165
201	0	0	0	172	0	172
202	0	170	0	0	0	170
203	1	0	174	0	0	175
204	1	0	0	161	0	162
205	0	173	0	1	0	174
206	0	159	0	1	0	160
207	0	0	176	0	0	176
208	0	0	0	169	0	169
209	0	0	179	0	0	179
210	0	1	0	171	0	172
211	0	2	0	177	0	179
212	0	0	180	0	0	180
213	0	186	0	0	0	186
214	171	1	3	0	0	175
215	2	0	182	0	0	184
216	0	181	0	6	0	187
217	0	184	0	1	0	185
218	0	0	183	0	0	183
219	191	0	3	0	0	194
220	0	0	0	191	0	191
221	0	197	0	0	0	197
222	196	0	0	0	0	196
223	0	0	0	203	0	203
224	0	204	0	1	0	205
225	189	0	0	0	0	189
226	0	0	210	0	0	210
227	0	210	0	0	0	210
228	193	0	0	0	0	193
229	0	219	0	0	0	219
230	219	0	0	0	0	219
231	0	3	0	211	0	214
232	0	230	0	0	0	230
233	0	0	0	233	0	233
234	228	0	0	0	0	228
235	0	0	236	0	0	236
236	0	0	239	0	0	239
237	0	0	0	232	0	232
238	0	0	0	232	0	232
239	0	0	0	243	0	243
240	0	239	0	0	0	239
241	0	0	253	0	0	253
242	0	2	0	252	0	254
243	0	253	0	0	0	253
244	0	238	0	2	0	240
245	0	0	248	2	0	250
246	0	0	239	0	0	239
247	0	0	264	0	0	264
248	0	0	0	256	0	256
249	0	0	266	0	0	266
250	0	0	0	263	0	263
251	0	0	262	0	0	262
252	266	0	0	0	0	266
253	0	271	0	0	0	271
254	0	252	0	0	0	252
255	0	0	252	0	0	252
256	262	0	0	0	0	262
257	255	0	2	0	0	257
258	268	0	3	0	0	271
259	0	0	270	0	0	270
260	0	0	287	0	0	287
261	1	0	0	266	0	267
262	286	0	0	0	0	286
263	276	0	1	0	0	277
264	0	0	287	0	0	287
265	288	0	0	0	0	288
266	0	2	0	283	0	285
267	0	0	287	0	0	287
268	0	0	279	0	0	279
269	269	0	4	0	0	273
270	0	0	279	0	0	279
271	274	0	0	0	0	274
272	0	0	291	0	0	291
273	0	291	0	0	0	291
274	0	282	0	0	0	282
275	0	1	0	281	0	282
276	0	0	0	280	0	280
277	0	0	282	0	0	282
278	0	4	0	273	0	277
279	0	280	0	0	0	280
280	0	273	0	0	0	273
281	0	269	0	0	0	269
282	0	0	0	267	0	267
283	0	0	278	0	0	278
284	0	0	281	0	0	281
285	0	2	0	258	0	260
286	0	3	0	241	0	244
287	0	0	0	271	0	271
288	0	264	0	0	0	264
289	254	0	0	0	0	254
290	260	0	1	0	0	261
291	0	273	0	0	0	273
292	0	0	269	0	0	269
293	273	0	0	0	0	273
294	0	0	267	0	0	267
295	266	0	0	0	0	266
296	248	0	1	0	0	249
297	240	0	0	1	0	241
298	252	0	0	0	0	252
299	0	280	0	0	0	280
300	273	0	0	0	0	273
301	0	282	0	0	0	282
302	263	0	0	0	0	263
303	0	278	0	0	0	278
304	0	0	283	0	0	283
305	0	0	0	268	0	268
306	0	273	0	0	0	273
307	0	270	0	0	0	270
308	267	0	0	1	0	268
309	243	0	0	0	0	243
310	0	275	0	1	0	276
311	0	0	0	259	0	259
312	0	274	0	0	0	274
313	264	0	0	0	0	264
314	0	0	271	0	0	271
315	0	3	0	252	0	255
316	0	0	0	240	0	240
317	0	1	0	254	0	255
318	0	0	268	0	0	268
319	0	267	0	0	0	267
320	0	267	0	0	0	267
321	0	0	0	262	0	262
322	1	0	275	0	0	276
323	0	0	0	257	0	257
324	0	0	0	238	0	238
325	0	4	0	250	0	254
326	0	0	0	261	0	261
327	249	0	0	0	0	249
328	0	273	0	0	0	273
329	265	0	0	0	0	265
330	0	0	259	0	0	259
331	0	0	267	1	0	268
332	0	0	0	256	0	256
333	0	0	0	252	0	252
334	0	255	0	0	0	255
335	2	0	253	0	0	255
336	0	249	0	3	0	252
337	0	0	248	0	0	248
338	243	0	2	0	0	245
339	0	255	0	0	0	255
340	0	0	259	0	0	259
341	0	0	0	250	0	250
342	0	0	256	0	0	256
343	0	254	0	1	0	255
344	1	0	0	242	0	243
345	0	245	0	4	0	249
346	0	0	252	0	0	252
347	0	0	0	241	0	241
348	244	0	1	0	0	245
349	0	234	0	0	0	234
350	0	0	237	0	0	237
351	0	0	0	215	0	215
352	0	0	218	0	0	218
353	1	0	219	0	0	220
354	0	213	0	1	0	214
355	0	2	0	207	0	209
356	0	0	0	201	0	201
357	0	0	0	212	0	212
358	1	0	208	0	0	209
359	0	0	210	0	0	210
360	197	0	1	0	0	198
361	0	0	213	0	0	213
362	189	0	0	0	0	189
363	0	206	0	0	0	206
364	0	1	0	192	0	193
365	0	194	0	0	0	194
366	0	189	0	0	0	189
367	0	0	198	0	0	198
368	0	0	0	193	0	193
369	0	0	196	0	0	196
370	0	0	196	0	0	196
371	189	0	0	0	0	189
372	0	0	178	0	0	178
373	0	0	177	0	0	177
374	168	0	0	0	0	168
375	0	0	163	0	0	163
376	1	0	165	0	0	166
377	0	0	0	166	0	166
378	0	163	0	0	0	163
379	0	0	0	153	0	153
380	0	0	1	157	0	158
381	157	0	1	0	0	158
382	0	0	0	158	0	158
383	0	163	0	0	0	163
384	129	0	2	0	0	131
385	0	0	141	0	0	141
386	126	0	2	3	0	131
387	0	0	132	0	0	132
388	0	0	132	0	0	132
389	0	121	0	0	0	121
390	118	0	0	0	0	118
391	0	120	0	0	0	120
392	0	0	108	0	0	108
393	0	1	0	122	0	123
394	0	118	0	0	0	118
395	121	0	0	0	0	121
396	121	0	0	0	0	121
397	0	122	0	0	0	122
398	122	0	0	0	0	122
399	0	1	0	122	0	123
400	0	121	0	0	0	121
401	0	0	0	114	0	114
402	0	0	0	110	0	110
403	106	0	0	0	0	106
404	110	0	0	0	0	110
405	119	0	0	0	0	119
406	0	0	121	0	0	121
407	98	0	7	0	0	105
408	0	1	0	102	0	103
409	0	0	95	0	0	95
410	0	0	95	0	0	95
411	0	97	0	0	0	97
412	96	0	0	0	0	96
413	0	95	0	0	0	95
414	0	0	0	92	0	92
415	0	4	0	88	0	92
416	0	0	94	0	0	94
417	0	0	0	93	0	93
418	0	0	90	0	0	90
419	0	0	95	0	0	95
420	0	93	0	0	0	93
421	0	0	0	88	0	88
422	0	1	0	89	0	90
423	91	0	1	0	0	92
424	0	0	95	0	0	95
425	0	0	0	94	0	94
426	90	0	2	0	0	92
427	0	0	89	0	0	89
428	83	0	2	0	0	85
429	82	0	0	0	0	82
430	0	0	93	0	0	93
431	0	0	0	84	0	84
432	0	2	0	86	0	88
433	0	0	89	0	0	89
434	79	6	0	1	0	86
435	86	0	0	0	0	86
436	74	0	1	0	0	75
437	83	0	1	0	0	84
438	76	0	0	0	0	76
439	0	0	84	0	0	84
440	1	0	91	0	0	92
441	0	91	0	0	0	91
442	0	0	90	0	0	90
443	0	0	0	90	0	90
444	0	0	0	87	0	87
445	0	1	0	89	0	90
446	0	1	0	99	0	100
447	0	0	103	0	0	103
448	0	104	0	1	0	105
449	0	103	0	0	0	103
450	2	0	0	102	0	104
451	0	107	0	0	0	107
452	115	0	0	0	0	115
453	114	0	0	0	0	114
454	0	121	0	0	0	121
455	0	0	0	118	0	118
456	0	0	0	120	0	120
457	0	0	117	0	0	117
458	126	0	0	0	0	126
459	122	0	1	0	0	123
460	0	129	0	0	0	129
461	122	0	0	0	0	122
462	0	0	132	0	0	132
463	0	135	0	0	0	135
464	0	135	0	0	0	135
465	0	138	0	0	0	138
466	0	0	0	131	0	131
467	129	0	0	0	0	129
468	0	0	0	134	0	134
469	0	0	144	0	0	144
470	0	0	0	138	0	138
471	0	0	136	0	0	136
472	0	0	0	126	0	126
473	0	2	0	128	0	130
474	0	133	0	0	0	133
475	129	0	0	0	0	129
476	0	1	0	128	0	129
477	0	134	0	0	0	134
478	125	0	0	0	0	125
479	124	0	0	0	0	124
480	122	0	1	0	0	123
481	0	133	0	0	0	133
482	0	0	132	0	0	132
483	1	0	0	133	0	134
484	0	0	0	132	0	132
485	0	131	0	0	0	131
486	0	0	123	0	0	123
487	0	0	128	0	0	128
488	129	0	0	0	0	129
489	0	0	0	136	0	136
490	0	0	135	0	0	135
491	0	139	0	0	0	139
492	0	0	0	137	0	137
493	0	131	0	0	0	131
494	0	0	131	0	0	131
495	133	0	0	0	0	133
496	129	0	0	0	0	129
497	0	139	0	0	0	139
498	0	0	1	129	0	130
499	0	0	130	0	0	130
500	0	134	0	0	0	134
501	135	0	0	0	0	135
502	0	139	0	1	0	140
503	0	140	0	0	0	140
504	0	0	0	149	0	149
505	0	146	0	0	0	146
506	144	0	0	0	0	144
507	0	2	0	145	0	147
508	0	0	154	0	0	154
509	0	0	162	0	0	162
510	0	1	0	154	0	155
511	0	152	0	0	0	152
512	158	0	0	0	0	158
513	0	1	0	162	0	163
514	0	0	169	0	0	169
515	2	0	0	163	0	165
516	0	1	0	155	0	156
517	167	0	0	0	0	167
518	0	0	0	168	0	168
519	1	0	174	0	0	175
520	0	0	178	0	0	178
521	0	0	0	164	0	164
522	0	0	0	164	0	164
523	0	0	167	0	0	167
524	167	0	1	0	0	168
525	0	0	172	0	0	172
526	0	173	0	0	0	173
527	0	0	0	164	0	164
528	0	0	171	0	0	171
529	0	1	172	0	0	173
530	0	0	0	170	0	170
531	164	0	0	0	0	164
532	0	0	170	0	0	170
533	0	171	0	0	0	171
534	171	0	0	0	0	171
535	0	0	165	0	0	165
536	169	0	0	0	0	169
537	156	0	0	4	0	160
538	5	174	0	0	0	179
539	0	0	0	185	0	185
540	0	185	0	0	0	185
541	0	0	182	0	0	182
542	196	0	0	0	0	196
543	191	3	0	3	0	197
544	0	3	207	0	0	210
545	2	4	203	1	0	210
546	0	210	0	3	0	213
547	226	0	1	1	0	228
548	0	0	0	202	0	202
549	0	0	0	214	0	214
550	0	228	0	0	0	228
551	217	0	2	1	0	220
552	0	0	229	0	0	229
553	0	3	0	227	0	230
554	228	0	0	0	0	228
555	0	236	0	0	0	236
556	0	0	231	0	0	231
557	0	0	239	0	0	239
558	0	0	0	233	0	233
559	0	236	0	0	0	236
560	0	0	242	0	0	242
561	0	0	0	228	0	228
562	237	0	2	0	0	239
563	1	0	241	0	0	242
564	0	2	0	230	0	232
565	0	0	239	0	0	239
566	0	0	243	0	0	243
567	0	1	0	240	0	241
568	1	0	244	0	0	245
569	234	0	0	0	0	234
570	0	0	242	0	0	242
571	239	0	1	2	0	242
572	0	242	0	0	0	242
573	233	0	1	0	0	234
574	0	243	0	0	0	243
575	0	2	0	228	0	230
576	0	2	0	230	0	232
577	0	0	230	0	0	230
578	0	0	241	0	0	241
579	0	1	0	237	0	238
580	1	0	248	0	0	249
581	0	1	0	232	0	233
582	0	236	0	0	0	236
583	0	231	0	0	0	231
584	0	0	0	238	0	238
585	0	2	0	224	0	226
586	0	0	238	0	0	238
587	0	2	0	243	0	245
588	0	245	0	0	0	245
589	0	231	0	0	0	231
590	0	242	0	0	0	242
591	1	2	0	228	0	231
592	0	233	1	1	0	235
593	227	0	0	0	0	227
594	0	1	0	234	0	235
595	0	0	238	0	0	238
596	1	2	0	208	0	211
597	0	0	207	0	0	207
598	0	0	209	0	0	209
599	0	0	214	0	0	214
600	0	212	0	0	0	212
601	0	0	198	0	0	198
602	209	0	0	0	0	209
603	197	0	2	0	0	199
604	192	0	0	0	0	192
605	2	0	0	204	0	206
606	209	0	0	0	0	209
607	0	221	0	0	0	221
608	0	211	0	2	0	213
609	205	1	0	0	0	206
610	0	0	218	0	0	218
611	0	1	0	215	0	216
612	2	0	212	0	0	214
613	1	0	220	0	0	221
614	0	224	0	0	0	224
615	0	0	0	208	0	208
616	0	0	0	211	0	211
617	211	0	1	0	0	212
618	0	217	0	0	0	217
619	0	204	2	1	0	207
620	1	0	206	0	0	207
621	0	196	0	0	0	196
622	196	0	2	0	0	198
623	209	0	0	0	0	209
624	0	0	208	0	0	208
625	0	0	217	0	0	217
626	0	0	0	213	0	213
627	0	0	0	206	0	206
628	0	218	0	0	0	218
629	0	0	0	206	0	206
630	0	0	0	206	0	206
631	0	211	0	0	0	211
632	1	2	0	209	0	212
633	1	0	0	205	0	206
634	0	210	0	1	0	211
635	0	0	213	0	0	213
636	0	0	0	200	0	200
637	197	0	0	0	0	197
638	201	0	0	0	0	201
639	0	0	205	0	0	205
640	207	0	0	0	0	207
641	210	0	0	0	0	210
642	0	213	0	0	0	213
643	0	0	195	0	0	195
644	0	0	219	0	0	219
645	0	0	0	205	0	205
646	214	0	0	0	0	214
647	188	0	3	1	0	192
648	0	0	0	209	0	209
649	225	0	0	0	0	225
650	191	0	0	0	0	191
651	215	0	1	0	0	216
652	1	0	220	0	0	221
653	0	0	220	0	0	220
654	199	0	0	0	0	199
655	0	0	210	0	0	210
656	0	208	0	0	0	208
657	2	0	0	198	0	200
658	0	0	203	0	0	203
659	0	0	206	0	0	206
660	0	3	0	207	0	210
661	0	0	205	0	0	205
662	0	1	203	0	0	204
663	0	203	0	0	0	203
664	0	203	0	0	0	203
665	196	0	0	1	0	197
666	0	0	0	191	0	191
667	204	0	0	0	0	204
668	6	0	208	0	0	214
669	0	1	0	200	0	201
670	0	0	0	208	0	208
671	187	0	0	0	0	187
672	0	203	0	0	0	203
673	0	0	197	0	0	197
674	0	0	204	0	0	204
675	0	195	0	0	0	195
676	0	0	190	0	0	190
677	0	205	0	0	0	205
678	0	198	0	0	0	198
679	0	0	200	0	0	200
680	200	0	0	0	0	200
681	0	1	0	201	0	202
682	0	202	0	0	0	202
683	0	0	0	194	0	194
684	189	0	1	0	0	190
685	186	0	6	0	0	192
686	188	0	4	0	0	192
687	0	0	199	0	0	199
688	0	1	0	173	0	174
689	0	184	0	0	0	184
690	179	0	0	0	0	179
691	0	0	0	155	0	155
692	0	0	0	167	0	167
693	0	0	0	173	0	173
694	0	0	179	0	0	179
695	180	0	2	0	0	182
696	0	171	0	0	0	171
697	0	0	0	171	0	171
698	0	0	0	168	0	168
699	167	0	0	0	0	167
700	0	0	170	0	0	170
701	0	0	173	0	0	173
702	0	164	0	0	0	164
703	0	0	172	0	0	172
704	168	0	0	0	0	168
705	0	172	0	0	0	172
706	0	0	162	0	0	162
707	174	0	0	0	0	174
708	0	0	173	0	0	173
709	0	183	0	0	0	183
710	0	1	0	173	0	174
711	0	1	0	171	0	172
712	0	0	177	0	0	177
713	1	0	187	0	0	188
714	0	189	0	0	0	189
715	184	0	1	0	0	185
716	0	183	0	0	0	183
717	0	1	0	165	0	166
718	0	0	178	0	0	178
719	176	0	0	1	0	177
720	0	0	0	178	0	178
721	0	182	0	0	0	182
722	0	190	0	0	0	190
723	1	1	0	174	0	176
724	1	0	0	183	0	184
725	192	0	0	1	0	193
726	1	2	0	192	0	195
727	1	0	191	0	0	192
728	189	0	0	0	0	189
729	188	0	0	0	0	188
730	0	0	195	0	0	195
731	191	0	0	0	0	191
732	0	1	0	186	0	187
733	0	1	0	179	0	180
734	0	1	0	183	0	184
735	0	1	0	194	0	195
736	0	187	1	0	0	188
737	180	0	1	2	0	183
738	183	0	0	0	0	183
739	0	0	189	0	0	189
740	188	0	0	0	0	188
741	180	0	0	1	0	181
742	172	0	0	0	0	172
743	179	1	1	0	0	181
744	0	203	0	1	0	204
745	0	0	0	197	0	197
746	0	0	195	0	0	195
747	0	0	201	0	0	201
748	201	0	1	0	0	202
749	201	0	0	0	0	201
750	0	237	0	0	0	237
751	229	0	1	3	0	233
752	0	255	0	0	0	255
753	0	1	0	251	0	252
754	275	0	1	0	0	276
755	277	0	1	5	0	283
756	309	0	1	0	0	310
757	0	324	0	0	0	324
758	306	0	0	0	0	306
759	0	2	0	309	0	311
760	304	0	2	0	0	306
761	0	1	347	0	0	348
762	0	341	0	0	0	341
763	329	0	0	0	0	329
764	0	0	337	0	0	337
765	0	1	0	328	0	329
766	0	0	329	0	0	329
767	0	0	366	0	0	366
768	0	0	0	359	0	359
769	1	0	368	0	0	369
770	1	1	0	348	0	350
771	0	0	0	350	0	350
772	346	0	2	1	0	349
773	0	367	0	1	0	368
774	0	371	0	0	0	371
775	0	361	0	2	0	363
776	0	0	377	0	0	377
777	0	0	0	372	0	372
778	0	0	362	0	0	362
779	371	0	7	0	0	378
780	381	0	2	0	0	383
781	0	400	0	0	0	400
782	0	5	0	386	0	391
783	0	397	0	1	0	398
784	381	0	2	0	0	383
785	0	3	0	396	0	399
786	0	0	394	0	0	394
787	0	393	0	0	0	393
788	1	0	399	0	0	400
789	0	3	0	385	0	388
790	1	0	388	0	0	389
791	393	0	1	0	0	394
792	0	0	409	0	0	409
793	0	414	0	0	0	414
794	0	0	0	407	0	407
795	0	3	0	376	0	379
796	408	0	0	0	0	408
797	420	0	0	0	0	420
798	0	432	0	0	0	432
799	2	0	406	0	0	408
800	0	0	407	0	0	407
801	414	0	1	0	0	415
802	0	0	430	0	0	430
803	0	0	439	0	0	439
804	0	0	436	0	0	436
805	0	0	458	0	0	458
806	0	459	0	0	0	459
807	456	0	0	0	0	456
808	0	0	0	444	0	444
809	457	0	0	0	0	457
810	0	468	0	1	0	469
811	457	0	0	2	0	459
812	0	469	0	0	0	469
813	0	2	0	455	0	457
814	0	448	0	2	0	450
815	1	0	461	0	0	462
816	0	459	0	0	0	459
817	1	0	0	426	0	427
818	442	0	0	0	0	442
819	0	0	0	447	0	447
820	0	0	464	0	0	464
821	2	4	0	447	0	453
822	0	458	0	2	0	460
823	0	0	442	0	0	442
824	455	0	2	0	0	457
825	0	0	0	427	0	427
826	441	0	0	1	0	442
827	420	0	0	0	0	420
828	0	473	0	0	0	473
829	455	0	0	0	0	455
830	437	0	0	0	0	437
831	0	477	0	1	0	478
832	0	0	0	437	0	437
833	0	1	0	453	0	454
834	0	463	0	0	0	463
835	0	1	0	457	0	458
836	0	0	472	0	0	472
837	0	1	0	471	0	472
838	0	0	465	0	0	465
839	1	0	468	0	0	469
840	0	464	0	0	0	464
841	0	454	0	0	0	454
842	0	462	0	0	0	462
843	0	0	0	447	0	447
844	0	0	462	0	0	462
845	461	0	4	0	0	465
846	0	0	0	468	0	468
847	0	0	462	0	0	462
848	0	0	468	0	0	468
849	0	470	0	0	0	470
850	0	0	0	469	0	469
851	467	0	0	0	0	467
852	0	465	0	0	0	465
853	0	453	0	0	0	453
854	0	471	0	0	0	471
855	0	1	0	463	0	464
856	0	465	0	0	0	465
857	0	0	0	452	0	452
858	0	1	0	450	0	451
859	0	0	468	0	0	468
860	443	0	0	0	0	443
861	0	0	462	0	0	462
862	0	2	0	445	0	447
863	0	0	438	0	0	438
864	0	437	0	0	0	437
865	429	0	0	0	0	429
866	0	1	0	406	0	407
867	0	0	0	422	0	422
868	410	0	2	1	0	413
869	387	0	1	0	0	388
870	412	0	0	0	0	412
871	0	0	432	0	0	432
872	401	1	6	0	0	408
873	0	419	0	0	0	419
874	0	387	0	1	0	388
875	1	0	0	372	0	373
876	0	1	0	362	0	363
877	0	381	0	0	0	381
878	0	1	0	382	0	383
879	373	0	4	0	0	377
880	1	0	386	0	0	387
881	0	381	0	0	0	381
882	362	0	0	0	0	362
883	0	373	0	1	0	374
884	0	0	366	0	0	366
885	1	1	0	358	0	360
886	0	0	370	0	0	370
887	0	366	0	2	0	368
888	1	1	0	344	0	346
889	0	0	352	0	0	352
890	0	0	357	0	0	357
891	0	0	0	331	0	331
892	352	0	1	0	0	353
893	330	0	0	0	0	330
894	323	0	3	0	0	326
895	0	0	338	0	0	338
896	0	338	0	0	0	338
897	1	2	0	316	0	319
898	0	0	0	306	0	306
899	0	302	9	0	0	311
900	298	0	2	0	0	300
901	0	0	2	300	0	302
902	2	0	302	0	0	304
903	0	288	0	2	0	290
904	276	0	4	0	0	280
905	0	265	0	0	0	265
906	0	0	0	242	0	242
907	1	3	0	233	0	237
908	0	0	0	233	0	233
909	0	0	239	0	0	239
910	0	1	0	230	0	231
911	0	227	0	0	0	227
912	0	218	0	1	0	219
913	0	0	218	0	0	218
914	221	0	0	0	0	221
915	207	0	0	0	0	207
916	0	222	0	0	0	222
917	202	0	1	0	0	203
918	191	0	0	0	0	191
919	0	200	0	0	0	200
920	3	0	0	186	0	189
921	0	0	185	0	0	185
922	0	0	190	0	0	190
923	193	0	1	0	0	194
924	0	187	0	0	0	187
925	0	1	0	167	0	168
926	0	0	0	171	0	171
927	0	0	0	170	0	170
928	169	0	0	0	0	169
929	1	0	0	169	0	170
930	1	1	0	157	0	159
931	0	0	163	0	0	163
932	151	0	2	0	0	153
933	0	154	0	0	0	154
934	147	0	0	0	0	147
935	0	150	0	0	0	150
936	0	0	0	138	0	138
937	139	0	0	0	0	139
938	130	0	1	0	0	131
939	1	0	147	0	0	148
940	137	0	0	0	0	137
941	0	0	143	0	0	143
942	0	0	125	0	0	125
943	0	0	120	0	0	120
944	0	0	120	0	0	120
945	1	3	0	109	0	113
946	0	0	117	0	0	117
947	1	1	0	112	0	114
948	110	0	0	0	0	110
949	0	0	0	114	0	114
950	103	0	0	0	0	103
951	0	109	1	0	0	110
952	0	0	0	75	0	75
953	1	0	80	0	0	81
954	0	82	0	0	0	82
955	0	0	0	72	0	72
956	0	0	77	0	0	77
957	0	73	0	0	0	73
958	0	63	0	1	0	64
959	0	0	74	0	0	74
960	0	0	0	74	0	74
961	1	0	59	0	0	60
962	71	0	1	0	0	72
963	68	0	0	0	0	68
964	0	71	0	0	0	71
965	64	0	0	0	0	64
966	0	0	0	67	0	67
967	0	0	69	0	0	69
968	62	0	0	0	0	62
969	0	0	69	0	0	69
970	0	67	0	0	0	67
971	69	0	0	0	0	69
972	0	1	0	63	0	64
973	0	0	67	0	0	67
974	68	0	0	0	0	68
975	67	0	0	0	0	67
976	61	0	1	0	0	62
977	0	3	0	57	0	60
978	0	0	0	61	0	61
979	0	0	66	0	0	66
980	0	64	0	0	0	64
981	0	0	0	58	0	58
982	1	0	0	59	0	60
983	1	0	61	0	0	62
984	0	0	66	0	0	66
985	0	0	0	62	0	62
986	61	0	0	0	0	61
987	0	65	0	0	0	65
988	61	0	0	0	0	61
989	0	60	0	3	0	63
990	1	0	59	0	0	60
991	0	0	56	0	0	56
992	62	0	0	0	0	62
993	50	0	0	0	0	50
994	0	50	0	0	0	50
995	0	0	49	0	0	49
996	0	0	0	45	0	45
997	0	0	0	47	0	47
998	0	48	0	0	0	48
999	0	0	0	44	0	44
1000	0	0	46	0	0	46
1001	41	0	1	0	0	42
1002	44	0	0	0	0	44
1003	40	0	0	0	0	40
1004	32	0	0	0	0	32
1005	0	0	34	0	0	34
1006	33	0	0	0	0	33
1007	0	0	28	1	0	29
1008	0	23	0	3	0	26
1009	0	0	0	25	0	25
1010	22	0	0	0	0	22
1011	0	0	0	20	0	20
1012	0	0	21	0	0	21
1013	20	0	0	0	0	20
1014	12	0	1	0	0	13
1015	0	0	0	12	0	12
1016	0	0	0	11	0	11
1017	0	0	11	0	0	11
1018	0	12	0	0	0	12
1019	11	0	0	0	0	11
1020	0	0	12	0	0	12
1021	13	0	0	0	0	13
1022	0	9	0	3	0	12
1023	13	0	0	0	0	13
1024	0	22	0	4	0	26
1025	0	42	0	0	0	42
1026	0	0	0	40	0	40
1027	0	0	0	47	0	47
1028	0	0	0	48	0	48
1029	1	2	0	48	0	51
1030	3	1	49	0	0	53
1031	41	5	3	3	0	52
1032	51	0	0	0	0	51
1033	54	0	2	0	0	56
1034	0	0	0	55	0	55
1035	0	0	0	58	0	58
1036	54	0	0	0	0	54
1037	53	0	0	0	0	53
1038	54	0	0	0	0	54
1039	0	0	0	53	0	53
1040	0	0	0	60	0	60
1041	0	0	58	0	0	58
1042	0	1	59	0	0	60
1043	0	60	0	0	0	60
1044	58	0	1	0	0	59
1045	55	0	0	0	0	55
1046	56	0	0	0	0	56
1047	0	1	64	0	0	65
1048	65	0	0	0	0	65
1049	65	0	0	0	0	65
1050	70	0	0	0	0	70
1051	0	0	0	71	0	71
1052	0	3	0	71	0	74
1053	0	0	0	78	0	78
1054	0	0	76	0	0	76
1055	75	0	0	0	0	75
1056	0	82	0	0	0	82
1057	74	0	1	0	0	75
1058	0	88	0	0	0	88
1059	0	103	0	0	0	103
1060	0	0	0	102	0	102
1061	0	1	0	107	0	108
1062	0	121	0	2	0	123
1063	116	0	0	0	0	116
1064	109	0	2	0	0	111
1065	0	1	0	121	0	122
1066	1	0	121	0	0	122
1067	0	0	114	0	0	114
1068	0	0	112	2	0	114
1069	0	0	117	0	0	117
1070	119	0	0	0	0	119
1071	108	0	1	0	0	109
1072	0	0	0	120	0	120
1073	0	0	132	0	0	132
1074	0	0	0	126	0	126
1075	0	131	0	0	0	131
1076	0	116	0	1	0	117
1077	123	0	0	0	0	123
1078	115	0	0	1	0	116
1079	127	0	1	0	0	128
1080	0	0	0	128	0	128
1081	0	0	0	138	0	138
1082	0	1	0	141	0	142
1083	0	0	0	142	0	142
1084	0	0	144	0	0	144
1085	0	0	0	145	0	145
1086	140	0	0	0	0	140
1087	0	1	0	137	0	138
1088	0	2	2	132	0	136
1089	1	0	0	146	0	147
1090	0	126	0	0	0	126
1091	0	152	0	0	0	152
1092	0	145	0	0	0	145
1093	0	0	0	146	0	146
1094	0	2	0	144	0	146
1095	124	0	0	0	0	124
1096	137	0	0	0	0	137
1097	141	0	0	0	0	141
1098	1	4	0	140	0	145
1099	0	0	0	151	0	151
1100	0	152	0	0	0	152
1101	0	148	0	0	0	148
1102	149	0	1	2	0	152
1103	0	1	0	152	0	153
1104	170	0	2	3	0	175
1105	179	0	0	0	0	179
1106	1	1	0	201	0	203
1107	0	208	0	0	0	208
1108	198	0	0	1	0	199
1109	207	0	3	0	0	210
1110	0	0	220	0	0	220
1111	215	0	0	0	0	215
1112	0	247	1	0	0	248
1113	1	0	0	255	0	256
1114	287	0	0	0	0	287
1115	0	0	0	280	0	280
1116	0	1	0	285	0	286
1117	0	257	1	0	0	258
1118	281	0	2	0	0	283
1119	296	0	1	0	0	297
1120	0	324	0	0	0	324
1121	0	312	0	1	0	313
1122	287	2	0	0	0	289
1123	274	1	1	1	0	277
1124	0	0	322	0	0	322
1125	0	0	321	1	0	322
1126	0	0	335	0	0	335
1127	0	1	0	291	0	292
1128	0	2	0	305	0	307
1129	4	0	330	0	0	334
1130	332	0	2	3	0	337
1131	316	0	6	0	0	322
1132	326	0	4	0	0	330
1133	342	0	3	2	0	347
1134	0	0	381	0	0	381
1135	382	0	2	0	0	384
1136	380	0	3	1	0	384
1137	383	1	1	0	0	385
1138	363	0	2	0	0	365
1139	390	0	3	0	0	393
1140	1	0	410	0	0	411
1141	0	423	0	1	0	424
1142	0	3	0	379	0	382
1143	0	2	0	401	0	403
1144	1	0	426	0	0	427
1145	412	0	4	2	0	418
1146	0	3	0	409	0	412
1147	1	0	435	1	0	437
1148	0	0	470	0	0	470
1149	0	519	0	1	0	520
1150	0	1	0	463	0	464
1151	1	2	0	470	0	473
1152	0	7	0	502	0	509
1153	513	0	1	1	0	515
1154	1	3	0	504	0	508
1155	0	0	549	0	0	549
1156	3	0	554	0	0	557
1157	0	0	589	0	0	589
1158	0	1	0	568	0	569
1159	586	0	0	0	0	586
1160	1	1	605	0	0	607
1161	617	1	1	0	0	619
1162	577	0	2	0	0	579
1163	0	0	0	608	0	608
1164	8	1	0	633	0	642
1165	2	624	0	1	0	627
1166	0	0	627	0	0	627
1167	619	0	9	2	0	630
1168	3	0	0	628	0	631
1169	0	639	0	1	0	640
1170	0	5	1	639	0	645
1171	0	0	756	0	0	756
1172	1	2	0	745	0	748
1173	0	779	0	0	0	779
1174	0	6	0	788	0	794
1175	808	0	1	0	0	809
1176	0	5	0	801	0	806
1177	0	781	0	6	0	787
1178	0	808	0	1	0	809
1179	770	2	3	0	0	775
1180	1	0	826	0	0	827
1181	2	2	0	816	0	820
1182	0	6	0	831	0	837
1183	1	0	816	0	0	817
1184	0	833	0	0	0	833
1185	1	0	842	0	0	843
1186	0	4	0	838	0	842
1187	0	883	0	1	0	884
1188	854	6	1	1	0	862
1189	0	905	0	6	0	911
1190	1	897	0	2	0	900
1191	881	0	0	1	0	882
1192	864	0	0	0	0	864
1193	861	3	6	0	0	870
1194	0	1	0	911	0	912
1195	0	0	920	0	0	920
1196	907	0	6	0	0	913
1197	864	0	4	0	0	868
1198	0	0	0	935	0	935
1199	1	0	928	0	0	929
1200	0	946	0	1	0	947
1201	926	0	0	0	0	926
1202	906	0	3	0	0	909
1203	0	983	0	0	0	983
1204	8	958	0	0	0	966
1205	955	0	2	0	0	957
1206	923	0	3	1	0	927
1207	911	0	1	1	0	913
1208	2	3	0	969	0	974
1209	1	0	993	0	0	994
1210	0	6	1	953	0	960
1211	0	1	953	0	0	954
1212	0	955	0	0	0	955
1213	0	927	0	1	0	928
1214	0	3	0	919	0	922
1215	2	0	0	862	0	864
1216	1	1	0	954	0	956
1217	0	926	0	1	0	927
1218	921	0	3	0	0	924
1219	914	0	4	0	0	918
1220	0	986	0	0	0	986
1221	0	4	0	967	0	971
1222	0	968	0	0	0	968
1223	2	0	1	977	0	980
1224	0	997	1	0	0	998
1225	952	0	3	0	0	955
1226	1	6	0	964	0	971
1227	0	0	974	0	0	974
1228	979	0	2	1	0	982
1229	923	0	2	4	0	929
1230	1	0	1000	0	0	1001
1231	0	2	1	943	0	946
1232	0	0	991	0	0	991
1233	0	2	0	935	0	937
1234	3	0	950	0	0	953
1235	947	0	4	2	0	953
1236	0	0	0	942	0	942
1237	0	975	0	0	0	975
1238	950	0	0	1	0	951
1239	0	1	0	847	0	848
1240	1	0	1	910	0	912
1241	0	0	920	0	0	920
1242	0	0	0	922	0	922
1243	2	0	909	0	0	911
1244	0	0	934	0	0	934
1245	1	0	0	907	0	908
1246	0	0	923	0	0	923
1247	915	0	2	0	0	917
1248	869	0	0	1	0	870
1249	896	0	2	0	0	898
1250	0	945	0	1	0	946
1251	0	2	0	864	0	866
1252	3	2	0	904	0	909
1253	0	893	0	3	0	896
1254	888	0	4	0	0	892
1255	1	2	0	889	0	892
1256	2	0	891	0	0	893
1257	0	0	851	0	0	851
1258	0	898	1	3	0	902
1259	868	0	7	0	0	875
1260	0	0	871	0	0	871
1261	877	0	0	0	0	877
1262	0	873	0	2	0	875
1263	1	0	793	0	0	794
1264	1	0	855	0	0	856
1265	1	0	859	0	0	860
1266	0	824	0	0	0	824
1267	1	0	845	0	0	846
1268	871	0	2	1	0	874
1269	0	4	0	793	0	797
1270	2	1	0	781	0	784
1271	0	3	0	795	0	798
1272	0	1	0	833	0	834
1273	0	0	866	0	0	866
1274	0	0	0	813	0	813
1275	1	6	0	771	0	778
1276	786	0	2	0	0	788
1277	734	0	2	0	0	736
1278	774	0	4	3	0	781
1279	1	0	832	0	0	833
1280	0	811	0	0	0	811
1281	1	800	0	0	0	801
1282	806	0	4	0	0	810
1283	0	792	0	1	0	793
1284	1	2	0	750	0	753
1285	0	3	0	758	0	761
1286	0	0	789	0	0	789
1287	0	739	0	2	0	741
1288	1	0	762	0	0	763
1289	776	0	2	2	0	780
1290	750	0	2	0	0	752
1291	1	1	0	749	0	751
1292	2	0	0	731	0	733
1293	0	6	0	696	0	702
1294	1	7	0	714	0	722
1295	0	0	774	0	0	774
1296	2	2	0	763	0	767
1297	3	0	756	0	0	759
1298	0	0	745	0	0	745
1299	0	705	0	2	0	707
1300	705	0	4	0	0	709
1301	1	704	0	0	0	705
1302	0	0	0	630	0	630
1303	0	0	682	0	0	682
1304	673	0	2	2	0	677
1305	1	0	663	0	0	664
1306	665	0	8	2	0	675
1307	596	0	7	0	0	603
1308	0	1	0	601	0	602
1309	0	5	0	588	0	593
1310	0	3	0	591	0	594
1311	2	0	635	1	0	638
1312	613	0	1	0	0	614
1313	0	647	0	0	0	647
1314	0	2	0	616	0	618
1315	596	0	2	0	0	598
1316	549	0	3	1	0	553
1317	604	0	1	0	0	605
1318	1	0	632	0	0	633
1319	577	0	6	0	0	583
1320	539	0	1	1	0	541
1321	0	0	565	0	0	565
1322	0	0	577	0	0	577
1323	0	4	0	562	0	566
1324	1	0	556	0	0	557
1325	0	541	0	1	0	542
1326	0	545	0	1	0	546
1327	561	0	2	0	0	563
1328	0	561	1	0	0	562
1329	0	0	0	563	0	563
1330	549	0	2	0	0	551
1331	0	547	0	0	0	547
1332	0	2	0	519	0	521
1333	1	5	0	510	0	516
1334	0	0	539	0	0	539
1335	0	0	0	497	0	497
1336	0	0	499	0	0	499
1337	0	0	511	0	0	511
1338	1	1	0	457	0	459
1339	0	0	0	457	0	457
1340	468	0	0	0	0	468
1341	0	466	0	1	0	467
1342	0	1	0	419	0	420
1343	0	3	0	440	0	443
1344	424	0	1	1	0	426
1345	0	440	0	0	0	440
1346	0	408	0	0	0	408
1347	0	395	0	3	0	398
1348	1	408	0	0	0	409
1349	419	0	1	0	0	420
1350	395	1	1	2	0	399
1351	386	0	7	0	0	393
1352	354	0	3	0	0	357
1353	0	4	3	401	0	408
1354	1	0	369	0	0	370
1355	0	353	0	0	0	353
1356	0	3	0	340	0	343
1357	0	0	364	0	0	364
1358	0	3	0	319	0	322
1359	1	3	0	340	0	344
1360	0	0	360	0	0	360
1361	1	0	0	313	0	314
1362	0	1	0	303	0	304
1363	334	0	3	0	0	337
1364	334	0	3	1	0	338
1365	325	0	1	0	0	326
1366	320	0	1	0	0	321
1367	0	0	0	308	0	308
1368	0	1	0	312	0	313
1369	0	1	0	319	0	320
1370	319	0	1	0	0	320
1371	0	3	0	300	0	303
1372	0	0	0	332	0	332
1373	0	0	349	0	0	349
1374	7	0	1	310	0	318
1375	0	322	0	0	0	322
1376	0	326	0	1	0	327
1377	324	0	3	2	0	329
1378	0	0	333	0	0	333
1379	0	294	0	0	0	294
1380	321	0	0	1	0	322
1381	0	2	0	309	0	311
1382	0	0	318	0	0	318
1383	0	0	0	300	0	300
1384	0	297	0	0	0	297
1385	292	1	1	1	0	295
1386	0	306	0	0	0	306
1387	295	0	1	0	0	296
1388	287	0	0	0	0	287
1389	0	1	0	278	0	279
1390	0	0	2	292	0	294
1391	0	290	0	0	0	290
1392	290	0	0	0	0	290
1393	1	0	288	0	0	289
1394	288	0	0	0	0	288
1395	272	0	2	0	0	274
1396	0	0	305	0	0	305
1397	0	1	0	271	0	272
1398	275	0	2	0	0	277
1399	0	1	278	0	0	279
1400	0	0	282	0	0	282
1401	259	0	1	0	0	260
1402	0	275	0	2	0	277
1403	0	272	0	0	0	272
1404	0	0	0	249	0	249
1405	1	0	265	0	0	266
1406	253	0	5	0	0	258
1407	0	0	255	1	0	256
1408	0	249	0	0	0	249
1409	238	0	1	0	0	239
1410	0	0	0	224	0	224
1411	234	0	0	0	0	234
1412	2	0	248	0	0	250
1413	1	2	0	242	0	245
1414	0	232	0	0	0	232
1415	0	0	0	211	0	211
1416	0	3	0	208	0	211
1417	1	1	225	0	0	227
1418	0	226	0	0	0	226
1419	0	211	0	0	0	211
1420	1	0	225	0	0	226
1421	215	0	0	0	0	215
1422	215	0	0	1	0	216
1423	0	0	0	247	0	247
1424	277	2	1	11	0	291
1425	0	293	0	57	0	350
1426	0	369	0	2	0	371
1427	384	1	4	0	0	389
1428	2	4	3	411	0	420
1429	413	2	9	5	0	429
1430	396	5	11	6	0	418
1431	5	2	0	454	0	461
1432	3	0	459	6	0	468
1433	449	0	1	2	0	452
1434	423	0	3	2	0	428
1435	0	1	0	454	0	455
1436	0	461	0	2	0	463
1437	0	8	0	446	0	454
1438	0	0	468	0	0	468
1439	0	0	459	0	0	459
1440	0	486	0	0	0	486
1441	0	3	0	459	0	462
1442	1	1	0	456	0	458
1443	0	0	487	0	0	487
1444	481	0	1	0	0	482
1445	460	0	2	3	0	465
1446	455	0	5	0	0	460
1447	470	0	4	0	0	474
1448	0	525	0	0	0	525
1449	0	498	0	0	0	498
1450	505	0	0	0	0	505
1451	0	3	0	469	0	472
1452	3	1	0	517	0	521
1453	0	523	0	2	0	525
1454	1	2	0	491	0	494
1455	1	1	0	689	0	691
1456	0	725	0	0	0	725
1457	0	0	719	0	0	719
1458	0	0	0	672	0	672
1459	693	0	6	1	0	700
1460	655	0	3	2	0	660
1461	0	0	708	0	0	708
1462	0	0	706	0	0	706
1463	0	0	726	0	0	726
1464	2	3	0	692	0	697
1465	0	0	703	0	0	703
1466	0	0	729	0	0	729
1467	2	3	0	724	0	729
1468	0	724	0	2	0	726
1469	0	0	681	0	0	681
1470	0	758	0	7	0	765
1471	744	0	4	1	0	749
1472	0	816	0	1	0	817
1473	0	1	0	799	0	800
1474	801	0	3	0	0	804
1475	0	6	1	804	0	811
1476	0	2	0	826	0	828
1477	0	0	727	0	0	727
1478	0	848	0	1	0	849
1479	0	851	0	0	0	851
1480	0	4	0	822	0	826
1481	0	0	0	784	0	784
1482	0	0	0	863	0	863
1483	0	0	851	0	0	851
1484	1	0	862	0	0	863
1485	848	0	3	0	0	851
1486	0	0	858	0	0	858
1487	0	1	848	0	0	849
1488	0	883	0	0	0	883
1489	0	2	0	848	0	850
1490	1	0	889	0	0	890
1491	1	8	0	843	0	852
1492	1	0	893	0	0	894
1493	0	3	1	869	0	873
1494	5	2	913	0	0	920
1495	1	9	2	783	0	795
1496	2	9	2	839	0	852
1497	4	987	0	3	0	994
1498	0	10	0	1010	0	1020
1499	0	1108	0	0	0	1108
1500	0	13	0	1039	0	1052
1501	1	4	0	995	0	1000
1502	1045	1	6	4	0	1056
1503	0	9	0	1103	0	1112
1504	0	0	1148	0	0	1148
1505	2	3	0	1108	0	1113
1506	0	4	0	1122	0	1126
1507	1	0	1112	0	0	1113
1508	0	0	1154	0	0	1154
1509	0	5	0	1127	0	1132
1510	0	2	0	1154	0	1156
1511	4	1	1201	0	0	1206
1512	0	1226	0	1	0	1227
1513	2	1212	0	6	0	1220
1514	1223	0	5	0	0	1228
1515	1	3	0	1245	0	1249
1516	1180	0	1	0	0	1181
1517	1221	0	2	1	0	1224
1518	0	1322	0	1	0	1323
1519	1282	0	2	4	0	1288
1520	1293	0	2	0	0	1295
1521	0	0	1362	0	0	1362
1522	1	8	0	1354	0	1363
1523	0	0	1387	0	0	1387
1524	2	3	0	1360	0	1365
1525	1	0	1401	0	0	1402
1526	0	1398	0	0	0	1398
1527	0	1401	0	1	0	1402
1528	0	4	0	1416	0	1420
1529	1398	0	3	1	0	1402
1530	0	5	0	1354	0	1359
1531	1	5	0	1443	0	1449
1532	0	0	1428	0	0	1428
1533	2	0	1435	0	0	1437
1534	0	0	1510	0	0	1510
1535	3	0	1	1453	0	1457
1536	0	5	0	1480	0	1485
1537	0	1511	0	0	0	1511
1538	0	1499	0	1	0	1500
1539	1508	0	2	1	0	1511
1540	1	1529	0	2	0	1532
1541	1	0	1526	0	0	1527
1542	0	4	0	1560	0	1564
1543	2	0	1576	0	0	1578
1544	0	1582	0	1	0	1583
1545	0	2	0	1531	0	1533
1546	1525	0	4	0	0	1529
1547	0	0	1570	0	0	1570
1548	0	1502	0	3	0	1505
1549	0	0	1494	0	0	1494
1550	0	1591	0	0	0	1591
1551	3	2	0	1449	0	1454
1552	1540	0	1	2	0	1543
1553	1526	0	7	1	0	1534
1554	0	1635	0	0	0	1635
1555	1578	0	10	0	0	1588
1556	1	4	0	1544	0	1549
1557	1535	0	5	0	0	1540
1558	0	0	1582	0	0	1582
1559	0	0	1638	0	0	1638
1560	0	7	0	1590	0	1597
1561	0	7	0	1542	0	1549
1562	0	0	1624	0	0	1624
1563	0	3	0	1587	0	1590
1564	1557	0	11	0	0	1568
1565	1517	0	3	2	0	1522
1566	0	1587	0	8	0	1595
1567	0	1540	0	2	0	1542
1568	1548	0	3	0	0	1551
1569	0	0	0	1517	0	1517
1570	1505	0	0	2	0	1507
1571	0	1557	0	0	0	1557
1572	1473	0	6	0	0	1479
1573	0	0	1471	0	0	1471
1574	3	0	1468	0	0	1471
1575	0	4	6	1360	0	1370
1576	0	0	1402	0	0	1402
1577	0	4	0	1295	0	1299
1578	0	1	0	1300	0	1301
1579	4	0	1351	0	0	1355
1580	2	4	0	1293	0	1299
1581	0	2	0	1298	0	1300
1582	0	0	1310	0	0	1310
1583	1	0	1300	0	0	1301
1584	1270	0	2	3	0	1275
1585	0	0	1281	0	0	1281
1586	1241	0	11	0	0	1252
1587	1215	2	3	0	0	1220
1588	1	0	1260	0	0	1261
1589	0	0	1276	0	0	1276
1590	1	5	0	1229	0	1235
1591	0	3	0	1250	0	1253
1592	0	1209	0	0	0	1209
1593	0	1200	1	0	0	1201
1594	2	0	1225	2	0	1229
1595	1210	0	3	1	0	1214
1596	1178	1	6	2	0	1187
1597	3	0	1197	0	0	1200
1598	0	0	1225	0	0	1225
1599	5	0	0	1172	0	1177
1600	0	1205	0	0	0	1205
1601	0	3	0	1156	0	1159
1602	2	0	0	1054	0	1056
1603	1163	0	0	0	0	1163
1604	1084	0	2	0	0	1086
1605	12	5	1	1135	0	1153
1606	2	0	1092	0	0	1094
1607	971	0	6	0	0	977
1608	0	998	0	1	0	999
1609	967	2	5	0	0	974
1610	948	0	5	0	0	953
1611	2	978	2	0	0	982
1612	0	950	0	0	0	950
1613	3	3	0	842	0	848
1614	2	5	0	884	0	891
1615	0	933	0	0	0	933
1616	0	1	0	903	0	904
1617	0	6	0	899	0	905
1618	1	0	934	0	0	935
1619	915	2	5	2	0	924
1620	904	0	1	2	0	907
1621	828	0	7	1	0	836
1622	2	3	0	854	0	859
1623	776	0	0	1	0	777
1624	0	787	0	0	0	787
1625	3	2	0	737	0	742
1626	0	740	0	1	0	741
1627	2	727	0	1	0	730
1628	729	0	3	1	0	733
1629	708	0	1	2	0	711
1630	666	0	6	0	0	672
1631	630	0	3	0	0	633
1632	656	0	3	1	0	660
1633	0	0	705	0	0	705
1634	660	0	1	2	0	663
1635	0	0	688	0	0	688
1636	680	0	0	1	0	681
1637	610	0	2	1	0	613
1638	646	0	2	1	0	649
1639	0	0	701	0	0	701
1640	1	1	0	661	0	663
1641	2	662	0	0	0	664
1642	635	1	3	0	0	639
1643	601	0	2	1	0	604
1644	0	673	1	0	0	674
1645	638	0	0	0	0	638
1646	1	1	0	642	0	644
1647	4	603	0	3	0	610
1648	611	0	3	0	0	614
1649	579	0	2	1	0	582
1650	2	0	0	588	0	590
1651	571	0	4	1	0	576
1652	0	2	0	506	0	508
1653	0	2	0	524	0	526
1654	0	0	541	0	0	541
1655	1	4	0	464	0	469
1656	3	1	0	455	0	459
1657	1	0	464	1	0	466
1658	0	0	456	0	0	456
1659	0	1	0	434	0	435
1660	1	0	437	0	0	438
1661	423	0	2	0	0	425
1662	0	430	0	1	0	431
1663	1	3	0	384	0	388
1664	1	10	0	374	0	385
1665	0	1	0	387	0	388
1666	391	0	1	0	0	392
1667	394	1	1	0	0	396
1668	392	0	2	0	0	394
1669	0	405	0	0	0	405
1670	0	1	0	350	0	351
1671	1	0	0	287	0	288
1672	320	0	4	0	0	324
1673	316	0	2	0	0	318
1674	1	0	0	331	0	332
1675	0	0	332	1	0	333
1676	292	2	0	2	0	296
1677	307	0	2	0	0	309
1678	0	0	317	0	0	317
1679	277	0	1	1	0	279
1680	0	0	241	14	0	255
1681	228	0	0	0	0	228
1682	0	1	0	228	0	229
1683	10	181	0	0	0	191
1684	0	0	179	0	0	179
1685	0	178	1	0	0	179
1686	0	184	0	1	0	185
1687	180	0	2	0	0	182
1688	0	0	0	159	0	159
1689	0	0	0	177	0	177
1690	175	0	1	0	0	176
1691	0	0	0	179	0	179
1692	0	2	0	172	0	174
1693	0	0	0	171	0	171
1694	0	0	0	164	0	164
1695	0	0	169	0	0	169
1696	0	0	167	0	0	167
1697	0	169	0	0	0	169
1698	180	0	1	0	0	181
1699	0	0	0	175	0	175
1700	0	177	0	0	0	177
1701	0	0	0	173	0	173
1702	0	1	0	174	0	175
1703	0	2	0	177	0	179
1704	0	1	0	179	0	180
1705	0	0	0	180	0	180
1706	1	181	0	0	0	182
1707	0	0	0	179	0	179
1708	0	0	188	0	0	188
1709	0	180	1	0	0	181
1710	2	2	0	171	0	175
1711	0	0	0	180	0	180
1712	0	178	0	0	0	178
1713	0	186	0	0	0	186
1714	187	1	0	0	0	188
1715	0	193	0	0	0	193
1716	171	0	4	1	0	176
1717	178	0	0	1	0	179
1718	1	0	192	0	0	193
1719	1	1	0	179	0	181
1720	0	0	191	0	0	191
1721	0	187	0	0	0	187
1722	0	1	0	164	0	165
1723	0	0	0	162	0	162
1724	0	1	0	167	0	168
1725	4	0	0	168	0	172
1726	0	0	187	0	0	187
1727	0	1	0	178	0	179
1728	0	0	181	0	0	181
1729	0	0	179	0	0	179
1730	174	0	1	1	0	176
1731	173	0	1	0	0	174
1732	178	0	0	0	0	178
1733	0	187	0	0	0	187
1734	0	1	0	167	0	168
1735	1	0	182	0	0	183
1736	0	0	0	176	0	176
1737	1	1	174	0	0	176
1738	175	0	1	0	0	176
1739	161	0	0	0	0	161
1740	169	0	0	0	0	169
1741	0	0	176	0	0	176
1742	0	0	177	0	0	177
1743	1	0	0	158	0	159
1744	1	0	0	155	0	156
1745	1	0	0	167	0	168
1746	0	0	169	0	0	169
1747	0	0	165	0	0	165
1748	169	0	0	0	0	169
1749	0	0	0	155	0	155
1750	0	1	0	163	0	164
1751	167	0	0	0	0	167
1752	1	0	0	163	0	164
1753	167	0	1	0	0	168
1754	158	0	0	0	0	158
1755	150	0	1	0	0	151
1756	1	0	156	0	0	157
1757	0	160	0	0	0	160
1758	151	0	0	0	0	151
1759	0	0	0	141	0	141
1760	0	0	0	152	0	152
1761	0	152	0	0	0	152
1762	147	0	2	1	0	150
1763	131	0	1	0	0	132
1764	142	0	1	0	0	143
1765	0	147	0	0	0	147
1766	141	0	0	0	0	141
1767	137	0	0	0	0	137
1768	136	0	2	0	0	138
1769	0	1	0	113	0	114
1770	0	1	0	139	0	140
1771	0	0	148	0	0	148
1772	0	1	0	133	0	134
1773	0	0	0	138	0	138
1774	0	0	146	0	0	146
1775	146	0	0	0	0	146
1776	144	0	0	0	0	144
1777	1	0	0	150	0	151
1778	0	144	0	1	0	145
1779	1	150	0	0	0	151
1780	1	0	0	130	0	131
1781	0	0	151	0	0	151
1782	1	0	0	147	0	148
1783	0	0	151	0	0	151
1784	0	0	148	0	0	148
1785	0	0	0	139	0	139
1786	144	0	1	0	0	145
1787	128	0	0	0	0	128
1788	0	1	0	142	0	143
1789	0	4	0	143	0	147
1790	0	0	0	138	0	138
1791	1	0	0	142	0	143
1792	140	0	1	0	0	141
1793	134	0	0	1	0	135
1794	145	0	1	0	0	146
1795	0	0	152	0	0	152
1796	0	1	0	141	0	142
1797	1	0	0	144	0	145
1798	143	0	0	0	0	143
1799	0	146	0	1	0	147
1800	140	0	2	0	0	142
1801	142	0	0	0	0	142
1802	128	0	0	0	0	128
1803	142	0	0	0	0	142
1804	0	0	143	0	0	143
1805	1	0	141	0	0	142
1806	142	0	0	0	0	142
1807	144	0	1	0	0	145
1808	130	0	1	1	0	132
1809	146	0	0	0	0	146
1810	0	0	157	0	0	157
1811	1	157	0	0	0	158
1812	0	0	0	156	0	156
1813	152	0	1	0	0	153
1814	149	0	1	0	0	150
1815	150	0	0	0	0	150
1816	144	0	2	1	0	147
1817	142	0	1	0	0	143
1818	144	0	2	0	0	146
1819	0	0	154	0	0	154
1820	0	0	155	0	0	155
1821	0	0	0	149	0	149
1822	0	0	150	0	0	150
1823	0	150	0	0	0	150
1824	0	152	0	0	0	152
1825	0	3	0	143	0	146
1826	0	0	156	0	0	156
1827	0	0	158	0	0	158
1828	164	0	0	0	0	164
1829	161	0	1	0	0	162
1830	0	0	0	166	0	166
1831	171	0	0	0	0	171
1832	0	0	0	165	0	165
1833	0	1	0	176	0	177
1834	0	0	170	0	0	170
1835	0	0	180	0	0	180
1836	0	0	0	167	0	167
1837	0	0	162	0	0	162
1838	159	0	0	1	0	160
1839	169	0	22	0	0	191
1840	0	209	0	0	0	209
1841	199	0	1	1	0	201
1842	0	0	225	0	0	225
1843	253	0	0	0	0	253
1844	242	0	2	455	0	699
1845	819	0	3	0	0	822
1846	0	0	0	1097	0	1097
1847	0	1221	0	1	0	1222
1848	1189	1	31	25	0	1246
1849	1476	5	20	55	0	1556
1850	22	10	18	1575	0	1625
1851	1501	80	31	51	0	1663
1852	0	1658	21	72	0	1751
1853	0	5	0	1758	0	1763
1854	0	1	1800	0	0	1801
1855	1760	0	2	0	0	1762
1856	0	0	1868	0	0	1868
1857	1	5	0	1849	0	1855
1858	0	1797	0	1	0	1798
1859	0	1912	0	4	0	1916
1860	0	4	0	1919	0	1923
1861	0	2160	0	2	0	2162
1862	2	2	0	2140	0	2144
1863	0	1	0	2148	0	2149
1864	1	4	0	2198	0	2203
1865	2126	0	11	0	0	2137
1866	1	13	0	2209	0	2223
1867	7	0	2223	0	0	2230
1868	0	2375	0	0	0	2375
1869	2336	1	10	1	0	2348
1870	0	12	0	2255	0	2267
1871	4	16	0	2338	0	2358
1872	0	5	0	2444	0	2449
1873	7	0	2406	0	0	2413
1874	0	2596	0	4	0	2600
1875	2601	1	3	2	0	2607
1876	1	7	0	2575	0	2583
1877	0	2651	0	3	0	2654
1878	2531	2	16	1	0	2550
1879	1	0	2631	0	0	2632
1880	2558	0	6	1	0	2565
1881	2	0	2643	0	0	2645
1882	2	0	2647	0	0	2649
1883	0	2687	0	2	0	2689
1884	0	6	0	2717	0	2723
1885	6	0	2731	0	0	2737
1886	0	2750	0	0	0	2750
1887	1	3	0	2688	0	2692
1888	0	2754	2	1	0	2757
1889	4	0	2749	0	0	2753
1890	0	9	0	2720	0	2729
1891	0	0	2833	0	0	2833
1892	7	8	0	2637	0	2652
1893	0	6	0	2751	0	2757
1894	1	0	2825	1	0	2827
1895	0	4	1	2732	0	2737
1896	2777	0	8	1	0	2786
1897	0	2824	0	4	0	2828
1898	0	0	2782	2	0	2784
1899	2787	0	7	1	0	2795
1900	0	3	0	2716	0	2719
1901	0	2805	0	8	0	2813
1902	2762	0	7	0	0	2769
1903	2624	0	7	0	0	2631
1904	1	4	0	2643	0	2648
1905	0	16	1	2716	0	2733
1906	6	9	0	2779	0	2794
1907	1	12	0	2855	0	2868
1908	0	2762	0	1	0	2763
1909	1	9	2	2846	0	2858
1910	0	2716	2	2	0	2720
1911	3	2712	0	4	0	2719
1912	0	2629	2	2	0	2633
1913	0	0	2754	0	0	2754
1914	0	2829	0	0	0	2829
1915	2800	0	5	2	0	2807
1916	0	2972	0	0	0	2972
1917	5	12	0	2899	0	2916
1918	0	3005	0	2	0	3007
1919	0	3	0	2958	0	2961
1920	0	14	0	2961	0	2975
1921	0	0	3024	0	0	3024
1922	3035	0	11	1	0	3047
1923	2900	0	12	2	0	2914
1924	2967	0	3	1	0	2971
1925	0	3145	0	1	0	3146
1926	0	14	3	2987	0	3004
1927	0	0	3057	0	0	3057
1928	0	3091	0	0	0	3091
1929	0	2	0	3004	0	3006
1930	0	3072	0	0	0	3072
1931	2966	4	19	6	0	2995
1932	2869	0	10	0	0	2879
1933	2947	0	1	0	0	2948
1934	2898	0	3	0	0	2901
1935	1	10	0	2888	0	2899
1936	0	2	0	3082	0	3084
1937	1	3086	0	1	0	3088
1938	3	6	0	3038	0	3047
1939	3	0	3130	0	0	3133
1940	0	7	0	3086	0	3093
1941	3	0	3107	0	0	3110
1942	0	3028	0	1	0	3029
1943	2	0	3060	0	0	3062
1944	2	9	2	3036	0	3049
1945	0	0	3144	0	0	3144
1946	3	7	4	2963	0	2977
1947	0	12	0	2830	0	2842
1948	5	18	2	2914	0	2939
1949	0	7	0	3081	0	3088
1950	3065	0	12	2	0	3079
1951	0	3157	0	5	0	3162
1952	3016	0	21	3	0	3040
1953	1	0	3069	0	0	3070
1954	2925	0	6	0	0	2931
1955	2884	0	7	0	0	2891
1956	0	0	2950	0	0	2950
1957	0	0	2955	0	0	2955
1958	0	2933	0	13	0	2946
1959	0	2735	0	3	0	2738
1960	1	0	2853	2	0	2856
1961	0	3011	0	5	0	3016
1962	2	6	2	2874	0	2884
1963	2946	0	7	1	0	2954
1964	0	11	2	2923	0	2936
1965	2888	0	7	3	0	2898
1966	2930	0	9	6	0	2945
1967	0	3118	0	1	0	3119
1968	2985	2	4	0	0	2991
1969	2837	0	3	0	0	2840
1970	0	9	0	2951	0	2960
1971	2943	0	5	3	0	2951
1972	0	3038	0	2	0	3040
1973	0	3	0	2853	0	2856
1974	2863	0	8	0	0	2871
1975	0	0	2873	0	0	2873
1976	2763	0	10	0	0	2773
1977	0	7	1	2814	0	2822
1978	2	0	2724	0	0	2726
1979	0	1	2752	0	0	2753
1980	2789	0	6	0	0	2795
1981	2690	0	10	2	0	2702
1982	0	12	1	2653	0	2666
1983	1	7	0	2695	0	2703
1984	2	11	1	2808	0	2822
1985	2	2790	0	2	0	2794
1986	2764	0	2	3	0	2769
1987	0	2824	0	2	0	2826
1988	2671	0	3	0	0	2674
1989	1	0	2862	0	0	2863
1990	2	7	0	2756	0	2765
1991	2790	0	4	1	0	2795
1992	6	5	0	2640	0	2651
1993	1	17	0	2757	0	2775
1994	0	2516	0	13	0	2529
1995	2535	0	7	1	0	2543
1996	0	2415	0	29	0	2444
1997	0	9	1	2311	0	2321
1998	3	0	2346	0	0	2349
1999	2203	0	5	1	0	2209
2000	0	0	2134	0	0	2134
2001	2093	0	6	0	0	2099
2002	0	2148	0	2	0	2150
2003	0	2	0	2013	0	2015
2004	0	2052	0	0	0	2052
2005	1994	0	1	0	0	1995
2006	0	8	0	1879	0	1887
2007	3	10	0	1957	0	1970
2008	0	0	2004	1	0	2005
2009	1970	0	7	1	0	1978
2010	1	7	2	1943	0	1953
2011	1	1	1930	0	0	1932
2012	0	1895	0	0	0	1895
2013	4	4	0	1751	0	1759
2014	1755	0	4	1	0	1760
2015	2	7	0	1792	0	1801
2016	5	0	1787	0	0	1792
2017	1771	0	7	4	0	1782
2018	0	8	0	1615	0	1623
2019	27	0	1665	0	0	1692
2020	3	16	0	1536	0	1555
2021	3	11	0	1566	0	1580
2022	0	1551	0	2	0	1553
2023	1542	2	13	1	0	1558
2024	0	1632	0	5	0	1637
2025	1573	0	18	0	0	1591
2026	0	5	0	1561	0	1566
2027	1	1517	0	4	0	1522
2028	1	13	2	1496	0	1512
2029	3	0	1576	0	0	1579
2030	1558	3	12	1	0	1574
2031	0	6	0	1475	0	1481
2032	2	13	0	1482	0	1497
2033	2	14	1	1461	0	1478
2034	1	0	1462	0	0	1463
2035	2	0	1522	0	0	1524
2036	1	1568	0	0	0	1569
2037	0	5	0	1543	0	1548
2038	1534	0	7	1	0	1542
2039	0	1598	0	0	0	1598
2040	0	3	0	1530	0	1533
2041	1501	2	1	1	0	1505
2042	1496	0	10	1	0	1507
2043	0	1628	0	0	0	1628
2044	1569	0	2	3	0	1574
2045	1474	0	5	3	0	1482
2046	0	10	0	1630	0	1640
2047	0	1659	0	1	0	1660
2048	0	2	0	1628	0	1630
2049	1664	0	3	1	0	1668
2050	1	0	1711	0	0	1712
2051	0	5	0	1657	0	1662
2052	0	6	0	1643	0	1649
2053	1	0	1705	0	0	1706
2054	3	0	0	1622	0	1625
2055	1636	0	0	0	0	1636
2056	1522	1	6	0	0	1529
2057	0	2	0	1665	0	1667
2058	3	0	1650	0	0	1653
2059	0	0	1681	0	0	1681
2060	0	1678	1	1	0	1680
2061	0	1699	0	1	0	1700
2062	3	2	1	1680	0	1686
2063	1787	0	1	0	0	1788
2064	0	1905	0	1	0	1906
2065	1836	0	15	0	0	1851
2066	0	7	1	1699	0	1707
2067	0	0	0	1838	0	1838
2068	1746	0	4	4	0	1754
2069	0	1854	0	4	0	1858
2070	1784	2	9	5	0	1800
2071	1	0	1742	0	0	1743
2072	0	0	1755	2	0	1757
2073	0	9	1	1639	0	1649
2074	3	0	1618	0	0	1621
2075	0	0	1696	0	0	1696
2076	1	6	0	1646	0	1653
2077	0	0	1711	0	0	1711
2078	1	5	0	1593	0	1599
2079	1	8	0	1620	0	1629
2080	0	0	1682	0	0	1682
2081	1	3	0	1587	0	1591
2082	0	5	0	1615	0	1620
2083	0	1673	0	1	0	1674
2084	1633	0	3	1	0	1637
2085	2	0	1666	0	0	1668
2086	0	5	0	1616	0	1621
2087	0	2	0	1617	0	1619
2088	2	1	1612	0	0	1615
2089	1589	2	4	0	0	1595
2090	0	1652	0	0	0	1652
2091	0	11	0	1575	0	1586
2092	1	7	1	1605	0	1614
2093	0	1498	0	0	0	1498
2094	0	0	1557	0	0	1557
2095	0	1599	1	0	0	1600
2096	1553	0	4	0	0	1557
2097	1	0	1606	0	0	1607
2098	0	5	2	1566	0	1573
2099	2	0	1546	0	0	1548
2100	0	0	1560	0	0	1560
2101	2	1585	0	2	0	1589
2102	1	3	0	1500	0	1504
2103	1542	0	9	2	0	1553
2104	1506	0	5	1	0	1512
2105	0	1605	1	1	0	1607
2106	0	1	0	1567	0	1568
2107	1531	0	3	0	0	1534
2108	1449	0	2	7	0	1458
2109	0	1557	0	4	0	1561
2110	1570	0	6	1	0	1577
2111	0	11	0	1599	0	1610
2112	0	1634	0	0	0	1634
2113	4	4	0	1538	0	1546
2114	8	6	2	1452	0	1468
2115	1	3	2	1558	0	1564
2116	19	0	1547	1	0	1567
2117	2	0	1564	2	0	1568
2118	0	1578	0	3	0	1581
2119	1512	3	9	1	0	1525
2120	0	1567	0	5	0	1572
2121	0	10	2	1451	0	1463
2122	2	0	1587	0	0	1589
2123	1	6	3	1457	0	1467
2124	0	10	0	1442	0	1452
2125	1	6	0	1486	0	1493
2126	1525	0	3	0	0	1528
2127	0	2	0	1565	0	1567
2128	1	0	1570	0	0	1571
2129	1511	1	11	3	0	1526
2130	1480	0	4	0	0	1484
2131	1297	2	12	2	0	1313
2132	1199	0	3	1	0	1203
2133	1281	0	4	0	0	1285
2134	0	1362	0	0	0	1362
2135	2	3	0	1328	0	1333
2136	0	1365	0	1	0	1366
2137	1260	0	3	1	0	1264
2138	1197	0	5	0	0	1202
2139	1210	0	10	2	0	1222
2140	0	1261	0	2	0	1263
2141	0	1180	0	0	0	1180
2142	0	1095	0	5	0	1100
2143	3	0	1180	0	0	1183
2144	2	6	0	1168	0	1176
2145	0	1251	1	0	0	1252
2146	0	1206	0	0	0	1206
2147	0	11	0	1134	0	1145
2148	0	3	0	1181	0	1184
2149	0	0	1254	0	0	1254
2150	1237	0	3	0	0	1240
2151	1	3	0	1118	0	1122
2152	2	5	1	1203	0	1211
2153	2	0	1241	0	0	1243
2154	4	0	1265	0	0	1269
2155	0	1302	0	1	0	1303
2156	0	3	0	1233	0	1236
2157	2	8	1	1193	0	1204
2158	0	0	1314	0	0	1314
2159	1250	0	9	0	0	1259
2160	1215	0	7	0	0	1222
2161	1	0	1316	0	0	1317
2162	1279	0	1	0	0	1280
2163	2	0	1229	0	0	1231
2164	1241	0	7	1	0	1249
2165	1234	0	2	6	0	1242
2166	0	0	1365	0	0	1365
2167	1	4	0	1236	0	1241
2168	2	2	1	1155	0	1160
2169	1	2	0	1198	0	1201
2170	1255	1	2	0	0	1258
2171	1243	0	3	1	0	1247
2172	3	0	1298	0	0	1301
2173	0	0	1282	0	0	1282
2174	1267	0	4	2	0	1273
2175	1135	0	7	0	0	1142
2176	1	0	1165	0	0	1166
2177	1	0	1242	0	0	1243
2178	0	7	0	1203	0	1210
2179	1	0	1259	0	0	1260
2180	0	2	0	1182	0	1184
2181	1222	0	1	0	0	1223
2182	1	0	1229	0	0	1230
2183	1210	1	3	1	0	1215
2184	0	1	1239	0	0	1240
2185	3	2	1	1092	0	1098
2186	1	6	0	1060	0	1067
2187	0	6	0	1142	0	1148
2188	0	1163	0	0	0	1163
2189	3	2	0	1112	0	1117
2190	4	2	0	1042	0	1048
2191	1132	0	2	1	0	1135
2192	1	0	1169	0	0	1170
2193	1088	0	3	0	0	1091
2194	3	1	1116	0	0	1120
2195	1081	1	1	0	0	1083
2196	0	1116	0	7	0	1123
2197	3	0	1031	0	0	1034
2198	2	0	1133	0	0	1135
2199	0	1	2	1053	0	1056
2200	2	3	3	1065	0	1073
2201	2	0	1078	1	0	1081
2202	0	0	1090	0	0	1090
2203	2	0	1061	0	0	1063
2204	1093	0	3	0	0	1096
2205	1032	0	12	0	0	1044
2206	1030	0	3	1	0	1034
2207	0	13	0	985	0	998
2208	0	4	0	1058	0	1062
2209	0	1	1101	0	0	1102
2210	1	5	0	1014	0	1020
2211	1	2	0	997	0	1000
2212	1003	0	2	2	0	1007
2213	979	0	8	0	0	987
2214	959	0	3	0	0	962
2215	0	6	2	921	0	929
2216	0	4	0	923	0	927
2217	1	3	0	943	0	947
2218	1011	0	5	0	0	1016
2219	1	3	0	1036	0	1040
2220	0	1050	0	1	0	1051
2221	1	2	0	1026	0	1029
2222	1	1059	0	0	0	1060
2223	988	0	8	1	0	997
2224	1020	0	4	1	0	1025
2225	0	1093	0	0	0	1093
2226	0	1065	0	1	0	1066
2227	2	1	0	1002	0	1005
2228	2	0	1093	0	0	1095
2229	0	2	1	1054	0	1057
2230	0	4	1086	0	0	1090
2231	0	1088	1	0	0	1089
2232	0	1	0	1055	0	1056
2233	2	4	0	1025	0	1031
2234	0	0	1128	0	0	1128
2235	2	6	2	1079	0	1089
2236	0	0	1071	0	0	1071
2237	1091	0	2	2	0	1095
2238	1041	0	5	0	0	1046
2239	1023	0	5	0	0	1028
2240	0	8	0	1012	0	1020
2241	3	1	0	1055	0	1059
2242	0	0	1096	0	0	1096
2243	2	0	1	1082	0	1085
2244	2	1071	0	3	0	1076
2245	0	0	965	0	0	965
2246	2	0	1111	0	0	1113
2247	0	1	0	1095	0	1096
2248	6	0	1012	0	0	1018
2249	3	0	1106	0	0	1109
2250	1084	1	1	1	0	1087
2251	0	1120	0	1	0	1121
2252	1103	0	3	2	0	1108
2253	1062	0	6	0	0	1068
2254	1097	0	2	1	0	1100
2255	0	5	0	1053	0	1058
2256	0	8	0	1059	0	1067
2257	2	0	1113	0	0	1115
2258	2	2	0	1087	0	1091
2259	0	1101	0	0	0	1101
2260	1101	1	2	3	0	1107
2261	0	1102	0	0	0	1102
2262	0	1049	0	0	0	1049
2263	2	4	1	938	0	945
2264	3	0	1078	0	0	1081
2265	1	9	0	1019	0	1029
2266	5	1	1083	0	0	1089
2267	0	1033	0	5	0	1038
2268	1068	0	6	0	0	1074
2269	979	1	10	0	0	990
2270	1018	2	7	0	0	1027
2271	0	0	1039	0	0	1039
2272	5	0	979	0	0	984
2273	974	1	3	1	0	979
2274	920	0	1	1	0	922
2275	903	1	3	1	0	908
2276	0	3	0	883	0	886
2277	4	7	0	909	0	920
2278	931	0	0	0	0	931
2279	927	1	2	2	0	932
2280	0	0	984	0	0	984
2281	0	0	959	0	0	959
2282	930	1	2	0	0	933
2283	3	1	921	0	0	925
2284	904	0	3	0	0	907
2285	1	0	950	0	0	951
2286	1	2	0	900	0	903
2287	1	3	936	0	0	940
2288	0	4	0	862	0	866
2289	2	1	1	895	0	899
2290	0	900	0	1	0	901
2291	922	0	2	0	0	924
2292	2	0	928	0	0	930
2293	898	0	4	0	0	902
2294	0	909	0	2	0	911
2295	852	0	1	1	0	854
2296	1	4	0	765	0	770
2297	0	3	0	870	0	873
2298	1	876	0	3	0	880
2299	1	2	0	812	0	815
2300	0	1	0	824	0	825
2301	1	0	0	848	0	849
2302	812	0	4	1	0	817
2303	805	0	1	1	0	807
2304	0	0	857	1	0	858
2305	0	819	0	6	0	825
2306	2	4	0	761	0	767
2307	1	3	0	736	0	740
2308	1	0	784	0	0	785
2309	1	4	0	742	0	747
2310	766	0	5	0	0	771
2311	714	0	1	1	0	716
2312	701	0	3	0	0	704
2313	1	0	0	743	0	744
2314	761	0	1	0	0	762
2315	724	0	1	0	0	725
2316	699	1	5	0	0	705
2317	0	1	0	688	0	689
2318	0	2	0	687	0	689
2319	0	1	1	708	0	710
2320	1	3	0	683	0	687
2321	3	2	0	712	0	717
2322	2	0	729	1	0	732
2323	3	0	760	0	0	763
2324	0	764	0	1	0	765
2325	0	1	0	738	0	739
2326	0	2	0	683	0	685
2327	5	3	0	707	0	715
2328	0	1	800	0	0	801
2329	1	4	0	774	0	779
2330	0	1	859	0	0	860
2331	0	3	0	826	0	829
2332	1	0	859	0	0	860
2333	0	841	2	1	0	844
2334	0	2	1	829	0	832
2335	0	0	884	0	0	884
2336	859	2	3	1	0	865
2337	0	978	0	4	0	982
2338	1	0	0	934	0	935
2339	0	1000	0	0	0	1000
2340	1	5	1	951	0	958
2341	996	0	1	1	0	998
2342	0	3	0	1019	0	1022
2343	0	1051	1	4	0	1056
2344	1038	0	4	2	0	1044
2345	1	3	0	975	0	979
2346	0	4	0	1030	0	1034
2347	1011	0	6	0	0	1017
2348	0	3	0	969	0	972
2349	0	3	0	1024	0	1027
2350	3	0	1025	0	0	1028
2351	3	0	1064	0	0	1067
2352	0	5	0	1040	0	1045
2353	2	0	1028	0	0	1030
2354	2	0	1064	0	0	1066
2355	1044	0	7	0	0	1051
2356	0	0	1094	0	0	1094
2357	0	1091	0	1	0	1092
2358	0	3	0	1079	0	1082
2359	1049	0	4	0	0	1053
2360	1004	0	1	1	0	1006
2361	1070	0	3	1	0	1074
2362	0	1132	0	0	0	1132
2363	0	1	0	1067	0	1068
2364	2	4	0	1017	0	1023
2365	1036	0	1	4	0	1041
2366	983	0	2	1	0	986
2367	1044	0	5	0	0	1049
2368	3	2	1121	0	0	1126
2369	0	1103	0	2	0	1105
2370	0	1079	0	2	0	1081
2371	1	0	0	1043	0	1044
2372	2	6	0	1027	0	1035
2373	4	0	1102	0	0	1106
2374	1132	0	4	1	0	1137
2375	1080	0	6	0	0	1086
2376	0	1	0	1050	0	1051
2377	1	2	0	1027	0	1030
2378	1	0	0	1037	0	1038
2379	1115	0	6	0	0	1121
2380	0	0	1088	0	0	1088
2381	1	0	1127	0	0	1128
2382	0	6	0	1079	0	1085
2383	1	0	1096	0	0	1097
2384	1097	0	0	0	0	1097
2385	1024	0	3	0	0	1027
2386	1068	0	1	0	0	1069
2387	0	1122	1	0	0	1123
2388	1118	0	6	0	0	1124
2389	0	4	0	1047	0	1051
2390	0	5	0	1032	0	1037
2391	2	2	0	1062	0	1066
2392	0	0	1123	0	0	1123
2393	2	11	0	1073	0	1086
2394	0	1106	0	0	0	1106
2395	1076	2	5	0	0	1083
2396	0	1065	0	2	0	1067
2397	8	0	1023	0	0	1031
2398	0	1079	0	1	0	1080
2399	1078	0	1	0	0	1079
2400	0	1131	0	0	0	1131
2401	1	0	0	1090	0	1091
2402	0	1104	0	2	0	1106
2403	1091	0	2	6	0	1099
2404	1008	0	7	1	0	1016
2405	1037	0	12	1	0	1050
2406	3	0	1065	3	0	1071
2407	1	0	1040	0	0	1041
2408	2	0	972	0	0	974
2409	939	0	7	0	0	946
2410	0	5	0	871	0	876
2411	13	5	0	767	0	785
2412	0	1	812	0	0	813
2413	0	1	0	792	0	793
2414	754	0	0	1	0	755
2415	0	789	0	0	0	789
2416	717	2	6	0	0	725
2417	0	0	725	0	0	725
2418	703	0	2	1	0	706
2419	652	1	3	0	0	656
2420	658	2	3	0	0	663
2421	0	0	690	0	0	690
2422	1	2	0	526	0	529
2423	0	0	551	0	0	551
2424	0	1	0	514	0	515
2425	1	0	530	0	0	531
2426	4	2	0	442	0	448
2427	0	0	0	414	0	414
2428	458	0	1	1	0	460
2429	436	2	3	2	0	443
2430	452	0	0	0	0	452
2431	0	1	0	459	0	460
2432	0	455	0	0	0	455
2433	0	449	0	1	0	450
2434	455	0	1	0	0	456
2435	8	0	454	0	0	462
2436	447	0	3	0	0	450
2437	1	0	451	0	0	452
2438	427	0	1	1	0	429
2439	395	0	2	0	0	397
2440	0	0	429	0	0	429
2441	412	0	1	0	0	413
2442	369	0	1	7	0	377
2443	372	0	1	0	0	373
2444	0	403	0	0	0	403
2445	1	2	0	391	0	394
2446	0	0	388	0	0	388
2447	1	0	393	0	0	394
2448	0	384	0	0	0	384
2449	0	388	0	0	0	388
2450	0	1	0	391	0	392
2451	396	0	0	0	0	396
2452	0	410	0	0	0	410
2453	1	1	0	406	0	408
2454	0	418	0	0	0	418
2455	391	0	0	0	0	391
2456	0	0	0	420	0	420
2457	2	0	411	0	0	413
2458	0	416	0	1	0	417
2459	1	420	0	0	0	421
2460	0	1	0	416	0	417
2461	0	434	1	2	0	437
2462	0	1	0	422	0	423
2463	420	0	1	0	0	421
2464	395	0	2	0	0	397
2465	391	1	3	0	0	395
2466	448	0	1	0	0	449
2467	3	0	490	0	0	493
2468	0	506	0	0	0	506
2469	0	502	0	0	0	502
2470	1	491	0	0	0	492
2471	0	501	0	2	0	503
2472	493	0	3	0	0	496
2473	484	0	2	1	0	487
2474	474	0	0	0	0	474
2475	487	0	1	0	0	488
2476	1	0	533	0	0	534
2477	519	0	1	0	0	520
2478	481	0	1	3	0	485
2479	482	0	4	0	0	486
2480	0	2	0	467	0	469
2481	2	0	0	552	0	554
2482	557	1	1	4	0	563
2483	0	2	0	600	0	602
2484	0	610	0	1	0	611
2485	0	5	0	584	0	589
2486	0	5	0	619	0	624
2487	0	649	0	3	0	652
2488	3	1	0	600	0	604
2489	0	0	0	607	0	607
2490	626	0	1	0	0	627
2491	0	0	648	0	0	648
2492	608	0	0	0	0	608
2493	0	0	644	0	0	644
2494	0	0	640	1	0	641
2495	0	0	679	0	0	679
2496	615	0	5	0	0	620
2497	0	0	674	0	0	674
2498	637	0	2	0	0	639
2499	629	0	5	2	0	636
2500	642	0	3	0	0	645
2501	0	703	0	0	0	703
2502	664	0	1	0	0	665
2503	0	704	0	1	0	705
2504	0	8	0	655	0	663
2505	2	1	0	723	0	726
2506	0	661	0	0	0	661
2507	0	722	0	3	0	725
2508	0	766	0	0	0	766
2509	731	0	7	0	0	738
2510	0	775	1	1	0	777
2511	736	0	1	0	0	737
2512	0	0	750	0	0	750
2513	741	0	3	0	0	744
2514	707	0	7	1	0	715
2515	2	0	794	0	0	796
2516	0	4	0	737	0	741
2517	0	0	794	0	0	794
2518	1	4	0	727	0	732
2519	0	0	0	682	0	682
2520	703	0	3	2	0	708
2521	749	0	1	0	0	750
2522	0	789	0	0	0	789
2523	728	0	4	0	0	732
2524	0	1	754	0	0	755
2525	738	0	0	1	0	739
2526	1	0	744	0	0	745
2527	0	0	737	0	0	737
2528	722	1	1	0	0	724
2529	681	0	9	0	0	690
2530	1	0	756	0	0	757
2531	0	0	0	679	0	679
2532	0	5	0	701	0	706
2533	0	0	760	0	0	760
2534	1	1	0	730	0	732
2535	0	756	1	0	0	757
2536	0	7	0	739	0	746
2537	0	5	0	746	0	751
2538	2	0	763	0	0	765
2539	724	0	6	2	0	732
2540	728	0	5	2	0	735
2541	722	0	7	0	0	729
2542	724	4	10	0	0	738
2543	0	778	0	13	0	791
2544	2	16	4	748	0	770
2545	8	0	784	0	0	792
2546	2	0	806	0	0	808
2547	3	5	0	789	0	797
2548	0	0	809	0	0	809
2549	844	2	6	5	0	857
2550	0	7	0	798	0	805
2551	1	5	2	787	0	795
2552	0	6	0	838	0	844
2553	830	0	3	0	0	833
2554	0	877	0	4	0	881
2555	843	0	5	1	0	849
2556	839	0	0	1	0	840
2557	0	902	0	1	0	903
2558	0	938	1	1	0	940
2559	951	0	1	0	0	952
2560	0	2	0	867	0	869
2561	0	5	0	928	0	933
2562	930	0	4	3	0	937
2563	2	0	957	0	0	959
2564	914	0	1	1	0	916
2565	885	0	3	0	0	888
2566	0	997	0	0	0	997
2567	932	0	1	0	0	933
2568	940	0	2	1	0	943
2569	1	1056	0	0	0	1057
2570	0	1039	0	0	0	1039
2571	2	3	0	1032	0	1037
2572	1047	1	0	0	0	1048
2573	0	1081	0	0	0	1081
2574	0	0	0	1069	0	1069
2575	1072	0	0	1	0	1073
2576	0	0	1094	0	0	1094
2577	0	2	0	1070	0	1072
2578	0	0	1071	0	0	1071
2579	1009	0	6	1	0	1016
2580	1002	0	4	1	0	1007
2581	0	0	1084	0	0	1084
2582	0	1103	0	2	0	1105
2583	1	5	0	1036	0	1042
2584	0	0	1118	0	0	1118
2585	0	0	0	1033	0	1033
2586	0	11	0	1033	0	1044
2587	3	0	1082	0	0	1085
2588	1058	0	2	2	0	1062
2589	1007	0	6	1	0	1014
2590	3	0	1095	0	0	1098
2591	0	1101	0	0	0	1101
2592	3	6	0	1048	0	1057
2593	0	1095	0	1	0	1096
2594	0	1109	0	0	0	1109
2595	1105	0	1	0	0	1106
2596	0	2	0	1039	0	1041
2597	1	4	0	1109	0	1114
2598	1	0	1107	0	0	1108
2599	4	0	1127	0	0	1131
2600	1	3	0	1090	0	1094
2601	2	3	1	1113	0	1119
2602	2	0	1078	0	0	1080
2603	1	0	1117	0	0	1118
2604	2	2	0	1114	0	1118
2605	1129	0	1	1	0	1131
2606	0	1131	0	0	0	1131
2607	1078	0	6	1	0	1085
2608	0	1109	0	0	0	1109
2609	0	1028	0	0	0	1028
2610	1089	0	2	0	0	1091
2611	0	0	1117	0	0	1117
2612	0	6	0	1023	0	1029
2613	0	4	0	1004	0	1008
2614	0	3	0	1011	0	1014
2615	0	0	1112	0	0	1112
2616	0	3	1	1084	0	1088
2617	1086	0	3	0	0	1089
2618	0	3	0	1007	0	1010
2619	0	0	0	1055	0	1055
2620	983	0	2	2	0	987
2621	1016	0	8	0	0	1024
2622	0	1062	0	2	0	1064
2623	3	0	965	0	0	968
2624	0	0	1023	0	0	1023
2625	1	0	1053	0	0	1054
2626	0	1070	0	0	0	1070
2627	0	3	0	985	0	988
2628	0	4	1	930	0	935
2629	1024	0	0	0	0	1024
2630	0	1	0	1046	0	1047
2631	1	1	1076	0	0	1078
2632	1	6	2	967	0	976
2633	0	4	0	916	0	920
2634	5	0	913	0	0	918
2635	0	951	0	0	0	951
2636	2	7	0	865	0	874
2637	0	908	1	0	0	909
2638	0	0	906	0	0	906
2639	908	0	3	3	0	914
2640	888	0	4	0	0	892
2641	855	0	4	0	0	859
2642	0	5	0	912	0	917
2643	0	921	0	1	0	922
2644	876	0	10	0	0	886
2645	825	0	6	0	0	831
2646	844	1	3	2	0	850
2647	0	0	887	0	0	887
2648	868	0	3	1	0	872
2649	0	912	0	0	0	912
2650	856	0	10	0	0	866
2651	0	889	0	0	0	889
2652	837	0	9	0	0	846
2653	3	1	908	0	0	912
2654	893	0	2	0	0	895
2655	851	0	3	1	0	855
2656	766	0	2	0	0	768
2657	819	0	4	1	0	824
2658	1	0	898	1	0	900
2659	0	6	0	885	0	891
2660	882	0	0	0	0	882
2661	0	901	1	0	0	902
2662	0	4	0	834	0	838
2663	1	0	884	0	0	885
2664	1	3	0	855	0	859
2665	0	0	856	0	0	856
2666	0	856	1	1	0	858
2667	0	835	0	2	0	837
2668	0	856	0	0	0	856
2669	2	5	0	825	0	832
2670	0	3	0	855	0	858
2671	1	0	850	0	0	851
2672	0	879	0	2	0	881
2673	877	0	0	0	0	877
2674	0	901	0	1	0	902
2675	0	867	0	0	0	867
2676	2	4	0	738	0	744
2677	875	0	0	1	0	876
2678	843	0	5	0	0	848
2679	0	3	0	889	0	892
2680	861	0	2	0	0	863
2681	1	3	0	885	0	889
2682	0	0	887	0	0	887
2683	859	0	3	0	0	862
2684	0	1	0	859	0	860
2685	0	0	843	0	0	843
2686	1	0	870	0	0	871
2687	0	3	0	811	0	814
2688	808	0	1	0	0	809
2689	784	0	3	3	0	790
2690	0	866	0	1	0	867
2691	837	0	4	0	0	841
2692	824	0	3	0	0	827
2693	806	2	6	0	0	814
2694	0	895	0	2	0	897
2695	822	0	8	2	0	832
2696	801	0	2	0	0	803
2697	0	3	0	903	0	906
2698	878	1	3	1	0	883
2699	0	939	0	1	0	940
2700	0	872	0	0	0	872
2701	2	7	1	855	0	865
2702	1	4	1	885	0	891
2703	0	860	0	3	0	863
2704	878	0	2	0	0	880
2705	0	915	0	6	0	921
2706	859	0	3	2	0	864
2707	1	946	0	1	0	948
2708	1	5	0	884	0	890
2709	0	905	0	0	0	905
2710	871	2	1	1	0	875
2711	812	0	3	1	0	816
2712	864	0	4	0	0	868
2713	0	0	921	2	0	923
2714	1	0	905	0	0	906
2715	0	885	0	0	0	885
2716	1	0	827	0	0	828
2717	1	0	931	0	0	932
2718	1	3	4	894	0	902
2719	0	0	911	0	0	911
2720	0	914	0	0	0	914
2721	917	1	1	0	0	919
2722	0	924	0	0	0	924
2723	0	898	1	0	0	899
2724	905	0	2	0	0	907
2725	880	1	4	1	0	886
2726	0	931	0	0	0	931
2727	882	0	5	2	0	889
2728	812	0	3	0	0	815
2729	821	0	2	0	0	823
2730	1	0	864	0	0	865
2731	0	0	917	0	0	917
2732	0	7	0	807	0	814
2733	0	0	0	853	0	853
2734	871	0	3	0	0	874
2735	0	893	0	1	0	894
2736	0	5	0	840	0	845
2737	0	2	1	781	0	784
2738	0	1	1	812	0	814
2739	0	5	0	855	0	860
2740	0	0	878	0	0	878
2741	1	0	887	0	0	888
2742	1	0	0	848	0	849
2743	1	0	853	0	0	854
2744	857	0	1	0	0	858
2745	2	2	1	825	0	830
2746	0	0	860	0	0	860
2747	862	0	3	0	0	865
2748	0	868	0	0	0	868
2749	853	1	1	0	0	855
2750	0	852	0	0	0	852
2751	1	5	1	792	0	799
2752	1	0	885	0	0	886
2753	3	2	4	829	0	838
2754	2	0	848	0	0	850
2755	841	0	5	5	0	851
2756	1	4	0	807	0	812
2757	823	0	4	1	0	828
2758	0	0	835	0	0	835
2759	805	0	0	0	0	805
2760	764	0	13	0	0	777
2761	0	1	847	0	0	848
2762	0	7	0	763	0	770
2763	2	0	777	0	0	779
2764	0	743	0	1	0	744
2765	740	2	5	2	0	749
2766	728	0	2	1	0	731
2767	2	0	757	0	0	759
2768	0	0	807	0	0	807
2769	2	7	1	754	0	764
2770	2	0	2	779	0	783
2771	798	0	5	0	0	803
2772	9	807	0	2	0	818
2773	775	0	15	0	0	790
2774	770	0	4	2	0	776
2775	0	0	805	0	0	805
2776	765	0	3	1	0	769
2777	1	0	783	0	0	784
2778	1	4	1	775	0	781
2779	0	0	796	0	0	796
2780	0	0	1	772	0	773
2781	1	0	759	0	0	760
2782	795	0	5	0	0	800
2783	774	0	2	0	0	776
2784	1	3	0	789	0	793
2785	781	2	0	0	0	783
2786	2	1	0	787	0	790
2787	0	783	0	0	0	783
2788	804	0	1	2	0	807
2789	0	834	1	0	0	835
2790	0	3	0	784	0	787
2791	1	1	0	755	0	757
2792	3	3	0	776	0	782
2793	2	4	0	797	0	803
2794	1	0	787	0	0	788
2795	799	0	0	0	0	799
2796	774	0	0	0	0	774
2797	0	836	0	0	0	836
2798	2	1	0	753	0	756
2799	1	1	0	742	0	744
2800	0	0	793	0	0	793
2801	790	0	0	0	0	790
2802	0	2	0	778	0	780
2803	1	0	791	0	0	792
2804	765	0	1	1	0	767
2805	700	0	9	0	0	709
2806	724	0	4	0	0	728
2807	0	0	769	0	0	769
2808	0	0	760	0	0	760
2809	770	0	4	0	0	774
2810	0	5	0	712	0	717
2811	3	3	0	706	0	712
2812	0	0	770	0	0	770
2813	753	0	5	0	0	758
2814	1	0	0	713	0	714
2815	735	0	1	1	0	737
2816	654	0	0	2	0	656
2817	684	0	3	1	0	688
2818	0	0	754	0	0	754
2819	1	6	0	742	0	749
2820	744	0	2	0	0	746
2821	0	776	0	1	0	777
2822	1	9	2	701	0	713
2823	0	0	0	704	0	704
2824	746	0	2	1	0	749
2825	690	0	22	0	0	712
2826	0	0	1	761	0	762
2827	2	0	790	0	0	792
2828	749	0	19	2	0	770
2829	1	0	746	0	0	747
2830	718	0	10	2	0	730
2831	750	0	4	1	0	755
2832	0	2	829	0	0	831
2833	0	1	0	810	0	811
2834	0	0	829	0	0	829
2835	0	794	0	0	0	794
2836	7	3	0	790	0	800
2837	0	825	0	2	0	827
2838	0	2	0	813	0	815
2839	0	0	926	0	0	926
2840	0	942	0	0	0	942
2841	0	935	0	6	0	941
2842	3	5	0	936	0	944
2843	950	0	1	0	0	951
2844	0	3	0	927	0	930
2845	914	0	1	0	0	915
2846	0	967	0	2	0	969
2847	843	0	7	0	0	850
2848	0	0	872	0	0	872
2849	1	0	0	815	0	816
2850	1	2	0	821	0	824
2851	3	0	777	0	0	780
2852	802	0	1	0	0	803
2853	777	0	1	0	0	778
2854	0	850	0	0	0	850
2855	1	1	0	796	0	798
2856	0	834	0	1	0	835
2857	1	0	780	0	0	781
2858	0	0	848	0	0	848
2859	0	0	1	832	0	833
2860	825	0	5	0	0	830
2861	0	858	0	0	0	858
2862	820	0	1	1	0	822
2863	1	0	824	0	0	825
2864	800	0	0	1	0	801
2865	794	0	2	0	0	796
2866	0	0	835	0	0	835
2867	0	0	4	780	0	784
2868	789	0	3	0	0	792
2869	707	0	2	0	0	709
2870	715	0	3	0	0	718
2871	1	2	0	772	0	775
2872	0	0	782	0	0	782
2873	739	0	2	0	0	741
2874	0	0	762	0	0	762
2875	0	1	0	710	0	711
2876	0	1	0	736	0	737
2877	0	706	0	3	0	709
2878	0	0	709	3	0	712
2879	0	738	0	2	0	740
2880	0	734	0	1	0	735
2881	1	3	1	706	0	711
2882	0	0	761	0	0	761
2883	0	3	0	729	0	732
2884	0	0	761	0	0	761
2885	0	0	0	720	0	720
2886	0	5	0	668	0	673
2887	0	0	714	0	0	714
2888	0	2	0	687	0	689
2889	0	0	688	0	0	688
2890	0	0	693	0	0	693
2891	0	686	0	0	0	686
2892	667	0	2	0	0	669
2893	0	0	628	0	0	628
2894	654	0	1	0	0	655
2895	0	3	0	629	0	632
2896	0	0	637	1	0	638
2897	0	624	0	1	0	625
2898	0	0	0	580	0	580
2899	0	0	602	0	0	602
2900	0	3	0	577	0	580
2901	0	604	0	2	0	606
2902	595	0	1	1	0	597
2903	0	2	0	560	0	562
2904	546	0	0	2	0	548
2905	553	0	2	1	0	556
2906	540	0	9	1	0	550
2907	546	0	3	0	0	549
2908	532	0	2	0	0	534
2909	0	581	0	0	0	581
2910	2	4	0	503	0	509
2911	1	3	0	469	0	473
2912	0	0	0	537	0	537
2913	0	0	530	2	0	532
2914	0	539	0	0	0	539
2915	525	1	0	0	0	526
2916	514	1	0	0	0	515
2917	0	543	0	2	0	545
2918	0	537	0	0	0	537
2919	533	0	2	0	0	535
2920	0	0	571	0	0	571
2921	2	0	0	565	0	567
2922	570	0	0	0	0	570
2923	0	1	1	606	0	608
2924	0	606	0	0	0	606
2925	0	2	0	584	0	586
2926	0	0	602	0	0	602
2927	591	0	3	0	0	594
2928	556	0	4	0	0	560
2929	1	1	0	528	0	530
2930	0	3	0	581	0	584
2931	613	0	0	1	0	614
2932	0	672	0	0	0	672
2933	0	0	0	639	0	639
2934	0	0	0	664	0	664
2935	619	0	0	0	0	619
2936	0	683	0	0	0	683
2937	639	0	2	0	0	641
2938	0	691	0	3	0	694
2939	0	633	1	0	0	634
2940	650	0	1	0	0	651
2941	0	691	0	0	0	691
2942	0	3	0	643	0	646
2943	1	0	674	0	0	675
2944	0	0	639	0	0	639
2945	1	0	660	0	0	661
2946	0	650	0	3	0	653
2947	649	0	0	1	0	650
2948	0	0	0	613	0	613
2949	0	0	0	642	0	642
2950	0	0	676	0	0	676
2951	684	0	4	0	0	688
2952	0	1	0	622	0	623
2953	1	0	0	644	0	645
2954	0	0	1	663	0	664
2955	652	0	4	0	0	656
2956	0	0	661	0	0	661
2957	662	0	2	0	0	664
2958	0	2	0	646	0	648
2959	0	0	662	0	0	662
2960	649	0	1	1	0	651
2961	0	0	674	0	0	674
2962	0	4	0	673	0	677
2963	0	0	665	0	0	665
2964	0	0	661	0	0	661
2965	629	0	5	0	0	634
2966	0	0	694	0	0	694
2967	0	5	0	668	0	673
2968	660	0	2	0	0	662
2969	0	0	0	660	0	660
2970	1	0	662	0	0	663
2971	0	0	666	0	0	666
2972	0	670	0	1	0	671
2973	0	0	0	627	0	627
2974	620	0	1	1	0	622
2975	0	625	0	0	0	625
2976	602	0	4	1	0	607
2977	0	3	0	594	0	597
2978	567	0	0	1	0	568
2979	0	610	0	1	0	611
2980	0	1	0	548	0	549
2981	553	0	1	1	0	555
2982	0	559	0	0	0	559
2983	2	2	0	504	0	508
2984	0	3	0	510	0	513
2985	497	0	0	0	0	497
2986	1	0	0	487	0	488
2987	0	1	0	493	0	494
2988	3	2	0	470	0	475
2989	5	0	457	0	0	462
2990	422	0	1	1	0	424
2991	0	2	0	429	0	431
2992	1	0	440	0	0	441
2993	408	1	1	1	0	411
2994	0	0	439	0	0	439
2995	0	0	0	410	0	410
2996	0	423	0	1	0	424
2997	0	1	0	399	0	400
2998	0	0	406	0	0	406
2999	3	0	427	0	0	430
3000	0	4	0	403	0	407
3001	0	0	410	0	0	410
3002	374	0	0	0	0	374
3003	0	0	383	0	0	383
3004	0	0	0	352	0	352
3005	0	3	0	346	0	349
3006	1	1	0	347	0	349
3007	360	0	0	0	0	360
3008	340	0	5	0	0	345
3009	329	0	0	0	0	329
3010	0	0	0	351	0	351
3011	1	0	0	357	0	358
3012	1	0	355	0	0	356
3013	0	0	368	0	0	368
3014	0	367	0	4	0	371
3015	1	3	0	348	0	352
3016	0	0	0	360	0	360
3017	0	382	0	0	0	382
3018	363	0	2	0	0	365
3019	0	399	0	0	0	399
3020	387	0	3	0	0	390
3021	1	1	0	366	0	368
3022	375	0	3	0	0	378
3023	3	1	0	391	0	395
3024	0	0	419	0	0	419
3025	0	1	0	381	0	382
3026	395	0	1	0	0	396
3027	0	1	0	368	0	369
3028	0	1	0	383	0	384
3029	0	0	387	0	0	387
3030	0	1	0	366	0	367
3031	1	2	0	372	0	375
3032	0	382	0	0	0	382
3033	0	1	0	366	0	367
3034	0	1	0	360	0	361
3035	0	1	0	378	0	379
3036	0	378	0	4	0	382
3037	0	0	0	382	0	382
3038	364	0	0	1	0	365
3039	0	387	0	1	0	388
3040	0	343	0	0	0	343
3041	0	379	0	1	0	380
3042	1	1	0	357	0	359
3043	0	362	0	0	0	362
3044	0	366	0	0	0	366
3045	362	0	5	0	0	367
3046	2	0	368	0	0	370
3047	367	0	0	0	0	367
3048	0	2	0	357	0	359
3049	0	1	358	0	0	359
3050	365	0	4	0	0	369
3051	0	0	372	0	0	372
3052	0	0	353	0	0	353
3053	385	0	0	0	0	385
3054	0	3	0	353	0	356
3055	2	0	349	0	0	351
3056	368	0	1	0	0	369
3057	349	0	1	0	0	350
3058	0	0	359	0	0	359
3059	374	0	0	2	0	376
3060	323	0	3	0	0	326
3061	0	0	348	0	0	348
3062	336	0	0	0	0	336
3063	329	0	1	1	0	331
3064	0	0	339	0	0	339
3065	0	0	353	0	0	353
3066	1	0	0	336	0	337
3067	0	0	337	0	0	337
3068	341	0	0	0	0	341
3069	0	0	0	310	0	310
3070	0	3	0	315	0	318
3071	1	0	345	0	0	346
3072	1	0	0	335	0	336
3073	0	0	334	0	0	334
3074	325	0	1	0	0	326
3075	322	0	1	0	0	323
3076	1	0	334	1	0	336
3077	332	1	1	0	0	334
3078	320	0	0	1	0	321
3079	0	0	325	0	0	325
3080	325	0	1	1	0	327
3081	336	0	0	0	0	336
3082	0	0	347	0	0	347
3083	329	0	0	0	0	329
3084	1	0	356	0	0	357
3085	0	2	0	326	0	328
3086	0	3	0	312	0	315
3087	1	0	0	321	0	322
3088	1	0	340	0	0	341
3089	314	0	2	1	0	317
3090	0	0	334	0	0	334
3091	0	323	0	1	0	324
3092	0	333	0	1	0	334
3093	307	0	3	0	0	310
3094	0	1	0	321	0	322
3095	0	322	0	2	0	324
3096	315	0	1	0	0	316
3097	306	0	2	0	0	308
3098	0	347	0	2	0	349
3099	0	0	0	340	0	340
3100	0	348	0	0	0	348
3101	352	0	1	0	0	353
3102	342	2	2	0	0	346
3103	0	1	0	339	0	340
3104	338	1	2	1	0	342
3105	1	1	0	348	0	350
3106	0	0	370	0	0	370
3107	352	0	2	0	0	354
3108	0	1	371	0	0	372
3109	0	1	0	334	0	335
3110	343	0	1	0	0	344
3111	0	1	0	333	0	334
3112	0	0	337	0	0	337
3113	5	0	339	0	0	344
3114	1	5	0	320	0	326
3115	325	0	2	0	0	327
3116	0	342	0	0	0	342
3117	0	0	0	309	0	309
3118	0	0	314	0	0	314
3119	313	0	0	0	0	313
3120	304	0	3	0	0	307
3121	0	0	317	0	0	317
3122	305	0	1	0	0	306
3123	0	0	0	301	0	301
3124	1	0	302	0	0	303
3125	295	0	0	0	0	295
3126	0	0	1	284	0	285
3127	0	1	0	304	0	305
3128	298	0	0	0	0	298
3129	0	301	0	0	0	301
3130	0	288	0	0	0	288
3131	273	0	2	0	0	275
3132	287	0	1	1	0	289
3133	0	0	286	0	0	286
3134	0	0	302	0	0	302
3135	0	0	0	291	0	291
3136	281	0	0	0	0	281
3137	260	0	1	0	0	261
3138	279	1	3	1	0	284
3139	0	300	0	0	0	300
3140	0	268	0	0	0	268
3141	1	3	0	255	0	259
3142	0	2	0	252	0	254
3143	0	1	0	269	0	270
3144	0	0	273	0	0	273
3145	2	0	274	0	0	276
3146	274	0	1	0	0	275
3147	259	0	1	0	0	260
3148	1	1	0	252	0	254
3149	0	0	0	251	0	251
3150	0	1	0	264	0	265
3151	0	0	263	1	0	264
3152	0	0	270	0	0	270
3153	0	1	0	266	0	267
3154	1	0	263	0	0	264
3155	0	261	0	0	0	261
3156	0	261	0	0	0	261
3157	262	0	0	0	0	262
3158	0	277	0	0	0	277
3159	0	2	0	264	0	266
3160	0	2	0	261	0	263
3161	0	275	0	0	0	275
3162	0	0	0	268	0	268
3163	0	0	275	0	0	275
3164	0	264	0	0	0	264
3165	0	1	0	262	0	263
3166	1	0	272	0	0	273
3167	0	285	0	1	0	286
3168	0	0	0	277	0	277
3169	0	269	0	0	0	269
3170	0	0	0	260	0	260
3171	0	0	1	261	0	262
3172	0	264	0	0	0	264
3173	257	0	1	0	0	258
3174	251	0	0	2	0	253
3175	0	264	0	0	0	264
3176	0	245	0	0	0	245
3177	0	2	0	236	0	238
3178	0	0	246	0	0	246
3179	245	0	0	1	0	246
3180	236	0	1	0	0	237
3181	0	0	249	0	0	249
3182	258	0	2	0	0	260
3183	236	0	1	0	0	237
3184	1	0	239	0	0	240
3185	250	0	0	0	0	250
3186	1	0	251	0	0	252
3187	0	241	0	0	0	241
3188	262	0	0	0	0	262
3189	254	0	1	0	0	255
3190	0	1	249	0	0	250
3191	269	0	0	0	0	269
3192	253	0	1	2	0	256
3193	0	0	251	0	0	251
3194	266	0	1	0	0	267
3195	258	0	0	0	0	258
3196	0	0	243	0	0	243
3197	266	0	0	0	0	266
3198	0	1	0	248	0	249
3199	0	0	0	248	0	248
3200	0	0	261	0	0	261
3201	0	0	273	0	0	273
3202	0	2	0	245	0	247
3203	1	0	0	250	0	251
3204	272	0	2	0	0	274
3205	0	0	274	0	0	274
3206	261	0	1	0	0	262
3207	0	1	0	262	0	263
3208	2	0	262	0	0	264
3209	250	0	0	0	0	250
3210	3	1	0	246	0	250
3211	0	0	263	0	0	263
3212	261	0	0	0	0	261
3213	1	2	1	245	0	249
3214	249	0	1	0	0	250
3215	0	0	257	0	0	257
3216	0	2	0	246	0	248
3217	0	244	0	2	0	246
3218	243	0	2	1	0	246
3219	248	0	0	0	0	248
3220	0	256	0	1	0	257
3221	253	0	0	0	0	253
3222	246	0	0	0	0	246
3223	238	0	1	0	0	239
3224	0	256	0	0	0	256
3225	0	0	0	242	0	242
3226	0	0	268	0	0	268
3227	1	1	0	245	0	247
3228	1	1	0	249	0	251
3229	0	0	236	0	0	236
3230	0	0	271	0	0	271
3231	0	2	0	261	0	263
3232	0	262	0	0	0	262
3233	262	0	3	0	0	265
3234	265	0	2	0	0	267
3235	0	279	0	0	0	279
3236	259	0	3	0	0	262
3237	263	0	0	0	0	263
3238	0	0	272	0	0	272
3239	263	0	0	0	0	263
3240	0	266	0	0	0	266
3241	5	0	233	0	0	238
3242	2	0	262	0	0	264
3243	0	245	0	2	0	247
3244	268	0	0	0	0	268
3245	4	0	271	0	0	275
3246	0	1	0	261	0	262
3247	1	0	252	0	0	253
3248	259	0	3	1	0	263
3249	0	0	248	0	0	248
3250	0	0	264	0	0	264
3251	256	0	0	0	0	256
3252	0	248	0	0	0	248
3253	252	1	1	1	0	255
3254	245	0	0	0	0	245
3255	0	1	0	251	0	252
3256	0	246	0	1	0	247
3257	244	0	2	0	0	246
3258	0	0	244	0	0	244
3259	239	0	0	0	0	239
3260	0	243	0	0	0	243
3261	222	0	0	0	0	222
3262	218	0	0	0	0	218
3263	0	235	0	0	0	235
3264	0	0	0	235	0	235
3265	230	0	2	1	0	233
3266	0	237	0	1	0	238
3267	0	0	0	229	0	229
3268	212	0	0	0	0	212
3269	0	4	0	185	0	189
3270	1	0	0	217	0	218
3271	0	225	0	0	0	225
3272	208	0	1	0	0	209
3273	190	0	1	0	0	191
3274	194	0	1	2	0	197
3275	0	217	0	0	0	217
3276	214	0	1	0	0	215
3277	197	0	0	0	0	197
3278	0	0	0	177	0	177
3279	1	1	0	200	0	202
3280	0	0	218	0	0	218
3281	1	0	0	206	0	207
3282	0	0	0	201	0	201
3283	2	0	209	0	0	211
3284	214	0	0	0	0	214
3285	1	0	204	0	0	205
3286	2	0	221	0	0	223
3287	0	2	0	194	0	196
3288	0	1	0	208	0	209
3289	0	218	0	0	0	218
3290	217	0	1	0	0	218
3291	209	0	0	0	0	209
3292	0	218	0	0	0	218
3293	0	214	0	0	0	214
3294	0	0	0	204	0	204
3295	0	206	0	0	0	206
3296	235	0	0	1	0	236
3297	232	0	1	0	0	233
3298	0	2	0	225	0	227
3299	0	4	0	210	0	214
3300	235	0	1	0	0	236
3301	0	0	237	0	0	237
3302	226	0	0	1	0	227
3303	0	0	232	0	0	232
3304	217	0	1	1	0	219
3305	0	1	0	222	0	223
3306	0	0	216	0	0	216
3307	0	0	218	0	0	218
3308	216	0	2	0	0	218
3309	219	0	0	0	0	219
3310	0	225	0	1	0	226
3311	1	1	0	202	0	204
3312	0	0	0	219	0	219
3313	218	0	0	0	0	218
3314	0	226	0	1	0	227
3315	216	0	1	0	0	217
3316	0	223	0	1	0	224
3317	0	206	0	0	0	206
3318	209	0	0	0	0	209
3319	0	0	214	0	0	214
3320	0	2	0	191	0	193
3321	0	1	0	196	0	197
3322	2	0	210	0	0	212
3323	0	2	0	192	0	194
3324	2	0	0	194	0	196
3325	0	205	1	0	0	206
3326	207	0	1	0	0	208
3327	0	0	209	0	0	209
3328	198	0	1	1	0	200
3329	0	198	0	2	0	200
3330	0	1	0	193	0	194
3331	185	0	0	0	0	185
3332	0	0	0	179	0	179
3333	0	0	0	185	0	185
3334	0	0	184	0	0	184
3335	183	0	0	3	0	186
3336	174	0	1	0	0	175
3337	0	0	186	0	0	186
3338	1	1	0	155	0	157
3339	0	0	142	0	0	142
3340	160	0	0	0	0	160
3341	143	0	1	0	0	144
3342	1	1	0	145	0	147
3343	158	0	1	0	0	159
3344	0	0	160	0	0	160
3345	0	1	0	146	0	147
3346	0	1	0	131	0	132
3347	0	1	0	140	0	141
3348	0	0	0	138	0	138
3349	145	0	0	0	0	145
3350	0	0	150	0	0	150
3351	0	1	0	136	0	137
3352	0	0	131	0	0	131
3353	0	0	132	0	0	132
3354	0	2	0	107	0	109
3355	0	2	0	113	0	115
3356	123	0	0	0	0	123
3357	0	0	0	114	0	114
3358	0	0	0	110	0	110
3359	0	0	0	120	0	120
3360	125	0	0	0	0	125
3361	123	0	0	0	0	123
3362	119	0	0	0	0	119
3363	119	0	1	0	0	120
3364	0	126	0	0	0	126
3365	0	1	0	110	0	111
3366	0	1	0	118	0	119
3367	115	0	0	0	0	115
3368	0	127	0	0	0	127
3369	0	0	0	120	0	120
3370	0	0	127	0	0	127
3371	111	0	0	0	0	111
3372	0	125	0	0	0	125
3373	114	0	0	0	0	114
3374	102	0	1	1	0	104
3375	0	0	0	110	0	110
3376	1	1	118	0	0	120
3377	0	0	0	117	0	117
3378	115	0	0	1	0	116
3379	0	1	0	117	0	118
3380	108	0	0	0	0	108
3381	0	114	0	0	0	114
3382	100	0	0	0	0	100
3383	0	0	0	92	0	92
3384	1	0	0	89	0	90
3385	94	0	0	1	0	95
3386	94	0	0	0	0	94
3387	92	0	0	0	0	92
3388	95	0	0	0	0	95
3389	86	1	0	0	0	87
3390	0	0	0	87	0	87
3391	0	0	88	0	0	88
3392	0	87	0	1	0	88
3393	89	0	0	0	0	89
3394	0	0	88	0	0	88
3395	85	0	0	0	0	85
3396	0	85	0	1	0	86
3397	84	0	1	0	0	85
3398	0	1	0	74	0	75
3399	0	2	0	82	0	84
3400	0	0	82	0	0	82
3401	0	0	0	77	0	77
3402	0	0	79	0	0	79
3403	0	0	74	0	0	74
3404	79	0	0	0	0	79
3405	75	0	0	0	0	75
3406	0	0	76	0	0	76
3407	69	0	0	0	0	69
3408	69	0	0	0	0	69
3409	0	0	72	0	0	72
3410	0	73	0	0	0	73
3411	0	0	0	63	0	63
3412	69	0	0	0	0	69
3413	70	0	0	0	0	70
3414	69	0	0	0	0	69
3415	65	0	1	0	0	66
3416	66	0	0	0	0	66
3417	0	0	59	0	0	59
3418	0	0	71	0	0	71
3419	0	0	0	63	0	63
3420	68	0	1	0	0	69
3421	61	0	2	0	0	63
3422	64	0	2	1	0	67
3423	65	0	0	0	0	65
3424	0	74	0	0	0	74
3425	0	71	0	0	0	71
3426	72	0	0	0	0	72
3427	72	0	0	0	0	72
3428	0	76	0	0	0	76
3429	70	0	0	0	0	70
3430	0	0	75	0	0	75
3431	0	1	0	68	0	69
3432	0	0	65	0	0	65
3433	0	0	65	0	0	65
3434	0	0	0	54	0	54
3435	0	0	0	64	0	64
3436	0	0	70	0	0	70
3437	0	0	0	63	0	63
3438	0	0	0	57	0	57
3439	60	0	0	0	0	60
3440	60	0	0	0	0	60
3441	0	0	0	63	0	63
3442	0	0	65	0	0	65
3443	0	63	0	0	0	63
3444	58	0	0	0	0	58
3445	0	0	59	0	0	59
3446	0	59	0	0	0	59
3447	0	53	0	0	0	53
3448	59	0	0	0	0	59
3449	59	0	0	0	0	59
3450	0	0	0	61	0	61
3451	0	0	64	0	0	64
3452	0	0	0	60	0	60
3453	0	1	0	60	0	61
3454	0	1	0	54	0	55
3455	62	0	0	0	0	62
3456	0	60	0	0	0	60
3457	0	60	0	0	0	60
3458	0	0	0	60	0	60
3459	0	0	0	58	0	58
3460	50	0	3	0	0	53
3461	61	0	0	0	0	61
3462	52	0	0	0	0	52
3463	0	62	0	0	0	62
3464	57	0	0	0	0	57
3465	0	0	0	54	0	54
3466	1	0	51	0	0	52
3467	1	0	50	0	0	51
3468	50	0	0	0	0	50
3469	1	0	49	0	0	50
3470	0	0	48	0	0	48
3471	47	0	0	0	0	47
3472	0	0	45	0	0	45
3473	1	0	39	0	0	40
3474	0	0	0	35	0	35
3475	0	0	36	0	0	36
3476	0	0	0	32	0	32
3477	0	0	0	33	0	33
3478	0	0	29	0	0	29
3479	0	33	0	0	0	33
3480	29	0	0	0	0	29
3481	0	0	33	0	0	33
3482	0	0	33	0	0	33
3483	33	0	0	0	0	33
3484	0	0	35	0	0	35
3485	0	33	0	0	0	33
3486	0	34	0	0	0	34
3487	0	0	0	35	0	35
3488	1	0	0	35	0	36
3489	40	0	0	0	0	40
3490	33	0	1	0	0	34
3491	37	0	0	0	0	37
3492	0	1	0	35	0	36
3493	41	0	0	0	0	41
3494	36	0	0	0	0	36
3495	0	0	39	0	0	39
3496	0	0	39	0	0	39
3497	0	40	0	0	0	40
3498	0	0	0	38	0	38
3499	42	0	0	0	0	42
3500	0	47	0	0	0	47
3501	0	0	0	48	0	48
3502	46	0	0	0	0	46
3503	43	0	0	1	0	44
3504	0	50	0	0	0	50
3505	46	0	0	0	0	46
3506	48	0	0	0	0	48
3507	0	0	0	46	0	46
3508	0	0	44	0	0	44
3509	0	46	0	0	0	46
3510	0	45	0	0	0	45
3511	46	0	0	0	0	46
3512	0	0	0	43	0	43
3513	0	0	46	0	0	46
3514	0	46	0	0	0	46
3515	46	0	0	0	0	46
3516	44	0	0	0	0	44
3517	0	0	48	0	0	48
3518	0	1	0	48	0	49
3519	0	0	0	46	0	46
3520	0	0	47	0	0	47
3521	47	0	0	1	0	48
3522	46	0	1	0	0	47
3523	0	0	0	49	0	49
3524	0	48	0	0	0	48
3525	1	0	0	41	0	42
3526	1	0	44	0	0	45
3527	46	0	2	0	0	48
3528	1	0	0	49	0	50
3529	0	0	50	0	0	50
3530	46	0	0	0	0	46
3531	0	0	0	46	0	46
3532	0	1	0	47	0	48
3533	49	0	0	0	0	49
3534	0	51	0	0	0	51
3535	46	0	1	0	0	47
3536	0	0	0	50	0	50
3537	46	0	0	0	0	46
3538	0	0	51	0	0	51
3539	0	51	0	0	0	51
3540	0	0	0	49	0	49
3541	50	0	1	0	0	51
3542	0	55	0	0	0	55
3543	0	0	0	47	0	47
3544	49	0	2	0	0	51
3545	48	0	1	0	0	49
3546	0	0	0	51	0	51
3547	0	0	49	0	0	49
3548	0	0	50	0	0	50
3549	52	0	0	0	0	52
3550	0	54	0	0	0	54
3551	0	53	0	0	0	53
3552	58	0	0	0	0	58
3553	0	59	0	0	0	59
3554	0	0	0	53	0	53
3555	0	0	0	53	0	53
3556	47	0	0	0	0	47
3557	51	0	0	0	0	51
3558	51	0	0	0	0	51
3559	0	0	59	0	0	59
3560	0	0	0	49	0	49
3561	0	0	52	0	0	52
3562	0	0	46	0	0	46
3563	0	0	51	0	0	51
3564	0	0	0	50	0	50
3565	0	0	54	0	0	54
3566	0	0	50	0	0	50
3567	0	0	0	53	0	53
3568	53	0	0	0	0	53
3569	0	0	55	0	0	55
3570	0	0	0	55	0	55
3571	0	0	0	54	0	54
3572	0	0	56	0	0	56
3573	0	0	0	52	0	52
3574	0	0	53	0	0	53
3575	0	0	0	51	0	51
3576	0	0	0	49	0	49
3577	0	1	0	48	0	49
3578	0	0	0	55	0	55
3579	50	0	0	0	0	50
3580	51	0	0	0	0	51
3581	0	0	55	0	0	55
3582	0	55	0	0	0	55
3583	0	0	45	0	0	45
3584	0	0	56	0	0	56
3585	54	0	1	0	0	55
3586	0	58	0	0	0	58
3587	56	0	0	0	0	56
3588	0	57	0	0	0	57
3589	56	0	0	0	0	56
3590	60	0	0	0	0	60
3591	0	0	0	60	0	60
3592	0	63	0	2	0	65
3593	0	0	0	66	0	66
3594	0	0	0	68	0	68
3595	0	0	69	0	0	69
3596	0	71	0	0	0	71
3597	0	0	0	72	0	72
3598	67	0	1	0	0	68
3599	65	0	0	0	0	65
3600	62	0	2	0	0	64
3601	0	70	0	0	0	70
3602	65	0	0	0	0	65
3603	0	69	0	0	0	69
3604	0	0	0	68	0	68
3605	0	0	72	0	0	72
3606	0	0	0	68	0	68
3607	0	72	0	0	0	72
3608	0	0	0	71	0	71
3609	0	0	0	66	0	66
3610	0	73	0	0	0	73
3611	67	0	1	0	0	68
3612	0	0	0	74	0	74
3613	0	0	71	0	0	71
3614	0	0	0	66	0	66
3615	0	1	0	63	0	64
3616	0	0	62	0	0	62
3617	0	1	0	62	0	63
3618	0	62	0	0	0	62
3619	0	0	60	0	0	60
3620	0	0	63	0	0	63
3621	0	65	0	0	0	65
3622	0	63	0	0	0	63
3623	0	58	0	0	0	58
3624	61	0	0	0	0	61
3625	56	0	0	0	0	56
3626	57	0	0	0	0	57
3627	0	2	0	60	0	62
3628	0	0	66	0	0	66
3629	0	0	0	66	0	66
3630	0	0	0	59	0	59
3631	56	0	0	0	0	56
3632	62	0	0	0	0	62
3633	0	61	0	0	0	61
3634	57	0	1	0	0	58
3635	56	0	0	0	0	56
3636	55	0	2	0	0	57
3637	0	0	60	0	0	60
3638	0	0	62	0	0	62
3639	0	0	1	56	0	57
3640	0	0	53	0	0	53
3641	55	0	1	0	0	56
3642	50	0	0	0	0	50
3643	0	0	59	0	0	59
3644	60	0	0	0	0	60
3645	0	61	0	0	0	61
3646	59	0	0	0	0	59
3647	0	0	0	51	0	51
3648	0	0	0	56	0	56
3649	0	58	0	0	0	58
3650	57	0	0	1	0	58
3651	59	0	0	0	0	59
3652	0	61	0	0	0	61
3653	0	0	0	55	0	55
3654	0	0	0	61	0	61
3655	0	66	0	0	0	66
3656	0	1	0	61	0	62
3657	0	0	0	63	0	63
3658	60	0	0	0	0	60
3659	62	0	0	0	0	62
3660	0	0	69	0	0	69
3661	61	0	0	0	0	61
3662	0	0	66	0	0	66
3663	0	0	0	64	0	64
3664	0	0	65	0	0	65
3665	0	64	0	0	0	64
3666	0	0	0	54	0	54
3667	0	0	0	61	0	61
3668	62	0	0	0	0	62
3669	0	0	0	61	0	61
3670	0	0	62	0	0	62
3671	62	0	0	0	0	62
3672	57	0	0	1	0	58
3673	57	0	0	0	0	57
3674	63	0	0	0	0	63
3675	0	0	0	60	0	60
3676	0	0	0	64	0	64
3677	0	1	0	63	0	64
3678	1	0	0	65	0	66
3679	60	0	0	0	0	60
3680	60	0	2	0	0	62
3681	0	0	0	68	0	68
3682	0	65	0	0	0	65
3683	58	0	1	0	0	59
3684	0	0	70	0	0	70
3685	0	68	0	1	0	69
3686	65	0	0	0	0	65
3687	0	67	0	0	0	67
3688	0	0	65	0	0	65
3689	65	0	0	0	0	65
3690	61	0	0	0	0	61
3691	0	0	70	0	0	70
3692	0	2	0	63	0	65
3693	0	0	0	67	0	67
3694	0	69	0	0	0	69
3695	0	0	0	69	0	69
3696	67	0	0	0	0	67
3697	0	73	0	0	0	73
3698	0	1	0	68	0	69
3699	0	1	0	66	0	67
3700	0	0	64	0	0	64
3701	0	67	0	0	0	67
3702	69	0	1	0	0	70
3703	0	76	0	0	0	76
3704	0	72	0	0	0	72
3705	75	0	0	0	0	75
3706	0	0	0	72	0	72
3707	0	0	0	75	0	75
3708	77	0	0	0	0	77
3709	0	0	0	71	0	71
3710	0	0	0	86	0	86
3711	76	0	1	0	0	77
3712	0	0	0	83	0	83
3713	0	88	0	0	0	88
3714	78	0	0	0	0	78
3715	0	0	89	0	0	89
3716	0	91	0	0	0	91
3717	0	0	0	82	0	82
3718	0	0	83	0	0	83
3719	0	0	88	0	0	88
3720	0	0	0	81	0	81
3721	87	0	0	0	0	87
3722	0	1	0	78	0	79
3723	0	0	0	85	0	85
3724	0	0	0	79	0	79
3725	0	0	0	89	0	89
3726	0	1	0	87	0	88
3727	0	0	82	0	0	82
3728	0	0	86	0	0	86
3729	0	1	0	85	0	86
3730	0	0	92	0	0	92
3731	0	91	0	0	0	91
3732	0	1	0	84	0	85
3733	0	0	92	0	0	92
3734	94	1	1	0	0	96
3735	0	109	0	0	0	109
3736	0	99	0	0	0	99
3737	0	100	0	0	0	100
3738	0	1	0	99	0	100
3739	99	0	1	0	0	100
3740	0	2	0	97	0	99
3741	94	0	0	0	0	94
3742	0	108	0	0	0	108
3743	93	0	1	0	0	94
3744	0	1	0	89	0	90
3745	0	0	0	97	0	97
3746	0	98	0	0	0	98
3747	0	1	0	99	0	100
3748	0	0	0	87	0	87
3749	0	0	0	103	0	103
3750	92	0	0	0	0	92
3751	98	0	0	0	0	98
3752	0	0	106	0	0	106
3753	99	0	0	1	0	100
3754	0	0	102	0	0	102
3755	0	0	0	91	0	91
3756	0	1	0	77	0	78
3757	0	0	0	84	0	84
3758	0	0	99	0	0	99
3759	0	0	0	98	0	98
3760	0	0	104	0	0	104
3761	0	0	0	99	0	99
3762	97	0	0	0	0	97
3763	0	0	105	0	0	105
3764	98	0	2	1	0	101
3765	0	0	0	98	0	98
3766	93	0	1	0	0	94
3767	0	104	0	0	0	104
3768	0	0	0	104	0	104
3769	0	0	106	0	0	106
3770	0	1	0	95	0	96
3771	0	1	0	101	0	102
3772	0	90	0	0	0	90
3773	0	0	100	0	0	100
3774	0	103	0	0	0	103
3775	101	0	0	0	0	101
3776	0	107	0	0	0	107
3777	91	0	0	0	0	91
3778	84	0	1	0	0	85
3779	91	0	0	0	0	91
3780	0	0	0	101	0	101
3781	0	0	101	0	0	101
3782	0	1	0	101	0	102
3783	0	104	0	0	0	104
3784	0	0	0	100	0	100
3785	107	0	0	0	0	107
3786	0	108	0	0	0	108
3787	0	1	0	93	0	94
3788	0	3	0	98	0	101
3789	85	0	1	0	0	86
3790	0	0	106	0	0	106
3791	0	104	0	0	0	104
3792	0	0	0	101	0	101
3793	0	0	105	0	0	105
3794	0	1	0	96	0	97
3795	0	103	0	1	0	104
3796	0	0	0	100	0	100
3797	0	0	0	94	0	94
3798	0	0	0	105	0	105
3799	0	0	110	0	0	110
3800	108	0	1	0	0	109
3801	0	0	0	107	0	107
3802	95	0	0	0	0	95
3803	94	0	0	0	0	94
3804	102	0	0	0	0	102
3805	95	0	0	1	0	96
3806	100	0	0	0	0	100
3807	0	0	0	106	0	106
3808	2	117	0	0	0	119
3809	0	1	0	114	0	115
3810	0	119	0	1	0	120
3811	0	0	0	118	0	118
3812	113	0	0	0	0	113
3813	0	0	0	121	0	121
3814	0	0	124	0	0	124
3815	116	0	1	0	0	117
3816	0	123	0	0	0	123
3817	114	0	0	1	0	115
3818	98	0	1	0	0	99
3819	112	0	0	0	0	112
3820	0	124	0	0	0	124
3821	0	0	0	113	0	113
3822	0	0	0	117	0	117
3823	0	0	116	0	0	116
3824	0	1	1	108	0	110
3825	0	1	0	107	0	108
3826	1	0	0	117	0	118
3827	0	122	0	0	0	122
3828	115	0	0	0	0	115
3829	118	0	1	0	0	119
3830	0	0	115	0	0	115
3831	0	122	0	0	0	122
3832	0	0	0	113	0	113
3833	0	2	0	104	0	106
3834	0	0	0	112	0	112
3835	0	0	0	114	0	114
3836	0	0	0	117	0	117
3837	0	0	118	0	0	118
3838	0	0	114	0	0	114
3839	112	0	0	0	0	112
3840	108	0	0	2	0	110
3841	103	0	1	0	0	104
3842	0	0	0	117	0	117
3843	0	0	118	0	0	118
3844	113	0	1	0	0	114
3845	107	0	0	0	0	107
3846	0	0	107	0	0	107
3847	111	1	0	0	0	112
3848	0	0	113	0	0	113
3849	0	0	0	113	0	113
3850	0	0	113	0	0	113
3851	108	0	1	0	0	109
3852	97	0	2	0	0	99
3853	98	0	0	0	0	98
3854	102	0	1	0	0	103
3855	0	0	108	0	0	108
3856	0	93	0	1	0	94
3857	102	0	0	0	0	102
3858	98	0	0	0	0	98
3859	0	1	104	0	0	105
3860	0	1	0	98	0	99
3861	0	0	0	98	0	98
3862	1	0	101	0	0	102
3863	106	0	0	0	0	106
3864	101	0	0	0	0	101
3865	0	109	0	0	0	109
3866	107	0	1	0	0	108
3867	97	0	1	0	0	98
3868	98	0	0	0	0	98
3869	94	0	0	0	0	94
3870	0	0	106	0	0	106
3871	105	0	0	0	0	105
3872	1	1	0	105	0	107
3873	0	105	0	0	0	105
3874	0	0	103	0	0	103
3875	0	108	0	0	0	108
3876	0	1	0	107	0	108
3877	0	0	114	0	0	114
3878	108	0	0	0	0	108
3879	0	0	114	0	0	114
3880	109	0	2	0	0	111
3881	1	0	0	107	0	108
3882	1	1	0	117	0	119
3883	0	115	0	0	0	115
3884	0	116	0	0	0	116
3885	0	0	0	110	0	110
3886	109	0	2	0	0	111
3887	101	0	0	0	0	101
3888	109	0	1	0	0	110
3889	0	0	115	0	0	115
3890	107	0	0	0	0	107
3891	0	0	113	0	0	113
3892	0	0	107	0	0	107
3893	107	0	0	0	0	107
3894	114	0	0	0	0	114
3895	0	0	117	0	0	117
3896	0	0	0	109	0	109
3897	0	1	0	109	0	110
3898	105	0	0	0	0	105
3899	111	0	0	0	0	111
3900	0	0	112	0	0	112
3901	0	111	0	1	0	112
3902	0	107	0	0	0	107
3903	111	0	1	0	0	112
3904	0	0	0	111	0	111
3905	0	0	0	109	0	109
3906	0	1	0	116	0	117
3907	116	0	0	0	0	116
3908	0	0	0	112	0	112
3909	111	0	1	0	0	112
3910	114	0	0	0	0	114
3911	0	120	0	0	0	120
3912	0	0	0	111	0	111
3913	0	0	112	0	0	112
3914	119	0	0	0	0	119
3915	113	0	0	0	0	113
3916	118	0	1	0	0	119
3917	0	0	130	0	0	130
3918	0	0	0	125	0	125
3919	127	0	0	0	0	127
3920	121	0	0	0	0	121
3921	129	0	1	0	0	130
3922	0	136	0	0	0	136
3923	0	132	0	0	0	132
3924	0	1	0	125	0	126
3925	0	1	0	125	0	126
3926	0	137	0	0	0	137
3927	137	0	0	0	0	137
3928	3	0	138	0	0	141
3929	0	0	0	128	0	128
3930	1	0	0	123	0	124
3931	0	0	128	0	0	128
3932	138	0	1	1	0	140
3933	133	0	0	0	0	133
3934	0	144	1	0	0	145
3935	135	0	1	0	0	136
3936	0	0	140	0	0	140
3937	131	0	1	0	0	132
3938	1	0	141	0	0	142
3939	137	0	0	0	0	137
3940	132	0	0	0	0	132
3941	117	0	1	0	0	118
3942	136	1	0	1	0	138
3943	0	140	0	0	0	140
3944	135	0	1	0	0	136
3945	125	0	4	0	0	129
3946	0	0	133	0	0	133
3947	133	0	0	0	0	133
3948	0	0	0	130	0	130
3949	0	0	122	0	0	122
3950	119	0	2	0	0	121
3951	0	0	0	114	0	114
3952	118	0	1	0	0	119
3953	115	0	1	0	0	116
3954	0	0	127	0	0	127
3955	117	0	0	0	0	117
3956	114	0	0	0	0	114
3957	109	0	3	0	0	112
3958	110	0	0	0	0	110
3959	1	1	0	117	0	119
3960	0	118	0	2	0	120
3961	115	0	0	1	0	116
3962	107	0	0	0	0	107
3963	111	0	0	0	0	111
3964	0	0	119	0	0	119
3965	0	121	0	0	0	121
3966	0	1	0	106	0	107
3967	0	4	1	102	0	107
3968	1	0	116	0	0	117
3969	0	0	0	119	0	119
3970	0	0	121	0	0	121
3971	0	1	0	119	0	120
3972	0	1	0	113	0	114
3973	0	0	123	0	0	123
3974	131	0	0	0	0	131
3975	130	0	0	0	0	130
3976	1	0	131	0	0	132
3977	129	0	0	0	0	129
3978	128	0	0	0	0	128
3979	0	0	139	0	0	139
3980	0	0	0	131	0	131
3981	0	0	0	133	0	133
3982	129	0	5	0	0	134
3983	0	138	0	0	0	138
3984	132	0	2	0	0	134
3985	131	0	0	0	0	131
3986	0	142	0	0	0	142
3987	138	0	3	0	0	141
3988	140	0	0	0	0	140
3989	0	150	0	0	0	150
3990	0	4	0	143	0	147
3991	0	152	0	0	0	152
3992	0	1	0	144	0	145
3993	0	0	147	0	0	147
3994	0	0	155	0	0	155
3995	150	0	0	0	0	150
3996	151	0	0	0	0	151
3997	0	0	151	0	0	151
3998	153	0	0	0	0	153
3999	148	0	1	0	0	149
4000	154	0	0	0	0	154
4001	0	164	0	0	0	164
4002	0	2	0	155	0	157
4003	159	0	0	0	0	159
4004	154	0	1	0	0	155
4005	0	0	166	0	0	166
4006	0	0	0	158	0	158
4007	0	0	0	160	0	160
4008	0	156	0	0	0	156
4009	0	161	0	0	0	161
4010	0	1	0	152	0	153
4011	0	161	0	1	0	162
4012	159	0	0	0	0	159
4013	0	168	0	0	0	168
4014	156	0	0	0	0	156
4015	0	0	165	0	0	165
4016	165	1	0	0	0	166
4017	152	0	0	0	0	152
4018	148	0	0	0	0	148
4019	155	0	1	0	0	156
4020	0	169	0	0	0	169
4021	0	1	0	149	0	150
4022	0	0	0	159	0	159
4023	0	0	167	0	0	167
4024	0	1	0	148	0	149
4025	0	0	0	157	0	157
4026	166	0	0	0	0	166
4027	0	168	0	0	0	168
4028	0	0	0	164	0	164
4029	1	0	0	152	0	153
4030	0	0	0	154	0	154
4031	157	0	1	0	0	158
4032	0	0	0	160	0	160
4033	152	0	2	0	0	154
4034	0	0	0	154	0	154
4035	0	0	0	148	0	148
4036	0	0	150	0	0	150
4037	150	0	0	0	0	150
4038	0	157	0	0	0	157
4039	156	0	0	0	0	156
4040	0	1	0	147	0	148
4041	0	0	0	152	0	152
4042	148	0	0	0	0	148
4043	144	0	1	0	0	145
4044	0	0	0	159	0	159
4045	0	0	155	0	0	155
4046	0	0	152	0	0	152
4047	0	157	0	0	0	157
4048	152	0	0	0	0	152
4049	146	0	0	0	0	146
4050	0	1	0	147	0	148
4051	0	150	0	0	0	150
4052	0	3	1	139	0	143
4053	1	0	0	144	0	145
4054	0	144	0	1	0	145
4055	142	0	1	0	0	143
4056	0	0	0	146	0	146
4057	0	143	0	0	0	143
4058	0	143	0	2	0	145
4059	131	0	0	0	0	131
4060	0	0	139	0	0	139
4061	133	0	1	0	0	134
4062	0	1	0	123	0	124
4063	1	0	0	128	0	129
4064	0	126	0	0	0	126
4065	0	2	0	124	0	126
4066	0	0	122	0	0	122
4067	0	124	0	0	0	124
4068	0	114	0	0	0	114
4069	115	0	2	0	0	117
4070	0	119	0	0	0	119
4071	0	0	0	123	0	123
4072	0	113	0	0	0	113
4073	0	1	0	106	0	107
4074	0	2	0	112	0	114
4075	0	0	125	0	0	125
4076	0	0	0	113	0	113
4077	0	2	0	112	0	114
4078	119	0	0	0	0	119
4079	0	0	128	0	0	128
4080	0	0	0	121	0	121
4081	1	0	115	0	0	116
4082	116	0	0	0	0	116
4083	0	116	0	0	0	116
4084	112	0	0	0	0	112
4085	0	0	0	112	0	112
4086	0	0	0	112	0	112
4087	0	0	110	0	0	110
4088	108	0	0	0	0	108
4089	0	109	0	0	0	109
4090	108	0	1	0	0	109
4091	0	0	0	114	0	114
4092	0	106	0	0	0	106
4093	110	0	0	0	0	110
4094	0	114	0	0	0	114
4095	0	0	0	109	0	109
4096	0	0	0	106	0	106
4097	0	0	0	116	0	116
4098	0	123	0	0	0	123
4099	0	0	0	117	0	117
4100	0	0	0	116	0	116
4101	111	0	1	0	0	112
4102	111	0	0	0	0	111
4103	117	0	1	0	0	118
4104	0	0	126	0	0	126
4105	126	0	0	0	0	126
4106	124	0	0	0	0	124
4107	122	0	1	0	0	123
4108	0	0	127	0	0	127
4109	131	0	0	0	0	131
4110	0	0	0	122	0	122
4111	1	0	132	0	0	133
4112	0	134	1	0	0	135
4113	0	0	0	133	0	133
4114	0	170	6	0	0	176
4115	0	185	0	0	0	185
4116	196	0	1	0	0	197
4117	0	0	9	184	0	193
4118	208	0	0	2	0	210
4119	0	0	0	210	0	210
4120	203	0	0	0	0	203
4121	1	1	0	201	0	203
4122	179	10	2	0	0	191
4123	0	0	202	0	0	202
4124	1	0	0	180	0	181
4125	0	0	197	0	0	197
4126	3	0	188	0	0	191
4127	0	0	200	1	0	201
4128	1	0	0	193	0	194
4129	4	0	180	0	0	184
4130	199	0	0	0	0	199
4131	0	0	0	201	0	201
4132	1	0	205	0	0	206
4133	0	2	0	190	0	192
4134	0	0	0	197	0	197
4135	1	0	212	0	0	213
4136	0	1	0	193	0	194
4137	0	0	0	205	0	205
4138	0	211	0	0	0	211
4139	200	0	1	0	0	201
4140	203	0	4	0	0	207
4141	0	0	215	0	0	215
4142	201	0	0	0	0	201
4143	0	0	203	0	0	203
4144	0	0	196	0	0	196
4145	0	0	203	0	0	203
4146	0	1	0	205	0	206
4147	0	0	213	0	0	213
4148	0	0	0	195	0	195
4149	0	4	0	187	0	191
4150	0	2	0	188	0	190
4151	0	0	0	211	0	211
4152	190	0	0	0	0	190
4153	209	0	0	0	0	209
4154	0	236	0	0	0	236
4155	1	2	0	221	0	224
4156	2	0	240	0	0	242
4157	0	247	0	0	0	247
4158	0	1	2	245	0	248
4159	0	0	262	0	0	262
4160	0	0	0	262	0	262
4161	0	0	344	0	0	344
4162	2	0	365	0	0	367
4163	0	4	1	334	0	339
4164	0	0	0	356	0	356
4165	339	0	0	0	0	339
4166	3	4	0	337	0	344
4167	343	0	1	0	0	344
4168	0	369	0	0	0	369
4169	0	360	0	0	0	360
4170	0	1	0	364	0	365
4171	369	0	0	0	0	369
4172	0	415	0	1	0	416
4173	0	2	0	411	0	413
4174	406	0	2	0	0	408
4175	401	0	0	0	0	401
4176	387	0	4	0	0	391
4177	368	0	1	0	0	369
4178	382	0	4	0	0	386
4179	0	0	411	0	0	411
4180	0	0	424	0	0	424
4181	0	421	0	4	0	425
4182	0	1	0	421	0	422
4183	0	0	425	0	0	425
4184	0	0	423	0	0	423
4185	0	1	0	431	0	432
4186	0	0	424	0	0	424
4187	3	0	417	0	0	420
4188	0	430	0	1	0	431
4189	428	0	2	0	0	430
4190	0	448	0	0	0	448
4191	0	0	0	440	0	440
4192	450	0	0	0	0	450
4193	0	463	0	0	0	463
4194	0	0	0	448	0	448
4195	0	0	458	0	0	458
4196	453	0	0	0	0	453
4197	437	0	1	0	0	438
4198	415	0	1	0	0	416
4199	1	0	0	462	0	463
4200	1	0	462	0	0	463
4201	0	465	0	0	0	465
4202	0	0	0	457	0	457
4203	444	0	0	0	0	444
4204	3	0	461	0	0	464
4205	0	453	0	0	0	453
4206	0	0	451	0	0	451
4207	458	0	0	0	0	458
4208	426	0	0	0	0	426
4209	447	0	0	0	0	447
4210	0	0	475	0	0	475
4211	0	470	0	3	0	473
4212	0	1	0	452	0	453
4213	0	0	0	419	0	419
4214	0	0	0	447	0	447
4215	0	0	464	0	0	464
4216	462	0	0	0	0	462
4217	0	0	456	0	0	456
4218	462	0	1	0	0	463
4219	438	0	0	2	0	440
4220	423	0	3	0	0	426
4221	436	0	1	0	0	437
4222	0	0	470	0	0	470
4223	0	0	0	468	0	468
4224	0	0	472	0	0	472
4225	0	463	0	1	0	464
4226	0	465	0	0	0	465
4227	456	0	0	2	0	458
4228	468	0	0	0	0	468
4229	0	473	0	0	0	473
4230	468	0	2	0	0	470
4231	2	0	407	0	0	409
4232	458	0	2	0	0	460
4233	0	456	0	0	0	456
4234	474	0	0	0	0	474
4235	444	0	1	0	0	445
4236	0	0	0	461	0	461
4237	0	0	0	464	0	464
4238	478	0	0	0	0	478
4239	0	0	0	475	0	475
4240	461	0	1	0	0	462
4241	0	1	0	467	0	468
4242	426	0	2	0	0	428
4243	422	0	4	0	0	426
4244	0	457	0	0	0	457
4245	0	436	0	0	0	436
4246	445	0	0	0	0	445
4247	0	438	0	0	0	438
4248	0	1	0	417	0	418
4249	0	1	0	429	0	430
4250	403	0	0	0	0	403
4251	0	423	0	0	0	423
4252	0	403	0	0	0	403
4253	0	386	1	0	0	387
4254	0	0	382	0	0	382
4255	0	0	393	0	0	393
4256	0	0	407	0	0	407
4257	0	2	0	401	0	403
4258	0	409	0	0	0	409
4259	395	0	1	0	0	396
4260	0	0	403	0	0	403
4261	0	0	387	0	0	387
4262	0	0	412	0	0	412
4263	1	0	0	391	0	392
4264	2	2	0	372	0	376
4265	0	0	0	307	0	307
4266	366	0	0	0	0	366
4267	357	0	0	1	0	358
4268	349	0	0	0	0	349
4269	0	2	0	336	0	338
4270	0	0	337	0	0	337
4271	1	0	335	0	0	336
4272	0	2	0	314	0	316
4273	0	3	0	319	0	322
4274	322	0	2	0	0	324
4275	0	328	0	0	0	328
4276	319	0	1	0	0	320
4277	0	320	0	0	0	320
4278	1	0	0	281	0	282
4279	0	0	298	0	0	298
4280	0	2	0	289	0	291
4281	290	0	0	0	0	290
4282	0	0	289	0	0	289
4283	284	0	0	0	0	284
4284	0	0	273	0	0	273
4285	0	1	262	0	0	263
4286	233	0	0	1	0	234
4287	2	0	209	0	0	211
4288	0	0	200	0	0	200
4289	0	166	0	0	0	166
4290	160	0	0	0	0	160
4291	153	0	0	0	0	153
4292	147	0	1	0	0	148
4293	0	0	153	0	0	153
4294	148	0	0	1	0	149
4295	0	143	0	0	0	143
4296	135	0	1	0	0	136
4297	0	0	141	0	0	141
4298	0	0	0	135	0	135
4299	0	0	137	0	0	137
4300	0	138	0	0	0	138
4301	0	1	0	122	0	123
4302	1	0	0	128	0	129
4303	126	0	0	0	0	126
4304	128	0	0	0	0	128
4305	127	0	0	0	0	127
4306	112	0	0	2	0	114
4307	110	0	0	0	0	110
4308	0	0	115	0	0	115
4309	1	0	0	105	0	106
4310	0	0	106	0	0	106
4311	0	0	0	100	0	100
4312	95	0	0	0	0	95
4313	89	0	2	0	0	91
4314	92	0	0	0	0	92
4315	91	0	1	0	0	92
4316	0	0	93	0	0	93
4317	0	2	0	78	0	80
4318	0	0	84	0	0	84
4319	0	77	0	0	0	77
4320	0	79	0	0	0	79
4321	1	1	0	69	0	71
4322	0	1	0	66	0	67
4323	0	0	0	75	0	75
4324	0	0	0	77	0	77
4325	75	0	0	0	0	75
4326	0	75	0	0	0	75
4327	72	0	0	0	0	72
4328	0	1	0	66	0	67
4329	0	1	0	66	0	67
4330	0	68	0	0	0	68
4331	0	0	0	71	0	71
4332	70	1	0	0	0	71
4333	0	74	0	0	0	74
4334	0	66	0	0	0	66
4335	67	0	0	0	0	67
4336	0	0	0	68	0	68
4337	0	72	0	4	0	76
4338	0	0	0	71	0	71
4339	69	0	0	0	0	69
4340	0	0	0	63	0	63
4341	0	0	0	65	0	65
4342	61	0	2	0	0	63
4343	0	1	0	72	0	73
4344	0	73	0	0	0	73
4345	0	1	0	68	0	69
4346	0	68	0	0	0	68
4347	0	0	0	60	0	60
4348	65	0	0	0	0	65
4349	65	0	0	0	0	65
4350	0	0	0	68	0	68
4351	1	0	68	0	0	69
4352	65	0	0	0	0	65
4353	0	0	62	0	0	62
4354	62	0	0	0	0	62
4355	54	0	0	1	0	55
4356	0	0	58	0	0	58
4357	0	61	0	0	0	61
4358	60	0	0	0	0	60
4359	54	0	0	0	0	54
4360	0	0	59	0	0	59
4361	55	0	0	0	0	55
4362	55	0	0	1	0	56
4363	52	0	0	0	0	52
4364	0	0	0	51	0	51
4365	0	0	0	64	0	64
4366	0	62	0	0	0	62
4367	0	0	0	63	0	63
4368	0	0	0	61	0	61
4369	0	0	64	0	0	64
4370	1	0	64	0	0	65
4371	64	0	0	0	0	64
4372	61	0	0	0	0	61
4373	0	66	0	0	0	66
4374	0	1	0	60	0	61
4375	0	0	64	0	0	64
4376	0	0	0	61	0	61
4377	0	1	0	61	0	62
4378	0	0	0	62	0	62
4379	0	65	0	0	0	65
4380	0	0	0	62	0	62
4381	0	0	0	58	0	58
4382	1	0	65	0	0	66
4383	0	0	65	0	0	65
4384	68	0	1	0	0	69
4385	66	0	0	0	0	66
4386	0	0	0	57	0	57
4387	0	1	0	57	0	58
4388	0	0	0	60	0	60
4389	0	0	61	0	0	61
4390	0	50	0	0	0	50
4391	0	0	59	0	0	59
4392	60	0	0	0	0	60
4393	0	0	59	0	0	59
4394	59	0	1	0	0	60
4395	56	0	0	0	0	56
4396	54	0	1	0	0	55
4397	0	0	0	64	0	64
4398	0	0	62	0	0	62
4399	0	59	0	1	0	60
4400	0	0	0	60	0	60
4401	0	0	0	62	0	62
4402	0	0	62	0	0	62
4403	0	61	0	0	0	61
4404	59	0	1	0	0	60
4405	0	60	0	0	0	60
4406	56	0	0	0	0	56
4407	0	2	0	53	0	55
4408	0	0	55	0	0	55
4409	0	58	0	0	0	58
4410	54	0	0	0	0	54
4411	1	0	54	0	0	55
4412	54	0	0	0	0	54
4413	49	0	1	0	0	50
4414	0	0	57	0	0	57
4415	51	0	0	0	0	51
4416	46	0	0	1	0	47
4417	49	0	0	0	0	49
4418	0	51	0	0	0	51
4419	51	0	0	0	0	51
4420	0	47	0	0	0	47
4421	0	0	46	0	0	46
4422	0	41	0	0	0	41
4423	48	0	0	0	0	48
4424	53	0	0	0	0	53
4425	54	0	0	0	0	54
4426	0	0	0	52	0	52
4427	0	0	0	52	0	52
4428	56	0	0	0	0	56
4429	59	0	0	0	0	59
4430	0	0	0	60	0	60
4431	0	0	62	0	0	62
4432	0	58	0	0	0	58
4433	0	59	0	0	0	59
4434	0	0	0	58	0	58
4435	0	0	63	0	0	63
4436	0	0	0	62	0	62
4437	0	61	0	0	0	61
4438	0	0	0	63	0	63
4439	0	0	63	0	0	63
4440	0	0	0	59	0	59
4441	0	0	66	0	0	66
4442	1	0	0	65	0	66
4443	0	0	66	0	0	66
4444	0	0	61	0	0	61
4445	67	0	0	0	0	67
4446	59	0	0	0	0	59
4447	63	0	0	0	0	63
4448	0	68	0	0	0	68
4449	0	0	0	63	0	63
4450	64	0	1	0	0	65
4451	63	0	0	0	0	63
4452	64	0	0	0	0	64
4453	0	0	68	0	0	68
4454	0	68	0	0	0	68
4455	0	65	1	0	0	66
4456	69	0	0	0	0	69
4457	0	0	0	65	0	65
4458	73	0	0	1	0	74
4459	0	0	79	0	0	79
4460	0	0	0	69	0	69
4461	0	0	0	72	0	72
4462	0	0	0	75	0	75
4463	0	74	0	0	0	74
4464	78	0	0	0	0	78
4465	84	0	0	0	0	84
4466	0	82	0	1	0	83
4467	0	0	0	79	0	79
4468	83	0	0	0	0	83
4469	0	0	0	81	0	81
4470	76	0	0	0	0	76
4471	0	82	0	0	0	82
4472	64	0	0	0	0	64
4473	0	0	74	0	0	74
4474	0	69	0	0	0	69
4475	0	0	71	0	0	71
4476	0	0	0	57	0	57
4477	70	0	0	0	0	70
4478	68	0	0	0	0	68
4479	67	0	0	0	0	67
4480	0	0	0	68	0	68
4481	69	0	0	0	0	69
4482	0	0	0	66	0	66
4483	64	0	0	0	0	64
4484	61	0	0	0	0	61
4485	0	0	68	0	0	68
4486	0	0	65	0	0	65
4487	2	0	64	0	0	66
4488	0	0	0	58	0	58
4489	63	0	0	0	0	63
4490	0	0	0	54	0	54
4491	0	0	0	65	0	65
4492	58	0	0	0	0	58
4493	60	0	0	0	0	60
4494	60	0	0	1	0	61
4495	65	0	0	0	0	65
4496	0	0	0	72	0	72
4497	73	0	0	0	0	73
4498	0	75	0	0	0	75
4499	70	0	0	0	0	70
4500	73	0	0	0	0	73
4501	0	0	72	0	0	72
4502	67	0	0	0	0	67
4503	0	0	73	0	0	73
4504	0	0	63	0	0	63
4505	0	0	66	0	0	66
4506	0	1	0	65	0	66
4507	0	0	67	0	0	67
4508	0	0	0	63	0	63
4509	0	0	57	0	0	57
4510	2	0	63	0	0	65
4511	0	0	0	54	0	54
4512	0	0	0	58	0	58
4513	0	0	67	0	0	67
4514	65	0	0	0	0	65
4515	1	1	0	55	0	57
4516	0	0	0	60	0	60
4517	64	0	0	0	0	64
4518	0	0	0	61	0	61
4519	0	0	58	0	0	58
4520	0	0	60	0	0	60
4521	0	0	0	56	0	56
4522	0	0	54	0	0	54
4523	0	58	0	0	0	58
4524	0	0	0	56	0	56
4525	55	0	0	0	0	55
4526	0	0	57	0	0	57
4527	57	0	0	0	0	57
4528	0	0	0	57	0	57
4529	0	0	0	49	0	49
4530	0	0	0	58	0	58
4531	0	0	0	59	0	59
4532	56	0	0	0	0	56
4533	0	57	0	0	0	57
4534	0	0	0	56	0	56
4535	0	0	0	58	0	58
4536	0	0	0	55	0	55
4537	0	0	0	58	0	58
4538	55	0	1	0	0	56
4539	0	58	0	0	0	58
4540	54	0	1	0	0	55
4541	0	59	0	0	0	59
4542	0	43	0	0	0	43
4543	51	0	0	0	0	51
4544	0	0	54	0	0	54
4545	0	0	0	55	0	55
4546	51	0	0	0	0	51
4547	47	0	0	1	0	48
4548	47	0	0	0	0	47
4549	51	0	0	0	0	51
4550	0	53	0	0	0	53
4551	44	0	0	0	0	44
4552	45	0	0	0	0	45
4553	0	53	0	0	0	53
4554	0	1	0	51	0	52
4555	0	0	52	0	0	52
4556	0	0	0	51	0	51
4557	47	0	0	0	0	47
4558	0	0	47	0	0	47
4559	0	42	0	4	0	46
4560	0	0	46	0	0	46
4561	0	1	0	48	0	49
4562	0	48	0	1	0	49
4563	46	0	0	0	0	46
4564	0	50	0	0	0	50
4565	0	0	0	47	0	47
4566	0	0	0	43	0	43
4567	43	0	1	0	0	44
4568	0	0	0	49	0	49
4569	0	50	0	0	0	50
4570	45	0	0	0	0	45
4571	43	0	0	0	0	43
4572	0	52	0	0	0	52
4573	47	0	0	0	0	47
4574	0	56	0	0	0	56
4575	54	0	0	0	0	54
4576	0	54	0	0	0	54
4577	0	0	0	51	0	51
4578	0	1	0	49	0	50
4579	53	0	0	0	0	53
4580	53	0	1	0	0	54
4581	0	58	0	0	0	58
4582	0	0	56	0	0	56
4583	60	0	0	0	0	60
4584	0	0	0	56	0	56
4585	0	62	0	0	0	62
4586	0	0	0	60	0	60
4587	58	0	0	0	0	58
4588	49	0	0	0	0	49
4589	48	0	1	0	0	49
4590	0	0	0	58	0	58
4591	0	0	60	0	0	60
4592	52	0	0	0	0	52
4593	48	0	2	0	0	50
4594	51	0	0	0	0	51
4595	0	58	0	0	0	58
4596	0	0	0	59	0	59
4597	0	58	0	0	0	58
4598	0	1	0	55	0	56
4599	0	0	1	58	0	59
4600	0	0	56	0	0	56
4601	0	0	0	57	0	57
4602	0	0	0	61	0	61
4603	61	1	0	0	0	62
4604	0	65	0	0	0	65
4605	60	0	1	0	0	61
4606	63	0	0	0	0	63
4607	0	2	0	60	0	62
4608	0	0	51	0	0	51
4609	0	62	0	0	0	62
4610	0	58	0	0	0	58
4611	62	1	0	0	0	63
4612	0	66	0	0	0	66
4613	0	0	0	61	0	61
4614	0	0	0	61	0	61
4615	0	0	59	0	0	59
4616	0	0	56	0	0	56
4617	0	58	0	0	0	58
4618	0	0	0	57	0	57
4619	62	0	0	0	0	62
4620	0	0	0	62	0	62
4621	0	0	62	0	0	62
4622	0	0	0	63	0	63
4623	63	0	0	0	0	63
4624	58	0	2	0	0	60
4625	0	63	0	0	0	63
4626	60	0	0	0	0	60
4627	0	64	0	0	0	64
4628	56	0	0	0	0	56
4629	0	0	0	55	0	55
4630	0	0	50	0	0	50
4631	0	0	52	0	0	52
4632	0	55	0	0	0	55
4633	0	0	0	54	0	54
4634	0	0	0	45	0	45
4635	53	0	0	0	0	53
4636	48	0	0	0	0	48
4637	44	0	0	0	0	44
4638	0	0	0	45	0	45
4639	1	0	0	44	0	45
4640	0	0	0	45	0	45
4641	0	0	46	0	0	46
4642	0	0	45	0	0	45
4643	46	0	0	0	0	46
4644	45	0	0	0	0	45
4645	1	0	46	0	0	47
4646	38	0	0	0	0	38
4647	39	0	0	0	0	39
4648	0	0	43	0	0	43
4649	0	43	0	0	0	43
4650	0	0	0	42	0	42
4651	0	0	44	0	0	44
4652	0	44	0	0	0	44
4653	0	0	0	40	0	40
4654	0	45	0	0	0	45
4655	0	0	40	0	0	40
4656	0	0	53	0	0	53
4657	0	0	0	52	0	52
4658	56	0	0	0	0	56
4659	0	0	0	48	0	48
4660	51	0	0	0	0	51
4661	0	0	0	52	0	52
4662	0	0	54	0	0	54
4663	48	0	0	0	0	48
4664	0	0	52	1	0	53
4665	55	0	0	0	0	55
4666	0	0	0	53	0	53
4667	0	58	0	0	0	58
4668	0	0	0	50	0	50
4669	0	59	0	0	0	59
4670	0	1	0	59	0	60
4671	0	58	0	0	0	58
4672	62	0	0	0	0	62
4673	60	0	0	0	0	60
4674	59	0	0	0	0	59
4675	0	0	64	0	0	64
4676	0	0	0	58	0	58
4677	0	0	60	0	0	60
4678	0	56	0	0	0	56
4679	0	57	0	0	0	57
4680	55	0	0	1	0	56
4681	0	0	62	0	0	62
4682	0	66	0	0	0	66
4683	0	0	0	62	0	62
4684	62	0	0	0	0	62
4685	0	63	0	0	0	63
4686	60	0	0	0	0	60
4687	0	0	59	0	0	59
4688	0	0	0	55	0	55
4689	0	0	0	54	0	54
4690	0	0	0	57	0	57
4691	0	57	0	0	0	57
4692	0	0	7	48	0	55
4693	0	0	56	0	0	56
4694	0	0	0	53	0	53
4695	0	0	0	55	0	55
4696	0	0	0	57	0	57
4697	0	57	0	0	0	57
4698	0	0	0	55	0	55
4699	1	2	0	52	0	55
4700	0	58	0	0	0	58
4701	62	0	0	0	0	62
4702	0	61	0	2	0	63
4703	0	61	1	0	0	62
4704	0	0	0	62	0	62
4705	0	0	60	0	0	60
4706	56	0	0	0	0	56
4707	0	1	0	59	0	60
4708	0	0	62	0	0	62
4709	0	59	0	0	0	59
4710	0	0	0	57	0	57
4711	0	0	61	0	0	61
4712	0	0	0	58	0	58
4713	0	0	0	63	0	63
4714	58	0	2	0	0	60
4715	0	65	0	0	0	65
4716	58	0	1	0	0	59
4717	0	0	65	0	0	65
4718	0	63	0	0	0	63
4719	1	0	64	0	0	65
4720	0	0	0	61	0	61
4721	66	0	0	0	0	66
4722	0	0	0	62	0	62
4723	66	0	0	0	0	66
4724	55	0	1	0	0	56
4725	0	0	0	63	0	63
4726	1	0	62	0	0	63
4727	0	0	67	0	0	67
4728	0	0	0	55	0	55
4729	0	0	0	54	0	54
4730	57	0	0	0	0	57
4731	1	0	0	60	0	61
4732	0	58	0	0	0	58
4733	0	0	0	52	0	52
4734	0	0	0	56	0	56
4735	54	0	0	0	0	54
4736	0	57	0	0	0	57
4737	0	0	0	52	0	52
4738	0	1	0	53	0	54
4739	0	50	0	0	0	50
4740	0	1	0	46	0	47
4741	0	0	0	53	0	53
4742	0	55	0	0	0	55
4743	0	0	0	50	0	50
4744	0	0	0	50	0	50
4745	0	57	0	0	0	57
4746	0	0	0	52	0	52
4747	54	0	0	0	0	54
4748	52	0	0	0	0	52
4749	49	0	0	1	0	50
4750	56	0	0	0	0	56
4751	0	51	0	0	0	51
4752	53	0	0	0	0	53
4753	0	52	0	1	0	53
4754	0	49	0	0	0	49
4755	0	0	0	52	0	52
4756	0	0	51	0	0	51
4757	48	0	0	0	0	48
4758	46	0	0	0	0	46
4759	0	0	54	0	0	54
4760	50	0	0	0	0	50
4761	51	0	0	0	0	51
4762	0	51	0	0	0	51
4763	52	0	0	0	0	52
4764	0	0	0	45	0	45
4765	0	0	0	47	0	47
4766	0	0	0	51	0	51
4767	0	0	0	52	0	52
4768	51	0	0	0	0	51
4769	0	1	0	44	0	45
4770	1	0	0	51	0	52
4771	0	0	50	0	0	50
4772	46	0	0	0	0	46
4773	52	0	0	0	0	52
4774	49	0	0	0	0	49
4775	0	53	0	0	0	53
4776	0	49	0	0	0	49
4777	54	0	0	0	0	54
4778	0	0	0	52	0	52
4779	0	47	0	0	0	47
4780	0	0	0	51	0	51
4781	0	50	0	0	0	50
4782	50	0	0	1	0	51
4783	0	55	0	0	0	55
4784	0	0	0	45	0	45
4785	1	0	0	48	0	49
4786	0	0	53	0	0	53
4787	0	55	0	0	0	55
4788	0	0	0	47	0	47
4789	0	0	53	0	0	53
4790	0	0	54	0	0	54
4791	0	0	0	51	0	51
4792	0	0	0	48	0	48
4793	0	52	0	0	0	52
4794	0	54	0	0	0	54
4795	0	0	0	53	0	53
4796	55	0	0	0	0	55
4797	0	0	0	56	0	56
4798	47	0	0	0	0	47
4799	49	0	1	0	0	50
4800	53	0	0	0	0	53
4801	0	0	57	0	0	57
4802	56	0	0	0	0	56
4803	0	0	0	51	0	51
4804	0	0	0	53	0	53
4805	0	0	57	0	0	57
4806	0	0	58	0	0	58
4807	0	1	0	50	0	51
4808	0	56	0	0	0	56
4809	0	55	0	0	0	55
4810	0	0	0	53	0	53
4811	50	0	1	0	0	51
4812	0	0	0	53	0	53
4813	0	2	0	53	0	55
4814	0	54	0	0	0	54
4815	0	0	0	53	0	53
4816	0	0	54	0	0	54
4817	0	0	55	0	0	55
4818	53	0	1	0	0	54
4819	0	56	0	0	0	56
4820	56	0	0	0	0	56
4821	53	0	4	0	0	57
4822	0	0	0	62	0	62
4823	0	63	0	0	0	63
4824	0	0	0	63	0	63
4825	58	0	0	0	0	58
4826	0	61	0	1	0	62
4827	63	0	0	0	0	63
4828	0	64	0	2	0	66
4829	62	0	1	0	0	63
4830	53	0	0	0	0	53
4831	0	60	0	0	0	60
4832	0	0	0	56	0	56
4833	54	0	0	0	0	54
4834	0	0	55	0	0	55
4835	0	0	64	0	0	64
4836	0	0	0	61	0	61
4837	58	0	0	0	0	58
4838	0	0	0	55	0	55
4839	61	0	0	0	0	61
4840	0	0	61	0	0	61
4841	61	0	0	0	0	61
4842	57	1	1	0	0	59
4843	1	1	0	60	0	62
4844	0	0	0	55	0	55
4845	0	0	0	59	0	59
4846	0	61	0	0	0	61
4847	0	0	0	52	0	52
4848	0	0	0	58	0	58
4849	57	0	0	0	0	57
4850	52	0	0	0	0	52
4851	0	0	60	0	0	60
4852	60	0	0	0	0	60
4853	0	0	58	0	0	58
4854	57	0	0	0	0	57
4855	0	0	53	0	0	53
4856	0	0	57	0	0	57
4857	0	0	0	57	0	57
4858	0	0	53	0	0	53
4859	58	0	0	0	0	58
4860	0	0	0	54	0	54
4861	54	0	1	0	0	55
4862	56	0	0	0	0	56
4863	56	0	1	0	0	57
4864	59	0	0	0	0	59
4865	0	0	65	0	0	65
4866	0	0	0	63	0	63
4867	0	0	69	0	0	69
4868	0	0	0	62	0	62
4869	80	0	0	0	0	80
4870	0	0	0	77	0	77
4871	75	0	0	0	0	75
4872	0	1	0	77	0	78
4873	0	0	0	82	0	82
4874	75	0	0	0	0	75
4875	0	85	0	0	0	85
4876	76	0	0	0	0	76
4877	0	87	0	0	0	87
4878	0	0	0	85	0	85
4879	85	0	0	0	0	85
4880	0	0	85	0	0	85
4881	0	0	0	82	0	82
4882	86	0	0	0	0	86
4883	80	0	0	0	0	80
4884	0	1	0	100	0	101
4885	0	97	0	0	0	97
4886	0	95	0	0	0	95
4887	0	0	0	99	0	99
4888	97	1	0	0	0	98
4889	0	106	0	0	0	106
4890	0	101	0	0	0	101
4891	105	1	0	0	0	106
4892	0	108	0	0	0	108
4893	108	0	0	0	0	108
4894	0	0	0	104	0	104
4895	0	0	0	113	0	113
4896	0	108	0	0	0	108
4897	0	116	0	0	0	116
4898	116	0	0	0	0	116
4899	0	115	0	0	0	115
4900	0	110	0	0	0	110
4901	0	0	0	114	0	114
4902	119	0	0	0	0	119
4903	0	0	117	0	0	117
4904	114	0	0	0	0	114
4905	0	0	0	119	0	119
4906	0	0	116	0	0	116
4907	0	0	117	0	0	117
4908	0	0	0	113	0	113
4909	0	0	109	0	0	109
4910	116	0	0	0	0	116
4911	117	0	0	0	0	117
4912	0	0	119	0	0	119
4913	0	0	0	110	0	110
4914	0	0	1	106	0	107
4915	108	0	1	0	0	109
4916	0	1	0	112	0	113
4917	0	106	0	0	0	106
4918	112	0	2	0	0	114
4919	0	114	0	0	0	114
4920	0	110	0	0	0	110
4921	1	0	0	108	0	109
4922	3	0	0	100	0	103
4923	0	0	2	106	0	108
4924	0	0	112	0	0	112
4925	110	0	0	0	0	110
4926	0	111	0	0	0	111
4927	105	0	1	0	0	106
4928	92	0	0	0	0	92
4929	0	0	0	106	0	106
4930	0	103	0	0	0	103
4931	0	4	0	96	0	100
4932	0	0	0	103	0	103
4933	93	0	0	0	0	93
4934	104	0	1	0	0	105
4935	0	0	104	0	0	104
4936	100	0	1	0	0	101
4937	0	102	0	0	0	102
4938	86	0	0	0	0	86
4939	0	87	0	0	0	87
4940	0	0	0	82	0	82
4941	0	0	0	84	0	84
4942	0	85	0	0	0	85
4943	0	0	0	81	0	81
4944	0	0	0	81	0	81
4945	0	0	0	85	0	85
4946	0	83	0	0	0	83
4947	2	0	0	78	0	80
4948	0	0	0	76	0	76
4949	0	0	0	78	0	78
4950	0	0	86	0	0	86
4951	86	0	0	0	0	86
4952	0	0	82	0	0	82
4953	87	0	0	0	0	87
4954	0	0	83	0	0	83
4955	80	0	0	0	0	80
4956	85	0	1	0	0	86
4957	0	0	87	0	0	87
4958	0	4	0	73	0	77
4959	0	0	76	0	0	76
4960	76	0	2	3	0	81
4961	0	0	74	0	0	74
4962	0	0	76	0	0	76
4963	72	0	0	2	0	74
4964	0	77	0	0	0	77
4965	0	0	0	77	0	77
4966	75	0	0	0	0	75
4967	0	2	0	67	0	69
4968	0	0	0	71	0	71
4969	75	2	0	0	0	77
4970	74	0	2	0	0	76
4971	0	0	74	0	0	74
4972	0	0	75	0	0	75
4973	0	0	1	75	0	76
4974	1	0	79	0	0	80
4975	0	0	0	72	0	72
4976	0	0	0	72	0	72
4977	0	0	0	79	0	79
4978	77	0	0	0	0	77
4979	0	80	0	0	0	80
4980	74	0	0	0	0	74
4981	79	0	0	0	0	79
4982	0	76	0	0	0	76
4983	72	0	0	0	0	72
4984	0	0	73	0	0	73
4985	0	0	0	72	0	72
4986	71	0	0	0	0	71
4987	0	0	69	0	0	69
4988	69	0	0	0	0	69
4989	0	67	0	0	0	67
4990	64	0	0	0	0	64
4991	61	0	1	0	0	62
4992	0	66	0	0	0	66
4993	60	0	0	0	0	60
4994	0	0	0	58	0	58
4995	0	0	0	60	0	60
4996	53	0	0	1	0	54
4997	57	0	0	0	0	57
4998	0	61	0	0	0	61
4999	0	55	0	0	0	55
5000	0	0	0	59	0	59
5001	0	57	0	0	0	57
5002	0	60	0	0	0	60
5003	57	0	1	0	0	58
5004	0	60	0	0	0	60
5005	58	0	0	0	0	58
5006	0	57	0	0	0	57
5007	0	0	59	0	0	59
5008	0	55	0	0	0	55
5009	55	0	0	0	0	55
5010	58	0	0	0	0	58
5011	0	0	62	0	0	62
5012	0	0	0	57	0	57
5013	0	0	0	54	0	54
5014	0	0	59	0	0	59
5015	0	2	0	55	0	57
5016	0	0	54	0	0	54
5017	0	0	51	0	0	51
5018	55	0	0	0	0	55
5019	0	52	1	0	0	53
5020	47	0	0	0	0	47
5021	0	0	0	52	0	52
5022	0	0	50	0	0	50
5023	0	0	0	49	0	49
5024	0	48	0	0	0	48
5025	50	0	0	0	0	50
5026	47	0	0	0	0	47
5027	0	0	0	46	0	46
5028	0	0	48	0	0	48
5029	46	0	4	0	0	50
5030	0	44	0	1	0	45
5031	43	0	0	0	0	43
5032	0	0	0	40	0	40
5033	42	0	0	1	0	43
5034	0	0	0	42	0	42
5035	0	0	39	0	0	39
5036	0	0	38	0	0	38
5037	35	0	0	1	0	36
5038	0	39	0	0	0	39
5039	36	0	0	0	0	36
5040	29	0	0	0	0	29
5041	0	36	0	0	0	36
5042	33	0	0	0	0	33
5043	0	0	34	0	0	34
5044	0	1	0	28	0	29
5045	0	1	0	27	0	28
5046	0	0	0	30	0	30
5047	0	0	29	0	0	29
5048	0	0	28	0	0	28
5049	0	0	0	28	0	28
5050	0	29	0	0	0	29
5051	0	28	0	0	0	28
5052	29	0	0	0	0	29
5053	29	0	0	0	0	29
5054	0	30	0	0	0	30
5055	0	0	0	27	0	27
5056	0	0	0	28	0	28
5057	28	0	1	0	0	29
5058	0	0	0	28	0	28
5059	0	0	0	26	0	26
5060	0	0	0	31	0	31
5061	0	0	24	0	0	24
5062	0	0	23	0	0	23
5063	24	0	0	0	0	24
5064	0	0	0	25	0	25
5065	0	0	21	0	0	21
5066	0	0	25	0	0	25
5067	22	0	0	0	0	22
5068	0	0	25	0	0	25
5069	0	26	0	0	0	26
5070	0	0	0	24	0	24
5071	0	0	25	0	0	25
5072	23	0	0	0	0	23
5073	0	0	0	25	0	25
5074	0	0	25	0	0	25
5075	0	0	0	24	0	24
5076	0	0	0	23	0	23
5077	23	0	0	0	0	23
5078	0	25	0	0	0	25
5079	0	0	0	24	0	24
5080	22	0	0	0	0	22
5081	24	0	0	0	0	24
5082	23	0	0	0	0	23
5083	23	0	0	0	0	23
5084	0	0	0	24	0	24
5085	22	0	0	0	0	22
5086	24	0	0	0	0	24
5087	21	0	0	1	0	22
5088	22	0	0	0	0	22
5089	0	25	0	0	0	25
5090	0	23	0	0	0	23
5091	0	1	0	22	0	23
5092	0	24	0	0	0	24
5093	23	0	0	0	0	23
5094	0	0	0	24	0	24
5095	23	0	0	0	0	23
5096	21	0	1	0	0	22
5097	1	1	0	23	0	25
5098	0	0	0	26	0	26
5099	0	24	0	0	0	24
5100	24	0	0	0	0	24
5101	0	25	0	0	0	25
5102	25	0	0	0	0	25
5103	0	0	0	24	0	24
5104	0	0	24	0	0	24
5105	25	0	0	0	0	25
5106	22	0	1	0	0	23
5107	0	0	24	0	0	24
5108	0	0	26	0	0	26
5109	0	0	0	25	0	25
5110	25	0	0	0	0	25
5111	23	0	0	0	0	23
5112	24	0	0	0	0	24
5113	23	0	0	0	0	23
5114	0	25	0	0	0	25
5115	27	0	0	0	0	27
5116	0	0	0	22	0	22
5117	0	0	0	19	0	19
5118	0	0	0	23	0	23
5119	0	0	0	21	0	21
5120	23	0	0	0	0	23
5121	0	0	0	22	0	22
5122	0	0	25	0	0	25
5123	0	0	0	21	0	21
5124	0	0	0	18	0	18
5125	0	0	0	20	0	20
5126	0	0	0	20	0	20
5127	22	0	0	0	0	22
5128	0	23	0	0	0	23
5129	0	21	0	1	0	22
5130	0	0	0	19	0	19
5131	24	0	0	0	0	24
5132	26	0	0	0	0	26
5133	0	0	0	25	0	25
5134	0	0	22	0	0	22
5135	24	0	0	0	0	24
5136	0	0	0	25	0	25
5137	0	0	25	0	0	25
5138	24	0	0	0	0	24
5139	0	27	0	0	0	27
5140	25	1	0	0	0	26
5141	0	25	0	0	0	25
5142	0	0	0	26	0	26
5143	0	26	0	0	0	26
5144	0	0	0	26	0	26
5145	25	0	0	0	0	25
5146	0	27	0	0	0	27
5147	0	0	25	0	0	25
5148	0	0	0	24	0	24
5149	0	0	22	0	0	22
5150	0	0	0	21	0	21
5151	0	0	0	21	0	21
5152	0	0	20	0	0	20
5153	19	0	0	0	0	19
5154	0	0	21	0	0	21
5155	0	0	20	0	0	20
5156	0	22	0	0	0	22
5157	0	0	0	20	0	20
5158	1	0	0	19	0	20
5159	0	2	0	20	0	22
5160	1	0	0	21	0	22
5161	0	0	24	0	0	24
5162	23	0	0	0	0	23
5163	0	0	23	0	0	23
5164	0	0	0	21	0	21
5165	21	0	0	0	0	21
5166	0	22	0	0	0	22
5167	0	0	0	22	0	22
5168	23	0	0	0	0	23
5169	0	23	0	0	0	23
5170	0	27	0	0	0	27
5171	25	0	0	0	0	25
5172	0	26	0	0	0	26
5173	24	0	0	0	0	24
5174	0	25	0	0	0	25
5175	20	0	0	0	0	20
5176	21	0	0	0	0	21
5177	0	26	0	0	0	26
5178	0	0	0	21	0	21
5179	0	0	24	0	0	24
5180	24	0	0	0	0	24
5181	0	0	0	23	0	23
5182	0	25	0	0	0	25
5183	0	25	0	0	0	25
5184	0	0	0	22	0	22
5185	23	0	0	0	0	23
5186	0	0	24	0	0	24
5187	0	0	0	17	0	17
5188	0	2	0	19	0	21
5189	0	0	0	20	0	20
5190	0	0	0	21	0	21
5191	0	19	0	0	0	19
5192	0	0	0	18	0	18
5193	0	0	20	0	0	20
5194	0	0	20	0	0	20
5195	0	0	22	0	0	22
5196	0	0	0	20	0	20
5197	20	0	0	0	0	20
5198	0	0	22	0	0	22
5199	0	0	24	0	0	24
5200	0	0	0	22	0	22
5201	25	0	0	0	0	25
5202	0	23	0	0	0	23
5203	23	0	0	0	0	23
5204	0	0	0	21	0	21
5205	0	0	24	0	0	24
5206	1	0	0	22	0	23
5207	0	20	0	0	0	20
5208	24	0	0	0	0	24
5209	0	0	23	0	0	23
5210	0	24	0	0	0	24
5211	26	0	0	0	0	26
5212	0	0	0	19	0	19
5213	0	1	0	23	0	24
5214	24	0	0	0	0	24
5215	23	0	0	2	0	25
5216	27	1	1	0	0	29
5217	0	0	0	30	0	30
5218	0	33	0	0	0	33
5219	34	0	1	0	0	35
5220	0	36	0	0	0	36
5221	37	0	0	0	0	37
5222	0	38	0	0	0	38
5223	1	0	0	36	0	37
5224	35	1	0	0	0	36
5225	38	0	0	0	0	38
5226	39	0	0	0	0	39
5227	34	0	0	0	0	34
5228	37	0	0	0	0	37
5229	0	0	41	0	0	41
5230	0	0	0	41	0	41
5231	0	0	37	0	0	37
5232	0	0	36	0	0	36
5233	40	0	0	0	0	40
5234	38	0	0	0	0	38
5235	32	0	0	0	0	32
5236	0	0	0	41	0	41
5237	40	0	0	0	0	40
5238	0	43	0	0	0	43
5239	0	36	0	0	0	36
5240	0	38	0	0	0	38
5241	41	0	0	0	0	41
5242	0	43	0	0	0	43
5243	41	0	0	0	0	41
5244	42	0	0	0	0	42
5245	0	0	46	0	0	46
5246	0	0	0	45	0	45
5247	0	0	0	42	0	42
5248	40	0	1	0	0	41
5249	35	0	0	0	0	35
5250	0	0	0	40	0	40
5251	1	0	42	0	0	43
5252	0	0	46	0	0	46
5253	0	0	0	43	0	43
5254	0	0	0	36	0	36
5255	0	0	0	42	0	42
5256	42	0	0	0	0	42
5257	40	0	0	0	0	40
5258	0	49	0	0	0	49
5259	0	0	0	45	0	45
5260	0	0	0	47	0	47
5261	0	61	0	0	0	61
5262	0	0	0	63	0	63
5263	62	0	0	1	0	63
5264	0	0	0	60	0	60
5265	0	0	0	68	0	68
5266	61	0	0	0	0	61
5267	63	0	1	1	0	65
5268	64	0	0	0	0	64
5269	0	0	0	70	0	70
5270	0	0	62	0	0	62
5271	0	0	64	0	0	64
5272	0	0	66	0	0	66
5273	0	68	0	0	0	68
5274	60	0	0	0	0	60
5275	0	0	78	0	0	78
5276	81	0	0	0	0	81
5277	0	0	0	80	0	80
5278	68	0	0	0	0	68
5279	69	0	2	1	0	72
5280	0	82	0	0	0	82
5281	82	0	0	0	0	82
5282	82	0	0	1	0	83
5283	0	97	0	0	0	97
5284	0	2	0	88	0	90
5285	0	0	99	0	0	99
5286	0	0	0	86	0	86
5287	0	0	0	95	0	95
5288	95	0	0	0	0	95
5289	0	1	0	99	0	100
5290	0	100	0	0	0	100
5291	0	0	0	101	0	101
5292	0	0	0	102	0	102
5293	1	0	93	0	0	94
5294	0	109	0	0	0	109
5295	0	113	0	0	0	113
5296	107	0	0	0	0	107
5297	0	122	0	0	0	122
5298	0	2	0	118	0	120
5299	1	0	124	0	0	125
5300	0	127	0	0	0	127
5301	138	0	0	0	0	138
5302	0	0	0	140	0	140
5303	1	1	0	145	0	147
5304	0	0	159	0	0	159
5305	0	1	0	158	0	159
5306	4	1	0	152	0	157
5307	137	4	0	2	0	143
5308	155	0	1	0	0	156
5309	0	166	0	2	0	168
5310	164	0	0	0	0	164
5311	0	179	0	0	0	179
5312	0	0	0	164	0	164
5313	0	160	0	2	0	162
5314	0	165	0	0	0	165
5315	162	0	1	0	0	163
5316	156	0	3	0	0	159
5317	0	175	0	0	0	175
5318	164	0	2	1	0	167
5319	155	0	1	0	0	156
5320	146	0	2	0	0	148
5321	0	0	0	166	0	166
5322	159	0	0	0	0	159
5323	0	0	164	0	0	164
5324	152	0	2	0	0	154
5325	0	0	157	0	0	157
5326	0	0	0	139	0	139
5327	0	0	0	152	0	152
5328	0	0	150	0	0	150
5329	153	0	0	1	0	154
5330	153	0	3	0	0	156
5331	0	0	163	0	0	163
5332	0	0	0	143	0	143
5333	0	4	0	132	0	136
5334	0	0	0	151	0	151
5335	149	0	0	2	0	151
5336	146	0	0	0	0	146
5337	0	0	0	155	0	155
5338	0	151	0	0	0	151
5339	0	130	0	2	0	132
5340	153	0	1	0	0	154
5341	0	155	0	0	0	155
5342	0	152	0	0	0	152
5343	0	0	0	157	0	157
5344	0	0	159	0	0	159
5345	0	163	0	0	0	163
5346	0	2	1	162	0	165
5347	0	170	0	0	0	170
5348	0	1	0	166	0	167
5349	161	0	0	0	0	161
5350	0	171	0	0	0	171
5351	162	0	0	0	0	162
5352	157	0	0	0	0	157
5353	0	0	159	0	0	159
5354	170	0	1	0	0	171
5355	0	1	0	163	0	164
5356	0	0	159	0	0	159
5357	0	180	0	0	0	180
5358	0	0	0	161	0	161
5359	0	0	0	163	0	163
5360	171	0	0	0	0	171
5361	0	1	0	169	0	170
5362	0	0	0	173	0	173
5363	175	0	1	0	0	176
5364	0	181	0	0	0	181
5365	166	0	1	1	0	168
5366	1	0	184	0	0	185
5367	173	0	2	0	0	175
5368	1	0	181	0	0	182
5369	0	176	0	0	0	176
5370	170	0	0	2	0	172
5371	164	0	0	0	0	164
5372	1	0	168	0	0	169
5373	0	0	171	0	0	171
5374	0	0	180	0	0	180
5375	0	189	0	0	0	189
5376	0	0	0	176	0	176
5377	0	0	184	0	0	184
5378	0	0	191	0	0	191
5379	0	0	0	189	0	189
5380	0	0	186	0	0	186
5381	187	0	1	2	0	190
5382	189	0	3	0	0	192
5383	0	0	191	0	0	191
5384	0	203	0	0	0	203
5385	1	0	0	188	0	189
5386	1	1	199	0	0	201
5387	0	207	0	0	0	207
5388	0	2	0	199	0	201
5389	198	0	0	0	0	198
5390	187	1	0	1	0	189
5391	0	221	0	0	0	221
5392	0	0	1	210	0	211
5393	0	1	0	198	0	199
5394	0	1	0	210	0	211
5395	1	0	0	217	0	218
5396	0	0	220	0	0	220
5397	0	0	0	209	0	209
5398	0	0	222	0	0	222
5399	0	225	0	0	0	225
5400	225	0	1	0	0	226
5401	0	231	0	0	0	231
5402	0	0	0	219	0	219
5403	1	2	0	221	0	224
5404	237	0	0	0	0	237
5405	0	0	0	256	0	256
5406	0	263	0	0	0	263
5407	0	0	0	259	0	259
5408	0	1	0	271	0	272
5409	230	0	2	2	0	234
5410	1	0	269	0	0	270
5411	0	259	0	1	0	260
5412	0	258	0	1	0	259
5413	0	1	0	263	0	264
5414	276	0	0	1	0	277
5415	0	281	0	0	0	281
5416	1	2	0	269	0	272
5417	0	1	315	0	0	316
5418	0	0	0	290	0	290
5419	306	0	4	0	0	310
5420	278	0	2	1	0	281
5421	0	0	0	302	0	302
5422	308	1	0	0	0	309
5423	300	0	1	0	0	301
5424	0	0	323	0	0	323
5425	320	0	0	0	0	320
5426	0	333	1	0	0	334
5427	311	0	0	0	0	311
5428	0	0	329	0	0	329
5429	0	0	0	314	0	314
5430	326	0	1	1	0	328
5431	0	0	319	0	0	319
5432	0	0	329	0	0	329
5433	0	0	0	303	0	303
5434	0	0	307	0	0	307
5435	320	0	1	0	0	321
5436	0	0	323	0	0	323
5437	0	1	1	301	0	303
5438	1	0	0	303	0	304
5439	309	0	1	0	0	310
5440	0	0	313	0	0	313
5441	1	0	318	0	0	319
5442	0	0	2	310	0	312
5443	0	0	307	0	0	307
5444	318	0	0	0	0	318
5445	0	2	0	296	0	298
5446	0	0	314	0	0	314
5447	0	4	0	298	0	302
5448	0	0	0	282	0	282
5449	283	0	2	1	0	286
5450	0	0	291	0	0	291
5451	275	1	0	0	0	276
5452	0	0	279	0	0	279
5453	266	0	0	0	0	266
5454	258	0	0	0	0	258
5455	247	1	0	0	0	248
5456	0	269	1	0	0	270
5457	265	0	0	0	0	265
5458	241	0	0	0	0	241
5459	0	0	0	262	0	262
5460	0	0	268	0	0	268
5461	260	0	0	0	0	260
5462	0	0	261	0	0	261
5463	0	1	0	240	0	241
5464	0	1	0	240	0	241
5465	254	0	0	0	0	254
5466	0	258	0	0	0	258
5467	0	1	0	238	0	239
5468	0	1	0	248	0	249
5469	0	0	262	0	0	262
5470	0	0	0	247	0	247
5471	0	1	0	236	0	237
5472	0	0	0	255	0	255
5473	0	259	0	0	0	259
5474	267	0	0	0	0	267
5475	256	0	2	0	0	258
5476	0	274	0	1	0	275
5477	263	0	0	0	0	263
5478	0	0	0	255	0	255
5479	1	0	252	0	0	253
5480	0	257	0	0	0	257
5481	0	255	0	0	0	255
5482	259	0	0	0	0	259
5483	236	0	0	0	0	236
5484	0	2	0	239	0	241
5485	0	1	0	247	0	248
5486	0	0	0	262	0	262
5487	262	0	0	0	0	262
5488	0	0	267	0	0	267
5489	269	0	0	0	0	269
5490	0	4	0	222	0	226
5491	0	1	1	261	0	263
5492	0	264	0	0	0	264
5493	0	1	0	250	0	251
5494	0	2	0	250	0	252
5495	0	0	265	0	0	265
5496	0	264	0	0	0	264
5497	265	0	2	0	0	267
5498	234	0	1	0	0	235
5499	239	0	0	0	0	239
5500	235	0	1	0	0	236
5501	0	0	255	0	0	255
5502	262	0	2	0	0	264
5503	1	0	266	0	0	267
5504	0	1	0	256	0	257
5505	0	256	0	0	0	256
5506	0	0	0	242	0	242
5507	1	0	0	245	0	246
5508	0	0	243	0	0	243
5509	259	0	0	0	0	259
5510	251	0	0	0	0	251
5511	0	262	0	0	0	262
5512	1	0	265	0	0	266
5513	0	0	0	258	0	258
5514	0	0	250	0	0	250
5515	4	0	271	0	0	275
5516	0	0	1	254	0	255
5517	1	0	279	0	0	280
5518	0	1	0	268	0	269
5519	0	0	280	0	0	280
5520	0	0	0	268	0	268
5521	277	0	1	0	0	278
5522	259	0	1	1	0	261
5523	259	0	0	0	0	259
5524	265	0	2	2	0	269
5525	0	281	0	0	0	281
5526	0	1	0	254	0	255
5527	1	2	0	258	0	261
5528	0	0	273	0	0	273
5529	0	0	0	277	0	277
5530	0	0	264	0	0	264
5531	0	0	278	0	0	278
5532	260	0	1	0	0	261
5533	0	266	0	3	0	269
5534	261	0	0	0	0	261
5535	266	0	0	0	0	266
5536	0	288	0	0	0	288
5537	274	0	1	0	0	275
5538	0	0	279	0	0	279
5539	0	273	0	1	0	274
5540	273	0	1	0	0	274
5541	0	0	277	0	0	277
5542	266	0	0	0	0	266
5543	0	280	0	0	0	280
5544	252	0	1	0	0	253
5545	257	0	0	0	0	257
5546	0	271	0	0	0	271
5547	0	261	0	0	0	261
5548	0	266	0	0	0	266
5549	0	1	0	242	0	243
5550	1	1	0	226	0	228
5551	233	0	2	0	0	235
5552	237	4	3	0	0	244
5553	0	0	267	0	0	267
5554	0	0	236	0	0	236
5555	0	0	257	0	0	257
5556	0	0	0	224	0	224
5557	0	0	245	0	0	245
5558	0	1	0	236	0	237
5559	245	0	1	0	0	246
5560	0	0	240	0	0	240
5561	248	0	0	1	0	249
5562	235	0	0	0	0	235
5563	1	0	241	0	0	242
5564	0	216	0	1	0	217
5565	0	3	0	204	0	207
5566	0	0	218	0	0	218
5567	0	0	0	203	0	203
5568	2	0	0	177	0	179
5569	209	0	0	0	0	209
5570	0	2	0	201	0	203
5571	0	0	221	0	0	221
5572	0	0	0	211	0	211
5573	208	0	0	0	0	208
5574	0	202	2	0	0	204
5575	190	0	2	0	0	192
5576	0	0	0	177	0	177
5577	0	0	174	0	0	174
5578	0	0	173	0	0	173
5579	1	0	183	0	0	184
5580	0	179	0	1	0	180
5581	190	0	0	0	0	190
5582	0	194	0	0	0	194
5583	188	0	0	0	0	188
5584	0	195	0	0	0	195
5585	0	1	0	174	0	175
5586	0	2	0	172	0	174
5587	0	0	0	181	0	181
5588	0	178	0	0	0	178
5589	0	2	0	166	0	168
5590	0	0	0	165	0	165
5591	179	0	0	0	0	179
5592	0	1	0	189	0	190
5593	0	0	185	0	0	185
5594	183	0	0	0	0	183
5595	184	0	0	0	0	184
5596	0	189	0	0	0	189
5597	191	0	0	0	0	191
5598	186	0	0	0	0	186
5599	0	1	0	182	0	183
5600	1	1	0	181	0	183
5601	0	0	0	193	0	193
5602	188	0	1	0	0	189
5603	184	0	3	0	0	187
5604	0	0	205	0	0	205
5605	195	0	1	0	0	196
5606	185	0	1	0	0	186
5607	178	0	0	0	0	178
5608	0	0	177	0	0	177
5609	0	0	203	0	0	203
5610	0	0	1	186	0	187
5611	0	0	200	0	0	200
5612	0	1	0	189	0	190
5613	1	2	0	187	0	190
5614	0	203	0	0	0	203
5615	203	0	1	0	0	204
5616	1	0	197	0	0	198
5617	195	0	0	0	0	195
5618	0	1	0	194	0	195
5619	183	0	1	0	0	184
5620	0	199	0	0	0	199
5621	0	180	0	0	0	180
5622	0	2	0	178	0	180
5623	0	2	0	177	0	179
5624	0	0	195	0	0	195
5625	0	1	0	187	0	188
5626	195	0	0	0	0	195
5627	0	187	0	0	0	187
5628	0	0	197	0	0	197
5629	0	1	0	182	0	183
5630	0	0	194	0	0	194
5631	0	0	0	183	0	183
5632	2	0	166	0	0	168
5633	0	0	187	0	0	187
5634	0	1	1	182	0	184
5635	180	0	0	0	0	180
5636	166	0	1	0	0	167
5637	176	0	1	0	0	177
5638	0	178	0	0	0	178
5639	174	0	1	0	0	175
5640	170	0	0	0	0	170
5641	0	0	181	0	0	181
5642	0	181	0	1	0	182
5643	3	0	0	177	0	180
5644	181	0	0	0	0	181
5645	0	183	0	0	0	183
5646	183	0	0	0	0	183
5647	175	0	0	0	0	175
5648	175	0	1	0	0	176
5649	171	0	1	0	0	172
5650	1	0	0	168	0	169
5651	166	0	0	0	0	166
5652	0	0	0	176	0	176
5653	0	164	0	1	0	165
5654	0	2	0	163	0	165
5655	166	0	1	1	0	168
5656	0	0	176	0	0	176
5657	0	0	0	166	0	166
5658	162	0	0	0	0	162
5659	0	170	0	0	0	170
5660	151	0	0	0	0	151
5661	148	0	2	0	0	150
5662	0	166	0	0	0	166
5663	149	0	1	0	0	150
5664	0	0	155	0	0	155
5665	0	0	148	0	0	148
5666	146	0	4	0	0	150
5667	0	0	138	4	0	142
5668	0	0	0	120	0	120
5669	0	125	0	0	0	125
5670	120	0	0	0	0	120
5671	0	124	0	0	0	124
5672	0	116	0	0	0	116
5673	0	0	0	120	0	120
5674	1	0	0	114	0	115
5675	0	1	0	118	0	119
5676	0	1	0	120	0	121
5677	0	0	129	0	0	129
5678	0	1	0	111	0	112
5679	0	0	0	115	0	115
5680	123	0	0	0	0	123
5681	0	0	0	123	0	123
5682	2	0	117	0	0	119
5683	116	0	0	0	0	116
5684	0	2	0	124	0	126
5685	0	0	126	0	0	126
5686	0	0	0	119	0	119
5687	0	122	0	0	0	122
5688	112	0	1	0	0	113
5689	0	0	126	0	0	126
5690	0	124	0	0	0	124
5691	118	0	0	0	0	118
5692	0	122	0	0	0	122
5693	0	121	0	2	0	123
5694	122	0	0	0	0	122
5695	0	122	0	0	0	122
5696	0	118	0	0	0	118
5697	0	0	0	116	0	116
5698	0	0	125	0	0	125
5699	0	125	0	0	0	125
5700	0	0	0	122	0	122
5701	0	122	0	0	0	122
5702	113	0	0	0	0	113
5703	0	0	128	0	0	128
5704	1	0	0	119	0	120
5705	116	0	0	0	0	116
5706	0	0	0	116	0	116
5707	0	0	118	0	0	118
5708	108	1	0	0	0	109
5709	111	0	1	0	0	112
5710	0	122	0	0	0	122
5711	0	0	0	113	0	113
5712	0	0	0	98	0	98
5713	99	0	0	0	0	99
5714	95	0	0	0	0	95
5715	0	0	105	0	0	105
5716	0	113	0	0	0	113
5717	107	0	0	0	0	107
5718	0	0	0	112	0	112
5719	0	0	110	0	0	110
5720	1	0	112	0	0	113
5721	0	1	0	103	0	104
5722	114	0	1	0	0	115
5723	0	113	0	0	0	113
5724	114	0	0	0	0	114
5725	0	0	0	104	0	104
5726	0	1	0	108	0	109
5727	0	0	0	112	0	112
5728	100	0	2	1	0	103
5729	0	110	0	0	0	110
5730	0	0	0	99	0	99
5731	0	0	0	93	0	93
5732	0	0	113	0	0	113
5733	0	1	0	111	0	112
5734	0	0	114	0	0	114
5735	0	116	0	0	0	116
5736	0	1	0	108	0	109
5737	117	0	0	0	0	117
5738	0	0	122	0	0	122
5739	0	0	0	121	0	121
5740	0	0	122	0	0	122
5741	107	0	1	0	0	108
5742	0	0	122	0	0	122
5743	0	1	0	120	0	121
5744	111	0	0	0	0	111
5745	0	112	0	0	0	112
5746	109	0	2	0	0	111
5747	0	114	0	0	0	114
5748	1	0	0	106	0	107
5749	0	0	108	0	0	108
5750	0	0	120	0	0	120
5751	0	0	0	111	0	111
5752	110	0	0	0	0	110
5753	95	0	0	0	0	95
5754	0	1	0	100	0	101
5755	0	0	0	114	0	114
5756	102	0	0	1	0	103
5757	0	108	0	0	0	108
5758	0	100	0	0	0	100
5759	99	0	1	0	0	100
5760	1	0	100	0	0	101
5761	6	0	0	90	0	96
5762	0	0	99	0	0	99
5763	0	0	0	99	0	99
5764	0	0	91	0	0	91
5765	0	0	97	0	0	97
5766	0	0	0	87	0	87
5767	0	95	1	0	0	96
5768	99	0	0	0	0	99
5769	0	116	0	0	0	116
5770	0	0	0	107	0	107
5771	102	0	0	0	0	102
5772	0	2	0	103	0	105
5773	103	0	0	0	0	103
5774	100	0	0	0	0	100
5775	101	0	0	0	0	101
5776	0	112	0	0	0	112
5777	109	0	0	0	0	109
5778	0	0	0	79	0	79
5779	83	0	0	0	0	83
5780	2	0	0	90	0	92
5781	85	0	0	1	0	86
5782	88	0	0	0	0	88
5783	0	101	0	0	0	101
5784	0	0	0	97	0	97
5785	0	1	0	92	0	93
5786	0	101	0	0	0	101
5787	0	0	0	98	0	98
5788	99	0	0	0	0	99
5789	95	0	2	0	0	97
5790	100	0	0	0	0	100
5791	0	0	109	2	0	111
5792	101	0	1	0	0	102
5793	100	0	0	0	0	100
5794	102	0	0	0	0	102
5795	0	111	0	0	0	111
5796	0	1	0	108	0	109
5797	0	1	0	92	0	93
5798	2	0	0	105	0	107
5799	0	0	118	0	0	118
5800	0	0	0	112	0	112
5801	110	0	0	0	0	110
5802	0	0	0	111	0	111
5803	0	0	0	118	0	118
5804	0	0	138	0	0	138
5805	0	146	0	0	0	146
5806	145	0	0	0	0	145
5807	0	0	0	144	0	144
5808	144	0	0	0	0	144
5809	0	0	150	0	0	150
5810	146	0	0	0	0	146
5811	0	146	0	0	0	146
5812	1	0	139	0	0	140
5813	0	0	148	0	0	148
5814	0	0	0	147	0	147
5815	0	0	142	0	0	142
5816	0	149	0	0	0	149
5817	0	1	0	142	0	143
5818	0	1	0	135	0	136
5819	0	0	0	148	0	148
5820	145	0	0	0	0	145
5821	0	150	0	0	0	150
5822	0	0	0	142	0	142
5823	0	1	0	144	0	145
5824	134	0	0	0	0	134
5825	0	150	0	0	0	150
5826	145	0	0	0	0	145
5827	136	0	0	0	0	136
5828	138	0	1	0	0	139
5829	0	0	150	0	0	150
5830	0	0	0	141	0	141
5831	0	143	0	0	0	143
5832	0	140	0	0	0	140
5833	1	0	0	101	0	102
5834	0	147	0	0	0	147
5835	138	0	0	0	0	138
5836	0	0	142	0	0	142
5837	144	0	1	0	0	145
5838	126	0	2	0	0	128
5839	0	0	0	140	0	140
5840	147	0	1	0	0	148
5841	0	146	0	0	0	146
5842	136	0	3	0	0	139
5843	129	0	0	0	0	129
5844	134	0	0	0	0	134
5845	0	0	126	0	0	126
5846	0	0	131	0	0	131
5847	0	0	0	125	0	125
5848	0	128	0	0	0	128
5849	2	123	0	0	0	125
5850	0	1	0	119	0	120
5851	121	0	0	0	0	121
5852	0	1	0	106	0	107
5853	0	0	0	119	0	119
5854	114	0	0	0	0	114
5855	0	104	0	0	0	104
5856	1	0	94	0	0	95
5857	0	0	84	0	0	84
5858	98	0	0	0	0	98
5859	0	0	0	104	0	104
5860	0	0	100	0	0	100
5861	2	1	0	91	0	94
5862	0	2	0	89	0	91
5863	0	1	0	94	0	95
5864	0	0	0	93	0	93
5865	0	97	0	0	0	97
5866	0	0	0	96	0	96
5867	95	0	0	0	0	95
5868	0	93	0	0	0	93
5869	82	0	0	0	0	82
5870	76	0	0	0	0	76
5871	73	0	1	0	0	74
5872	0	0	81	0	0	81
5873	86	0	0	0	0	86
5874	74	0	1	0	0	75
5875	68	0	0	0	0	68
5876	78	0	1	0	0	79
5877	0	82	0	0	0	82
5878	75	0	0	0	0	75
5879	0	1	78	0	0	79
5880	0	0	0	76	0	76
5881	0	0	0	78	0	78
5882	77	0	0	0	0	77
5883	0	78	0	0	0	78
5884	83	0	0	0	0	83
5885	0	79	0	0	0	79
5886	71	0	0	0	0	71
5887	75	0	1	0	0	76
5888	0	78	0	0	0	78
5889	70	0	1	0	0	71
5890	68	0	0	0	0	68
5891	0	73	0	0	0	73
5892	0	81	0	0	0	81
5893	73	0	0	0	0	73
5894	0	0	0	74	0	74
5895	74	0	0	0	0	74
5896	65	0	2	1	0	68
5897	73	0	0	0	0	73
5898	64	0	0	0	0	64
5899	0	70	0	1	0	71
5900	0	67	0	1	0	68
5901	69	0	0	0	0	69
5902	0	0	74	0	0	74
5903	0	0	0	64	0	64
5904	0	0	0	67	0	67
5905	64	0	1	0	0	65
5906	0	74	0	0	0	74
5907	0	0	0	66	0	66
5908	0	1	0	70	0	71
5909	67	0	0	0	0	67
5910	0	0	0	70	0	70
5911	75	0	0	0	0	75
5912	71	0	0	0	0	71
5913	66	0	0	0	0	66
5914	0	0	0	65	0	65
5915	0	0	0	69	0	69
5916	1	0	66	0	0	67
5917	0	0	68	0	0	68
5918	71	0	1	0	0	72
5919	1	0	0	71	0	72
5920	0	0	63	0	0	63
5921	0	0	74	0	0	74
5922	0	0	0	69	0	69
5923	0	0	73	0	0	73
5924	0	0	0	62	0	62
5925	0	1	0	69	0	70
5926	0	0	70	0	0	70
5927	0	0	0	65	0	65
5928	0	0	1	65	0	66
5929	0	1	0	62	0	63
5930	1	0	68	0	0	69
5931	0	1	0	66	0	67
5932	65	0	0	0	0	65
5933	0	67	0	0	0	67
5934	60	0	1	2	0	63
5935	0	0	64	0	0	64
5936	62	0	0	0	0	62
5937	57	0	0	0	0	57
5938	57	0	0	0	0	57
5939	0	0	0	43	0	43
5940	0	0	0	48	0	48
5941	0	0	52	0	0	52
5942	49	0	0	0	0	49
5943	0	49	0	0	0	49
5944	0	47	0	0	0	47
5945	0	49	0	0	0	49
5946	0	0	0	45	0	45
5947	44	0	0	0	0	44
5948	41	0	0	0	0	41
5949	0	0	51	0	0	51
5950	0	0	0	47	0	47
5951	0	0	0	42	0	42
5952	0	0	42	0	0	42
5953	0	0	43	0	0	43
5954	43	0	0	0	0	43
5955	0	42	0	0	0	42
5956	39	0	0	0	0	39
5957	35	0	0	0	0	35
5958	0	0	0	35	0	35
5959	0	0	0	38	0	38
5960	41	0	0	0	0	41
5961	0	0	0	40	0	40
5962	0	0	0	39	0	39
5963	38	0	0	0	0	38
5964	0	0	0	35	0	35
5965	39	0	1	0	0	40
5966	36	0	0	0	0	36
5967	0	0	37	0	0	37
5968	33	0	1	0	0	34
5969	30	0	0	0	0	30
5970	27	0	0	0	0	27
5971	0	0	32	0	0	32
5972	31	0	0	0	0	31
5973	0	27	0	0	0	27
5974	26	0	0	0	0	26
5975	23	0	0	0	0	23
5976	0	1	0	20	0	21
5977	0	0	0	25	0	25
5978	0	25	0	0	0	25
5979	0	0	0	24	0	24
5980	0	0	0	26	0	26
5981	28	0	1	0	0	29
5982	0	0	0	27	0	27
5983	0	0	0	27	0	27
5984	0	0	0	25	0	25
5985	0	29	0	0	0	29
5986	28	0	0	0	0	28
5987	0	29	0	0	0	29
5988	25	0	0	0	0	25
5989	0	0	27	0	0	27
5990	24	0	0	0	0	24
5991	0	0	26	0	0	26
5992	0	24	0	0	0	24
5993	21	0	1	1	0	23
5994	20	0	0	0	0	20
5995	0	27	0	0	0	27
5996	0	26	0	0	0	26
5997	25	0	0	0	0	25
5998	24	0	0	0	0	24
5999	0	0	0	24	0	24
6000	0	0	0	25	0	25
6001	0	0	26	0	0	26
6002	27	0	0	0	0	27
6003	0	0	0	27	0	27
6004	0	27	0	0	0	27
6005	1	0	0	22	0	23
6006	0	0	0	27	0	27
6007	0	0	29	0	0	29
6008	0	0	0	28	0	28
6009	29	0	0	0	0	29
6010	0	28	0	0	0	28
6011	0	28	0	0	0	28
6012	28	0	0	0	0	28
6013	23	0	0	0	0	23
6014	22	0	0	0	0	22
6015	0	27	0	0	0	27
6016	0	25	0	3	0	28
6017	26	0	0	0	0	26
6018	24	0	0	0	0	24
6019	0	22	0	2	0	24
6020	0	25	1	1	0	27
6021	27	0	0	0	0	27
6022	0	0	0	22	0	22
6023	25	0	0	0	0	25
6024	0	0	0	24	0	24
6025	0	22	0	0	0	22
6026	0	21	0	0	0	21
6027	21	0	0	0	0	21
6028	19	0	0	0	0	19
6029	21	0	0	0	0	21
6030	0	21	0	0	0	21
6031	1	0	20	0	0	21
6032	0	21	0	0	0	21
6033	20	0	0	0	0	20
6034	16	0	0	0	0	16
6035	0	0	21	0	0	21
6036	0	20	0	0	0	20
6037	0	0	0	19	0	19
6038	0	1	0	18	0	19
6039	0	19	0	0	0	19
6040	0	0	20	0	0	20
6041	20	0	0	0	0	20
6042	0	0	0	18	0	18
6043	19	0	0	0	0	19
6044	17	0	0	0	0	17
6045	0	0	0	17	0	17
6046	0	0	0	18	0	18
6047	0	0	0	18	0	18
6048	0	0	0	19	0	19
6049	21	0	0	0	0	21
6050	17	0	0	0	0	17
6051	0	0	23	0	0	23
6052	0	0	0	20	0	20
6053	0	0	0	20	0	20
6054	0	0	0	20	0	20
6055	0	0	21	0	0	21
6056	0	0	0	17	0	17
6057	19	0	0	0	0	19
6058	0	0	0	18	0	18
6059	0	0	20	0	0	20
6060	0	0	0	19	0	19
6061	0	0	18	0	0	18
6062	18	0	0	0	0	18
6063	0	0	0	17	0	17
6064	17	0	0	0	0	17
6065	14	0	1	0	0	15
6066	0	0	0	17	0	17
6067	15	1	0	0	0	16
6068	0	0	0	14	0	14
6069	0	14	0	0	0	14
6070	16	0	0	0	0	16
6071	17	0	0	0	0	17
6072	16	0	0	0	0	16
6073	0	0	0	15	0	15
6074	0	0	0	14	0	14
6075	0	0	0	17	0	17
6076	0	0	16	0	0	16
6077	0	16	0	0	0	16
6078	0	0	0	14	0	14
6079	0	0	17	0	0	17
6080	15	0	0	0	0	15
6081	0	0	0	17	0	17
6082	0	0	16	0	0	16
6083	18	0	0	0	0	18
6084	0	0	0	17	0	17
6085	0	2	0	14	0	16
6086	0	0	0	16	0	16
6087	14	0	0	1	0	15
6088	16	0	0	0	0	16
6089	14	0	0	0	0	14
6090	0	17	0	1	0	18
6091	0	17	0	0	0	17
6092	17	0	0	0	0	17
6093	0	0	19	0	0	19
6094	0	0	0	18	0	18
6095	0	0	0	17	0	17
6096	16	0	0	0	0	16
6097	18	0	0	0	0	18
6098	0	19	0	0	0	19
6099	0	0	0	18	0	18
6100	0	0	23	0	0	23
6101	0	0	23	0	0	23
6102	0	1	0	21	0	22
6103	0	0	0	20	0	20
6104	22	0	0	0	0	22
6105	0	0	0	22	0	22
6106	23	0	0	0	0	23
6107	20	0	0	0	0	20
6108	0	0	23	0	0	23
6109	21	0	1	0	0	22
6110	21	0	0	0	0	21
6111	20	0	0	0	0	20
6112	0	21	0	0	0	21
6113	0	20	0	0	0	20
6114	0	1	0	18	0	19
6115	0	0	20	0	0	20
6116	0	24	0	0	0	24
6117	0	0	0	22	0	22
6118	0	0	0	22	0	22
6119	0	22	0	0	0	22
6120	21	0	1	0	0	22
6121	19	0	0	0	0	19
6122	0	0	21	0	0	21
6123	20	0	0	0	0	20
6124	0	0	20	0	0	20
6125	20	0	0	0	0	20
6126	0	0	22	0	0	22
6127	0	22	0	0	0	22
6128	0	0	0	21	0	21
6129	0	0	0	20	0	20
6130	21	0	0	0	0	21
6131	17	0	0	0	0	17
6132	19	0	1	0	0	20
6133	0	0	20	0	0	20
6134	0	0	0	20	0	20
6135	0	0	0	22	0	22
6136	22	0	0	0	0	22
6137	0	22	0	0	0	22
6138	22	0	0	0	0	22
6139	0	0	0	20	0	20
6140	0	0	0	19	0	19
6141	0	0	0	20	0	20
6142	0	1	0	19	0	20
6143	0	0	0	29	0	29
6144	0	26	0	0	0	26
6145	0	32	0	0	0	32
6146	0	33	0	0	0	33
6147	0	0	0	34	0	34
6148	0	0	37	0	0	37
6149	38	0	0	0	0	38
6150	0	41	0	0	0	41
6151	0	0	0	40	0	40
6152	0	0	0	35	0	35
6153	38	0	0	0	0	38
6154	37	0	0	0	0	37
6155	41	0	0	0	0	41
6156	0	0	0	43	0	43
6157	0	0	42	0	0	42
6158	0	0	51	0	0	51
6159	0	0	0	48	0	48
6160	0	0	48	0	0	48
6161	51	0	0	0	0	51
6162	0	0	0	48	0	48
6163	0	0	51	0	0	51
6164	0	0	0	51	0	51
6165	0	0	54	0	0	54
6166	0	0	54	0	0	54
6167	0	0	0	53	0	53
6168	0	0	57	0	0	57
6169	0	0	58	0	0	58
6170	0	61	0	0	0	61
6171	0	0	0	59	0	59
6172	57	0	0	0	0	57
6173	0	0	0	58	0	58
6174	0	0	0	57	0	57
6175	0	0	65	0	0	65
6176	75	0	0	0	0	75
6177	0	0	0	74	0	74
6178	0	0	0	81	0	81
6179	80	0	0	0	0	80
6180	0	0	0	80	0	80
6181	81	0	0	0	0	81
6182	80	0	0	0	0	80
6183	80	0	1	0	0	81
6184	0	87	0	0	0	87
6185	83	0	0	2	0	85
6186	0	99	0	0	0	99
6187	0	0	0	95	0	95
6188	96	0	0	0	0	96
6189	0	99	0	0	0	99
6190	97	0	1	0	0	98
6191	0	100	0	0	0	100
6192	94	0	0	0	0	94
6193	0	96	0	0	0	96
6194	0	89	0	0	0	89
6195	0	97	0	0	0	97
6196	0	0	0	91	0	91
6197	0	100	0	0	0	100
6198	0	0	0	93	0	93
6199	0	4	0	93	0	97
6200	2	0	0	94	0	96
6201	0	0	0	106	0	106
6202	97	0	0	0	0	97
6203	95	0	0	0	0	95
6204	0	0	100	0	0	100
6205	103	0	1	0	0	104
6206	101	0	0	0	0	101
6207	91	0	0	0	0	91
6208	0	0	101	0	0	101
6209	0	0	108	0	0	108
6210	108	0	0	0	0	108
6211	0	0	114	0	0	114
6212	0	117	0	0	0	117
6213	0	0	0	113	0	113
6214	113	0	0	0	0	113
6215	107	0	0	0	0	107
6216	112	0	0	0	0	112
6217	0	0	0	108	0	108
6218	0	2	0	116	0	118
6219	0	0	120	0	0	120
6220	0	2	0	111	0	113
6221	0	0	0	116	0	116
6222	117	0	0	0	0	117
6223	0	128	0	0	0	128
6224	127	0	0	0	0	127
6225	0	0	0	127	0	127
6226	117	0	0	0	0	117
6227	145	0	0	0	0	145
6228	155	0	0	2	0	157
6229	0	169	0	2	0	171
6230	0	167	0	0	0	167
6231	0	0	0	170	0	170
6232	171	0	0	0	0	171
6233	0	0	0	159	0	159
6234	0	0	0	178	0	178
6235	0	0	178	0	0	178
6236	0	0	0	171	0	171
6237	0	7	0	168	0	175
6238	0	0	0	179	0	179
6239	0	0	177	0	0	177
6240	0	0	187	0	0	187
6241	0	187	0	0	0	187
6242	190	0	1	0	0	191
6243	0	0	0	186	0	186
6244	0	0	201	0	0	201
6245	0	0	0	186	0	186
6246	0	0	0	200	0	200
6247	184	0	0	0	0	184
6248	192	0	5	0	0	197
6249	0	202	0	0	0	202
6250	201	0	0	0	0	201
6251	189	0	0	0	0	189
6252	0	0	0	209	0	209
6253	0	0	195	0	0	195
6254	0	202	0	0	0	202
6255	203	0	0	0	0	203
6256	207	0	0	0	0	207
6257	0	211	0	0	0	211
6258	0	0	0	220	0	220
6259	220	0	0	0	0	220
6260	212	0	1	0	0	213
6261	0	0	0	213	0	213
6262	217	0	0	0	0	217
6263	203	0	0	0	0	203
6264	212	0	1	0	0	213
6265	0	0	221	0	0	221
6266	0	224	0	0	0	224
6267	0	207	0	0	0	207
6268	219	0	0	0	0	219
6269	0	225	0	0	0	225
6270	0	0	232	0	0	232
6271	0	2	0	228	0	230
6272	227	0	0	1	0	228
6273	0	0	0	235	0	235
6274	230	0	0	0	0	230
6275	225	0	2	0	0	227
6276	229	4	2	0	0	235
6277	0	261	0	0	0	261
6278	0	253	0	0	0	253
6279	246	0	1	0	0	247
6280	242	0	1	0	0	243
6281	228	0	0	0	0	228
6282	0	0	0	248	0	248
6283	254	0	1	1	0	256
6284	0	267	0	0	0	267
6285	0	258	0	0	0	258
6286	0	2	1	251	0	254
6287	0	0	251	0	0	251
6288	0	0	295	0	0	295
6289	0	2	0	285	0	287
6290	0	0	299	0	0	299
6291	0	0	0	293	0	293
6292	286	0	2	0	0	288
6293	0	0	0	301	0	301
6294	309	0	1	0	0	310
6295	0	314	0	0	0	314
6296	0	0	301	0	0	301
6297	0	0	0	293	0	293
6298	0	0	0	286	0	286
6299	0	0	302	0	0	302
6300	0	1	0	302	0	303
6301	0	310	0	0	0	310
6302	0	1	1	285	0	287
6303	0	1	0	285	0	286
6304	0	0	0	297	0	297
6305	0	0	300	0	0	300
6306	0	0	304	1	0	305
6307	302	1	0	0	0	303
6308	0	0	315	0	0	315
6309	0	316	0	1	0	317
6310	315	0	0	0	0	315
6311	0	320	0	0	0	320
6312	314	1	0	0	0	315
6313	300	0	0	0	0	300
6314	295	0	0	0	0	295
6315	298	0	1	0	0	299
6316	1	318	0	0	0	319
6317	0	314	0	0	0	314
6318	305	0	0	0	0	305
6319	0	0	329	0	0	329
6320	0	0	0	313	0	313
6321	0	0	0	321	0	321
6322	1	0	324	0	0	325
6323	317	0	0	0	0	317
6324	310	0	0	0	0	310
6325	308	0	2	0	0	310
6326	0	327	1	1	0	329
6327	316	0	3	0	0	319
6328	0	0	0	309	0	309
6329	0	312	0	0	0	312
6330	306	0	1	0	0	307
6331	299	0	0	0	0	299
6332	300	0	0	0	0	300
6333	0	0	0	289	0	289
6334	0	0	0	312	0	312
6335	0	307	0	3	0	310
6336	2	0	315	0	0	317
6337	0	1	0	295	0	296
6338	0	0	0	284	0	284
6339	0	0	0	294	0	294
6340	0	0	307	0	0	307
6341	305	0	0	0	0	305
6342	4	4	1	304	0	313
6343	0	0	330	0	0	330
6344	0	6	0	326	0	332
6345	336	0	0	0	0	336
6346	0	339	0	1	0	340
6347	0	6	0	279	0	285
6348	3	0	323	0	0	326
6349	331	0	0	0	0	331
6350	325	0	0	0	0	325
6351	0	0	342	0	0	342
6352	0	0	0	324	0	324
6353	0	330	0	0	0	330
6354	320	0	0	0	0	320
6355	0	0	326	0	0	326
6356	309	0	5	0	0	314
6357	0	0	313	0	0	313
6358	0	0	317	0	0	317
6359	311	0	0	0	0	311
6360	0	311	0	0	0	311
6361	1	0	302	0	0	303
6362	0	304	0	0	0	304
6363	3	0	304	0	0	307
6364	0	317	0	1	0	318
6365	307	0	0	1	0	308
6366	2	0	317	0	0	319
6367	0	0	320	0	0	320
6368	6	0	294	0	0	300
6369	327	0	0	0	0	327
6370	288	0	3	0	0	291
6371	0	0	0	303	0	303
6372	1	0	307	0	0	308
6373	5	0	303	1	0	309
6374	306	0	0	0	0	306
6375	0	2	0	288	0	290
6376	282	0	0	0	0	282
6377	265	0	0	0	0	265
6378	0	0	0	281	0	281
6379	0	276	0	0	0	276
6380	0	2	0	262	0	264
6381	0	0	0	257	0	257
6382	0	0	263	0	0	263
6383	0	273	0	0	0	273
6384	1	269	0	0	0	270
6385	0	2	0	256	0	258
6386	0	0	270	0	0	270
6387	0	262	0	0	0	262
6388	2	0	254	0	0	256
6389	270	0	0	0	0	270
6390	260	0	2	0	0	262
6391	0	0	263	0	0	263
6392	286	0	3	0	0	289
6393	0	4	0	283	0	287
6394	0	295	0	0	0	295
6395	2	1	0	276	0	279
6396	277	0	1	0	0	278
6397	272	0	0	0	0	272
6398	274	0	0	0	0	274
6399	275	0	1	0	0	276
6400	0	290	0	0	0	290
6401	0	274	0	0	0	274
6402	266	0	0	0	0	266
6403	0	0	274	0	0	274
6404	0	0	0	271	0	271
6405	0	274	0	0	0	274
6406	0	0	0	272	0	272
6407	0	281	0	0	0	281
6408	0	0	0	268	0	268
6409	0	0	286	0	0	286
6410	279	0	2	0	0	281
6411	271	0	1	0	0	272
6412	0	0	274	0	0	274
6413	273	0	0	0	0	273
6414	267	0	0	0	0	267
6415	0	0	273	0	0	273
6416	0	0	0	271	0	271
6417	271	0	0	0	0	271
6418	0	0	273	0	0	273
6419	0	0	0	270	0	270
6420	0	0	260	0	0	260
6421	0	0	268	0	0	268
6422	267	0	0	0	0	267
6423	255	0	0	1	0	256
6424	243	0	0	2	0	245
6425	261	0	1	1	0	263
6426	0	0	0	281	0	281
6427	0	273	0	0	0	273
6428	0	271	0	2	0	273
6429	0	0	0	275	0	275
6430	274	0	0	0	0	274
6431	0	285	0	0	0	285
6432	0	270	0	0	0	270
6433	276	0	0	0	0	276
6434	0	2	0	265	0	267
6435	273	0	0	0	0	273
6436	0	285	0	0	0	285
6437	268	0	0	0	0	268
6438	3	0	264	0	0	267
6439	249	0	0	0	0	249
6440	242	1	2	1	0	246
6441	248	0	1	0	0	249
6442	0	0	252	0	0	252
6443	249	0	1	1	0	251
6444	0	250	0	0	0	250
6445	0	0	254	0	0	254
6446	0	0	0	233	0	233
6447	2	1	0	234	0	237
6448	0	254	0	0	0	254
6449	0	0	0	247	0	247
6450	3	0	0	232	0	235
6451	1	0	251	0	0	252
6452	251	0	3	0	0	254
6453	0	0	252	0	0	252
6454	0	2	0	247	0	249
6455	0	0	253	0	0	253
6456	1	0	0	231	0	232
6457	237	0	1	0	0	238
6458	218	0	2	0	0	220
6459	1	0	0	229	0	230
6460	0	0	233	0	0	233
6461	2	5	0	220	0	227
6462	0	0	216	0	0	216
6463	221	0	1	0	0	222
6464	216	0	0	0	0	216
6465	210	0	2	0	0	212
6466	210	0	0	0	0	210
6467	0	225	0	0	0	225
6468	0	1	0	221	0	222
6469	217	0	1	0	0	218
6470	0	216	0	0	0	216
6471	0	206	0	1	0	207
6472	0	0	212	0	0	212
6473	212	0	0	0	0	212
6474	210	0	0	1	0	211
6475	0	0	219	0	0	219
6476	0	0	0	201	0	201
6477	0	0	0	199	0	199
6478	0	0	211	0	0	211
6479	0	0	0	204	0	204
6480	201	0	0	0	0	201
6481	0	0	205	0	0	205
6482	0	0	206	0	0	206
6483	200	0	4	0	0	204
6484	0	0	199	0	0	199
6485	201	0	0	0	0	201
6486	0	208	0	0	0	208
6487	198	0	0	0	0	198
6488	2	0	0	185	0	187
6489	3	0	0	190	0	193
6490	185	0	0	1	0	186
6491	0	1	0	191	0	192
6492	184	0	0	0	0	184
6493	0	186	0	0	0	186
6494	0	0	0	159	0	159
6495	0	0	0	151	0	151
6496	136	0	1	0	0	137
6497	144	0	0	0	0	144
6498	147	0	0	0	0	147
6499	0	149	0	0	0	149
6500	0	132	0	0	0	132
6501	118	0	1	0	0	119
6502	0	0	125	0	0	125
6503	0	126	0	0	0	126
6504	123	0	0	0	0	123
6505	115	0	3	0	0	118
6506	109	0	0	0	0	109
6507	0	0	0	116	0	116
6508	118	0	0	0	0	118
6509	101	0	0	0	0	101
6510	0	0	0	116	0	116
6511	109	0	0	0	0	109
6512	0	0	108	0	0	108
6513	0	0	0	90	0	90
6514	0	1	0	81	0	82
6515	0	0	0	92	0	92
6516	91	0	0	0	0	91
6517	93	0	0	0	0	93
6518	96	0	0	0	0	96
6519	96	0	0	0	0	96
6520	93	0	0	0	0	93
6521	0	0	0	95	0	95
6522	0	0	0	102	0	102
6523	103	0	0	0	0	103
6524	0	110	0	0	0	110
6525	104	0	0	0	0	104
6526	0	0	107	0	0	107
6527	108	0	0	0	0	108
6528	112	0	0	0	0	112
6529	1	0	119	0	0	120
6530	112	0	1	0	0	113
6531	0	0	117	0	0	117
6532	1	0	118	0	0	119
6533	0	0	0	114	0	114
6534	0	0	0	123	0	123
6535	0	0	118	0	0	118
6536	1	0	120	0	0	121
6537	0	117	0	0	0	117
6538	0	123	0	0	0	123
6539	130	0	0	0	0	130
6540	0	130	0	0	0	130
6541	128	0	0	0	0	128
6542	0	124	0	0	0	124
6543	119	0	0	0	0	119
6544	0	0	129	0	0	129
6545	131	0	0	0	0	131
6546	0	0	0	140	0	140
6547	0	141	0	0	0	141
6548	0	0	0	134	0	134
6549	138	0	0	0	0	138
6550	125	0	1	0	0	126
6551	0	0	0	137	0	137
6552	0	0	144	0	0	144
6553	0	0	143	0	0	143
6554	0	140	0	0	0	140
6555	0	0	1	128	0	129
6556	0	0	139	0	0	139
6557	0	142	0	0	0	142
6558	0	0	0	134	0	134
6559	0	0	1	127	0	128
6560	136	0	1	0	0	137
6561	0	1	0	141	0	142
6562	0	0	147	0	0	147
6563	0	2	0	144	0	146
6564	143	0	0	0	0	143
6565	0	0	135	0	0	135
6566	132	0	1	0	0	133
6567	0	139	0	1	0	140
6568	130	0	1	0	0	131
6569	124	0	2	0	0	126
6570	0	0	0	130	0	130
6571	0	0	0	138	0	138
6572	0	131	0	0	0	131
6573	0	1	0	130	0	131
6574	132	0	1	0	0	133
6575	1	0	132	0	0	133
6576	0	3	0	126	0	129
6577	0	128	0	0	0	128
6578	0	0	0	114	0	114
6579	0	0	0	118	0	118
6580	110	0	2	1	0	113
6581	0	122	0	0	0	122
6582	0	0	0	118	0	118
6583	114	0	1	0	0	115
6584	0	1	0	108	0	109
6585	0	2	0	114	0	116
6586	102	0	0	0	0	102
6587	114	0	0	0	0	114
6588	0	0	119	0	0	119
6589	114	0	0	0	0	114
6590	102	0	0	0	0	102
6591	109	0	1	0	0	110
6592	0	123	0	0	0	123
6593	0	111	0	0	0	111
6594	0	0	0	104	0	104
6595	104	0	0	0	0	104
6596	87	0	3	0	0	90
6597	0	0	0	111	0	111
6598	0	0	112	0	0	112
6599	113	0	2	0	0	115
6600	104	0	1	2	0	107
6601	0	2	0	99	0	101
6602	0	0	0	117	0	117
6603	127	0	1	1	0	129
6604	0	1	0	146	0	147
6605	0	147	0	0	0	147
6606	0	0	0	143	0	143
6607	140	0	0	0	0	140
6608	0	0	146	0	0	146
6609	143	0	0	0	0	143
6610	0	0	160	0	0	160
6611	0	2	0	150	0	152
6612	149	0	2	0	0	151
6613	0	0	0	141	0	141
6614	0	0	0	155	0	155
6615	140	0	0	1	0	141
6616	0	0	158	0	0	158
6617	0	0	157	0	0	157
6618	0	0	0	150	0	150
6619	0	0	0	144	0	144
6620	0	0	0	154	0	154
6621	0	0	147	0	0	147
6622	156	0	0	0	0	156
6623	149	0	0	0	0	149
6624	140	0	1	0	0	141
6625	151	0	0	0	0	151
6626	0	156	0	3	0	159
6627	0	147	0	0	0	147
6628	0	154	0	0	0	154
6629	0	0	0	145	0	145
6630	0	0	0	153	0	153
6631	1	0	155	0	0	156
6632	0	161	0	0	0	161
6633	0	0	0	161	0	161
6634	155	0	0	0	0	155
6635	0	156	0	0	0	156
6636	1	0	0	147	0	148
6637	0	157	0	1	0	158
6638	148	0	0	0	0	148
6639	0	0	0	153	0	153
6640	0	0	151	0	0	151
6641	0	0	154	0	0	154
6642	0	0	0	142	0	142
6643	0	3	0	134	0	137
6644	0	0	0	130	0	130
6645	148	0	0	0	0	148
6646	0	0	149	0	0	149
6647	0	148	0	0	0	148
6648	0	0	0	145	0	145
6649	0	0	141	0	0	141
6650	0	146	0	0	0	146
6651	0	1	0	143	0	144
6652	0	0	151	0	0	151
6653	0	1	0	135	0	136
6654	0	0	0	126	0	126
6655	142	0	0	0	0	142
6656	133	0	0	0	0	133
6657	0	0	0	144	0	144
6658	136	0	0	0	0	136
6659	0	0	142	0	0	142
6660	0	0	0	118	0	118
6661	2	0	113	0	0	115
6662	0	0	0	115	0	115
6663	0	118	0	0	0	118
6664	0	111	0	0	0	111
6665	0	111	0	0	0	111
6666	0	0	0	106	0	106
6667	0	0	0	109	0	109
6668	0	0	106	0	0	106
6669	0	0	109	0	0	109
6670	0	0	107	0	0	107
6671	111	0	0	0	0	111
6672	1	1	0	102	0	104
6673	103	0	0	0	0	103
6674	0	104	0	0	0	104
6675	0	1	0	99	0	100
6676	97	0	2	0	0	99
6677	0	1	0	98	0	99
6678	96	0	1	0	0	97
6679	0	0	105	0	0	105
6680	0	103	0	0	0	103
6681	0	0	0	87	0	87
6682	100	0	0	0	0	100
6683	94	0	0	0	0	94
6684	0	1	0	92	0	93
6685	0	0	0	91	0	91
6686	88	0	0	1	0	89
6687	0	0	0	93	0	93
6688	0	0	92	0	0	92
6689	0	86	0	1	0	87
6690	0	0	0	89	0	89
6691	80	0	0	2	0	82
6692	85	0	0	0	0	85
6693	0	0	92	0	0	92
6694	0	87	0	0	0	87
6695	0	86	0	0	0	86
6696	0	0	1	81	0	82
6697	0	0	0	80	0	80
6698	0	0	0	84	0	84
6699	0	0	0	86	0	86
6700	0	89	0	0	0	89
6701	0	0	0	83	0	83
6702	0	0	0	84	0	84
6703	76	0	0	0	0	76
6704	83	0	0	0	0	83
6705	0	90	0	0	0	90
6706	85	0	0	0	0	85
6707	77	0	0	0	0	77
6708	76	0	0	0	0	76
6709	0	0	88	0	0	88
6710	0	0	0	83	0	83
6711	0	1	0	86	0	87
6712	1	0	90	0	0	91
6713	0	2	0	82	0	84
6714	0	0	0	89	0	89
6715	89	0	0	0	0	89
6716	0	0	91	0	0	91
6717	0	0	0	91	0	91
6718	89	0	0	0	0	89
6719	0	90	0	0	0	90
6720	90	0	0	0	0	90
6721	95	0	0	0	0	95
6722	0	101	0	0	0	101
6723	0	2	0	102	0	104
6724	101	0	0	0	0	101
6725	0	98	0	1	0	99
6726	0	0	0	90	0	90
6727	96	0	0	0	0	96
6728	93	0	0	0	0	93
6729	0	104	0	0	0	104
6730	97	0	0	0	0	97
6731	0	1	0	94	0	95
6732	89	0	0	0	0	89
6733	0	0	95	0	0	95
6734	0	1	0	86	0	87
6735	0	0	0	94	0	94
6736	93	0	1	0	0	94
6737	0	93	0	0	0	93
6738	89	0	1	0	0	90
6739	0	90	0	0	0	90
6740	0	0	77	0	0	77
6741	0	0	93	0	0	93
6742	0	0	0	87	0	87
6743	0	0	93	0	0	93
6744	0	0	0	80	0	80
6745	0	0	0	83	0	83
6746	0	0	0	89	0	89
6747	86	0	0	0	0	86
6748	80	0	2	0	0	82
6749	82	0	0	0	0	82
6750	0	85	0	0	0	85
6751	0	62	0	1	0	63
6752	0	0	73	0	0	73
6753	0	0	1	72	0	73
6754	0	0	72	0	0	72
6755	0	1	0	67	0	68
6756	0	0	0	72	0	72
6757	0	0	0	68	0	68
6758	0	0	76	0	0	76
6759	1	0	0	75	0	76
6760	77	0	0	0	0	77
6761	0	76	0	0	0	76
6762	0	0	0	74	0	74
6763	78	0	0	0	0	78
6764	68	0	0	0	0	68
6765	0	0	0	73	0	73
6766	0	1	0	74	0	75
6767	70	0	0	0	0	70
6768	0	0	0	71	0	71
6769	69	0	0	0	0	69
6770	0	0	0	66	0	66
6771	0	0	68	0	0	68
6772	0	75	0	0	0	75
6773	0	73	0	0	0	73
6774	1	0	0	66	0	67
6775	1	0	0	69	0	70
6776	68	0	0	0	0	68
6777	0	1	0	81	0	82
6778	0	2	0	80	0	82
6779	0	0	0	90	0	90
6780	0	94	0	0	0	94
6781	0	8	0	77	0	85
6782	0	0	0	81	0	81
6783	0	0	0	90	0	90
6784	84	0	0	0	0	84
6785	0	92	0	0	0	92
6786	0	0	0	85	0	85
6787	0	0	0	85	0	85
6788	0	0	1	87	0	88
6789	91	0	0	0	0	91
6790	0	0	0	83	0	83
6791	0	0	0	96	0	96
6792	0	0	95	0	0	95
6793	0	108	0	0	0	108
6794	0	0	0	110	0	110
6795	106	0	0	2	0	108
6796	0	112	0	0	0	112
6797	107	0	2	0	0	109
6798	113	0	0	0	0	113
6799	0	0	0	109	0	109
6800	0	0	0	116	0	116
6801	0	0	119	0	0	119
6802	0	0	0	116	0	116
6803	0	0	116	0	0	116
6804	0	0	0	119	0	119
6805	118	0	0	0	0	118
6806	0	126	0	0	0	126
6807	0	1	0	122	0	123
6808	0	2	0	114	0	116
6809	0	2	0	121	0	123
6810	0	1	0	123	0	124
6811	124	0	0	0	0	124
6812	0	124	0	0	0	124
6813	0	0	0	122	0	122
6814	122	0	2	0	0	124
6815	0	0	115	0	0	115
6816	115	0	0	0	0	115
6817	117	0	0	0	0	117
6818	0	0	124	0	0	124
6819	0	0	0	122	0	122
6820	121	0	0	0	0	121
6821	0	121	0	0	0	121
6822	117	0	0	0	0	117
6823	117	0	0	0	0	117
6824	114	0	0	0	0	114
6825	0	0	0	110	0	110
6826	0	0	0	118	0	118
6827	0	112	0	0	0	112
6828	0	0	0	109	0	109
6829	112	0	2	0	0	114
6830	0	0	113	0	0	113
6831	115	0	0	0	0	115
6832	108	0	0	0	0	108
6833	0	0	0	104	0	104
6834	1	0	0	112	0	113
6835	113	0	0	0	0	113
6836	110	0	2	0	0	112
6837	112	0	0	0	0	112
6838	0	0	117	0	0	117
6839	0	117	0	0	0	117
6840	117	0	0	0	0	117
6841	0	0	0	111	0	111
6842	0	116	0	0	0	116
6843	2	0	0	111	0	113
6844	112	0	0	0	0	112
6845	0	0	0	113	0	113
6846	2	0	114	1	0	117
6847	0	115	0	0	0	115
6848	0	100	0	0	0	100
6849	0	0	103	0	0	103
6850	109	0	0	0	0	109
6851	0	113	0	0	0	113
6852	0	2	0	111	0	113
6853	103	0	0	0	0	103
6854	0	107	0	0	0	107
6855	0	0	0	105	0	105
6856	102	0	0	0	0	102
6857	0	0	0	98	0	98
6858	101	0	2	0	0	103
6859	0	0	107	0	0	107
6860	0	99	0	0	0	99
6861	94	0	2	0	0	96
6862	89	0	2	0	0	91
6863	81	0	0	0	0	81
6864	0	0	84	0	0	84
6865	85	0	0	0	0	85
6866	79	0	0	0	0	79
6867	0	0	0	82	0	82
6868	81	0	0	0	0	81
6869	0	89	0	0	0	89
6870	0	1	0	87	0	88
6871	0	0	98	0	0	98
6872	1	0	0	91	0	92
6873	1	0	0	83	0	84
6874	86	0	0	0	0	86
6875	83	0	0	0	0	83
6876	0	0	82	0	0	82
6877	76	0	0	1	0	77
6878	0	0	81	0	0	81
6879	0	0	0	67	0	67
6880	0	0	69	0	0	69
6881	0	0	0	66	0	66
6882	0	70	0	0	0	70
6883	2	0	59	0	0	61
6884	0	0	69	0	0	69
6885	0	0	0	67	0	67
6886	67	0	0	0	0	67
6887	65	0	1	0	0	66
6888	64	0	0	0	0	64
6889	0	0	0	65	0	65
6890	0	0	0	68	0	68
6891	0	0	0	69	0	69
6892	0	0	0	69	0	69
6893	1	0	68	0	0	69
6894	0	0	0	69	0	69
6895	0	68	0	0	0	68
6896	0	1	0	70	0	71
6897	68	0	2	0	0	70
6898	0	0	69	0	0	69
6899	67	0	0	0	0	67
6900	0	0	64	0	0	64
6901	0	0	66	0	0	66
6902	0	67	0	0	0	67
6903	0	0	0	65	0	65
6904	0	0	0	66	0	66
6905	0	70	0	0	0	70
6906	70	0	0	0	0	70
6907	0	0	0	61	0	61
6908	0	0	0	70	0	70
6909	0	0	0	63	0	63
6910	61	0	0	0	0	61
6911	63	0	0	0	0	63
6912	0	0	0	62	0	62
6913	0	0	0	63	0	63
6914	63	0	0	0	0	63
6915	0	0	0	57	0	57
6916	0	0	0	58	0	58
6917	0	0	0	62	0	62
6918	0	0	58	0	0	58
6919	56	0	0	0	0	56
6920	58	0	1	0	0	59
6921	0	0	61	0	0	61
6922	0	0	0	60	0	60
6923	0	59	0	0	0	59
6924	58	0	0	0	0	58
6925	0	59	0	0	0	59
6926	0	60	0	0	0	60
6927	0	0	0	58	0	58
6928	56	0	0	0	0	56
6929	59	0	0	0	0	59
6930	0	0	0	54	0	54
6931	0	1	0	59	0	60
6932	0	0	0	59	0	59
6933	0	0	0	58	0	58
6934	0	1	0	55	0	56
6935	0	59	0	0	0	59
6936	0	0	0	58	0	58
6937	55	0	1	0	0	56
6938	53	0	0	0	0	53
6939	56	0	0	0	0	56
6940	0	56	0	1	0	57
6941	1	0	0	51	0	52
6942	0	0	53	0	0	53
6943	55	0	1	0	0	56
6944	0	0	0	49	0	49
6945	52	0	0	0	0	52
6946	44	0	0	0	0	44
6947	53	0	0	1	0	54
6948	0	0	0	54	0	54
6949	59	0	0	0	0	59
6950	0	0	0	55	0	55
6951	0	0	0	57	0	57
6952	56	0	0	0	0	56
6953	0	1	0	56	0	57
6954	56	0	0	0	0	56
6955	57	0	0	0	0	57
6956	0	0	0	51	0	51
6957	0	0	0	60	0	60
6958	0	0	0	68	0	68
6959	0	0	73	0	0	73
6960	0	0	72	0	0	72
6961	0	0	0	67	0	67
6962	0	0	0	66	0	66
6963	0	0	0	71	0	71
6964	0	0	0	73	0	73
6965	0	0	0	75	0	75
6966	75	0	3	0	0	78
6967	0	84	0	0	0	84
6968	0	0	0	83	0	83
6969	94	0	0	0	0	94
6970	0	0	0	88	0	88
6971	1	0	0	85	0	86
6972	79	0	1	1	0	81
6973	83	0	0	0	0	83
6974	0	0	97	0	0	97
6975	2	0	0	102	0	104
6976	0	0	109	0	0	109
6977	0	0	0	101	0	101
6978	0	0	0	102	0	102
6979	0	0	0	112	0	112
6980	0	0	104	0	0	104
6981	0	118	0	0	0	118
6982	0	118	1	0	0	119
6983	0	0	0	121	0	121
6984	121	0	0	0	0	121
6985	0	0	117	0	0	117
6986	0	0	128	0	0	128
6987	0	1	0	125	0	126
6988	0	0	0	130	0	130
6989	0	136	0	0	0	136
6990	0	0	0	121	0	121
6991	0	0	0	126	0	126
6992	0	0	0	127	0	127
6993	127	0	0	25	0	152
6994	218	0	1	0	0	219
6995	0	2	0	246	0	248
6996	0	260	0	0	0	260
6997	0	0	1	260	0	261
6998	259	2	1	6	0	268
6999	1	352	1	2	0	356
7000	0	2	0	402	0	404
7001	0	396	0	0	0	396
7002	376	0	2	1	0	379
7003	401	1	0	0	0	402
7004	0	428	0	1	0	429
7005	0	400	0	1	0	401
7006	1	0	409	0	0	410
7007	0	437	0	0	0	437
7008	3	0	0	409	0	412
7009	0	0	426	2	0	428
7010	0	445	0	0	0	445
7011	0	3	0	405	0	408
7012	0	0	0	388	0	388
7013	0	1	0	434	0	435
7014	402	0	5	0	0	407
7015	0	0	432	0	0	432
7016	1	0	442	0	0	443
7017	1	5	0	414	0	420
7018	0	0	468	0	0	468
7019	0	1	0	415	0	416
7020	1	2	2	404	0	409
7021	0	2	0	413	0	415
7022	0	2	0	449	0	451
7023	424	0	0	0	0	424
7024	404	0	4	0	0	408
7025	0	3	0	462	0	465
7026	2	0	501	0	0	503
7027	0	5	0	470	0	475
7028	0	496	1	0	0	497
7029	2	0	0	497	0	499
7030	513	0	0	0	0	513
7031	463	0	9	0	0	472
7032	0	2	0	509	0	511
7033	1	6	0	507	0	514
7034	0	0	0	542	0	542
7035	487	0	1	2	0	490
7036	0	0	506	0	0	506
7037	0	0	498	0	0	498
7038	0	520	1	3	0	524
7039	498	1	2	0	0	501
7040	0	2	0	524	0	526
7041	0	0	513	0	0	513
7042	0	570	0	1	0	571
7043	0	551	0	0	0	551
7044	1	0	0	546	0	547
7045	0	3	0	546	0	549
7046	0	582	0	0	0	582
7047	0	9	0	579	0	588
7048	0	0	0	601	0	601
7049	581	0	0	0	0	581
7050	0	628	0	2	0	630
7051	0	1	0	610	0	611
7052	1	0	643	0	0	644
7053	0	1	0	610	0	611
7054	617	0	2	0	0	619
7055	1	650	0	0	0	651
7056	0	1	0	608	0	609
7057	2	0	620	1	0	623
7058	0	0	669	0	0	669
7059	0	16	0	626	0	642
7060	0	5	0	652	0	657
7061	680	0	10	2	0	692
7062	0	737	0	3	0	740
7063	676	0	7	2	0	685
7064	2	0	721	0	0	723
7065	679	0	3	3	0	685
7066	0	0	696	0	0	696
7067	661	0	2	0	0	663
7068	620	0	6	0	0	626
7069	0	0	693	0	0	693
7070	1	0	712	0	0	713
7071	0	760	0	1	0	761
7072	0	2	0	752	0	754
7073	749	0	2	0	0	751
7074	1	3	0	713	0	717
7075	1	4	0	728	0	733
7076	0	5	0	771	0	776
7077	3	1	708	0	0	712
7078	763	0	1	0	0	764
7079	744	0	1	0	0	745
7080	0	824	0	5	0	829
7081	0	1	0	812	0	813
7082	0	906	0	1	0	907
7083	0	3	0	919	0	922
7084	904	0	0	0	0	904
7085	0	937	0	0	0	937
7086	0	1	0	910	0	911
7087	885	0	0	0	0	885
7088	832	0	3	0	0	835
7089	0	7	0	924	0	931
7090	7	0	926	0	0	933
7091	1	4	0	926	0	931
7092	0	931	0	1	0	932
7093	910	0	2	1	0	913
7094	0	995	1	1	0	997
7095	0	2	0	970	0	972
7096	970	1	3	0	0	974
7097	2	4	1	893	0	900
7098	0	1	0	990	0	991
7099	0	0	930	0	0	930
7100	0	1000	0	1	0	1001
7101	921	1	11	1	0	934
7102	956	0	3	0	0	959
7103	0	1017	0	2	0	1019
7104	0	1051	1	0	0	1052
7105	0	4	1	1061	0	1066
7106	1034	0	3	1	0	1038
7107	0	1090	0	1	0	1091
7108	0	4	0	1057	0	1061
7109	1	0	1133	0	0	1134
7110	0	0	0	1070	0	1070
7111	1082	0	1	0	0	1083
7112	0	1130	0	1	0	1131
7113	0	2	0	1079	0	1081
7114	3	0	1067	0	0	1070
7115	1	0	1118	0	0	1119
7116	2	2	0	991	0	995
7117	2	5	0	1063	0	1070
7118	0	1081	1	1	0	1083
7119	0	9	0	1072	0	1081
7120	1027	0	6	0	0	1033
7121	0	0	0	1072	0	1072
7122	1048	1	4	3	0	1056
7123	0	1102	1	1	0	1104
7124	0	944	0	3	0	947
7125	4	4	0	925	0	933
7126	0	5	0	931	0	936
7127	1	2	984	0	0	987
7128	0	1	0	943	0	944
7129	938	0	1	0	0	939
7130	1	0	984	0	0	985
7131	2	7	3	903	0	915
7132	1	0	968	2	0	971
7133	5	12	5	806	0	828
7134	0	17	0	827	0	844
7135	0	1	1	907	0	909
7136	3	0	960	0	0	963
7137	1	0	0	901	0	902
7138	0	947	0	0	0	947
7139	1	3	0	867	0	871
7140	0	0	0	883	0	883
7141	884	0	1	1	0	886
7142	0	0	948	0	0	948
7143	0	2	0	927	0	929
7144	1	0	894	0	0	895
7145	2	0	911	0	0	913
7146	0	2	2	812	0	816
7147	1	0	0	778	0	779
7148	2	1	0	839	0	842
7149	856	0	1	0	0	857
7150	1	2	864	1	0	868
7151	856	0	3	0	0	859
7152	0	2	0	807	0	809
7153	0	2	0	875	0	877
7154	0	889	0	0	0	889
7155	0	5	0	835	0	840
7156	0	2	1	833	0	836
7157	0	1	0	875	0	876
7158	841	0	3	0	0	844
7159	1	0	889	0	0	890
7160	871	0	4	0	0	875
7161	0	904	0	1	0	905
7162	870	0	4	4	0	878
7163	0	907	0	1	0	908
7164	1	912	0	0	0	913
7165	0	2	0	969	0	971
7166	872	1	7	2	0	882
7167	1	0	0	959	0	960
7168	0	922	0	0	0	922
7169	1	944	0	0	0	945
7170	0	3	0	918	0	921
7171	1	5	0	915	0	921
7172	0	989	1	0	0	990
7173	0	7	0	949	0	956
7174	2	6	0	910	0	918
7175	0	2	0	982	0	984
7176	928	0	0	1	0	929
7177	0	0	968	0	0	968
7178	937	0	7	0	0	944
7179	916	0	0	2	0	918
7180	938	0	5	0	0	943
7181	0	1011	0	0	0	1011
7182	1	4	2	971	0	978
7183	965	0	2	3	0	970
7184	0	2	0	959	0	961
7185	949	0	3	0	0	952
7186	0	1014	0	2	0	1016
7187	953	0	4	0	0	957
7188	933	0	7	0	0	940
7189	949	0	2	0	0	951
7190	0	4	1	927	0	932
7191	1	1	1	1000	0	1003
7192	927	0	5	1	0	933
7193	0	1002	0	1	0	1003
7194	0	928	0	0	0	928
7195	963	0	2	0	0	965
7196	0	5	0	883	0	888
7197	0	4	0	938	0	942
7198	2	1	0	963	0	966
7199	0	948	0	0	0	948
7200	949	0	7	0	0	956
7201	0	2	0	936	0	938
7202	0	965	0	5	0	970
7203	0	3	0	913	0	916
7204	0	3	0	869	0	872
7205	0	1	0	924	0	925
7206	0	0	0	961	0	961
7207	936	0	2	0	0	938
7208	861	0	1	2	0	864
7209	864	1	3	0	0	868
7210	2	2	0	938	0	942
7211	2	0	940	0	0	942
7212	0	0	899	2	0	901
7213	1	0	933	0	0	934
7214	946	0	2	1	0	949
7215	0	4	1	888	0	893
7216	1	2	1	896	0	900
7217	2	3	0	918	0	923
7218	844	0	3	3	0	850
7219	926	1	2	0	0	929
7220	0	997	1	0	0	998
7221	0	3	1	957	0	961
7222	1	0	983	0	0	984
7223	1	989	0	0	0	990
7224	1	4	0	908	0	913
7225	1	2	2	877	0	882
7226	1	5	0	925	0	931
7227	2	3	1	1003	0	1009
7228	0	0	989	0	0	989
7229	1	0	1000	0	0	1001
7230	1	1003	1	1	0	1006
7231	1	0	1	943	0	945
7232	1	2	1	934	0	938
7233	973	0	3	2	0	978
7234	5	0	1002	0	0	1007
7235	0	4	0	936	0	940
7236	1	5	0	974	0	980
7237	1	0	991	1	0	993
7238	1	974	0	3	0	978
7239	952	0	1	0	0	953
7240	1	0	983	0	0	984
7241	954	1	2	0	0	957
7242	1	2	987	0	0	990
7243	0	2	0	959	0	961
7244	2	0	930	0	0	932
7245	0	1	953	0	0	954
7246	0	5	1	936	0	942
7247	0	2	0	909	0	911
7248	1	3	0	925	0	929
7249	0	1	0	955	0	956
7250	5	5	0	987	0	997
7251	0	1	1006	1	0	1008
7252	0	0	1018	0	0	1018
7253	0	1033	0	0	0	1033
7254	1014	0	2	1	0	1017
7255	0	5	3	971	0	979
7256	1006	0	3	0	0	1009
7257	0	4	0	1013	0	1017
7258	998	0	2	0	0	1000
7259	0	8	0	935	0	943
7260	0	9	1	1020	0	1030
7261	0	1035	0	0	0	1035
7262	0	9	0	946	0	955
7263	0	2	0	939	0	941
7264	1	8	0	933	0	942
7265	1	4	0	997	0	1002
7266	0	1009	1	0	0	1010
7267	980	1	4	1	0	986
7268	0	1038	0	0	0	1038
7269	1	4	0	989	0	994
7270	989	0	2	0	0	991
7271	1	0	1002	0	0	1003
7272	0	0	1058	0	0	1058
7273	1	2	4	974	0	981
7274	0	3	0	920	0	923
7275	3	2	0	956	0	961
7276	1	2	0	971	0	974
7277	0	5	1	1016	0	1022
7278	0	1034	0	1	0	1035
7279	1	2	0	1000	0	1003
7280	1014	0	4	2	0	1020
7281	2	10	0	1029	0	1041
7282	0	0	1091	0	0	1091
7283	6	3	1	1064	0	1074
7284	1076	0	3	0	0	1079
7285	0	1086	0	0	0	1086
7286	1	7	0	981	0	989
7287	0	5	1	1039	0	1045
7288	0	0	1010	0	0	1010
7289	0	0	1047	0	0	1047
7290	1060	0	3	0	0	1063
7291	0	6	0	982	0	988
7292	6	1	0	1014	0	1021
7293	0	0	992	0	0	992
7294	4	0	1019	0	0	1023
7295	1	1043	0	0	0	1044
7296	0	1	0	1036	0	1037
7297	2	0	1046	0	0	1048
7298	0	1056	0	1	0	1057
7299	1007	0	5	1	0	1013
7300	972	0	6	0	0	978
7301	0	3	1	1041	0	1045
7302	0	1036	0	1	0	1037
7303	1005	0	0	0	0	1005
7304	2	2	0	1014	0	1018
7305	1	0	1014	0	0	1015
7306	0	996	0	3	0	999
7307	981	2	3	0	0	986
7308	941	0	3	0	0	944
7309	0	1	0	903	0	904
7310	0	1	0	973	0	974
7311	1	0	993	0	0	994
7312	0	7	0	927	0	934
7313	0	3	1	882	0	886
7314	1	5	0	876	0	882
7315	4	3	0	892	0	899
7316	1	1	0	936	0	938
7317	0	957	0	0	0	957
7318	919	0	3	0	0	922
7319	2	0	951	0	0	953
7320	0	947	0	2	0	949
7321	0	7	0	925	0	932
7322	918	0	1	0	0	919
7323	0	5	0	883	0	888
7324	2	1	0	856	0	859
7325	2	5	0	851	0	858
7326	2	3	0	930	0	935
7327	0	0	936	0	0	936
7328	0	936	0	2	0	938
7329	897	0	4	2	0	903
7330	1	0	952	0	0	953
7331	2	2	0	909	0	913
7332	897	0	5	1	0	903
7333	0	914	0	1	0	915
7334	879	0	5	0	0	884
7335	0	2	0	828	0	830
7336	0	1	0	840	0	841
7337	0	1	0	818	0	819
7338	0	4	0	876	0	880
7339	843	0	2	0	0	845
7340	1	6	0	764	0	771
7341	0	2	0	826	0	828
7342	833	0	1	0	0	834
7343	1	0	874	0	0	875
7344	2	2	0	794	0	798
7345	844	0	1	0	0	845
7346	808	0	1	0	0	809
7347	0	0	0	790	0	790
7348	1	0	0	870	0	871
7349	2	877	0	1	0	880
7350	1	7	0	821	0	829
7351	1	5	1	846	0	853
7352	0	0	863	0	0	863
7353	1	1	891	2	0	895
7354	0	906	1	0	0	907
7355	0	5	0	844	0	849
7356	4	3	0	712	0	719
7357	814	0	3	0	0	817
7358	0	4	0	865	0	869
7359	1	0	904	0	0	905
7360	2	2	0	866	0	870
7361	0	0	861	0	0	861
7362	1	0	920	0	0	921
7363	1	2	0	869	0	872
7364	5	1	0	789	0	795
7365	905	0	1	0	0	906
7366	859	0	4	1	0	864
7367	1	2	0	939	0	942
7368	971	0	3	0	0	974
7369	908	0	2	0	0	910
7370	1	3	0	888	0	892
7371	0	4	0	926	0	930
7372	893	0	0	1	0	894
7373	900	0	1	0	0	901
7374	0	2	0	949	0	951
7375	0	956	0	0	0	956
7376	0	4	0	904	0	908
7377	1	4	0	906	0	911
7378	1	1	970	0	0	972
7379	0	2	0	944	0	946
7380	946	0	1	0	0	947
7381	1	981	0	0	0	982
7382	942	1	0	1	0	944
7383	882	0	5	0	0	887
7384	854	1	2	0	0	857
7385	1	2	0	929	0	932
7386	5	0	921	0	0	926
7387	12	0	891	0	0	903
7388	0	906	0	2	0	908
7389	4	868	0	1	0	873
7390	6	866	1	0	0	873
7391	0	807	0	2	0	809
7392	1	0	805	0	0	806
7393	799	0	1	0	0	800
7394	0	4	0	741	0	745
7395	51	1	0	646	0	698
7396	3	2	0	708	0	713
7397	0	713	0	0	0	713
7398	694	0	1	10	0	705
7399	3	0	733	0	0	736
7400	2	742	0	0	0	744
7401	1	3	0	680	0	684
7402	691	0	1	0	0	692
7403	0	1	0	707	0	708
7404	1	0	731	0	0	732
7405	3	1	754	0	0	758
7406	0	2	1	710	0	713
7407	0	0	0	724	0	724
7408	739	0	4	0	0	743
7409	2	0	747	0	0	749
7410	762	0	2	0	0	764
7411	722	0	1	0	0	723
7412	1	4	0	753	0	758
7413	0	0	781	0	0	781
7414	1	6	0	756	0	763
7415	761	0	1	0	0	762
7416	0	769	1	1	0	771
7417	757	0	3	0	0	760
7418	2	4	0	728	0	734
7419	0	716	1	0	0	717
7420	0	3	0	706	0	709
7421	1	2	0	721	0	724
7422	0	715	0	0	0	715
7423	1	1	0	648	0	650
7424	3	2	0	611	0	616
7425	1	4	0	673	0	678
7426	0	0	690	0	0	690
7427	0	669	0	2	0	671
7428	668	0	4	0	0	672
7429	0	4	0	668	0	672
7430	0	674	0	0	0	674
7431	675	0	2	1	0	678
7432	0	2	0	605	0	607
7433	4	2	0	654	0	660
7434	0	3	0	648	0	651
7435	0	1	0	674	0	675
7436	680	0	0	0	0	680
7437	0	3	0	637	0	640
7438	1	0	0	643	0	644
7439	662	0	0	0	0	662
7440	0	2	0	667	0	669
7441	0	0	694	0	0	694
7442	1	2	0	659	0	662
7443	685	0	2	0	0	687
7444	0	2	0	718	0	720
7445	5	0	725	0	0	730
7446	0	0	786	0	0	786
7447	808	0	10	2	0	820
7448	811	0	4	1	0	816
7449	759	0	8	0	0	767
7450	855	2	9	0	0	866
7451	1	0	973	0	0	974
7452	2	8	0	898	0	908
7453	0	1	0	886	0	887
7454	936	0	3	0	0	939
7455	2	9	0	964	0	975
7456	1	0	1007	0	0	1008
7457	3	4	0	989	0	996
7458	1	0	1014	1	0	1016
7459	0	984	0	2	0	986
7460	1003	0	1	1	0	1005
7461	0	5	0	1029	0	1034
7462	1	0	1146	0	0	1147
7463	0	10	0	1132	0	1142
7464	0	6	0	1156	0	1162
7465	0	1	1216	0	0	1217
7466	3	3	0	1197	0	1203
7467	1213	0	8	0	0	1221
7468	0	0	1225	0	0	1225
7469	1193	1	6	3	0	1203
7470	0	1239	1	0	0	1240
7471	2	0	1169	0	0	1171
7472	0	1	1310	0	0	1311
7473	0	6	0	1287	0	1293
7474	1	3	0	1293	0	1297
7475	1	0	1350	0	0	1351
7476	0	3	0	1308	0	1311
7477	1338	0	4	0	0	1342
7478	1269	0	8	2	0	1279
7479	1	3	0	1297	0	1301
7480	0	2	0	1366	0	1368
7481	0	1363	0	1	0	1364
7482	1336	1	7	0	0	1344
7483	0	2	0	1329	0	1331
7484	0	1338	0	1	0	1339
7485	1324	0	3	3	0	1330
7486	1339	0	2	1	0	1342
7487	0	1423	0	0	0	1423
7488	0	6	0	1351	0	1357
7489	0	4	0	1407	0	1411
7490	1	1	1469	0	0	1471
7491	2	1	0	1418	0	1421
7492	1413	0	8	0	0	1421
7493	1	0	0	1449	0	1450
7494	1	1	1444	0	0	1446
7495	1453	0	5	1	0	1459
7496	2	8	0	1448	0	1458
7497	3	0	1492	0	0	1495
7498	1	3	0	1454	0	1458
7499	2	0	1493	0	0	1495
7500	0	7	0	1431	0	1438
7501	3	15	0	1430	0	1448
7502	1445	0	7	0	0	1452
7503	0	1497	0	3	0	1500
7504	1466	1	2	0	0	1469
7505	1437	0	2	0	0	1439
7506	1462	0	2	2	0	1466
7507	0	1490	0	0	0	1490
7508	0	2	1478	0	0	1480
7509	0	0	0	1425	0	1425
7510	1499	0	2	0	0	1501
7511	1424	1	9	0	0	1434
7512	1	6	0	1460	0	1467
7513	1477	0	1	2	0	1480
7514	2	0	1460	0	0	1462
7515	1368	0	9	3	0	1380
7516	2	0	1420	0	0	1422
7517	0	1377	0	2	0	1379
7518	1353	0	4	1	0	1358
7519	1280	0	2	0	0	1282
7520	1	1353	3	10	0	1367
7521	1323	1	5	3	0	1332
7522	1292	0	4	0	0	1296
7523	5	0	1331	0	0	1336
7524	1270	0	3	1	0	1274
7525	0	0	1317	2	0	1319
7526	0	2	0	1274	0	1276
7527	0	1264	0	6	0	1270
7528	4	0	1215	0	0	1219
7529	1245	0	1	2	0	1248
7530	1143	0	5	2	0	1150
7531	1	2	0	1214	0	1217
7532	0	0	1241	0	0	1241
7533	0	5	0	1213	0	1218
7534	1192	0	5	0	0	1197
7535	0	1204	0	3	0	1207
7536	1157	2	6	0	0	1165
7537	1147	0	4	0	0	1151
7538	0	1203	0	3	0	1206
7539	2	7	0	1129	0	1138
7540	1148	0	6	0	0	1154
7541	2	3	0	1007	0	1012
7542	5	4	0	1086	0	1095
7543	0	0	1127	0	0	1127
7544	0	3	0	993	0	996
7545	8	2	0	960	0	970
7546	1020	0	2	1	0	1023
7547	949	0	2	3	0	954
7548	0	3	0	989	0	992
7549	0	0	933	1	0	934
7550	0	0	969	0	0	969
7551	0	4	0	865	0	869
7552	0	0	898	0	0	898
7553	0	4	0	816	0	820
7554	5	2	0	804	0	811
7555	827	0	5	2	0	834
7556	0	0	822	0	0	822
7557	765	0	5	1	0	771
7558	726	0	8	0	0	734
7559	0	0	605	0	0	605
7560	0	0	592	5	0	597
7561	0	2	0	551	0	553
7562	0	536	0	4	0	540
7563	0	505	0	1	0	506
7564	0	12	0	472	0	484
7565	0	0	0	478	0	478
7566	0	1	0	474	0	475
7567	1	1	0	473	0	475
7568	494	0	0	1	0	495
7569	0	0	0	503	0	503
7570	3	0	533	0	0	536
7571	0	0	0	503	0	503
7572	0	509	1	0	0	510
7573	0	4	2	492	0	498
7574	487	0	1	0	0	488
7575	0	3	0	521	0	524
7576	0	0	536	0	0	536
7577	0	544	0	0	0	544
7578	0	1	0	505	0	506
7579	510	0	3	0	0	513
7580	484	0	0	0	0	484
7581	4	1	2	516	0	523
7582	0	0	517	1	0	518
7583	1	4	505	0	0	510
7584	490	0	2	0	0	492
7585	0	0	497	0	0	497
7586	3	0	485	0	0	488
7587	0	0	0	430	0	430
7588	434	0	0	0	0	434
7589	388	0	0	0	0	388
7590	399	0	2	0	0	401
7591	1	0	424	0	0	425
7592	1	0	422	0	0	423
7593	0	432	0	0	0	432
7594	0	0	0	405	0	405
7595	1	3	0	394	0	398
7596	1	0	0	398	0	399
7597	0	1	0	427	0	428
7598	0	0	433	0	0	433
7599	0	419	0	1	0	420
7600	423	0	3	0	0	426
7601	413	0	0	0	0	413
7602	418	0	0	1	0	419
7603	0	442	0	3	0	445
7604	1	0	0	423	0	424
7605	440	0	0	0	0	440
7606	0	441	0	0	0	441
7607	417	0	2	0	0	419
7608	0	461	0	1	0	462
7609	444	0	2	0	0	446
7610	428	0	2	0	0	430
7611	0	1	0	447	0	448
7612	1	1	0	444	0	446
7613	0	0	439	0	0	439
7614	1	0	429	0	0	430
7615	441	0	5	0	0	446
7616	423	0	0	0	0	423
7617	0	2	0	399	0	401
7618	0	1	0	413	0	414
7619	1	0	454	0	0	455
7620	0	4	0	436	0	440
7621	2	0	457	0	0	459
7622	0	0	0	449	0	449
7623	3	6	0	380	0	389
7624	458	0	1	0	0	459
7625	435	0	2	1	0	438
7626	0	0	0	475	0	475
7627	0	8	0	486	0	494
7628	0	0	544	0	0	544
7629	1	1	0	515	0	517
7630	1	0	535	2	0	538
7631	540	0	2	0	0	542
7632	0	0	0	542	0	542
7633	523	0	1	0	0	524
7634	1	550	0	2	0	553
7635	603	0	2	0	0	605
7636	0	2	0	576	0	578
7637	0	1	0	642	0	643
7638	0	637	1	0	0	638
7639	0	2	0	619	0	621
7640	0	0	680	0	0	680
7641	0	2	0	665	0	667
7642	0	1	675	0	0	676
7643	0	666	0	0	0	666
7644	0	0	0	637	0	637
7645	0	0	674	0	0	674
7646	0	0	694	0	0	694
7647	0	0	2	683	0	685
7648	697	0	0	0	0	697
7649	0	0	717	0	0	717
7650	0	2	0	715	0	717
7651	730	0	0	0	0	730
7652	0	752	0	0	0	752
7653	760	0	5	0	0	765
7654	0	4	0	702	0	706
7655	2	2	0	737	0	741
7656	0	1	0	774	0	775
7657	760	0	1	0	0	761
7658	0	5	0	711	0	716
7659	0	0	0	775	0	775
7660	768	0	1	0	0	769
7661	1	0	787	0	0	788
7662	0	5	0	771	0	776
7663	0	0	777	0	0	777
7664	762	0	3	1	0	766
7665	0	0	0	773	0	773
7666	1	0	767	0	0	768
7667	771	0	0	2	0	773
7668	773	0	1	1	0	775
7669	0	0	805	0	0	805
7670	1	0	0	786	0	787
7671	0	2	0	784	0	786
7672	2	0	798	0	0	800
7673	1	773	0	1	0	775
7674	1	0	789	0	0	790
7675	770	0	6	0	0	776
7676	1	0	803	0	0	804
7677	784	0	4	1	0	789
7678	0	0	818	0	0	818
7679	810	0	4	0	0	814
7680	0	831	0	1	0	832
7681	2	0	2	800	0	804
7682	0	3	0	822	0	825
7683	1	0	829	0	0	830
7684	0	3	0	833	0	836
7685	0	843	0	1	0	844
7686	841	0	3	0	0	844
7687	0	849	0	0	0	849
7688	0	1	0	835	0	836
7689	843	0	2	2	0	847
7690	0	840	0	2	0	842
7691	808	0	3	0	0	811
7692	0	0	858	0	0	858
7693	2	0	0	838	0	840
7694	0	5	0	808	0	813
7695	1	0	0	822	0	823
7696	838	0	1	0	0	839
7697	815	0	0	0	0	815
7698	766	0	0	1	0	767
7699	809	0	0	0	0	809
7700	0	0	846	0	0	846
7701	832	7	0	0	0	839
7702	1	849	0	1	0	851
7703	0	812	0	0	0	812
7704	852	0	1	0	0	853
7705	813	0	0	0	0	813
7706	0	0	0	832	0	832
7707	852	0	1	0	0	853
7708	796	0	0	1	0	797
7709	807	0	2	0	0	809
7710	0	0	0	871	0	871
7711	0	851	0	0	0	851
7712	0	836	0	2	0	838
7713	0	4	0	841	0	845
7714	828	0	0	2	0	830
7715	0	853	0	0	0	853
7716	0	1	1	830	0	832
7717	1	0	847	0	0	848
7718	817	0	0	0	0	817
7719	0	830	0	0	0	830
7720	0	811	0	0	0	811
7721	787	0	1	1	0	789
7722	0	0	822	0	0	822
7723	0	0	0	811	0	811
7724	0	808	0	4	0	812
7725	3	0	1	751	0	755
7726	0	1	0	774	0	775
7727	0	796	0	0	0	796
7728	2	4	0	759	0	765
7729	0	0	0	789	0	789
7730	773	1	2	3	0	779
7731	0	779	0	0	0	779
7732	712	2	4	1	0	719
7733	4	6	0	719	0	729
7734	0	691	0	1	0	692
7735	0	0	715	0	0	715
7736	0	3	0	671	0	674
7737	0	1	0	661	0	662
7738	4	0	674	0	0	678
7739	672	0	4	2	0	678
7740	0	1	0	657	0	658
7741	682	0	2	0	0	684
7742	0	0	670	0	0	670
7743	0	0	0	665	0	665
7744	1	0	663	0	0	664
7745	1	2	0	609	0	612
7746	0	1	0	609	0	610
7747	587	0	0	0	0	587
7748	2	623	1	2	0	628
7749	592	0	0	0	0	592
7750	0	0	616	0	0	616
7751	0	2	0	569	0	571
7752	1	0	548	0	0	549
7753	543	0	0	0	0	543
7754	522	1	2	0	0	525
7755	2	1	540	0	0	543
7756	529	0	1	1	0	531
7757	492	0	6	0	0	498
7758	1	1	0	518	0	520
7759	1	0	486	0	0	487
7760	2	0	499	0	0	501
7761	6	5	0	463	0	474
7762	0	5	0	463	0	468
7763	0	459	0	1	0	460
7764	0	445	0	0	0	445
7765	440	0	0	0	0	440
7766	2	2	0	439	0	443
7767	0	431	0	0	0	431
7768	0	435	0	1	0	436
7769	435	0	0	0	0	435
7770	0	1	0	419	0	420
7771	0	423	0	0	0	423
7772	2	2	1	406	0	411
7773	0	0	0	406	0	406
7774	0	2	1	410	0	413
7775	411	0	0	0	0	411
7776	0	399	0	0	0	399
7777	0	4	0	355	0	359
7778	0	2	0	342	0	344
7779	0	3	0	295	0	298
7780	1	1	310	5	0	317
7781	311	0	2	0	0	313
7782	0	0	0	296	0	296
7783	306	0	1	0	0	307
7784	280	0	2	0	0	282
7785	291	0	1	0	0	292
7786	0	1	302	0	0	303
7787	0	291	0	0	0	291
7788	0	0	0	259	0	259
7789	0	0	239	0	0	239
7790	0	0	269	0	0	269
7791	1	3	1	262	0	267
7792	0	268	1	0	0	269
7793	269	0	1	0	0	270
7794	260	0	1	0	0	261
7795	245	0	0	1	0	246
7796	260	0	0	0	0	260
7797	1	0	259	0	0	260
7798	250	0	0	0	0	250
7799	0	253	0	0	0	253
7800	1	1	0	231	0	233
7801	0	0	0	226	0	226
7802	224	0	0	0	0	224
7803	0	1	0	232	0	233
7804	0	0	233	0	0	233
7805	223	0	1	0	0	224
7806	200	0	0	0	0	200
7807	207	0	0	2	0	209
7808	0	0	221	0	0	221
7809	212	0	0	0	0	212
7810	0	214	0	1	0	215
7811	192	0	1	0	0	193
7812	0	3	0	178	0	181
7813	1	0	0	190	0	191
7814	0	191	0	0	0	191
7815	0	2	0	187	0	189
7816	0	187	0	0	0	187
7817	0	0	0	186	0	186
7818	0	182	0	0	0	182
7819	0	1	0	175	0	176
7820	0	178	0	0	0	178
7821	0	0	0	173	0	173
7822	0	177	0	1	0	178
7823	181	0	0	0	0	181
7824	0	1	0	168	0	169
7825	0	3	0	163	0	166
7826	0	1	0	172	0	173
7827	0	0	0	161	0	161
7828	2	0	168	0	0	170
7829	0	0	0	158	0	158
7830	0	0	0	143	0	143
7831	163	0	0	0	0	163
7832	157	0	0	0	0	157
7833	0	168	1	0	0	169
7834	0	0	0	161	0	161
7835	0	0	0	159	0	159
7836	160	0	0	0	0	160
7837	0	0	167	0	0	167
7838	157	0	1	0	0	158
7839	0	165	0	0	0	165
7840	144	0	0	0	0	144
7841	143	0	0	0	0	143
7842	0	155	0	0	0	155
7843	0	145	1	0	0	146
7844	0	1	0	134	0	135
7845	1	0	151	0	0	152
7846	136	0	1	0	0	137
7847	1	0	145	0	0	146
7848	138	1	0	0	0	139
7849	1	0	152	0	0	153
7850	0	145	0	1	0	146
7851	0	0	0	109	0	109
7852	135	0	0	1	0	136
7853	125	0	1	0	0	126
7854	0	0	0	135	0	135
7855	131	0	0	1	0	132
7856	123	0	1	0	0	124
7857	0	136	0	0	0	136
7858	122	0	1	0	0	123
7859	0	126	0	0	0	126
7860	0	0	0	118	0	118
7861	113	0	0	0	0	113
7862	99	0	2	0	0	101
7863	106	0	0	0	0	106
7864	0	0	123	0	0	123
7865	1	0	127	0	0	128
7866	0	1	0	109	0	110
7867	0	0	0	111	0	111
7868	0	111	0	0	0	111
7869	104	0	0	0	0	104
7870	0	0	0	89	0	89
7871	0	1	0	100	0	101
7872	0	0	99	0	0	99
7873	0	96	0	1	0	97
7874	0	93	0	0	0	93
7875	0	1	0	92	0	93
7876	89	0	1	0	0	90
7877	0	1	0	82	0	83
7878	4	0	0	79	0	83
7879	88	0	0	0	0	88
7880	89	0	1	0	0	90
7881	0	0	0	98	0	98
7882	0	0	100	0	0	100
7883	0	0	0	83	0	83
7884	0	0	0	79	0	79
7885	81	0	1	0	0	82
7886	0	1	0	85	0	86
7887	86	0	0	0	0	86
7888	0	0	90	0	0	90
7889	0	0	0	80	0	80
7890	0	0	0	77	0	77
7891	0	0	0	69	0	69
7892	0	2	0	66	0	68
7893	0	0	0	72	0	72
7894	0	0	76	0	0	76
7895	72	0	1	0	0	73
7896	0	0	0	75	0	75
7897	0	0	74	0	0	74
7898	0	0	76	0	0	76
7899	0	0	0	72	0	72
7900	73	0	0	0	0	73
7901	68	0	0	0	0	68
7902	67	0	0	0	0	67
7903	0	0	0	76	0	76
7904	0	75	0	0	0	75
7905	73	0	1	0	0	74
7906	74	0	1	0	0	75
7907	74	0	0	0	0	74
7908	74	0	1	0	0	75
7909	0	2	0	71	0	73
7910	0	0	76	0	0	76
7911	0	0	0	73	0	73
7912	0	0	69	0	0	69
7913	72	0	0	0	0	72
7914	70	0	0	0	0	70
7915	0	0	71	0	0	71
7916	68	0	0	0	0	68
7917	46	0	1	1	0	48
7918	0	0	0	52	0	52
7919	0	53	0	0	0	53
7920	51	0	0	0	0	51
7921	0	0	0	50	0	50
7922	0	51	0	0	0	51
7923	0	0	0	55	0	55
7924	0	0	55	0	0	55
7925	0	58	0	0	0	58
7926	57	0	0	0	0	57
7927	55	0	1	0	0	56
7928	54	0	0	18	0	72
7929	91	0	0	0	0	91
7930	0	0	0	97	0	97
7931	0	101	0	0	0	101
7932	102	0	0	0	0	102
7933	10	4	104	2	0	120
7934	0	115	2	15	0	132
7935	1	0	138	0	0	139
7936	0	2	0	149	0	151
7937	0	155	0	0	0	155
7938	0	0	0	153	0	153
7939	0	0	178	0	0	178
7940	0	1	0	161	0	162
7941	0	0	0	177	0	177
7942	0	1	0	189	0	190
7943	198	0	0	0	0	198
7944	0	203	0	0	0	203
7945	2	3	0	196	0	201
7946	195	0	2	0	0	197
7947	0	211	0	0	0	211
7948	203	0	0	0	0	203
7949	0	0	208	0	0	208
7950	0	1	0	205	0	206
7951	0	214	0	0	0	214
7952	207	0	0	1	0	208
7953	0	1	223	0	0	224
7954	0	230	0	0	0	230
7955	0	0	0	225	0	225
7956	0	0	0	203	0	203
7957	215	0	0	0	0	215
7958	1	0	0	224	0	225
7959	1	0	236	1	0	238
7960	0	0	0	229	0	229
7961	0	0	238	0	0	238
7962	0	0	0	236	0	236
7963	0	238	0	3	0	241
7964	222	0	1	2	0	225
7965	246	0	1	0	0	247
7966	0	268	0	0	0	268
7967	0	258	0	0	0	258
7968	0	1	0	262	0	263
7969	267	0	0	0	0	267
7970	0	0	0	265	0	265
7971	267	0	0	1	0	268
7972	0	291	0	0	0	291
7973	0	10	0	275	0	285
7974	2	0	291	0	0	293
7975	0	2	0	271	0	273
7976	0	4	0	291	0	295
7977	286	0	0	0	0	286
7978	0	294	0	0	0	294
7979	0	0	0	289	0	289
7980	281	0	2	0	0	283
7981	1	0	277	0	0	278
7982	279	0	1	0	0	280
7983	0	2	0	281	0	283
7984	3	271	0	1	0	275
7985	272	0	0	0	0	272
7986	1	0	272	0	0	273
7987	0	0	273	0	0	273
7988	0	286	0	0	0	286
7989	276	0	2	0	0	278
7990	1	2	0	234	0	237
7991	0	0	0	275	0	275
7992	274	0	1	0	0	275
7993	0	0	280	0	0	280
7994	2	0	0	272	0	274
7995	0	0	281	0	0	281
7996	0	2	0	280	0	282
7997	0	285	0	2	0	287
7998	0	0	0	277	0	277
7999	0	0	285	0	0	285
8000	283	0	0	0	0	283
8001	0	0	0	276	0	276
8002	0	0	298	0	0	298
8003	1	1	0	268	0	270
8004	0	2	0	271	0	273
8005	2	0	277	0	0	279
8006	1	0	291	0	0	292
8007	2	2	0	276	0	280
8008	0	0	285	0	0	285
8009	282	0	1	0	0	283
8010	0	0	0	264	0	264
8011	258	0	1	0	0	259
8012	0	0	282	0	0	282
8013	1	0	0	260	0	261
8014	0	0	257	0	0	257
8015	0	243	0	1	0	244
8016	0	0	224	0	0	224
8017	1	0	244	0	0	245
8018	251	0	1	0	0	252
8019	237	0	2	0	0	239
8020	0	0	259	0	0	259
8021	0	0	0	250	0	250
8022	0	3	0	245	0	248
8023	0	0	253	0	0	253
8024	0	258	0	0	0	258
8025	237	0	4	0	0	241
8026	0	0	259	0	0	259
8027	0	2	0	253	0	255
8028	0	0	0	240	0	240
8029	243	0	0	0	0	243
8030	230	0	0	0	0	230
8031	229	0	3	0	0	232
8032	219	0	9	0	0	228
8033	0	4	0	236	0	240
8034	0	0	246	0	0	246
8035	1	1	0	222	0	224
8036	0	0	0	222	0	222
8037	2	0	0	220	0	222
8038	3	0	230	0	0	233
8039	224	0	0	0	0	224
8040	0	0	0	230	0	230
8041	0	0	232	0	0	232
8042	0	237	0	0	0	237
8043	1	1	0	229	0	231
8044	0	1	0	237	0	238
8045	237	0	0	0	0	237
8046	0	237	0	1	0	238
8047	0	0	241	1	0	242
8048	0	1	0	230	0	231
8049	1	0	0	220	0	221
8050	223	0	0	1	0	224
8051	212	0	1	0	0	213
8052	0	0	0	237	0	237
8053	235	0	0	0	0	235
8054	0	240	0	0	0	240
8055	0	0	226	0	0	226
8056	0	1	0	226	0	227
8057	0	2	0	215	0	217
8058	0	1	0	223	0	224
8059	0	3	0	235	0	238
8060	0	239	0	0	0	239
8061	233	0	1	0	0	234
8062	0	1	0	224	0	225
8063	0	235	0	0	0	235
8064	224	0	1	0	0	225
8065	236	1	0	0	0	237
8066	0	243	0	1	0	244
8067	0	0	0	226	0	226
8068	0	2	0	220	0	222
8069	0	0	0	223	0	223
8070	0	1	0	218	0	219
8071	219	0	0	0	0	219
8072	240	0	0	0	0	240
8073	0	235	0	0	0	235
8074	0	1	215	0	0	216
8075	1	0	0	226	0	227
8076	222	0	1	0	0	223
8077	0	231	0	0	0	231
8078	0	213	0	0	0	213
8079	210	0	1	3	0	214
8080	194	0	1	0	0	195
8081	0	1	7	202	0	210
8082	0	0	205	0	0	205
8083	0	0	208	0	0	208
8084	208	0	0	0	0	208
8085	194	0	4	0	0	198
8086	187	0	0	0	0	187
8087	184	0	2	0	0	186
8088	195	0	0	0	0	195
8089	0	193	0	0	0	193
8090	0	1	0	185	0	186
8091	0	185	0	0	0	185
8092	177	0	2	0	0	179
8093	168	0	2	0	0	170
8094	165	0	0	0	0	165
8095	172	0	1	0	0	173
8096	0	190	0	0	0	190
8097	181	0	2	0	0	183
8098	0	192	0	0	0	192
8099	0	1	0	194	0	195
8100	189	0	0	0	0	189
8101	1	0	200	0	0	201
8102	0	1	0	192	0	193
8103	1	0	0	189	0	190
8104	0	0	191	0	0	191
8105	0	183	0	0	0	183
8106	186	0	0	0	0	186
8107	174	0	2	0	0	176
8108	0	190	0	0	0	190
8109	0	0	0	180	0	180
8110	0	0	186	0	0	186
8111	0	192	0	1	0	193
8112	183	0	0	1	0	184
8113	2	0	183	0	0	185
8114	176	0	1	1	0	178
8115	163	0	1	0	0	164
8116	1	0	172	0	0	173
8117	0	171	0	0	0	171
8118	0	0	0	166	0	166
8119	1	0	165	0	0	166
8120	169	0	0	0	0	169
8121	159	0	0	0	0	159
8122	0	170	0	0	0	170
8123	0	0	0	157	0	157
8124	0	1	0	155	0	156
8125	0	0	171	0	0	171
8126	0	166	0	0	0	166
8127	162	0	1	2	0	165
8128	154	0	0	0	0	154
8129	160	0	0	0	0	160
8130	0	0	158	0	0	158
8131	170	0	1	0	0	171
8132	155	0	2	0	0	157
8133	0	1	0	174	0	175
8134	0	0	178	0	0	178
8135	0	0	0	173	0	173
8136	0	0	178	0	0	178
8137	0	2	0	184	0	186
8138	0	195	1	0	0	196
8139	0	189	0	0	0	189
8140	0	1	0	180	0	181
8141	0	2	0	184	0	186
8142	185	0	2	1	0	188
8143	0	0	191	0	0	191
8144	187	0	0	0	0	187
8145	0	182	1	0	0	183
8146	171	0	1	0	0	172
8147	161	0	1	0	0	162
8148	5	1	0	166	0	172
8149	0	0	184	0	0	184
8150	1	0	0	180	0	181
8151	0	186	0	0	0	186
8152	0	1	0	170	0	171
8153	0	0	0	171	0	171
8154	174	0	0	0	0	174
8155	0	0	0	188	0	188
8156	0	189	0	0	0	189
8157	0	0	0	184	0	184
8158	177	0	0	0	0	177
8159	0	183	0	2	0	185
8160	0	0	0	178	0	178
8161	0	1	0	160	0	161
8162	0	1	0	170	0	171
8163	0	0	0	173	0	173
8164	170	0	1	0	0	171
8165	0	2	0	154	0	156
8166	0	0	0	174	0	174
8167	2	1	0	174	0	177
8168	0	175	0	0	0	175
8169	164	0	4	0	0	168
8170	0	0	178	0	0	178
8171	1	176	1	0	0	178
8172	173	0	1	0	0	174
8173	0	0	182	0	0	182
8174	0	172	0	0	0	172
8175	0	0	0	175	0	175
8176	0	170	0	1	0	171
8177	0	0	175	0	0	175
8178	0	0	180	0	0	180
8179	0	168	0	0	0	168
8180	172	1	1	1	0	175
8181	172	0	0	0	0	172
8182	0	0	168	0	0	168
8183	0	0	169	0	0	169
8184	0	0	177	0	0	177
8185	0	1	0	164	0	165
8186	0	2	0	155	0	157
8187	0	0	0	168	0	168
8188	0	0	175	0	0	175
8189	0	0	0	156	0	156
8190	0	0	0	163	0	163
8191	0	0	172	0	0	172
8192	165	0	1	0	0	166
8193	0	2	0	147	0	149
8194	1	0	0	171	0	172
8195	0	171	0	0	0	171
8196	161	0	0	0	0	161
8197	1	0	161	0	0	162
8198	172	0	0	0	0	172
8199	0	1	0	170	0	171
8200	0	0	180	0	0	180
8201	0	0	0	178	0	178
8202	176	0	0	0	0	176
8203	0	0	179	0	0	179
8204	172	0	0	0	0	172
8205	167	0	0	0	0	167
8206	163	0	0	0	0	163
8207	0	179	0	0	0	179
8208	1	2	0	166	0	169
8209	168	0	1	0	0	169
8210	159	0	0	0	0	159
8211	160	0	0	0	0	160
8212	0	0	176	0	0	176
8213	165	0	0	0	0	165
8214	0	0	0	172	0	172
8215	1	0	184	0	0	185
8216	0	3	0	158	0	161
8217	0	2	0	174	0	176
8218	0	0	183	0	0	183
8219	0	1	0	164	0	165
8220	0	0	0	173	0	173
8221	0	0	176	0	0	176
8222	171	0	0	0	0	171
8223	149	0	2	0	0	151
8224	1	0	0	166	0	167
8225	0	0	185	0	0	185
8226	0	1	0	178	0	179
8227	0	185	0	0	0	185
8228	0	0	0	174	0	174
8229	0	0	0	173	0	173
8230	170	0	0	0	0	170
8231	181	0	1	0	0	182
8232	182	0	0	0	0	182
8233	0	0	0	170	0	170
8234	1	2	0	177	0	180
8235	0	0	185	0	0	185
8236	0	0	0	178	0	178
8237	0	182	0	0	0	182
8238	179	0	1	0	0	180
8239	0	185	0	0	0	185
8240	183	0	0	0	0	183
8241	0	0	0	184	0	184
8242	0	174	0	0	0	174
8243	179	0	1	0	0	180
8244	182	0	0	0	0	182
8245	0	1	0	195	0	196
8246	0	195	0	0	0	195
8247	1	0	0	187	0	188
8248	0	0	198	0	0	198
8249	192	0	1	0	0	193
8250	0	206	0	0	0	206
8251	186	0	9	0	0	195
8252	1	0	0	199	0	200
8253	195	0	0	0	0	195
8254	0	0	204	0	0	204
8255	196	0	0	0	0	196
8256	193	0	0	0	0	193
8257	0	0	206	0	0	206
8258	0	1	0	195	0	196
8259	0	0	0	200	0	200
8260	193	0	0	0	0	193
8261	0	208	0	0	0	208
8262	0	3	0	195	0	198
8263	1	0	201	0	0	202
8264	0	1	192	0	0	193
8265	0	186	0	1	0	187
8266	0	0	196	0	0	196
8267	194	0	1	0	0	195
8268	0	2	0	189	0	191
8269	204	0	0	0	0	204
8270	0	0	211	0	0	211
8271	3	0	0	196	0	199
8272	0	0	0	198	0	198
8273	0	0	213	0	0	213
8274	0	0	0	209	0	209
8275	205	0	1	0	0	206
8276	186	0	2	0	0	188
8277	0	0	0	202	0	202
8278	194	0	0	0	0	194
8279	200	0	0	1	0	201
8280	0	245	0	0	0	245
8281	0	0	0	217	0	217
8282	224	0	0	0	0	224
8283	0	1	1	213	0	215
8284	215	0	0	0	0	215
8285	0	1	0	223	0	224
8286	0	0	230	0	0	230
8287	0	224	0	0	0	224
8288	1	1	0	202	0	204
8289	0	195	0	1	0	196
8290	207	0	0	0	0	207
8291	0	231	0	1	0	232
8292	0	213	0	0	0	213
8293	0	2	0	216	0	218
8294	213	0	0	0	0	213
8295	0	1	0	219	0	220
8296	186	0	2	0	0	188
8297	205	0	1	0	0	206
8298	0	225	0	0	0	225
8299	204	0	3	1	0	208
8300	192	0	1	0	0	193
8301	191	0	5	0	0	196
8302	0	0	216	0	0	216
8303	2	0	0	210	0	212
8304	0	0	0	220	0	220
8305	0	0	224	0	0	224
8306	224	0	1	0	0	225
8307	215	0	1	0	0	216
8308	206	0	0	0	0	206
8309	221	0	4	2	0	227
8310	0	250	0	2	0	252
8311	240	0	3	0	0	243
8312	0	0	0	242	0	242
8313	2	0	231	0	0	233
8314	237	1	1	0	0	239
8315	0	254	0	2	0	256
8316	243	0	0	0	0	243
8317	0	255	1	0	0	256
8318	0	233	0	0	0	233
8319	0	242	0	1	0	243
8320	0	240	0	0	0	240
8321	0	0	243	0	0	243
8322	0	1	0	247	0	248
8323	0	0	250	0	0	250
8324	254	0	1	0	0	255
8325	0	268	0	0	0	268
8326	0	247	0	0	0	247
8327	0	0	0	241	0	241
8328	4	2	0	233	0	239
8329	0	0	255	0	0	255
8330	0	1	270	0	0	271
8331	0	0	0	261	0	261
8332	0	0	262	0	0	262
8333	0	265	0	0	0	265
8334	0	0	0	261	0	261
8335	0	3	0	251	0	254
8336	0	0	284	0	0	284
8337	2	1	0	267	0	270
8338	267	0	0	0	0	267
8339	0	1	0	257	0	258
8340	0	3	0	285	0	288
8341	0	0	286	0	0	286
8342	281	0	1	0	0	282
8343	0	301	0	0	0	301
8344	2	0	0	280	0	282
8345	0	0	301	0	0	301
8346	0	0	0	294	0	294
8347	290	0	6	0	0	296
8348	3	0	299	0	0	302
8349	0	0	0	292	0	292
8350	1	0	294	0	0	295
8351	0	269	0	0	0	269
8352	1	0	271	0	0	272
8353	0	270	0	0	0	270
8354	0	0	277	0	0	277
8355	1	1	0	288	0	290
8356	0	297	0	0	0	297
8357	302	0	6	3	0	311
8358	0	3	0	290	0	293
8359	301	0	1	0	0	302
8360	0	0	0	298	0	298
8361	1	5	0	289	0	295
8362	265	0	2	3	0	270
8363	274	0	0	0	0	274
8364	0	0	1	291	0	292
8365	0	0	273	0	0	273
8366	0	251	0	1	0	252
8367	1	0	255	0	0	256
8368	0	274	0	0	0	274
8369	262	0	0	3	0	265
8370	0	0	267	0	0	267
8371	0	0	274	0	0	274
8372	0	1	0	274	0	275
8373	277	0	0	0	0	277
8374	0	0	284	0	0	284
8375	0	275	0	0	0	275
8376	266	0	3	0	0	269
8377	269	0	2	0	0	271
8378	258	0	0	0	0	258
8379	244	0	1	0	0	245
8380	259	0	5	0	0	264
8381	0	0	279	0	0	279
8382	0	1	0	275	0	276
8383	0	277	0	0	0	277
8384	261	2	1	0	0	264
8385	0	281	1	0	0	282
8386	266	1	0	0	0	267
8387	264	0	1	0	0	265
8388	0	292	0	0	0	292
8389	283	0	1	0	0	284
8390	0	0	0	229	0	229
8391	0	2	0	268	0	270
8392	0	0	257	0	0	257
8393	0	272	0	1	0	273
8394	0	0	0	250	0	250
8395	0	0	0	230	0	230
8396	1	0	0	254	0	255
8397	0	0	276	0	0	276
8398	286	0	0	0	0	286
8399	0	1	0	266	0	267
8400	264	0	0	0	0	264
8401	0	0	0	272	0	272
8402	0	3	271	0	0	274
8403	0	0	270	0	0	270
8404	267	0	1	0	0	268
8405	257	0	1	0	0	258
8406	0	262	0	1	0	263
8407	0	0	272	0	0	272
8408	0	0	0	246	0	246
8409	1	0	0	245	0	246
8410	250	0	2	1	0	253
8411	241	0	4	0	0	245
8412	267	0	0	0	0	267
8413	0	0	287	0	0	287
8414	289	1	1	0	0	291
8415	1	0	0	280	0	281
8416	15	3	0	254	0	272
8417	2	3	0	325	0	330
8418	0	314	0	0	0	314
8419	333	0	2	0	0	335
8420	0	1	0	335	0	336
8421	0	0	366	0	0	366
8422	1	1	0	357	0	359
8423	0	365	0	0	0	365
8424	361	0	3	0	0	364
8425	0	4	0	330	0	334
8426	0	4	0	384	0	388
8427	0	0	402	0	0	402
8428	0	3	0	394	0	397
8429	0	396	0	0	0	396
8430	1	2	1	384	0	388
8431	6	0	394	0	0	400
8432	381	2	0	0	0	383
8433	380	1	0	0	0	381
8434	0	401	0	0	0	401
8435	387	0	1	0	0	388
8436	382	0	2	0	0	384
8437	0	405	0	0	0	405
8438	0	0	0	402	0	402
8439	399	0	0	0	0	399
8440	0	393	0	0	0	393
8441	0	0	403	0	0	403
8442	393	0	0	0	0	393
8443	375	0	0	0	0	375
8444	376	0	2	0	0	378
8445	390	0	0	0	0	390
8446	0	432	0	0	0	432
8447	433	0	1	0	0	434
8448	424	0	2	0	0	426
8449	425	1	0	0	0	426
8450	0	0	0	447	0	447
8451	467	0	0	0	0	467
8452	0	476	0	1	0	477
8453	0	0	466	0	0	466
8454	0	0	0	454	0	454
8455	446	0	1	0	0	447
8456	0	0	464	0	0	464
8457	0	0	0	446	0	446
8458	0	0	457	0	0	457
8459	0	461	0	0	0	461
8460	0	1	0	439	0	440
8461	0	0	462	0	0	462
8462	0	482	0	0	0	482
8463	0	2	0	470	0	472
8464	474	0	0	0	0	474
8465	441	0	6	0	0	447
8466	446	0	0	0	0	446
8467	422	0	0	0	0	422
8468	450	0	5	0	0	455
8469	0	0	468	0	0	468
8470	461	0	2	0	0	463
8471	426	0	0	0	0	426
8472	0	0	0	473	0	473
8473	466	0	0	0	0	466
8474	441	0	1	8	0	450
8475	0	499	0	0	0	499
8476	0	5	1	449	0	455
8477	0	0	0	474	0	474
8478	473	0	0	0	0	473
8479	0	500	0	0	0	500
8480	0	474	0	1	0	475
8481	1	0	0	453	0	454
8482	0	0	0	444	0	444
8483	0	0	0	450	0	450
8484	0	1	0	469	0	470
8485	467	0	2	0	0	469
8486	482	2	0	1	0	485
8487	0	0	495	0	0	495
8488	0	2	0	476	0	478
8489	0	4	0	468	0	472
8490	2	0	460	0	0	462
8491	478	0	0	0	0	478
8492	0	473	0	2	0	475
8493	468	0	2	0	0	470
8494	0	1	0	455	0	456
8495	0	0	471	0	0	471
8496	0	3	0	460	0	463
8497	0	0	463	0	0	463
8498	0	457	0	0	0	457
8499	463	0	0	0	0	463
8500	448	0	0	2	0	450
8501	0	480	0	1	0	481
8502	1	0	0	471	0	472
8503	472	0	0	0	0	472
8504	0	457	1	0	0	458
8505	0	3	0	439	0	442
8506	441	0	1	1	0	443
8507	1	0	429	0	0	430
8508	417	0	0	1	0	418
8509	0	435	0	0	0	435
8510	375	0	3	0	0	378
8511	389	0	0	0	0	389
8512	1	0	405	0	0	406
8513	0	0	0	374	0	374
8514	1	0	0	381	0	382
8515	2	0	404	0	0	406
8516	0	2	0	377	0	379
8517	2	0	0	358	0	360
8518	390	0	0	0	0	390
8519	375	0	1	0	0	376
8520	0	0	0	386	0	386
8521	0	0	381	0	0	381
8522	0	2	1	361	0	364
8523	0	6	0	342	0	348
8524	0	0	368	0	0	368
8525	0	1	0	345	0	346
8526	339	0	6	0	0	345
8527	334	0	7	0	0	341
8528	0	369	0	0	0	369
8529	342	0	3	1	0	346
8530	348	0	1	0	0	349
8531	0	345	0	2	0	347
8532	339	0	2	0	0	341
8533	318	0	9	1	0	328
8534	322	0	3	0	0	325
8535	1	0	335	0	0	336
8536	333	0	1	0	0	334
8537	1	0	0	308	0	309
8538	291	0	1	0	0	292
8539	0	0	305	0	0	305
8540	0	314	0	2	0	316
8541	322	0	1	2	0	325
8542	0	329	0	0	0	329
8543	0	0	0	298	0	298
8544	1	3	0	287	0	291
8545	297	0	2	0	0	299
8546	295	0	5	1	0	301
8547	0	0	312	0	0	312
8548	0	0	313	0	0	313
8549	0	1	319	0	0	320
8550	0	0	0	312	0	312
8551	1	0	291	0	0	292
8552	0	0	305	0	0	305
8553	0	0	0	287	0	287
8554	296	0	1	0	0	297
8555	279	0	1	0	0	280
8556	291	0	0	0	0	291
8557	280	0	1	0	0	281
8558	0	0	0	266	0	266
8559	0	1	0	288	0	289
8560	0	0	298	0	0	298
8561	0	0	1	281	0	282
8562	0	0	0	269	0	269
8563	286	0	1	0	0	287
8564	274	0	0	0	0	274
8565	0	0	0	281	0	281
8566	290	0	0	0	0	290
8567	265	0	0	0	0	265
8568	0	1	0	271	0	272
8569	0	1	0	271	0	272
8570	1	0	262	0	0	263
8571	0	0	278	0	0	278
8572	0	1	0	262	0	263
8573	0	1	0	266	0	267
8574	0	0	269	0	0	269
8575	256	0	1	0	0	257
8576	246	0	1	0	0	247
8577	0	0	262	0	0	262
8578	1	261	1	0	0	263
8579	251	0	0	0	0	251
8580	0	0	260	0	0	260
8581	2	1	0	241	0	244
8582	0	1	0	242	0	243
8583	252	0	0	0	0	252
8584	232	0	2	0	0	234
8585	0	0	0	241	0	241
8586	0	0	0	249	0	249
8587	240	0	0	0	0	240
8588	236	0	1	0	0	237
8589	237	0	2	0	0	239
8590	0	0	246	0	0	246
8591	0	0	0	229	0	229
8592	0	2	0	235	0	237
8593	237	0	0	0	0	237
8594	0	238	0	0	0	238
8595	234	0	1	1	0	236
8596	0	230	0	0	0	230
8597	0	1	0	208	0	209
8598	0	0	0	210	0	210
8599	0	0	218	0	0	218
8600	0	0	0	214	0	214
8601	0	0	217	0	0	217
8602	0	1	0	198	0	199
8603	1	0	0	198	0	199
8604	0	211	0	0	0	211
8605	0	203	0	0	0	203
8606	0	0	0	185	0	185
8607	0	2	0	176	0	178
8608	0	1	0	193	0	194
8609	0	0	0	196	0	196
8610	0	1	0	198	0	199
8611	1	0	199	0	0	200
8612	0	0	0	185	0	185
8613	0	0	0	171	0	171
8614	0	0	176	0	0	176
8615	1	173	0	0	0	174
8616	0	1	0	165	0	166
8617	0	0	180	0	0	180
8618	0	177	0	1	0	178
8619	0	0	0	180	0	180
8620	183	0	0	0	0	183
8621	0	2	0	172	0	174
8622	0	1	0	174	0	175
8623	0	1	0	168	0	169
8624	0	0	0	171	0	171
8625	0	185	0	0	0	185
8626	0	0	0	181	0	181
8627	178	0	0	0	0	178
8628	0	0	0	178	0	178
8629	0	0	0	172	0	172
8630	0	0	0	177	0	177
8631	175	0	0	0	0	175
8632	185	0	1	0	0	186
8633	0	2	0	187	0	189
8634	186	0	0	0	0	186
8635	181	0	1	0	0	182
8636	0	199	0	0	0	199
8637	197	0	0	0	0	197
8638	0	201	0	0	0	201
8639	0	200	0	0	0	200
8640	0	1	0	192	0	193
8641	1	0	194	0	0	195
8642	0	0	0	192	0	192
8643	0	3	0	196	0	199
8644	0	182	0	0	0	182
8645	179	0	0	0	0	179
8646	0	2	0	187	0	189
8647	0	0	188	0	0	188
8648	0	0	0	189	0	189
8649	0	174	0	0	0	174
8650	175	0	0	0	0	175
8651	0	1	0	182	0	183
8652	0	0	188	0	0	188
8653	0	3	0	183	0	186
8654	0	189	0	0	0	189
8655	0	0	0	186	0	186
8656	186	0	0	0	0	186
8657	171	0	0	0	0	171
8658	179	0	1	0	0	180
8659	0	194	0	0	0	194
8660	181	0	1	0	0	182
8661	0	0	0	180	0	180
8662	178	0	0	0	0	178
8663	0	180	0	0	0	180
8664	1	1	0	173	0	175
8665	0	0	182	0	0	182
8666	174	0	0	0	0	174
8667	0	187	0	0	0	187
8668	0	1	0	182	0	183
8669	0	2	0	171	0	173
8670	0	1	0	180	0	181
8671	0	2	0	182	0	184
8672	0	178	0	0	0	178
8673	170	0	1	0	0	171
8674	177	0	0	0	0	177
8675	0	0	185	0	0	185
8676	1	0	0	184	0	185
8677	1	0	169	0	0	170
8678	185	0	0	0	0	185
8679	181	0	0	0	0	181
8680	185	0	1	0	0	186
8681	0	1	0	206	0	207
8682	0	213	0	0	0	213
8683	210	1	0	0	0	211
8684	0	1	0	198	0	199
8685	196	0	2	1	0	199
8686	0	0	214	0	0	214
8687	0	0	217	0	0	217
8688	208	0	2	0	0	210
8689	0	0	0	211	0	211
8690	203	0	3	0	0	206
8691	0	213	0	0	0	213
8692	196	0	1	0	0	197
8693	202	0	0	0	0	202
8694	0	0	204	0	0	204
8695	0	0	217	0	0	217
8696	0	225	0	0	0	225
8697	0	0	0	203	0	203
8698	202	0	2	0	0	204
8699	0	2	0	191	0	193
8700	1	0	0	201	0	202
8701	1	0	212	0	0	213
8702	202	0	0	0	0	202
8703	2	0	0	204	0	206
8704	1	0	201	0	0	202
8705	0	0	211	0	0	211
8706	2	0	0	202	0	204
8707	1	0	197	0	0	198
8708	0	0	203	0	0	203
8709	0	1	0	196	0	197
8710	0	0	199	0	0	199
8711	0	0	0	197	0	197
8712	0	192	0	1	0	193
8713	193	0	0	0	0	193
8714	0	198	0	0	0	198
8715	0	0	0	186	0	186
8716	0	187	0	0	0	187
8717	0	0	192	0	0	192
8718	0	0	0	190	0	190
8719	0	0	186	0	0	186
8720	196	0	0	0	0	196
8721	0	197	0	0	0	197
8722	197	0	0	0	0	197
8723	0	0	0	190	0	190
8724	184	0	0	1	0	185
8725	0	0	194	0	0	194
8726	0	187	0	0	0	187
8727	193	0	1	0	0	194
8728	0	0	0	190	0	190
8729	0	201	0	0	0	201
8730	0	2	0	196	0	198
8731	185	0	13	1	0	199
8732	0	207	0	0	0	207
8733	193	0	0	0	0	193
8734	0	0	204	0	0	204
8735	188	0	1	0	0	189
8736	0	0	0	195	0	195
8737	192	0	1	8	0	201
8738	0	257	0	0	0	257
8739	0	1	0	252	0	253
8740	0	0	0	254	0	254
8741	0	2	255	17	0	274
8742	4	8	1	256	0	269
8743	0	6	0	277	0	283
8744	0	15	0	283	0	298
8745	0	2	0	300	0	302
8746	1	0	298	0	0	299
8747	0	321	0	0	0	321
8748	0	1	0	310	0	311
8749	302	0	0	0	0	302
8750	292	0	2	0	0	294
8751	0	334	0	0	0	334
8752	305	0	2	0	0	307
8753	302	0	2	0	0	304
8754	308	1	0	0	0	309
8755	0	334	0	0	0	334
8756	314	0	0	0	0	314
8757	0	0	0	317	0	317
8758	0	0	312	0	0	312
8759	0	325	0	0	0	325
8760	1	1	0	312	0	314
8761	0	0	342	0	0	342
8762	326	0	1	1	0	328
8763	0	4	0	290	0	294
8764	1	4	0	309	0	314
8765	0	2	0	323	0	325
8766	0	1	0	341	0	342
8767	0	0	327	0	0	327
8768	315	0	1	1	0	317
8769	0	345	0	1	0	346
8770	310	0	3	0	0	313
8771	0	340	1	0	0	341
8772	316	0	1	0	0	317
8773	0	1	0	334	0	335
8774	1	0	345	0	0	346
8775	1	1	379	0	0	381
8776	0	1	0	331	0	332
8777	1	1	0	324	0	326
8778	0	3	0	358	0	361
8779	363	0	0	1	0	364
8780	1	0	373	0	0	374
8781	0	369	0	0	0	369
8782	0	349	0	1	0	350
8783	344	0	0	0	0	344
8784	0	0	358	0	0	358
8785	0	350	0	0	0	350
8786	0	0	347	0	0	347
8787	1	2	0	350	0	353
8788	0	0	357	0	0	357
8789	1	0	393	0	0	394
8790	2	0	0	373	0	375
8791	1	0	381	0	0	382
8792	0	1	392	0	0	393
8793	0	0	0	413	0	413
8794	413	0	0	0	0	413
8795	1	0	430	0	0	431
8796	1	0	0	401	0	402
8797	0	1	0	420	0	421
8798	398	1	2	1	0	402
8799	0	1	0	410	0	411
8800	407	0	0	1	0	408
8801	0	453	0	3	0	456
8802	0	1	0	431	0	432
8803	391	1	1	0	0	393
8804	390	0	1	1	0	392
8805	0	8	0	444	0	452
8806	0	0	465	0	0	465
8807	443	0	1	0	0	444
8808	0	464	0	5	0	469
8809	446	0	0	0	0	446
8810	409	0	5	0	0	414
8811	444	0	2	0	0	446
8812	5	0	467	0	0	472
8813	0	483	1	0	0	484
8814	1	3	0	435	0	439
8815	0	2	0	459	0	461
8816	0	0	460	0	0	460
8817	0	465	0	0	0	465
8818	0	435	0	0	0	435
8819	0	437	0	3	0	440
8820	458	0	0	0	0	458
8821	0	2	0	424	0	426
8822	1	4	0	442	0	447
8823	0	0	444	0	0	444
8824	456	0	1	0	0	457
8825	0	4	0	414	0	418
8826	9	4	0	430	0	443
8827	0	0	438	8	0	446
8828	0	466	1	0	0	467
8829	0	2	0	443	0	445
8830	1	0	455	0	0	456
8831	0	460	0	2	0	462
8832	440	0	4	1	0	445
8833	0	0	468	0	0	468
8834	1	0	0	453	0	454
8835	0	471	0	1	0	472
8836	452	0	0	0	0	452
8837	0	5	0	421	0	426
8838	409	1	2	0	0	412
8839	434	1	3	0	0	438
8840	0	496	0	3	0	499
8841	457	0	4	0	0	461
8842	384	0	9	0	0	393
8843	1	0	473	0	0	474
8844	450	0	7	0	0	457
8845	2	0	460	0	0	462
8846	438	1	0	1	0	440
8847	400	0	3	2	0	405
8848	0	0	484	0	0	484
8849	0	3	0	467	0	470
8850	0	0	465	0	0	465
8851	1	0	461	0	0	462
8852	0	1	485	0	0	486
8853	1	8	0	451	0	460
8854	0	2	0	435	0	437
8855	0	0	0	470	0	470
8856	0	4	0	496	0	500
8857	0	1	488	0	0	489
8858	3	0	0	507	0	510
8859	0	450	0	0	0	450
8860	2	0	478	0	0	480
8861	1	7	0	513	0	521
8862	1	0	518	0	0	519
8863	0	518	0	0	0	518
8864	0	502	0	0	0	502
8865	0	0	0	495	0	495
8866	0	0	508	0	0	508
8867	0	0	521	0	0	521
8868	0	1	0	498	0	499
8869	0	3	0	488	0	491
8870	0	4	0	507	0	511
8871	0	0	522	1	0	523
8872	0	522	0	0	0	522
8873	0	489	0	8	0	497
8874	1	3	0	513	0	517
8875	1	0	519	0	0	520
8876	1	0	520	0	0	521
8877	0	540	0	0	0	540
8878	526	0	2	0	0	528
8879	0	534	0	2	0	536
8880	0	1	467	0	0	468
8881	620	0	4	0	0	624
8882	0	0	0	591	0	591
8883	625	0	0	2	0	627
8884	0	3	0	593	0	596
8885	0	3	0	629	0	632
8886	586	0	3	1	0	590
8887	0	599	0	4	0	603
8888	1	0	567	0	0	568
8889	0	596	0	1	0	597
8890	570	0	1	0	0	571
8891	0	612	0	0	0	612
8892	591	0	0	0	0	591
8893	592	0	3	0	0	595
8894	0	623	0	0	0	623
8895	0	0	0	591	0	591
8896	591	0	1	0	0	592
8897	550	0	2	0	0	552
8898	0	2	0	591	0	593
8899	3	0	597	0	0	600
8900	0	0	592	0	0	592
8901	4	1	1	568	0	574
8902	0	0	584	0	0	584
8903	570	0	1	0	0	571
8904	0	597	0	1	0	598
8905	2	0	0	543	0	545
8906	0	2	1	512	0	515
8907	0	2	0	549	0	551
8908	2	4	0	556	0	562
8909	0	4	0	583	0	587
8910	0	0	591	0	0	591
8911	0	609	0	0	0	609
8912	580	1	4	0	0	585
8913	0	5	0	536	0	541
8914	0	4	0	579	0	583
8915	1	2	0	626	0	629
8916	0	614	0	0	0	614
8917	0	2	2	570	0	574
8918	0	1	0	608	0	609
8919	577	1	0	1	0	579
8920	0	641	0	1	0	642
8921	0	607	0	1	0	608
8922	0	1	0	605	0	606
8923	589	3	3	0	0	595
8924	0	0	591	0	0	591
8925	579	1	0	0	0	580
8926	0	0	602	0	0	602
8927	0	4	0	555	0	559
8928	0	1	0	535	0	536
8929	0	3	0	538	0	541
8930	0	1	0	578	0	579
8931	0	1	0	597	0	598
8932	590	0	2	0	0	592
8933	0	0	621	0	0	621
8934	0	2	0	616	0	618
8935	0	0	611	0	0	611
8936	0	618	1	1	0	620
8937	579	0	1	0	0	580
8938	0	0	640	0	0	640
8939	4	3	0	601	0	608
8940	0	2	0	615	0	617
8941	1	0	596	0	0	597
8942	2	0	630	0	0	632
8943	0	3	0	602	0	605
8944	579	0	2	0	0	581
8945	560	0	2	1	0	563
8946	0	617	0	2	0	619
8947	579	1	4	0	0	584
8948	1	2	0	600	0	603
8949	0	596	0	0	0	596
8950	1	3	0	584	0	588
8951	1	0	638	0	0	639
8952	0	4	0	554	0	558
8953	0	1	0	605	0	606
8954	619	0	4	0	0	623
8955	0	627	0	1	0	628
8956	596	0	5	0	0	601
8957	0	611	0	0	0	611
8958	587	0	2	1	0	590
8959	0	606	0	1	0	607
8960	1	564	0	2	0	567
8961	588	0	0	0	0	588
8962	0	3	0	569	0	572
8963	0	575	0	6	0	581
8964	570	0	1	0	0	571
8965	549	0	1	1	0	551
8966	548	0	1	2	0	551
8967	578	1	5	0	0	584
8968	0	648	0	0	0	648
8969	1	3	0	595	0	599
8970	2	4	0	603	0	609
8971	605	0	0	0	0	605
8972	0	3	0	608	0	611
8973	637	0	2	0	0	639
8974	0	0	667	0	0	667
8975	628	0	0	1	0	629
8976	2	0	678	0	0	680
8977	1	1	0	670	0	672
8978	669	0	0	0	0	669
8979	1	683	0	0	0	684
8980	669	1	2	1	0	673
8981	0	687	1	1	0	689
8982	1	2	0	658	0	661
8983	2	0	680	0	0	682
8984	676	0	0	0	0	676
8985	0	706	0	0	0	706
8986	0	3	0	639	0	642
8987	0	1	0	624	0	625
8988	0	4	0	674	0	678
8989	1	0	665	0	0	666
8990	0	688	0	0	0	688
8991	639	0	6	1	0	646
8992	653	0	0	1	0	654
8993	0	707	0	0	0	707
8994	656	1	3	2	0	662
8995	0	8	0	660	0	668
8996	0	661	0	2	0	663
8997	641	0	3	1	0	645
8998	0	0	692	0	0	692
8999	0	690	0	0	0	690
9000	0	5	2	637	0	644
9001	2	1	0	629	0	632
9002	0	0	704	0	0	704
9003	1	1	0	669	0	671
9004	1	0	697	0	0	698
9005	0	5	0	631	0	636
9006	0	1	1	600	0	602
9007	0	1	0	627	0	628
9008	0	0	0	661	0	661
9009	0	0	662	0	0	662
9010	0	0	664	0	0	664
9011	0	666	2	5	0	673
9012	0	1	0	624	0	625
9013	0	0	658	0	0	658
9014	0	659	0	1	0	660
9015	1	2	0	649	0	652
9016	0	0	646	0	0	646
9017	645	0	4	1	0	650
9018	609	0	1	0	0	610
9019	0	1	0	652	0	653
9020	0	0	671	0	0	671
9021	0	3	0	640	0	643
9022	653	0	1	2	0	656
9023	0	665	0	0	0	665
9024	635	1	3	1	0	640
9025	599	0	1	0	0	600
9026	0	2	0	594	0	596
9027	1	1	0	588	0	590
9028	0	3	0	595	0	598
9029	2	2	0	589	0	593
9030	0	2	0	568	0	570
9031	569	0	1	1	0	571
9032	511	0	6	0	0	517
9033	546	0	2	3	0	551
9034	0	0	562	0	0	562
9035	540	0	1	0	0	541
9036	0	1	0	564	0	565
9037	1	0	561	0	0	562
9038	0	573	0	0	0	573
9039	0	2	0	545	0	547
9040	0	2	0	556	0	558
9041	0	561	0	1	0	562
9042	0	1	0	544	0	545
9043	0	0	546	0	0	546
9044	1	0	590	0	0	591
9045	1	1	0	563	0	565
9046	532	0	3	1	0	536
9047	547	1	1	1	0	550
9048	2	0	595	0	0	597
9049	0	589	0	0	0	589
9050	0	559	0	0	0	559
9051	576	0	0	0	0	576
9052	2	0	604	0	0	606
9053	0	2	0	578	0	580
9054	597	0	1	0	0	598
9055	0	604	0	0	0	604
9056	0	594	0	0	0	594
9057	652	0	4	0	0	656
9058	0	2	0	621	0	623
9059	643	0	2	0	0	645
9060	1	1	0	598	0	600
9061	0	5	2	660	0	667
9062	0	0	717	0	0	717
9063	5	1	0	652	0	658
9064	3	1	0	657	0	661
9065	698	0	1	0	0	699
9066	11	1	0	707	0	719
9067	0	0	749	0	0	749
9068	728	0	1	1	0	730
9069	0	2	0	753	0	755
9070	750	0	2	1	0	753
9071	0	812	0	1	0	813
9072	0	794	0	1	0	795
9073	810	0	1	0	0	811
9074	749	0	7	0	0	756
9075	1	0	0	814	0	815
9076	0	0	919	0	0	919
9077	0	2	0	910	0	912
9078	922	0	1	0	0	923
9079	1	953	0	1	0	955
9080	2	3	0	917	0	922
9081	923	0	1	1	0	925
9082	0	0	929	0	0	929
9083	883	1	5	2	0	891
9084	835	2	3	1	0	841
9085	1	0	894	2	0	897
9086	3	0	936	0	0	939
9087	0	2	0	859	0	861
9088	0	0	0	881	0	881
9089	0	921	0	0	0	921
9090	0	2	1	895	0	898
9091	0	0	933	0	0	933
9092	0	1	0	868	0	869
9093	0	1	1	898	0	900
9094	0	0	922	0	0	922
9095	0	929	0	1	0	930
9096	5	4	0	861	0	870
9097	3	1	1	880	0	885
9098	882	0	0	0	0	882
9099	0	1	0	904	0	905
9100	0	0	913	0	0	913
9101	891	0	5	0	0	896
9102	829	1	2	0	0	832
9103	874	0	7	2	0	883
9104	0	0	928	0	0	928
9105	0	4	0	901	0	905
9106	0	1	0	862	0	863
9107	1	1	0	906	0	908
9108	907	0	1	0	0	908
9109	0	890	0	1	0	891
9110	2	0	884	0	0	886
9111	0	895	0	2	0	897
9112	0	864	0	0	0	864
9113	0	903	0	0	0	903
9114	0	4	0	857	0	861
9115	0	0	925	0	0	925
9116	874	0	6	1	0	881
9117	0	891	0	6	0	897
9118	851	3	7	0	0	861
9119	0	888	0	0	0	888
9120	835	0	0	0	0	835
9121	0	852	0	1	0	853
9122	0	0	852	0	0	852
9123	5	1	0	795	0	801
9124	1	0	1	715	0	717
9125	773	0	1	0	0	774
9126	2	2	0	786	0	790
9127	0	2	802	0	0	804
9128	0	2	0	745	0	747
9129	2	0	751	0	0	753
9130	0	715	0	2	0	717
9131	0	3	4	664	0	671
9132	0	684	0	2	0	686
9133	671	0	0	0	0	671
9134	0	2	0	684	0	686
9135	1	0	665	0	0	666
9136	0	0	651	0	0	651
9137	635	0	3	1	0	639
9138	1	0	0	612	0	613
9139	0	0	566	0	0	566
9140	0	0	564	0	0	564
9141	0	569	0	0	0	569
9142	0	0	0	550	0	550
9143	0	554	0	0	0	554
9144	2	4	0	557	0	563
9145	552	0	0	0	0	552
9146	1	2	0	478	0	481
9147	0	0	0	541	0	541
9148	547	0	2	0	0	549
9149	0	4	0	458	0	462
9150	0	5	0	495	0	500
9151	0	490	0	0	0	490
9152	463	0	0	1	0	464
9153	428	0	2	0	0	430
9154	0	2	3	409	0	414
9155	0	1	0	425	0	426
9156	0	4	0	445	0	449
9157	0	432	0	1	0	433
9158	0	445	0	0	0	445
9159	0	1	0	433	0	434
9160	392	0	5	0	0	397
9161	397	0	14	0	0	411
9162	0	460	0	2	0	462
9163	406	1	4	0	0	411
9164	0	456	1	0	0	457
9165	0	424	0	1	0	425
9166	1	1	0	417	0	419
9167	425	1	0	0	0	426
9168	0	465	0	0	0	465
9169	3	444	1	1	0	449
9170	1	2	0	413	0	416
9171	0	1	0	428	0	429
9172	0	0	444	0	0	444
9173	430	0	2	0	0	432
9174	408	0	3	0	0	411
9175	4	0	469	0	0	473
9176	1	0	483	0	0	484
9177	0	0	0	442	0	442
9178	1	0	0	447	0	448
9179	0	482	0	0	0	482
9180	2	0	0	452	0	454
9181	0	0	504	0	0	504
9182	0	0	0	469	0	469
9183	0	3	0	466	0	469
9184	472	0	0	0	0	472
9185	0	0	495	0	0	495
9186	484	0	0	1	0	485
9187	0	0	502	0	0	502
9188	0	0	0	456	0	456
9189	1	0	450	0	0	451
9190	1	0	466	0	0	467
9191	0	0	0	425	0	425
9192	417	0	0	2	0	419
9193	409	1	3	0	0	413
9194	0	442	1	2	0	445
9195	449	0	1	0	0	450
9196	431	0	0	0	0	431
9197	0	442	0	0	0	442
9198	2	3	0	424	0	429
9199	0	2	0	405	0	407
9200	1	2	0	406	0	409
9201	0	1	0	416	0	417
9202	0	0	432	0	0	432
9203	417	0	1	1	0	419
9204	3	2	0	388	0	393
9205	1	3	0	405	0	409
9206	0	409	0	0	0	409
9207	0	2	0	377	0	379
9208	0	0	409	0	0	409
9209	379	0	1	0	0	380
9210	0	0	406	1	0	407
9211	1	0	0	367	0	368
9212	376	0	1	0	0	377
9213	0	380	0	0	0	380
9214	0	0	0	361	0	361
9215	1	0	382	0	0	383
9216	0	2	0	363	0	365
9217	337	0	2	1	0	340
9218	0	0	353	0	0	353
9219	0	0	340	0	0	340
9220	0	324	0	4	0	328
9221	323	0	0	0	0	323
9222	0	287	0	0	0	287
9223	5	0	286	0	0	291
9224	2	0	292	0	0	294
9225	0	286	0	0	0	286
9226	290	0	1	0	0	291
9227	0	294	0	1	0	295
9228	0	1	0	269	0	270
9229	0	0	0	271	0	271
9230	1	0	304	0	0	305
9231	0	0	0	290	0	290
9232	0	0	288	0	0	288
9233	285	0	0	0	0	285
9234	278	0	1	1	0	280
9235	276	0	2	0	0	278
9236	1	0	278	0	0	279
9237	268	0	1	0	0	269
9238	0	1	0	275	0	276
9239	1	265	0	0	0	266
9240	267	1	0	0	0	268
9241	0	0	263	0	0	263
9242	249	0	0	0	0	249
9243	244	0	3	0	0	247
9244	0	0	271	0	0	271
9245	0	268	0	0	0	268
9246	0	0	0	251	0	251
9247	0	0	254	0	0	254
9248	0	0	256	0	0	256
9249	0	1	0	243	0	244
9250	0	0	260	0	0	260
9251	1	7	0	207	0	215
9252	0	0	0	206	0	206
9253	0	0	0	216	0	216
9254	0	0	233	0	0	233
9255	0	2	1	218	0	221
9256	0	0	234	0	0	234
9257	0	6	0	199	0	205
9258	212	0	0	0	0	212
9259	0	7	0	204	0	211
9260	0	201	0	2	0	203
9261	0	1	0	211	0	212
9262	211	0	0	0	0	211
9263	0	209	0	0	0	209
9264	0	4	0	195	0	199
9265	200	0	0	0	0	200
9266	0	0	213	0	0	213
9267	0	0	1	196	0	197
9268	0	0	191	0	0	191
9269	0	0	207	0	0	207
9270	0	0	0	199	0	199
9271	199	0	1	0	0	200
9272	0	0	189	0	0	189
9273	199	0	0	0	0	199
9274	0	0	0	192	0	192
9275	0	0	187	0	0	187
9276	0	0	180	0	0	180
9277	0	0	197	0	0	197
9278	0	0	0	189	0	189
9279	180	0	0	0	0	180
9280	0	188	0	0	0	188
9281	0	0	0	173	0	173
9282	0	0	0	172	0	172
9283	166	0	0	0	0	166
9284	174	1	0	0	0	175
9285	0	193	0	0	0	193
9286	163	0	2	0	0	165
9287	153	0	0	0	0	153
9288	0	0	0	156	0	156
9289	0	0	162	0	0	162
9290	162	0	1	0	0	163
9291	0	0	0	149	0	149
9292	2	0	0	143	0	145
9293	146	0	0	0	0	146
9294	0	1	0	123	0	124
9295	0	0	0	143	0	143
9296	146	0	0	0	0	146
9297	0	150	0	0	0	150
9298	136	0	4	0	0	140
9299	0	0	142	0	0	142
9300	148	0	0	1	0	149
9301	0	1	0	145	0	146
9302	0	151	0	0	0	151
9303	0	0	0	142	0	142
9304	0	1	0	128	0	129
9305	0	0	0	144	0	144
9306	133	0	0	0	0	133
9307	0	145	0	0	0	145
9308	0	137	0	0	0	137
9309	138	0	0	0	0	138
9310	0	0	142	0	0	142
9311	0	0	137	0	0	137
9312	139	0	0	0	0	139
9313	0	0	147	0	0	147
9314	0	0	0	136	0	136
9315	0	1	0	124	0	125
9316	0	0	0	126	0	126
9317	0	0	0	131	0	131
9318	0	129	0	0	0	129
9319	0	0	0	128	0	128
9320	0	0	135	0	0	135
9321	0	0	0	134	0	134
9322	0	0	117	0	0	117
9323	0	0	136	0	0	136
9324	0	1	0	126	0	127
9325	0	0	129	0	0	129
9326	1	0	0	123	0	124
9327	127	0	0	0	0	127
9328	0	0	131	0	0	131
9329	115	0	1	0	0	116
9330	0	0	0	123	0	123
9331	1	0	119	0	0	120
9332	0	112	0	0	0	112
9333	1	0	0	108	0	109
9334	1	0	114	0	0	115
9335	0	0	0	106	0	106
9336	110	0	0	0	0	110
9337	103	0	0	0	0	103
9338	103	0	1	1	0	105
9339	0	0	0	105	0	105
9340	0	1	0	100	0	101
9341	0	0	0	108	0	108
9342	107	0	0	0	0	107
9343	0	106	0	0	0	106
9344	0	0	0	99	0	99
9345	0	1	0	98	0	99
9346	97	0	0	1	0	98
9347	0	113	0	0	0	113
9348	0	0	0	112	0	112
9349	115	0	0	0	0	115
9350	104	0	1	0	0	105
9351	3	0	0	102	0	105
9352	107	0	1	0	0	108
9353	0	0	0	116	0	116
9354	0	0	119	0	0	119
9355	0	0	0	110	0	110
9356	1	0	0	99	0	100
9357	0	0	0	102	0	102
9358	110	0	0	0	0	110
9359	0	112	0	0	0	112
9360	111	0	0	0	0	111
9361	0	112	0	0	0	112
9362	0	108	0	0	0	108
9363	110	0	0	0	0	110
9364	0	111	0	0	0	111
9365	0	1	0	102	0	103
9366	104	0	1	0	0	105
9367	98	0	0	0	0	98
9368	0	0	0	104	0	104
9369	1	0	0	109	0	110
9370	0	110	0	0	0	110
9371	100	0	0	0	0	100
9372	107	0	0	0	0	107
9373	0	106	0	0	0	106
9374	0	109	0	0	0	109
9375	0	1	0	101	0	102
9376	106	0	1	0	0	107
9377	0	0	0	98	0	98
9378	0	1	0	108	0	109
9379	0	0	103	0	0	103
9380	0	0	107	0	0	107
9381	0	1	0	106	0	107
9382	0	0	108	0	0	108
9383	0	109	0	0	0	109
9384	0	1	0	105	0	106
9385	0	0	0	95	0	95
9386	0	0	0	105	0	105
9387	0	0	103	0	0	103
9388	0	0	107	0	0	107
9389	99	0	0	0	0	99
9390	0	106	0	0	0	106
9391	108	0	0	0	0	108
9392	0	0	0	100	0	100
9393	110	0	0	0	0	110
9394	0	1	0	115	0	116
9395	0	107	0	0	0	107
9396	105	0	1	0	0	106
9397	0	0	111	0	0	111
9398	0	115	1	4	0	120
9399	115	0	0	0	0	115
9400	0	0	0	120	0	120
9401	0	123	0	0	0	123
9402	0	0	0	128	0	128
9403	127	1	1	0	0	129
9404	0	0	0	125	0	125
9405	133	0	0	0	0	133
9406	0	0	137	0	0	137
9407	0	0	0	129	0	129
9408	119	0	0	0	0	119
9409	0	0	118	0	0	118
9410	0	106	0	0	0	106
9411	0	0	0	99	0	99
9412	0	0	100	0	0	100
9413	0	0	102	0	0	102
9414	0	0	0	99	0	99
9415	0	0	95	0	0	95
9416	0	0	105	0	0	105
9417	0	0	0	105	0	105
9418	108	0	0	0	0	108
9419	0	1	0	99	0	100
9420	0	2	0	106	0	108
9421	1	0	113	0	0	114
9422	0	0	0	110	0	110
9423	111	0	0	0	0	111
9424	0	0	111	0	0	111
9425	1	107	0	1	0	109
9426	0	0	0	112	0	112
9427	113	0	0	0	0	113
9428	0	3	0	114	0	117
9429	0	117	0	1	0	118
9430	0	0	114	0	0	114
9431	0	0	0	123	0	123
9432	119	0	0	4	0	123
9433	0	0	126	0	0	126
9434	3	0	0	120	0	123
9435	121	0	0	0	0	121
9436	118	0	0	0	0	118
9437	0	129	0	0	0	129
9438	121	0	1	0	0	122
9439	0	0	0	122	0	122
9440	0	0	112	0	0	112
9441	0	117	0	0	0	117
9442	0	118	0	0	0	118
9443	3	0	0	105	0	108
9444	0	0	0	112	0	112
9445	0	0	110	0	0	110
9446	0	113	0	1	0	114
9447	0	111	0	0	0	111
9448	0	0	0	114	0	114
9449	114	0	0	0	0	114
9450	0	112	0	0	0	112
9451	0	0	0	114	0	114
9452	112	0	0	0	0	112
9453	0	0	0	102	0	102
9454	0	2	0	102	0	104
9455	0	0	0	101	0	101
9456	0	0	0	106	0	106
9457	103	0	0	0	0	103
9458	0	0	0	105	0	105
9459	0	0	102	0	0	102
9460	102	0	0	0	0	102
9461	0	0	94	0	0	94
9462	0	0	97	0	0	97
9463	0	0	0	89	0	89
9464	0	0	0	78	0	78
9465	0	0	0	92	0	92
9466	89	0	0	0	0	89
9467	0	0	93	0	0	93
9468	81	0	1	0	0	82
9469	80	0	0	0	0	80
9470	1	0	87	0	0	88
9471	79	0	0	0	0	79
9472	0	0	84	0	0	84
9473	0	83	0	0	0	83
9474	0	0	0	80	0	80
9475	0	0	0	67	0	67
9476	0	0	0	77	0	77
9477	0	3	0	81	0	84
9478	2	0	80	0	0	82
9479	0	0	79	0	0	79
9480	0	1	1	78	0	80
9481	0	0	83	0	0	83
9482	86	0	0	0	0	86
9483	78	0	0	0	0	78
9484	0	0	0	87	0	87
9485	83	0	0	0	0	83
9486	0	97	0	0	0	97
9487	93	0	0	0	0	93
9488	0	0	101	0	0	101
9489	0	1	0	99	0	100
9490	0	92	0	0	0	92
9491	95	0	0	0	0	95
9492	0	0	0	97	0	97
9493	0	0	97	0	0	97
9494	0	0	1	98	0	99
9495	90	0	1	0	0	91
9496	0	0	95	0	0	95
9497	0	0	0	96	0	96
9498	0	1	0	96	0	97
9499	0	0	96	0	0	96
9500	0	96	0	0	0	96
9501	0	96	0	0	0	96
9502	0	0	0	88	0	88
9503	0	0	0	84	0	84
9504	0	0	0	89	0	89
9505	90	0	0	0	0	90
9506	88	0	0	0	0	88
9507	0	0	0	90	0	90
9508	94	0	0	0	0	94
9509	0	97	0	0	0	97
9510	0	0	0	90	0	90
9511	0	0	0	91	0	91
9512	0	0	0	98	0	98
9513	94	0	2	0	0	96
9514	0	99	0	2	0	101
9515	0	0	0	96	0	96
9516	95	0	0	0	0	95
9517	0	0	0	85	0	85
9518	0	0	0	102	0	102
9519	0	94	0	0	0	94
9520	0	100	0	0	0	100
9521	0	0	0	98	0	98
9522	0	0	0	92	0	92
9523	93	0	0	0	0	93
9524	0	1	0	98	0	99
9525	0	0	105	0	0	105
9526	0	0	0	101	0	101
9527	0	100	0	0	0	100
9528	94	0	0	3	0	97
9529	0	0	0	87	0	87
9530	1	1	0	99	0	101
9531	0	95	0	0	0	95
9532	97	0	0	0	0	97
9533	0	103	0	0	0	103
9534	0	0	0	100	0	100
9535	0	0	105	0	0	105
9536	0	0	0	97	0	97
9537	93	0	0	0	0	93
9538	2	100	0	0	0	102
9539	0	0	0	92	0	92
9540	0	90	0	0	0	90
9541	0	1	0	89	0	90
9542	0	0	99	0	0	99
9543	0	2	0	95	0	97
9544	0	2	0	90	0	92
9545	0	0	0	89	0	89
9546	89	0	0	0	0	89
9547	82	0	0	0	0	82
9548	0	90	0	0	0	90
9549	91	0	0	0	0	91
9550	0	93	0	0	0	93
9551	0	87	0	0	0	87
9552	81	0	0	0	0	81
9553	0	0	85	0	0	85
9554	0	0	0	81	0	81
9555	0	0	0	81	0	81
9556	0	0	0	84	0	84
9557	82	1	0	0	0	83
9558	0	85	0	0	0	85
9559	0	0	0	84	0	84
9560	0	85	0	0	0	85
9561	83	0	0	0	0	83
9562	0	0	0	78	0	78
9563	0	0	0	81	0	81
9564	0	82	0	0	0	82
9565	0	0	0	77	0	77
9566	0	0	0	79	0	79
9567	80	0	0	0	0	80
9568	0	84	0	1	0	85
9569	0	79	0	0	0	79
9570	0	1	0	72	0	73
9571	0	0	72	0	0	72
9572	0	0	75	0	0	75
9573	0	0	0	70	0	70
9574	0	0	74	0	0	74
9575	0	0	0	70	0	70
9576	1	1	2	61	0	65
9577	0	0	0	69	0	69
9578	62	0	0	0	0	62
9579	0	0	0	64	0	64
9580	1	0	0	61	0	62
9581	0	59	0	0	0	59
9582	0	1	0	54	0	55
9583	0	0	59	0	0	59
9584	1	0	0	51	0	52
9585	0	0	0	53	0	53
9586	54	0	0	0	0	54
9587	0	0	0	55	0	55
9588	0	0	0	58	0	58
9589	0	0	0	58	0	58
9590	58	0	0	0	0	58
9591	0	60	0	0	0	60
9592	0	0	0	59	0	59
9593	0	0	0	60	0	60
9594	0	0	59	0	0	59
9595	0	0	0	60	0	60
9596	61	0	0	0	0	61
9597	0	62	0	0	0	62
9598	0	0	0	58	0	58
9599	0	0	0	60	0	60
9600	0	0	60	0	0	60
9601	62	0	0	0	0	62
9602	0	62	0	0	0	62
9603	61	0	0	0	0	61
9604	0	0	0	56	0	56
9605	0	0	0	58	0	58
9606	1	2	0	58	0	61
9607	0	0	0	67	0	67
9608	66	0	0	0	0	66
9609	0	0	0	69	0	69
9610	0	65	0	0	0	65
9611	0	0	0	66	0	66
9612	0	0	0	75	0	75
9613	69	0	0	0	0	69
9614	0	76	0	0	0	76
9615	0	2	0	71	0	73
9616	71	0	0	0	0	71
9617	68	0	0	0	0	68
9618	2	1	0	71	0	74
9619	0	0	78	0	0	78
9620	78	0	0	0	0	78
9621	0	1	0	72	0	73
9622	0	0	77	0	0	77
9623	0	0	0	68	0	68
9624	0	0	0	63	0	63
9625	0	2	0	69	0	71
9626	0	71	0	0	0	71
9627	0	1	0	67	0	68
9628	0	0	0	69	0	69
9629	0	0	0	74	0	74
9630	0	1	0	68	0	69
9631	0	0	0	74	0	74
9632	0	0	0	77	0	77
9633	77	0	0	0	0	77
9634	0	0	83	0	0	83
9635	0	84	0	1	0	85
9636	87	0	0	0	0	87
9637	0	92	2	0	0	94
9638	95	0	0	0	0	95
9639	0	0	0	93	0	93
9640	92	0	0	0	0	92
9641	0	0	0	94	0	94
9642	0	4	0	104	0	108
9643	0	110	0	0	0	110
9644	102	0	0	0	0	102
9645	0	0	117	0	0	117
9646	0	0	0	118	0	118
9647	0	0	113	0	0	113
9648	0	0	117	0	0	117
9649	112	0	3	0	0	115
9650	0	0	0	116	0	116
9651	1	0	110	0	0	111
9652	0	0	116	0	0	116
9653	0	0	0	118	0	118
9654	0	0	0	116	0	116
9655	120	0	0	0	0	120
9656	0	3	0	119	0	122
9657	0	0	125	0	0	125
9658	0	1	0	117	0	118
9659	0	1	0	126	0	127
9660	0	122	0	0	0	122
9661	121	0	2	0	0	123
9662	0	126	0	0	0	126
9663	124	0	0	0	0	124
9664	0	132	0	0	0	132
9665	0	131	0	0	0	131
9666	0	0	0	127	0	127
9667	1	1	0	124	0	126
9668	0	0	0	131	0	131
9669	125	0	1	0	0	126
9670	0	0	133	0	0	133
9671	0	0	0	129	0	129
9672	128	0	0	0	0	128
9673	0	132	0	1	0	133
9674	0	121	0	0	0	121
9675	0	1	0	121	0	122
9676	1	2	0	114	0	117
9677	0	0	0	126	0	126
9678	0	127	0	0	0	127
9679	0	0	0	130	0	130
9680	0	0	121	0	0	121
9681	0	0	115	0	0	115
9682	124	0	0	0	0	124
9683	0	0	0	120	0	120
9684	111	0	0	0	0	111
9685	108	0	0	0	0	108
9686	0	121	0	0	0	121
9687	116	0	0	0	0	116
9688	110	0	0	0	0	110
9689	0	0	2	103	0	105
9690	0	1	0	118	0	119
9691	0	0	119	0	0	119
9692	0	116	0	0	0	116
9693	0	0	0	114	0	114
9694	0	0	0	105	0	105
9695	103	0	1	0	0	104
9696	0	0	0	103	0	103
9697	107	0	1	0	0	108
9698	0	0	0	114	0	114
9699	0	109	0	0	0	109
9700	100	0	0	1	0	101
9701	0	0	0	93	0	93
9702	0	0	0	93	0	93
9703	0	0	0	102	0	102
9704	0	0	107	0	0	107
9705	0	2	0	104	0	106
9706	106	0	0	0	0	106
9707	0	0	0	93	0	93
9708	0	0	0	108	0	108
9709	0	1	0	106	0	107
9710	0	99	0	0	0	99
9711	0	103	0	0	0	103
9712	102	0	0	0	0	102
9713	0	108	0	0	0	108
9714	103	0	0	0	0	103
9715	97	0	0	0	0	97
9716	94	2	0	0	0	96
9717	0	1	101	0	0	102
9718	0	107	0	0	0	107
9719	105	0	3	0	0	108
9720	0	1	0	91	0	92
9721	0	0	0	103	0	103
9722	0	0	0	110	0	110
9723	0	114	0	1	0	115
9724	0	1	0	117	0	118
9725	112	0	0	0	0	112
9726	0	1	0	108	0	109
9727	0	0	0	116	0	116
9728	0	0	115	0	0	115
9729	0	0	118	0	0	118
9730	0	1	0	117	0	118
9731	0	0	0	130	0	130
9732	0	132	0	0	0	132
9733	0	0	0	127	0	127
9734	0	0	0	121	0	121
9735	0	0	0	133	0	133
9736	137	0	2	0	0	139
9737	0	0	145	0	0	145
9738	0	1	0	140	0	141
9739	138	0	0	0	0	138
9740	129	0	0	0	0	129
9741	0	0	0	131	0	131
9742	1	0	0	142	0	143
9743	132	0	0	1	0	133
9744	0	148	0	0	0	148
9745	0	147	0	0	0	147
9746	0	0	0	144	0	144
9747	146	0	0	0	0	146
9748	135	0	0	0	0	135
9749	142	0	0	1	0	143
9750	0	0	151	0	0	151
9751	149	0	0	1	0	150
9752	0	0	148	0	0	148
9753	144	0	0	0	0	144
9754	0	147	0	1	0	148
9755	0	0	150	0	0	150
9756	0	1	0	150	0	151
9757	0	0	154	0	0	154
9758	0	0	0	150	0	150
9759	148	0	0	0	0	148
9760	1	0	151	0	0	152
9761	0	2	0	147	0	149
9762	0	149	0	0	0	149
9763	0	2	0	144	0	146
9764	1	1	0	137	0	139
9765	0	1	0	132	0	133
9766	147	0	0	0	0	147
9767	136	0	2	0	0	138
9768	0	1	0	148	0	149
9769	0	0	147	0	0	147
9770	0	0	149	0	0	149
9771	0	0	0	147	0	147
9772	2	0	144	0	0	146
9773	0	1	0	138	0	139
9774	0	0	0	138	0	138
9775	0	0	0	141	0	141
9776	0	146	0	0	0	146
9777	0	143	0	0	0	143
9778	0	0	0	137	0	137
9779	0	0	0	134	0	134
9780	0	0	0	138	0	138
9781	140	0	1	0	0	141
9782	0	0	147	0	0	147
9783	1	2	0	140	0	143
9784	140	0	0	0	0	140
9785	0	139	0	0	0	139
9786	0	0	1	118	0	119
9787	0	0	0	119	0	119
9788	0	2	0	126	0	128
9789	0	0	0	122	0	122
9790	0	0	120	0	0	120
9791	108	0	2	0	0	110
9792	112	0	1	0	0	113
9793	0	0	125	0	0	125
9794	117	0	0	0	0	117
9795	116	0	0	0	0	116
9796	0	0	122	0	0	122
9797	0	120	0	0	0	120
9798	0	3	0	112	0	115
9799	0	0	117	0	0	117
9800	0	111	0	0	0	111
9801	0	0	103	0	0	103
9802	0	114	0	0	0	114
9803	0	1	0	104	0	105
9804	0	0	116	0	0	116
9805	0	0	0	112	0	112
9806	0	0	117	0	0	117
9807	0	111	0	1	0	112
9808	115	0	0	0	0	115
9809	0	113	0	0	0	113
9810	0	107	0	0	0	107
9811	0	1	0	115	0	116
9812	0	2	0	95	0	97
9813	0	0	0	105	0	105
9814	0	0	0	106	0	106
9815	1	0	0	108	0	109
9816	0	0	116	0	0	116
9817	0	0	0	111	0	111
9818	0	0	0	92	0	92
9819	105	0	0	0	0	105
9820	104	0	2	0	0	106
9821	107	0	0	0	0	107
9822	0	0	0	117	0	117
9823	110	0	1	0	0	111
9824	107	0	1	0	0	108
9825	105	0	4	0	0	109
9826	0	0	118	0	0	118
9827	123	0	2	0	0	125
9828	113	0	0	0	0	113
9829	114	0	0	0	0	114
9830	0	0	0	126	0	126
9831	1	0	130	0	0	131
9832	0	4	0	122	0	126
9833	136	0	0	0	0	136
9834	0	0	0	139	0	139
9835	0	141	0	0	0	141
9836	0	0	0	135	0	135
9837	135	0	0	0	0	135
9838	130	0	0	0	0	130
9839	139	0	0	0	0	139
9840	0	0	146	0	0	146
9841	0	0	0	145	0	145
9842	0	1	0	141	0	142
9843	0	0	160	0	0	160
9844	0	148	0	0	0	148
9845	0	0	154	0	0	154
9846	0	0	0	154	0	154
9847	159	0	0	0	0	159
9848	0	0	169	0	0	169
9849	0	1	0	169	0	170
9850	0	0	157	0	0	157
9851	169	0	1	0	0	170
9852	0	0	0	168	0	168
9853	0	0	168	0	0	168
9854	0	3	1	160	0	164
9855	0	0	171	0	0	171
9856	0	174	0	0	0	174
9857	0	0	0	168	0	168
9858	174	0	0	0	0	174
9859	0	0	0	159	0	159
9860	0	0	0	167	0	167
9861	166	0	1	1	0	168
9862	0	175	0	0	0	175
9863	0	171	0	1	0	172
9864	0	3	0	165	0	168
9865	0	172	0	0	0	172
9866	0	0	0	167	0	167
9867	0	0	0	165	0	165
9868	160	0	0	0	0	160
9869	0	170	0	0	0	170
9870	0	0	170	0	0	170
9871	0	155	0	0	0	155
9872	165	0	0	0	0	165
9873	160	0	1	0	0	161
9874	0	0	0	162	0	162
9875	166	0	0	0	0	166
9876	0	0	0	168	0	168
9877	161	0	0	0	0	161
9878	156	0	0	0	0	156
9879	0	0	0	165	0	165
9880	153	0	0	1	0	154
9881	0	0	161	0	0	161
9882	144	0	0	1	0	145
9883	0	0	0	141	0	141
9884	142	0	0	0	0	142
9885	0	145	0	0	0	145
9886	0	1	0	138	0	139
9887	0	0	0	130	0	130
9888	124	0	0	0	0	124
9889	0	0	137	0	0	137
9890	0	132	0	0	0	132
9891	0	0	0	122	0	122
9892	0	138	0	0	0	138
9893	0	4	0	123	0	127
9894	0	0	0	124	0	124
9895	0	0	0	125	0	125
9896	129	0	0	0	0	129
9897	0	0	0	130	0	130
9898	122	0	0	1	0	123
9899	111	0	0	0	0	111
9900	0	1	0	115	0	116
9901	97	0	0	0	0	97
9902	95	0	2	0	0	97
9903	0	0	102	0	0	102
9904	0	1	0	101	0	102
9905	98	0	1	0	0	99
9906	0	98	0	0	0	98
9907	96	0	1	0	0	97
9908	97	0	0	0	0	97
9909	0	0	104	0	0	104
9910	0	0	0	95	0	95
9911	95	0	0	0	0	95
9912	0	4	0	81	0	85
9913	0	0	0	87	0	87
9914	0	0	0	92	0	92
9915	0	0	0	90	0	90
9916	88	0	0	0	0	88
9917	0	0	91	0	0	91
9918	0	0	0	81	0	81
9919	2	0	76	0	0	78
9920	0	0	83	0	0	83
9921	78	0	0	0	0	78
9922	0	0	83	0	0	83
9923	0	81	0	1	0	82
9924	80	0	0	0	0	80
9925	74	0	0	0	0	74
9926	0	0	0	75	0	75
9927	0	0	86	0	0	86
9928	0	0	86	0	0	86
9929	81	0	1	0	0	82
9930	0	1	0	76	0	77
9931	79	0	0	0	0	79
9932	0	83	0	0	0	83
9933	72	1	0	0	0	73
9934	78	0	0	0	0	78
9935	0	86	0	0	0	86
9936	0	0	0	85	0	85
9937	83	0	0	0	0	83
9938	0	0	86	0	0	86
9939	0	91	0	0	0	91
9940	0	0	0	86	0	86
9941	88	0	0	0	0	88
9942	0	92	0	1	0	93
9943	90	0	0	0	0	90
9944	0	0	89	0	0	89
9945	85	0	0	0	0	85
9946	0	0	89	0	0	89
9947	83	0	0	0	0	83
9948	79	0	0	0	0	79
9949	0	0	86	0	0	86
9950	0	85	0	0	0	85
9951	0	0	0	75	0	75
9952	0	0	86	0	0	86
9953	0	84	0	0	0	84
9954	0	0	0	84	0	84
9955	0	0	0	84	0	84
9956	0	0	86	0	0	86
9957	0	1	0	86	0	87
9958	0	0	0	83	0	83
9959	0	0	82	0	0	82
9960	0	0	0	85	0	85
9961	0	86	0	0	0	86
9962	89	0	0	0	0	89
9963	0	0	0	87	0	87
9964	0	84	0	0	0	84
9965	0	0	0	89	0	89
9966	0	85	0	0	0	85
9967	0	0	79	0	0	79
9968	0	88	0	0	0	88
9969	82	0	2	0	0	84
9970	77	0	1	0	0	78
9971	84	0	0	0	0	84
9972	0	0	83	0	0	83
9973	0	0	81	0	0	81
9974	0	85	0	0	0	85
9975	0	0	0	73	0	73
9976	0	84	0	0	0	84
9977	2	0	0	74	0	76
9978	0	84	0	0	0	84
9979	82	0	1	0	0	83
9980	73	0	1	0	0	74
9981	0	0	0	84	0	84
9982	0	0	83	0	0	83
9983	81	0	0	0	0	81
9984	0	85	0	2	0	87
9985	0	0	0	82	0	82
9986	0	0	0	77	0	77
9987	0	81	0	0	0	81
9988	83	0	0	0	0	83
9989	0	0	86	0	0	86
9990	0	0	0	87	0	87
9991	84	0	0	0	0	84
9992	80	0	1	0	0	81
9993	0	82	0	0	0	82
9994	0	1	0	77	0	78
9995	0	80	0	1	0	81
9996	67	0	0	0	0	67
9997	0	0	73	0	0	73
9998	0	0	77	0	0	77
9999	0	0	0	71	0	71
10000	1	0	0	74	0	75
10001	0	79	0	0	0	79
10002	0	0	0	77	0	77
10003	0	0	75	0	0	75
10004	76	0	0	0	0	76
10005	0	2	0	70	0	72
10006	0	0	82	0	0	82
10007	0	0	0	73	0	73
10008	0	1	0	72	0	73
10009	0	72	0	0	0	72
10010	0	1	0	69	0	70
10011	0	0	0	68	0	68
10012	0	0	0	70	0	70
10013	69	0	0	0	0	69
10014	0	77	0	0	0	77
10015	0	71	0	0	0	71
10016	66	0	0	0	0	66
10017	73	0	0	0	0	73
10018	0	77	0	0	0	77
10019	0	70	0	0	0	70
10020	73	0	1	0	0	74
10021	0	76	0	0	0	76
10022	0	73	0	0	0	73
10023	71	0	0	0	0	71
10024	1	77	0	0	0	78
10025	73	0	0	0	0	73
10026	64	0	0	0	0	64
10027	71	0	0	0	0	71
10028	0	77	0	0	0	77
10029	0	76	0	0	0	76
10030	0	0	0	75	0	75
10031	0	79	0	0	0	79
10032	0	0	0	80	0	80
10033	69	0	0	0	0	69
10034	0	0	0	74	0	74
10035	0	69	0	1	0	70
10036	75	0	0	0	0	75
10037	0	78	0	0	0	78
10038	0	74	0	1	0	75
10039	0	0	0	74	0	74
10040	0	74	0	0	0	74
10041	69	0	0	0	0	69
10042	0	0	70	0	0	70
10043	0	71	0	0	0	71
10044	0	0	1	69	0	70
10045	0	0	76	0	0	76
10046	0	0	0	67	0	67
10047	0	0	0	63	0	63
10048	0	0	0	65	0	65
10049	0	0	0	70	0	70
10050	0	0	73	0	0	73
10051	0	73	0	0	0	73
10052	69	0	1	0	0	70
10053	0	0	73	0	0	73
10054	71	0	0	0	0	71
10055	0	0	74	0	0	74
10056	0	0	1	69	0	70
10057	0	0	72	0	0	72
10058	0	0	73	0	0	73
10059	0	0	0	73	0	73
10060	1	0	0	71	0	72
10061	0	0	0	68	0	68
10062	0	0	0	70	0	70
10063	74	0	0	0	0	74
10064	1	0	69	0	0	70
10065	70	0	0	0	0	70
10066	71	0	1	0	0	72
10067	64	0	0	0	0	64
10068	69	0	0	0	0	69
10069	58	0	1	0	0	59
10070	0	0	0	71	0	71
10071	0	0	70	0	0	70
10072	0	0	73	0	0	73
10073	0	72	0	0	0	72
10074	65	0	1	0	0	66
10075	0	0	0	62	0	62
10076	1	0	0	67	0	68
10077	0	66	0	0	0	66
10078	0	65	0	0	0	65
10079	0	74	0	0	0	74
10080	69	0	0	0	0	69
10081	0	0	0	65	0	65
10082	0	68	1	0	0	69
10083	0	0	0	64	0	64
10084	0	0	66	0	0	66
10085	0	0	71	0	0	71
10086	1	1	0	66	0	68
10087	69	0	0	0	0	69
10088	62	0	0	0	0	62
10089	69	0	0	0	0	69
10090	0	0	78	0	0	78
10091	0	0	0	71	0	71
10092	0	0	0	67	0	67
10093	0	0	77	0	0	77
10094	69	0	0	0	0	69
10095	0	0	77	0	0	77
10096	0	0	80	0	0	80
10097	0	0	85	0	0	85
10098	0	0	0	79	0	79
10099	0	0	0	85	0	85
10100	0	0	90	0	0	90
10101	0	0	0	87	0	87
10102	83	0	0	0	0	83
10103	0	0	0	84	0	84
10104	0	0	85	0	0	85
10105	0	0	92	1	0	93
10106	0	0	0	90	0	90
10107	92	0	1	0	0	93
10108	0	92	0	0	0	92
10109	90	0	0	0	0	90
10110	83	0	0	0	0	83
10111	0	0	93	0	0	93
10112	0	0	0	90	0	90
10113	88	0	0	0	0	88
10114	87	0	0	0	0	87
10115	0	92	0	0	0	92
10116	0	0	0	87	0	87
10117	1	0	0	84	0	85
10118	0	0	91	0	0	91
10119	1	0	0	93	0	94
10120	0	0	93	0	0	93
10121	0	0	94	0	0	94
10122	1	0	0	90	0	91
10123	93	0	0	0	0	93
10124	0	99	0	0	0	99
10125	99	0	0	0	0	99
10126	96	0	1	0	0	97
10127	0	100	0	0	0	100
10128	0	0	0	101	0	101
10129	100	0	0	0	0	100
10130	0	103	0	0	0	103
10131	103	0	0	0	0	103
10132	0	105	0	0	0	105
10133	0	0	0	97	0	97
10134	0	0	0	86	0	86
10135	89	0	1	0	0	90
10136	87	0	0	0	0	87
10137	0	96	0	0	0	96
10138	0	0	87	0	0	87
10139	0	0	96	0	0	96
10140	1	0	0	94	0	95
10141	0	96	0	0	0	96
10142	0	1	0	90	0	91
10143	2	0	0	80	0	82
10144	1	0	0	90	0	91
10145	0	0	90	0	0	90
10146	0	0	96	0	0	96
10147	0	96	0	0	0	96
10148	0	0	0	88	0	88
10149	0	1	0	85	0	86
10150	0	0	95	0	0	95
10151	87	0	0	0	0	87
10152	0	0	0	92	0	92
10153	0	0	97	0	0	97
10154	94	0	0	0	0	94
10155	0	93	0	0	0	93
10156	0	0	96	0	0	96
10157	0	0	0	92	0	92
10158	94	0	0	0	0	94
10159	0	0	95	0	0	95
10160	0	1	0	87	0	88
10161	0	0	0	85	0	85
10162	0	1	0	90	0	91
10163	95	0	0	0	0	95
10164	0	93	0	0	0	93
10165	0	1	0	86	0	87
10166	1	0	100	0	0	101
10167	0	0	0	97	0	97
10168	0	97	0	0	0	97
10169	0	97	0	0	0	97
10170	95	0	0	0	0	95
10171	93	0	2	0	0	95
10172	0	0	99	0	0	99
10173	97	0	1	0	0	98
10174	1	95	0	0	0	96
10175	96	0	0	0	0	96
10176	0	3	0	91	0	94
10177	0	0	89	0	0	89
10178	0	0	0	77	0	77
10179	0	0	79	0	0	79
10180	84	0	0	0	0	84
10181	0	1	0	86	0	87
10182	0	90	0	0	0	90
10183	0	0	0	78	0	78
10184	1	0	87	0	0	88
10185	0	85	0	0	0	85
10186	83	0	0	0	0	83
10187	0	91	0	0	0	91
10188	0	88	0	0	0	88
10189	0	0	0	92	0	92
10190	0	92	0	0	0	92
10191	0	0	0	95	0	95
10192	0	0	97	0	0	97
10193	88	1	0	0	0	89
10194	83	0	0	0	0	83
10195	0	0	92	0	0	92
10196	92	0	0	0	0	92
10197	0	90	0	1	0	91
10198	90	0	0	0	0	90
10199	0	0	0	92	0	92
10200	0	1	90	1	0	92
10201	0	103	0	1	0	104
10202	0	0	0	98	0	98
10203	0	0	0	99	0	99
10204	91	0	0	0	0	91
10205	94	0	0	0	0	94
10206	0	104	0	0	0	104
10207	0	93	0	0	0	93
10208	0	100	0	0	0	100
10209	1	0	0	92	0	93
10210	89	0	0	0	0	89
10211	90	0	0	0	0	90
10212	0	0	0	79	0	79
10213	0	0	0	94	0	94
10214	91	0	0	0	0	91
10215	0	0	0	87	0	87
10216	0	0	92	0	0	92
10217	86	0	0	0	0	86
10218	83	0	1	0	0	84
10219	0	0	96	0	0	96
10220	94	0	0	0	0	94
10221	0	0	0	86	0	86
10222	0	0	0	90	0	90
10223	0	0	0	89	0	89
10224	88	0	0	0	0	88
10225	0	91	0	0	0	91
10226	0	0	0	87	0	87
10227	0	90	0	0	0	90
10228	89	0	0	0	0	89
10229	0	0	0	91	0	91
10230	0	1	0	94	0	95
10231	0	92	0	1	0	93
10232	0	0	93	0	0	93
10233	0	0	0	78	0	78
10234	86	0	4	0	0	90
10235	89	0	0	0	0	89
10236	0	0	99	0	0	99
10237	4	0	0	90	0	94
10238	0	94	0	0	0	94
10239	0	0	0	95	0	95
10240	90	0	0	0	0	90
10241	86	0	0	0	0	86
10242	0	0	0	95	0	95
10243	0	100	0	0	0	100
10244	95	0	2	0	0	97
10245	0	0	0	82	0	82
10246	88	0	0	0	0	88
10247	75	0	1	0	0	76
10248	0	0	0	80	0	80
10249	0	0	0	82	0	82
10250	0	1	0	83	0	84
10251	0	82	0	0	0	82
10252	0	0	0	74	0	74
10253	0	0	0	79	0	79
10254	0	0	78	0	0	78
10255	0	0	87	0	0	87
10256	0	0	0	82	0	82
10257	86	0	0	0	0	86
10258	0	87	0	0	0	87
10259	81	0	0	0	0	81
10260	0	0	88	0	0	88
10261	1	0	90	0	0	91
10262	0	93	0	0	0	93
10263	0	0	1	91	0	92
10264	0	0	91	0	0	91
10265	0	0	93	0	0	93
10266	0	0	0	89	0	89
10267	89	0	0	0	0	89
10268	84	0	0	0	0	84
10269	1	0	0	89	0	90
10270	0	0	91	0	0	91
10271	0	1	0	80	0	81
10272	0	0	0	83	0	83
10273	0	81	0	0	0	81
10274	84	0	0	0	0	84
10275	80	0	0	0	0	80
10276	0	87	0	0	0	87
10277	0	1	0	78	0	79
10278	0	86	0	0	0	86
10279	81	0	0	0	0	81
10280	1	0	80	0	0	81
10281	0	0	83	0	0	83
10282	0	0	85	0	0	85
10283	0	1	0	80	0	81
10284	0	0	0	81	0	81
10285	89	0	0	0	0	89
10286	0	0	0	81	0	81
10287	0	0	0	88	0	88
10288	0	0	88	0	0	88
10289	0	0	90	0	0	90
10290	88	0	0	0	0	88
10291	0	93	0	2	0	95
10292	92	0	0	0	0	92
10293	0	0	0	95	0	95
10294	0	0	0	99	0	99
10295	0	101	0	0	0	101
10296	0	0	0	103	0	103
10297	100	0	0	0	0	100
10298	0	0	0	107	0	107
10299	0	0	107	0	0	107
10300	0	106	0	0	0	106
10301	105	0	0	0	0	105
10302	103	0	0	0	0	103
10303	103	0	0	0	0	103
10304	96	0	3	0	0	99
10305	0	0	0	105	0	105
10306	0	0	0	107	0	107
10307	0	0	110	0	0	110
10308	0	1	0	110	0	111
10309	0	0	112	0	0	112
10310	0	0	0	114	0	114
10311	114	0	0	0	0	114
10312	0	118	0	0	0	118
10313	0	0	0	112	0	112
10314	0	0	0	105	0	105
10315	95	0	2	0	0	97
10316	109	0	0	0	0	109
10317	0	0	112	0	0	112
10318	0	115	0	0	0	115
10319	0	1	0	106	0	107
10320	0	0	0	99	0	99
10321	106	0	1	0	0	107
10322	108	0	0	0	0	108
10323	0	0	117	0	0	117
10324	1	1	119	0	0	121
10325	0	0	0	117	0	117
10326	0	2	0	110	0	112
10327	0	0	117	0	0	117
10328	117	0	0	0	0	117
10329	0	0	0	115	0	115
10330	118	0	1	0	0	119
10331	0	119	0	0	0	119
10332	115	0	0	0	0	115
10333	0	0	114	0	0	114
10334	0	118	0	0	0	118
10335	0	114	0	0	0	114
10336	115	0	0	0	0	115
10337	114	0	0	0	0	114
10338	0	0	0	118	0	118
10339	0	124	0	0	0	124
10340	0	123	0	0	0	123
10341	0	0	0	117	0	117
10342	119	0	0	0	0	119
10343	115	0	0	0	0	115
10344	0	0	120	0	0	120
10345	116	0	0	0	0	116
10346	0	124	0	0	0	124
10347	110	1	0	0	0	111
10348	0	115	0	0	0	115
10349	0	111	0	0	0	111
10350	0	0	0	105	0	105
10351	106	0	0	0	0	106
10352	108	0	0	0	0	108
10353	0	0	116	0	0	116
10354	0	0	0	110	0	110
10355	103	0	0	0	0	103
10356	0	0	0	103	0	103
10357	107	0	0	0	0	107
10358	100	0	0	0	0	100
10359	1	0	107	0	0	108
10360	0	0	0	104	0	104
10361	0	0	0	98	0	98
10362	0	0	0	100	0	100
10363	0	0	103	0	0	103
10364	0	0	0	90	0	90
10365	0	0	0	93	0	93
10366	0	100	0	0	0	100
10367	0	0	96	0	0	96
10368	0	103	0	0	0	103
10369	101	0	0	0	0	101
10370	0	1	0	77	0	78
10371	0	0	0	98	0	98
10372	0	92	0	0	0	92
10373	90	0	0	0	0	90
10374	93	0	0	0	0	93
10375	0	101	0	0	0	101
10376	0	98	0	0	0	98
10377	93	0	0	0	0	93
10378	0	0	94	0	0	94
10379	0	0	98	0	0	98
10380	93	0	0	0	0	93
10381	0	97	0	0	0	97
10382	88	0	0	0	0	88
10383	0	0	93	0	0	93
10384	90	1	0	0	0	91
10385	0	91	0	0	0	91
10386	0	0	0	85	0	85
10387	0	2	0	74	0	76
10388	1	0	0	73	0	74
10389	0	0	0	78	0	78
10390	0	0	0	84	0	84
10391	0	84	0	0	0	84
10392	84	1	0	0	0	85
10393	0	0	88	0	0	88
10394	0	0	0	91	0	91
10395	0	0	90	0	0	90
10396	0	1	0	81	0	82
10397	0	0	0	86	0	86
10398	80	0	0	0	0	80
10399	0	0	89	0	0	89
10400	0	82	0	0	0	82
10401	0	0	0	85	0	85
10402	0	0	0	85	0	85
10403	0	0	94	0	0	94
10404	0	1	0	83	0	84
10405	0	0	0	87	0	87
10406	87	0	0	1	0	88
10407	0	90	0	0	0	90
10408	84	0	0	0	0	84
10409	74	0	0	0	0	74
10410	0	0	0	89	0	89
10411	0	0	88	0	0	88
10412	0	0	90	0	0	90
10413	0	0	0	84	0	84
10414	0	0	0	93	0	93
10415	0	90	0	0	0	90
10416	84	0	0	1	0	85
10417	0	84	0	0	0	84
10418	0	79	0	0	0	79
10419	88	0	1	0	0	89
10420	0	0	0	92	0	92
10421	0	92	0	0	0	92
10422	0	0	0	88	0	88
10423	0	0	88	0	0	88
10424	0	0	94	0	0	94
10425	0	0	0	96	0	96
10426	0	0	96	0	0	96
10427	0	0	0	91	0	91
10428	0	0	0	87	0	87
10429	0	0	0	96	0	96
10430	90	0	0	0	0	90
10431	0	100	0	0	0	100
10432	0	93	0	0	0	93
10433	95	0	0	0	0	95
10434	92	0	0	0	0	92
10435	0	0	0	93	0	93
10436	0	0	99	0	0	99
10437	0	0	0	92	0	92
10438	1	0	97	0	0	98
10439	0	100	0	2	0	102
10440	0	0	0	94	0	94
10441	90	0	0	0	0	90
10442	0	0	0	90	0	90
10443	0	0	99	0	0	99
10444	84	0	1	0	0	85
10445	0	0	82	0	0	82
10446	0	0	79	0	0	79
10447	0	80	0	0	0	80
10448	0	76	0	0	0	76
10449	0	79	0	0	0	79
10450	82	0	0	0	0	82
10451	76	0	1	0	0	77
10452	0	0	0	75	0	75
10453	0	0	0	78	0	78
10454	0	1	0	76	0	77
10455	0	79	0	0	0	79
10456	74	0	0	0	0	74
10457	0	85	0	0	0	85
10458	0	0	0	83	0	83
10459	74	0	0	0	0	74
10460	0	0	0	76	0	76
10461	0	0	0	73	0	73
10462	68	0	0	1	0	69
10463	75	0	1	0	0	76
10464	0	0	77	0	0	77
10465	0	0	80	0	0	80
10466	0	0	83	0	0	83
10467	0	4	0	62	0	66
10468	0	0	0	77	0	77
10469	0	74	0	0	0	74
10470	76	0	1	0	0	77
10471	0	1	0	71	0	72
10472	1	0	0	81	0	82
10473	0	79	0	0	0	79
10474	0	82	0	1	0	83
10475	0	0	0	79	0	79
10476	1	0	0	69	0	70
10477	72	0	0	1	0	73
10478	74	0	0	0	0	74
10479	0	0	0	81	0	81
10480	0	0	76	0	0	76
10481	0	0	76	0	0	76
10482	0	0	0	69	0	69
10483	0	0	0	68	0	68
10484	0	66	0	0	0	66
10485	66	0	1	0	0	67
10486	0	0	0	68	0	68
10487	0	0	73	0	0	73
10488	0	0	1	68	0	69
10489	0	0	63	0	0	63
10490	0	0	64	0	0	64
10491	0	0	0	61	0	61
10492	61	0	0	0	0	61
10493	1	0	67	0	0	68
10494	1	0	0	58	0	59
10495	0	0	63	0	0	63
10496	0	0	0	60	0	60
10497	0	0	0	60	0	60
10498	1	0	59	0	0	60
10499	0	0	63	0	0	63
10500	0	0	0	61	0	61
10501	0	0	0	59	0	59
10502	0	0	0	54	0	54
10503	0	0	0	58	0	58
10504	53	0	1	0	0	54
10505	56	0	0	0	0	56
10506	0	63	0	0	0	63
10507	62	0	0	0	0	62
10508	0	0	0	60	0	60
10509	60	0	0	0	0	60
10510	0	1	74	0	0	75
10511	72	0	0	0	0	72
10512	0	0	0	66	0	66
10513	0	0	0	71	0	71
10514	68	0	0	0	0	68
10515	0	0	0	75	0	75
10516	0	0	77	0	0	77
10517	69	0	1	0	0	70
10518	0	76	0	0	0	76
10519	0	0	0	72	0	72
10520	0	0	72	0	0	72
10521	0	0	1	70	0	71
10522	0	0	75	0	0	75
10523	1	0	0	71	0	72
10524	0	74	0	0	0	74
10525	0	0	0	72	0	72
10526	0	74	0	0	0	74
10527	0	0	0	71	0	71
10528	0	0	0	66	0	66
10529	0	1	0	69	0	70
10530	1	2	0	66	0	69
10531	0	0	0	72	0	72
10532	0	0	73	0	0	73
10533	0	0	0	71	0	71
10534	0	0	0	74	0	74
10535	74	0	0	0	0	74
10536	0	82	0	0	0	82
10537	77	0	0	0	0	77
10538	0	0	0	77	0	77
10539	0	0	77	0	0	77
10540	0	80	0	0	0	80
10541	79	0	0	0	0	79
10542	0	83	0	1	0	84
10543	0	80	0	0	0	80
10544	85	0	0	0	0	85
10545	0	0	0	81	0	81
10546	83	0	0	0	0	83
10547	0	1	0	86	0	87
10548	0	0	86	0	0	86
10549	0	0	85	0	0	85
10550	90	0	0	0	0	90
10551	89	0	0	0	0	89
10552	0	0	0	80	0	80
10553	0	0	0	85	0	85
10554	87	0	0	0	0	87
10555	0	91	0	0	0	91
10556	0	83	0	0	0	83
10557	87	0	0	1	0	88
10558	85	0	0	0	0	85
10559	0	84	0	0	0	84
10560	0	0	0	79	0	79
10561	0	0	86	0	0	86
10562	0	0	85	0	0	85
10563	86	0	1	0	0	87
10564	0	0	91	0	0	91
10565	0	1	0	84	0	85
10566	1	0	0	84	0	85
10567	1	83	0	0	0	84
10568	86	0	0	0	0	86
10569	0	0	0	89	0	89
10570	0	0	90	0	0	90
10571	0	96	0	0	0	96
10572	0	0	0	90	0	90
10573	0	0	96	0	0	96
10574	0	0	91	0	0	91
10575	0	91	0	0	0	91
10576	94	0	0	0	0	94
10577	0	98	0	0	0	98
10578	92	0	0	0	0	92
10579	0	0	102	0	0	102
10580	104	0	0	0	0	104
10581	0	102	0	7	0	109
10582	0	0	0	104	0	104
10583	0	1	0	98	0	99
10584	99	0	0	0	0	99
10585	0	0	103	0	0	103
10586	99	1	0	0	0	100
10587	96	0	0	0	0	96
10588	0	0	99	0	0	99
10589	0	0	96	0	0	96
10590	0	0	0	94	0	94
10591	98	0	1	0	0	99
10592	91	0	0	0	0	91
10593	0	101	0	0	0	101
10594	0	1	0	97	0	98
10595	0	0	0	91	0	91
10596	0	0	0	98	0	98
10597	0	0	0	102	0	102
10598	92	0	0	0	0	92
10599	0	1	0	90	0	91
10600	0	0	100	0	0	100
10601	0	0	100	0	0	100
10602	95	0	0	0	0	95
10603	0	100	0	0	0	100
10604	0	94	0	0	0	94
10605	0	0	0	82	0	82
10606	0	0	0	89	0	89
10607	0	1	0	87	0	88
10608	0	0	0	93	0	93
10609	0	0	96	0	0	96
10610	0	0	0	89	0	89
10611	0	0	0	90	0	90
10612	0	0	90	0	0	90
10613	90	0	0	0	0	90
10614	0	91	0	0	0	91
10615	89	0	0	0	0	89
10616	0	0	87	0	0	87
10617	0	0	90	0	0	90
10618	0	91	0	0	0	91
10619	95	0	0	0	0	95
10620	89	0	0	0	0	89
10621	90	0	0	0	0	90
10622	0	97	0	0	0	97
10623	95	0	1	0	0	96
10624	0	0	94	0	0	94
10625	0	96	0	0	0	96
10626	91	0	2	0	0	93
10627	0	97	0	0	0	97
10628	87	0	1	0	0	88
10629	93	0	0	0	0	93
10630	0	0	97	0	0	97
10631	0	100	0	0	0	100
10632	92	0	0	0	0	92
10633	0	0	101	0	0	101
10634	2	110	0	0	0	112
10635	0	0	1	109	0	110
10636	2	0	107	0	0	109
10637	0	0	113	0	0	113
10638	0	0	0	116	0	116
10639	121	0	0	0	0	121
10640	0	122	0	1	0	123
10641	0	0	114	0	0	114
10642	0	0	121	0	0	121
10643	118	0	0	0	0	118
10644	0	120	0	4	0	124
10645	121	0	0	0	0	121
10646	0	127	0	0	0	127
10647	121	0	0	0	0	121
10648	119	0	2	0	0	121
10649	0	133	0	0	0	133
10650	1	0	0	131	0	132
10651	127	0	0	1	0	128
10652	0	0	0	123	0	123
10653	0	0	0	131	0	131
10654	135	0	0	0	0	135
10655	0	140	0	0	0	140
10656	136	0	0	0	0	136
10657	0	0	138	0	0	138
10658	1	0	0	131	0	132
10659	0	0	0	117	0	117
10660	133	0	0	0	0	133
10661	119	0	1	0	0	120
10662	0	0	0	129	0	129
10663	0	0	135	0	0	135
10664	0	1	0	126	0	127
10665	0	0	0	123	0	123
10666	0	0	0	124	0	124
10667	0	0	0	134	0	134
10668	133	0	0	0	0	133
10669	0	0	140	0	0	140
10670	0	135	0	0	0	135
10671	0	0	0	130	0	130
10672	1	0	0	132	0	133
10673	0	0	134	0	0	134
10674	0	0	139	0	0	139
10675	0	1	0	132	0	133
10676	0	1	0	139	0	140
10677	0	0	140	0	0	140
10678	0	0	0	137	0	137
10679	137	0	0	0	0	137
10680	0	133	0	0	0	133
10681	0	0	133	0	0	133
10682	0	138	0	0	0	138
10683	0	1	0	126	0	127
10684	1	0	137	0	0	138
10685	0	139	0	0	0	139
10686	0	0	0	128	0	128
10687	0	0	139	0	0	139
10688	0	0	0	133	0	133
10689	0	1	0	126	0	127
10690	136	0	2	0	0	138
10691	3	0	0	129	0	132
10692	137	0	0	0	0	137
10693	132	0	0	0	0	132
10694	124	0	0	0	0	124
10695	0	0	0	133	0	133
10696	0	0	115	0	0	115
10697	0	0	125	0	0	125
10698	119	0	0	0	0	119
10699	1	0	121	0	0	122
10700	119	0	0	0	0	119
10701	0	120	0	0	0	120
10702	115	0	0	0	0	115
10703	0	0	116	0	0	116
10704	0	0	115	0	0	115
10705	2	0	0	114	0	116
10706	0	0	110	0	0	110
10707	0	0	116	0	0	116
10708	1	0	0	104	0	105
10709	0	0	0	108	0	108
10710	0	1	0	111	0	112
10711	0	112	0	0	0	112
10712	0	0	0	108	0	108
10713	0	111	0	0	0	111
10714	108	0	0	0	0	108
10715	109	0	0	0	0	109
10716	0	0	0	112	0	112
10717	0	106	0	0	0	106
10718	0	0	108	0	0	108
10719	110	0	0	0	0	110
10720	0	3	0	99	0	102
10721	0	0	0	91	0	91
10722	0	0	0	103	0	103
10723	103	0	0	0	0	103
10724	0	103	0	2	0	105
10725	0	99	0	0	0	99
10726	100	0	0	0	0	100
10727	0	101	0	0	0	101
10728	99	0	0	0	0	99
10729	98	0	1	0	0	99
10730	0	88	0	0	0	88
10731	0	1	0	84	0	85
10732	0	79	0	0	0	79
10733	0	3	0	77	0	80
10734	0	0	0	82	0	82
10735	82	0	0	0	0	82
10736	71	0	3	0	0	74
10737	0	0	0	78	0	78
10738	0	0	84	0	0	84
10739	79	0	0	0	0	79
10740	0	77	0	0	0	77
10741	0	1	0	73	0	74
10742	0	0	0	61	0	61
10743	0	0	0	72	0	72
10744	67	0	0	0	0	67
10745	73	0	0	0	0	73
10746	0	71	0	0	0	71
10747	0	74	0	0	0	74
10748	0	0	0	65	0	65
10749	0	0	0	70	0	70
10750	1	0	71	0	0	72
10751	0	1	0	73	0	74
10752	0	0	71	0	0	71
10753	0	0	74	0	0	74
10754	0	74	0	0	0	74
10755	0	0	0	72	0	72
10756	71	0	0	0	0	71
10757	0	0	0	72	0	72
10758	0	0	72	0	0	72
10759	69	0	0	0	0	69
10760	67	0	1	0	0	68
10761	0	0	77	0	0	77
10762	0	1	0	73	0	74
10763	71	0	0	0	0	71
10764	0	72	0	0	0	72
10765	73	0	0	0	0	73
10766	72	0	0	0	0	72
10767	0	0	0	73	0	73
10768	0	0	0	71	0	71
10769	66	0	1	0	0	67
10770	0	0	0	69	0	69
10771	0	0	67	0	0	67
10772	61	0	0	0	0	61
10773	61	0	1	0	0	62
10774	0	69	0	0	0	69
10775	0	65	0	0	0	65
10776	0	0	0	67	0	67
10777	0	66	0	0	0	66
10778	0	0	0	64	0	64
10779	63	1	0	0	0	64
10780	60	0	0	0	0	60
10781	0	66	0	0	0	66
10782	60	0	0	0	0	60
10783	0	55	0	5	0	60
10784	41	0	0	0	0	41
10785	44	0	0	0	0	44
10786	0	0	47	0	0	47
10787	45	0	0	0	0	45
10788	0	42	0	0	0	42
10789	0	32	0	0	0	32
10790	31	0	1	0	0	32
10791	0	1	0	29	0	30
10792	0	0	32	0	0	32
10793	0	0	0	33	0	33
10794	0	0	0	30	0	30
10795	0	0	33	0	0	33
10796	30	0	0	0	0	30
10797	0	32	0	0	0	32
10798	32	0	0	0	0	32
10799	0	0	0	26	0	26
10800	26	0	0	0	0	26
10801	0	27	0	0	0	27
10802	0	0	0	24	0	24
10803	24	0	0	0	0	24
10804	0	0	25	0	0	25
10805	0	0	26	0	0	26
10806	24	0	0	0	0	24
10807	0	28	0	0	0	28
10808	0	24	0	0	0	24
10809	0	1	0	22	0	23
10810	0	25	0	0	0	25
10811	0	1	0	22	0	23
10812	0	0	0	22	0	22
10813	0	0	0	23	0	23
10814	0	22	0	0	0	22
10815	0	0	0	24	0	24
10816	0	0	23	0	0	23
10817	0	24	0	0	0	24
10818	0	0	0	25	0	25
10819	0	27	0	0	0	27
10820	28	0	1	0	0	29
10821	25	0	1	0	0	26
10822	25	0	0	0	0	25
10823	0	31	0	0	0	31
10824	0	0	0	31	0	31
10825	0	0	30	0	0	30
10826	0	0	30	0	0	30
10827	29	0	0	0	0	29
10828	25	0	0	0	0	25
10829	0	1	0	28	0	29
10830	0	0	0	33	0	33
10831	0	0	25	0	0	25
10832	0	32	0	0	0	32
10833	0	31	0	0	0	31
10834	0	0	30	0	0	30
10835	0	0	0	32	0	32
10836	0	0	0	28	0	28
10837	0	0	0	35	0	35
10838	0	0	0	35	0	35
10839	39	0	0	0	0	39
10840	0	0	41	0	0	41
10841	37	0	0	0	0	37
10842	0	0	0	35	0	35
10843	37	0	0	0	0	37
10844	0	0	0	41	0	41
10845	0	3	39	0	0	42
10846	0	0	0	39	0	39
10847	0	0	38	0	0	38
10848	0	1	0	39	0	40
10849	0	0	41	0	0	41
10850	0	43	0	0	0	43
10851	0	0	0	39	0	39
10852	0	0	0	40	0	40
10853	0	38	0	0	0	38
10854	40	0	0	0	0	40
10855	0	0	0	37	0	37
10856	0	0	0	40	0	40
10857	33	0	0	0	0	33
10858	38	0	0	0	0	38
10859	40	0	0	0	0	40
10860	41	0	0	0	0	41
10861	0	0	44	0	0	44
10862	40	0	1	0	0	41
10863	40	0	0	0	0	40
10864	0	0	0	42	0	42
10865	0	0	0	46	0	46
10866	45	0	0	0	0	45
10867	0	49	0	0	0	49
10868	0	0	0	48	0	48
10869	0	0	46	0	0	46
10870	0	46	0	0	0	46
10871	43	0	0	0	0	43
10872	44	0	1	0	0	45
10873	38	0	2	0	0	40
10874	38	0	0	0	0	38
10875	0	0	0	47	0	47
10876	0	0	44	0	0	44
10877	0	0	49	0	0	49
10878	0	0	0	49	0	49
10879	53	0	0	0	0	53
10880	0	0	0	48	0	48
10881	0	0	55	0	0	55
10882	50	0	0	0	0	50
10883	47	0	1	0	0	48
10884	0	0	0	54	0	54
10885	0	0	53	0	0	53
10886	0	0	56	0	0	56
10887	51	0	0	0	0	51
10888	0	60	0	0	0	60
10889	0	0	63	0	0	63
10890	0	0	0	64	0	64
10891	64	0	1	0	0	65
10892	0	69	0	0	0	69
10893	0	65	0	0	0	65
10894	74	0	0	0	0	74
10895	0	0	1	62	0	63
10896	67	0	0	0	0	67
10897	0	0	0	70	0	70
10898	1	1	0	77	0	79
10899	0	0	78	0	0	78
10900	1	0	73	0	0	74
10901	0	0	73	0	0	73
10902	0	0	0	70	0	70
10903	73	0	0	0	0	73
10904	0	0	73	0	0	73
10905	0	0	0	69	0	69
10906	0	0	72	0	0	72
10907	0	73	0	1	0	74
10908	0	0	0	70	0	70
10909	0	0	0	66	0	66
10910	0	0	0	72	0	72
10911	76	0	0	0	0	76
10912	0	0	0	66	0	66
10913	0	1	0	71	0	72
10914	66	0	0	0	0	66
10915	0	0	71	0	0	71
10916	67	0	1	0	0	68
10917	64	0	1	0	0	65
10918	0	0	66	0	0	66
10919	68	0	0	0	0	68
10920	0	0	0	68	0	68
10921	0	0	70	0	0	70
10922	70	0	0	0	0	70
10923	71	0	0	0	0	71
10924	0	0	0	67	0	67
10925	0	1	0	71	0	72
10926	0	1	0	73	0	74
10927	68	0	0	0	0	68
10928	0	72	0	0	0	72
10929	71	0	0	0	0	71
10930	0	74	0	0	0	74
10931	0	65	0	0	0	65
10932	0	0	0	60	0	60
10933	0	0	0	61	0	61
10934	0	0	0	63	0	63
10935	0	0	0	66	0	66
10936	0	0	70	0	0	70
10937	67	0	0	0	0	67
10938	0	0	0	66	0	66
10939	0	0	75	0	0	75
10940	1	0	0	71	0	72
10941	1	0	0	76	0	77
10942	0	0	82	0	0	82
10943	0	0	0	75	0	75
10944	0	0	0	76	0	76
10945	80	0	1	0	0	81
10946	0	0	80	0	0	80
10947	78	0	0	0	0	78
10948	0	83	0	0	0	83
10949	80	0	0	0	0	80
10950	74	0	1	1	0	76
10951	0	0	0	84	0	84
10952	0	0	77	0	0	77
10953	0	88	0	0	0	88
10954	0	0	0	84	0	84
10955	0	85	0	1	0	86
10956	78	0	1	0	0	79
10957	0	0	82	0	0	82
10958	0	0	84	0	0	84
10959	0	1	0	80	0	81
10960	0	0	84	0	0	84
10961	0	0	0	75	0	75
10962	0	0	0	81	0	81
10963	78	0	0	0	0	78
10964	0	79	0	0	0	79
10965	0	1	0	76	0	77
10966	0	0	0	71	0	71
10967	0	0	0	83	0	83
10968	0	73	0	0	0	73
10969	0	80	0	0	0	80
10970	82	0	0	0	0	82
10971	77	0	0	0	0	77
10972	78	0	0	0	0	78
10973	0	0	83	0	0	83
10974	0	0	0	80	0	80
10975	0	0	82	0	0	82
10976	0	78	0	0	0	78
10977	72	0	7	0	0	79
10978	0	0	82	0	0	82
10979	0	0	0	80	0	80
10980	0	0	78	0	0	78
10981	79	0	0	0	0	79
10982	75	0	0	0	0	75
10983	71	0	0	0	0	71
10984	78	0	1	0	0	79
10985	0	0	81	0	0	81
10986	82	0	0	0	0	82
10987	74	0	0	0	0	74
10988	0	78	0	0	0	78
10989	80	0	0	0	0	80
10990	71	0	0	0	0	71
10991	0	1	0	80	0	81
10992	0	84	0	0	0	84
10993	79	0	0	0	0	79
10994	79	0	0	0	0	79
10995	0	0	84	0	0	84
10996	1	0	86	0	0	87
10997	0	0	91	0	0	91
10998	0	0	0	89	0	89
10999	92	0	0	0	0	92
11000	0	97	0	0	0	97
11001	89	0	0	0	0	89
11002	0	96	0	0	0	96
11003	91	0	0	0	0	91
11004	0	97	0	0	0	97
11005	0	88	0	0	0	88
11006	91	0	0	0	0	91
11007	0	94	0	0	0	94
11008	0	0	0	92	0	92
11009	0	0	93	0	0	93
11010	1	0	92	0	0	93
11011	0	0	0	85	0	85
11012	0	0	0	83	0	83
11013	0	0	90	0	0	90
11014	0	1	0	83	0	84
11015	0	0	0	88	0	88
11016	87	0	0	0	0	87
11017	0	90	0	0	0	90
11018	0	0	0	85	0	85
11019	0	89	0	0	0	89
11020	88	0	2	0	0	90
11021	0	92	0	0	0	92
11022	85	0	0	0	0	85
11023	82	0	0	0	0	82
11024	0	1	0	86	0	87
11025	1	0	0	86	0	87
11026	0	0	0	90	0	90
11027	0	0	0	94	0	94
11028	0	0	87	0	0	87
11029	89	0	2	0	0	91
11030	0	90	0	0	0	90
11031	0	0	0	78	0	78
11032	0	1	0	80	0	81
11033	0	73	0	0	0	73
11034	81	0	1	0	0	82
11035	0	85	0	0	0	85
11036	0	0	0	76	0	76
11037	3	0	0	71	0	74
11038	0	0	0	72	0	72
11039	0	0	0	80	0	80
11040	73	0	0	0	0	73
11041	0	0	80	0	0	80
11042	0	0	0	74	0	74
11043	0	0	0	66	0	66
11044	0	0	0	64	0	64
11045	0	1	0	69	0	70
11046	63	0	0	1	0	64
11047	0	0	68	0	0	68
11048	0	0	0	72	0	72
11049	0	70	0	1	0	71
11050	0	70	0	0	0	70
11051	69	1	0	0	0	70
11052	0	0	71	0	0	71
11053	72	0	1	0	0	73
11054	0	0	71	0	0	71
11055	0	0	0	69	0	69
11056	72	0	0	0	0	72
11057	0	75	0	0	0	75
11058	0	0	0	71	0	71
11059	0	76	0	0	0	76
11060	76	0	0	0	0	76
11061	66	0	0	0	0	66
11062	0	0	0	78	0	78
11063	0	0	79	0	0	79
11064	0	0	80	0	0	80
11065	0	0	0	77	0	77
11066	0	78	0	0	0	78
11067	0	1	0	73	0	74
11068	0	0	0	69	0	69
11069	0	0	0	77	0	77
11070	1	0	79	0	0	80
11071	0	0	0	69	0	69
11072	0	0	0	71	0	71
11073	0	75	0	0	0	75
11074	0	0	0	57	0	57
11075	0	0	0	67	0	67
11076	0	0	0	68	0	68
11077	0	0	0	72	0	72
11078	0	0	0	70	0	70
11079	0	0	0	71	0	71
11080	0	0	0	69	0	69
11081	0	0	0	78	0	78
11082	0	0	76	0	0	76
11083	0	0	0	75	0	75
11084	76	0	1	0	0	77
11085	0	0	0	78	0	78
11086	0	0	77	0	0	77
11087	79	0	0	0	0	79
11088	76	0	0	0	0	76
11089	75	0	0	0	0	75
11090	67	0	0	0	0	67
11091	0	0	0	75	0	75
11092	0	0	74	0	0	74
11093	0	73	0	0	0	73
11094	0	76	0	1	0	77
11095	0	0	0	75	0	75
11096	0	0	0	67	0	67
11097	0	0	0	76	0	76
11098	0	2	0	66	0	68
11099	0	0	0	75	0	75
11100	73	0	0	1	0	74
11101	0	76	0	2	0	78
11102	0	82	0	0	0	82
11103	0	0	0	81	0	81
11104	0	0	0	73	0	73
11105	0	1	0	74	0	75
11106	0	0	0	81	0	81
11107	0	0	81	0	0	81
11108	0	83	0	0	0	83
11109	0	0	0	82	0	82
11110	78	0	0	0	0	78
11111	0	0	0	85	0	85
11112	0	0	93	0	0	93
11113	0	0	85	0	0	85
11114	2	0	89	0	0	91
11115	0	0	0	87	0	87
11116	90	0	0	0	0	90
11117	0	0	0	85	0	85
11118	0	0	0	89	0	89
11119	93	0	1	0	0	94
11120	0	0	0	93	0	93
11121	0	1	0	94	0	95
11122	0	0	97	0	0	97
11123	0	101	0	0	0	101
11124	0	0	0	95	0	95
11125	99	0	0	0	0	99
11126	0	2	0	95	0	97
11127	0	0	98	0	0	98
11128	0	1	0	102	0	103
11129	0	103	0	0	0	103
11130	0	1	0	101	0	102
11131	0	0	106	0	0	106
11132	0	104	1	0	0	105
11133	0	0	0	104	0	104
11134	0	1	0	94	0	95
11135	0	1	0	98	0	99
11136	0	0	0	103	0	103
11137	0	0	101	0	0	101
11138	0	103	0	0	0	103
11139	95	0	0	2	0	97
11140	101	0	0	0	0	101
11141	0	0	0	102	0	102
11142	0	0	100	0	0	100
11143	102	0	0	0	0	102
11144	0	1	0	104	0	105
11145	0	0	103	0	0	103
11146	0	0	0	94	0	94
11147	0	0	0	94	0	94
11148	0	1	0	101	0	102
11149	0	0	104	0	0	104
11150	0	0	0	100	0	100
11151	0	102	0	0	0	102
11152	97	0	1	1	0	99
11153	92	0	0	0	0	92
11154	108	0	0	0	0	108
11155	0	111	0	0	0	111
11156	107	0	0	0	0	107
11157	0	0	0	102	0	102
11158	97	0	0	0	0	97
11159	104	0	1	2	0	107
11160	0	1	108	0	0	109
11161	0	113	0	0	0	113
11162	110	0	0	0	0	110
11163	1	0	0	109	0	110
11164	3	0	107	0	0	110
11165	0	110	0	0	0	110
11166	107	0	0	0	0	107
11167	0	0	0	105	0	105
11168	1	0	0	105	0	106
11169	0	0	0	122	0	122
11170	7	115	0	0	0	122
11171	0	0	0	134	0	134
11172	0	132	0	0	0	132
11173	0	1	0	136	0	137
11174	0	0	141	0	0	141
11175	0	1	0	120	0	121
11176	0	0	0	121	0	121
11177	1	0	0	138	0	139
11178	0	0	140	0	0	140
11179	0	0	0	128	0	128
11180	0	0	0	119	0	119
11181	0	1	0	117	0	118
11182	0	0	0	132	0	132
11183	0	0	0	137	0	137
11184	0	0	139	0	0	139
11185	0	1	0	131	0	132
11186	0	1	0	138	0	139
11187	134	0	1	0	0	135
11188	0	142	0	0	0	142
11189	0	139	0	0	0	139
11190	2	0	0	138	0	140
11191	0	0	0	152	0	152
11192	2	160	0	0	0	162
11193	0	0	0	165	0	165
11194	0	175	0	0	0	175
11195	0	0	0	166	0	166
11196	0	2	0	177	0	179
11197	0	0	165	0	0	165
11198	0	181	0	1	0	182
11199	0	174	0	0	0	174
11200	186	0	2	0	0	188
11201	0	194	0	0	0	194
11202	0	0	0	193	0	193
11203	0	0	193	0	0	193
11204	0	0	0	178	0	178
11205	189	0	0	0	0	189
11206	0	0	201	0	0	201
11207	0	199	0	0	0	199
11208	0	2	0	189	0	191
11209	0	0	0	192	0	192
11210	200	1	0	0	0	201
11211	0	0	0	204	0	204
11212	0	1	0	204	0	205
11213	0	2	0	219	0	221
11214	0	2	0	198	0	200
11215	205	0	0	1	0	206
11216	216	0	0	0	0	216
11217	0	0	0	237	0	237
11218	222	0	4	0	0	226
11219	0	0	0	245	0	245
11220	0	0	255	0	0	255
11221	0	2	335	0	0	337
11222	0	0	0	319	0	319
11223	0	392	0	0	0	392
11224	0	1	0	391	0	392
11225	393	0	1	0	0	394
11226	1	0	1	391	0	393
11227	389	0	7	0	0	396
11228	0	0	0	422	0	422
11229	2	0	370	0	0	372
11230	0	409	0	0	0	409
11231	0	407	0	0	0	407
11232	0	0	0	394	0	394
11233	0	0	403	0	0	403
11234	0	423	0	0	0	423
11235	0	2	0	423	0	425
11236	432	0	1	0	0	433
11237	0	0	445	0	0	445
11238	0	3	0	420	0	423
11239	0	0	1	420	0	421
11240	0	0	413	0	0	413
11241	0	0	402	0	0	402
11242	0	0	426	0	0	426
11243	0	1	0	415	0	416
11244	0	4	424	0	0	428
11245	418	0	1	0	0	419
11246	0	2	0	418	0	420
11247	1	0	429	0	0	430
11248	0	422	1	0	0	423
11249	0	0	439	0	0	439
11250	1	2	0	462	0	465
11251	480	0	0	0	0	480
11252	0	1	0	449	0	450
11253	0	2	0	473	0	475
11254	464	0	1	0	0	465
11255	0	3	0	479	0	482
11256	1	0	488	0	0	489
11257	473	0	2	0	0	475
11258	0	486	0	0	0	486
11259	473	0	3	0	0	476
11260	0	0	0	472	0	472
11261	0	0	480	0	0	480
11262	0	1	505	0	0	506
11263	0	3	0	454	0	457
11264	0	1	0	483	0	484
11265	1	0	505	0	0	506
11266	1	0	494	0	0	495
11267	509	0	1	0	0	510
11268	0	2	0	481	0	483
11269	502	0	1	1	0	504
11270	0	2	0	494	0	496
11271	0	0	500	0	0	500
11272	0	0	521	0	0	521
11273	0	1	0	501	0	502
11274	2	4	0	486	0	492
11275	0	0	515	0	0	515
11276	530	0	1	1	0	532
11277	0	1	0	519	0	520
11278	531	0	2	1	0	534
11279	0	557	0	0	0	557
11280	0	2	0	544	0	546
11281	524	1	0	0	0	525
11282	0	1	534	0	0	535
11283	0	0	0	492	0	492
11284	1	4	0	480	0	485
11285	0	1	0	493	0	494
11286	3	0	515	0	0	518
11287	0	0	0	496	0	496
11288	0	511	0	1	0	512
11289	0	3	3	490	0	496
11290	3	0	502	0	0	505
11291	1	0	512	0	0	513
11292	0	5	0	481	0	486
11293	0	1	0	464	0	465
11294	0	0	0	482	0	482
11295	0	0	0	490	0	490
11296	445	0	1	0	0	446
11297	481	0	0	2	0	483
11298	1	0	519	0	0	520
11299	0	511	0	11	0	522
11300	2	2	0	495	0	499
11301	509	0	0	1	0	510
11302	449	0	4	0	0	453
11303	453	0	2	1	0	456
11304	470	0	4	0	0	474
11305	0	0	499	0	0	499
11306	505	0	0	1	0	506
11307	0	510	0	0	0	510
11308	0	1	0	476	0	477
11309	0	0	524	0	0	524
11310	0	1	0	509	0	510
11311	0	0	543	0	0	543
11312	0	3	1	510	0	514
11313	2	1	0	493	0	496
11314	565	0	4	3	0	572
11315	0	6	1	570	0	577
11316	1	0	617	0	0	618
11317	9	2	0	589	0	600
11318	578	0	5	0	0	583
11319	1	6	0	603	0	610
11320	0	0	612	0	0	612
11321	0	621	0	3	0	624
11322	600	0	8	0	0	608
11323	1	4	0	596	0	601
11324	0	609	0	0	0	609
11325	586	1	6	0	0	593
11326	3	0	672	0	0	675
11327	0	689	0	4	0	693
11328	2	1	0	713	0	716
11329	2	0	759	0	0	761
11330	2	1	0	744	0	747
11331	767	0	0	0	0	767
11332	0	0	802	0	0	802
11333	2	0	0	773	0	775
11334	1	0	805	0	0	806
11335	0	5	0	780	0	785
11336	0	5	0	796	0	801
11337	807	0	1	3	0	811
11338	0	830	0	0	0	830
11339	3	2	0	836	0	841
11340	821	0	2	0	0	823
11341	805	0	9	0	0	814
11342	0	0	0	868	0	868
11343	0	872	0	0	0	872
11344	0	897	0	0	0	897
11345	0	1	0	875	0	876
11346	2	2	0	839	0	843
11347	871	0	0	0	0	871
11348	3	1	2	906	0	912
11349	2	0	919	0	0	921
11350	892	0	3	0	0	895
11351	0	930	0	4	0	934
11352	909	0	2	0	0	911
11353	2	0	939	0	0	941
11354	0	954	0	0	0	954
11355	923	0	0	1	0	924
11356	902	0	0	0	0	902
11357	0	1	928	0	0	929
11358	957	0	1	0	0	958
11359	903	0	2	0	0	905
11360	0	964	0	0	0	964
11361	2	0	0	918	0	920
11362	0	0	997	0	0	997
11363	2	9	1	962	0	974
11364	0	0	1012	0	0	1012
11365	1	0	1	964	0	966
11366	993	0	0	0	0	993
11367	0	1	0	979	0	980
11368	0	0	991	0	0	991
11369	979	1	4	0	0	984
11370	2	5	0	969	0	976
11371	2	0	932	0	0	934
11372	922	0	0	2	0	924
11373	1	0	1	927	0	929
11374	0	0	898	0	0	898
11375	0	0	944	0	0	944
11376	0	1	0	934	0	935
11377	2	0	956	0	0	958
11378	0	950	3	0	0	953
11379	1	0	0	941	0	942
11380	956	0	1	0	0	957
11381	0	0	941	1	0	942
11382	0	0	936	0	0	936
11383	898	0	0	1	0	899
11384	0	0	922	0	0	922
11385	841	0	4	0	0	845
11386	1	0	865	0	0	866
11387	2	4	0	842	0	848
11388	2	0	864	0	0	866
11389	0	5	1	859	0	865
11390	0	0	816	0	0	816
11391	0	0	858	0	0	858
11392	851	0	0	0	0	851
11393	0	876	0	1	0	877
11394	855	0	1	1	0	857
11395	0	861	0	0	0	861
11396	0	2	0	828	0	830
11397	1	0	0	813	0	814
11398	808	0	1	0	0	809
11399	3	3	0	820	0	826
11400	3	0	821	0	0	824
11401	803	0	1	1	0	805
11402	747	0	0	0	0	747
11403	0	6	0	807	0	813
11404	1	0	762	0	0	763
11405	0	2	0	734	0	736
11406	0	727	0	1	0	728
11407	0	3	0	712	0	715
11408	0	3	0	714	0	717
11409	3	0	730	0	0	733
11410	739	0	1	0	0	740
11411	0	742	0	1	0	743
11412	728	1	3	0	0	732
11413	0	730	0	0	0	730
11414	0	1	0	695	0	696
11415	2	677	0	1	0	680
11416	2	0	694	0	0	696
11417	1	3	0	662	0	666
11418	0	3	0	650	0	653
11419	0	2	1	671	0	674
11420	672	0	0	0	0	672
11421	2	1	0	652	0	655
11422	643	0	0	0	0	643
11423	589	0	1	0	0	590
11424	571	0	3	0	0	574
11425	0	0	608	0	0	608
11426	0	2	0	535	0	537
11427	0	0	0	503	0	503
11428	0	3	0	528	0	531
11429	548	0	0	1	0	549
11430	0	5	0	479	0	484
11431	0	2	0	515	0	517
11432	494	0	4	0	0	498
11433	2	16	0	507	0	525
11434	1	0	478	0	0	479
11435	1	0	504	0	0	505
11436	0	1	0	432	0	433
11437	432	0	5	0	0	437
11438	409	0	1	0	0	410
11439	0	4	0	449	0	453
11440	1	0	460	0	0	461
11441	0	452	0	0	0	452
11442	2	2	0	416	0	420
11443	0	2	0	410	0	412
11444	1	2	0	425	0	428
11445	433	0	1	0	0	434
11446	1	0	447	0	0	448
11447	427	0	2	0	0	429
11448	0	2	0	433	0	435
11449	0	407	1	0	0	408
11450	386	0	1	0	0	387
11451	382	0	3	0	0	385
11452	0	0	414	0	0	414
11453	1	406	0	0	0	407
11454	1	401	0	2	0	404
11455	405	0	2	0	0	407
11456	0	5	0	368	0	373
11457	2	3	0	384	0	389
11458	0	3	0	397	0	400
11459	0	401	0	1	0	402
11460	0	375	0	0	0	375
11461	387	1	1	1	0	390
11462	0	1	0	389	0	390
11463	0	0	406	0	0	406
11464	0	0	0	369	0	369
11465	5	0	362	0	0	367
11466	0	0	354	0	0	354
11467	0	0	361	0	0	361
11468	0	369	0	0	0	369
11469	0	1	1	358	0	360
11470	0	363	0	0	0	363
11471	0	2	0	346	0	348
11472	0	1	0	356	0	357
11473	359	0	1	0	0	360
11474	0	1	0	355	0	356
11475	328	1	0	16	0	345
11476	406	0	1	0	0	407
11477	0	2	0	462	0	464
11478	11	495	0	1	0	507
11479	0	2	2	460	0	464
11480	17	480	3	27	0	527
11481	8	3	0	502	0	513
11482	14	0	514	17	0	545
11483	15	3	2	487	0	507
11484	0	10	0	521	0	531
11485	504	13	1	6	0	524
11486	0	570	0	1	0	571
11487	1	5	0	527	0	533
11488	0	2	1	564	0	567
11489	0	524	18	0	0	542
11490	0	5	0	539	0	544
11491	471	0	2	1	0	474
11492	531	0	2	0	0	533
11493	0	584	0	0	0	584
11494	0	0	1	554	0	555
11495	541	0	0	0	0	541
11496	0	578	0	2	0	580
11497	2	2	0	531	0	535
11498	0	553	0	0	0	553
11499	503	0	0	2	0	505
11500	0	0	571	0	0	571
11501	2	0	577	0	0	579
11502	0	0	0	560	0	560
11503	2	0	592	0	0	594
11504	0	1	0	560	0	561
11505	572	0	2	1	0	575
11506	0	0	615	0	0	615
11507	1	0	0	571	0	572
11508	0	2	0	584	0	586
11509	564	0	0	1	0	565
11510	0	590	0	2	0	592
11511	537	0	6	0	0	543
11512	518	0	2	0	0	520
11513	1	565	3	0	0	569
11514	1	2	0	525	0	528
11515	0	0	553	0	0	553
11516	0	0	0	495	0	495
11517	0	538	0	0	0	538
11518	513	0	1	0	0	514
11519	2	1	0	483	0	486
11520	1	0	528	0	0	529
11521	1	0	0	448	0	449
11522	0	4	0	420	0	424
11523	0	1	0	455	0	456
11524	0	1	0	468	0	469
11525	1	1	0	493	0	495
11526	0	1	483	1	0	485
11527	1	0	473	0	0	474
11528	0	482	0	1	0	483
11529	0	449	0	1	0	450
11530	434	0	1	0	0	435
11531	5	0	451	0	0	456
11532	435	0	2	0	0	437
11533	0	0	457	0	0	457
11534	2	0	462	0	0	464
11535	1	3	0	418	0	422
11536	431	0	3	0	0	434
11537	0	2	0	392	0	394
11538	0	3	0	446	0	449
11539	1	0	475	0	0	476
11540	0	4	3	431	0	438
11541	0	4	0	404	0	408
11542	0	1	0	429	0	430
11543	0	4	0	442	0	446
11544	0	2	0	468	0	470
11545	446	1	0	2	0	449
11546	0	2	0	452	0	454
11547	0	0	481	0	0	481
11548	0	1	0	462	0	463
11549	0	0	492	0	0	492
11550	0	1	0	485	0	486
11551	1	1	521	0	0	523
11552	1	3	0	470	0	474
11553	1	1	0	494	0	496
11554	2	0	504	0	0	506
11555	505	0	0	2	0	507
11556	1	0	548	0	0	549
11557	0	1	0	533	0	534
11558	534	0	1	0	0	535
11559	0	2	0	501	0	503
11560	0	2	0	555	0	557
11561	0	3	502	0	0	505
11562	0	558	0	1	0	559
11563	0	549	0	0	0	549
11564	0	560	0	0	0	560
11565	0	4	0	544	0	548
11566	560	0	1	4	0	565
11567	0	4	0	528	0	532
11568	1	3	0	550	0	554
11569	0	5	0	587	0	592
11570	0	0	0	613	0	613
11571	0	643	0	0	0	643
11572	0	2	0	594	0	596
11573	0	8	1	611	0	620
11574	0	637	0	5	0	642
11575	628	0	1	0	0	629
11576	0	1	0	617	0	618
11577	556	0	2	2	0	560
11578	619	0	3	1	0	623
11579	0	706	0	0	0	706
11580	0	3	0	691	0	694
11581	5	0	728	0	0	733
11582	1	0	783	1	0	785
11583	0	1	0	771	0	772
11584	755	0	3	1	0	759
11585	779	0	6	0	0	785
11586	1	3	0	835	0	839
11587	828	0	4	1	0	833
11588	0	867	0	3	0	870
11589	832	0	9	0	0	841
11590	4	933	0	1	0	938
11591	1	7	0	827	0	835
11592	1	1	0	965	0	967
11593	0	977	0	0	0	977
11594	979	1	1	0	0	981
11595	1	1	1071	0	0	1073
11596	1	8	0	1015	0	1024
11597	2	1	1214	1	0	1218
11598	1	2	0	1141	0	1144
11599	1198	0	4	1	0	1203
11600	0	3	0	1185	0	1188
11601	1194	0	0	2	0	1196
11602	1142	0	9	1	0	1152
11603	3	5	0	1265	0	1273
11604	2	0	1240	0	0	1242
11605	0	1297	0	0	0	1297
11606	0	3	0	1242	0	1245
11607	1283	0	5	2	0	1290
11608	1	0	1350	0	0	1351
11609	0	6	0	1254	0	1260
11610	2	5	1	1202	0	1210
11611	1	5	0	1323	0	1329
11612	1338	0	6	0	0	1344
11613	0	5	0	1263	0	1268
11614	0	2	0	1384	0	1386
11615	0	1	1382	0	0	1383
11616	0	5	0	1291	0	1296
11617	0	3	0	1308	0	1311
11618	1	5	0	1439	0	1445
11619	0	1479	0	0	0	1479
11620	2	4	0	1398	0	1404
11621	0	3	0	1402	0	1405
11622	1394	0	4	2	0	1400
11623	0	0	1442	0	0	1442
11624	3	1	1436	0	0	1440
11625	0	1481	0	0	0	1481
11626	0	3	0	1438	0	1441
11627	1432	0	7	1	0	1440
11628	0	1	1	1338	0	1340
11629	0	7	0	1363	0	1370
11630	3	2	0	1423	0	1428
11631	0	5	0	1434	0	1439
11632	3	8	0	1455	0	1466
11633	4	0	1477	0	0	1481
11634	5	7	0	1426	0	1438
11635	1466	0	0	0	0	1466
11636	0	1499	0	1	0	1500
11637	6	10	0	1380	0	1396
11638	3	4	0	1444	0	1451
11639	0	0	1482	0	0	1482
11640	2	5	0	1396	0	1403
11641	0	4	0	1433	0	1437
11642	1474	0	3	0	0	1477
11643	0	1518	0	2	0	1520
11644	7	4	0	1504	0	1515
11645	0	5	0	1460	0	1465
11646	3	10	1	1567	0	1581
11647	4	1	1514	0	0	1519
11648	4	0	1537	0	0	1541
11649	0	1571	0	3	0	1574
11650	0	1567	0	1	0	1568
11651	0	3	1	1542	0	1546
11652	0	1746	1	0	0	1747
11653	0	17	2	1650	0	1669
11654	2	2	0	1651	0	1655
11655	1	13	1	1697	0	1712
11656	0	9	0	1810	0	1819
11657	2	0	1831	0	0	1833
11658	1	8	2	1729	0	1740
11659	3	19	0	1717	0	1739
11660	1	8	1	1814	0	1824
11661	1847	0	9	6	0	1862
11662	3	1960	0	0	0	1963
11663	2	7	0	1968	0	1977
11664	0	2014	0	2	0	2016
11665	1831	2	4	4	0	1841
11666	1966	4	7	4	0	1981
11667	0	2060	2	1	0	2063
11668	0	1891	0	1	0	1892
11669	1	1	1958	2	0	1962
11670	0	2121	0	1	0	2122
11671	0	3	0	2097	0	2100
11672	2296	0	6	9	0	2311
11673	0	2441	0	1	0	2442
11674	1	16	0	2308	0	2325
11675	0	6	0	2270	0	2276
11676	1	9	0	2406	0	2416
11677	2329	3	6	0	0	2338
11678	6	1	2424	0	0	2431
11679	2454	0	7	4	0	2465
11680	0	2570	0	8	0	2578
11681	3	8	1	2459	0	2471
11682	2	0	2561	1	0	2564
11683	2511	0	9	9	0	2529
11684	43	2729	0	1	0	2773
11685	3	8	0	2794	0	2805
11686	0	2887	0	2	0	2889
11687	3	2	0	2713	0	2718
11688	0	4	1	2809	0	2814
11689	6	6	2728	0	0	2740
11690	1	0	3057	0	0	3058
11691	0	11	0	3010	0	3021
11692	2	1	3182	0	0	3185
11693	0	10	1	2944	0	2955
11694	2	25	0	2941	0	2968
11695	2	4	0	3012	0	3018
11696	3097	0	5	1	0	3103
11697	2	5	0	3172	0	3179
11698	3	0	3222	0	0	3225
11699	3239	1	11	5	0	3256
11700	0	6	0	3006	0	3012
11701	0	9	0	3280	0	3289
11702	3272	0	2	1	0	3275
11703	0	3402	1	0	0	3403
11704	3	20	0	3168	0	3191
11705	2	9	0	3274	0	3285
11706	3204	0	6	7	0	3217
11707	0	2	3499	1	0	3502
11708	4	5	0	3300	0	3309
11709	4	17	0	3339	0	3360
11710	1	7	0	3480	0	3488
11711	0	3555	0	2	0	3557
11712	4	4	0	3596	0	3604
11713	3586	0	3	1	0	3590
11714	0	3685	0	0	0	3685
11715	3544	0	14	3	0	3561
11716	0	3679	0	1	0	3680
11717	3381	1	3	1	0	3386
11718	2	0	3548	2	0	3552
11719	0	0	3598	0	0	3598
11720	3599	1	5	2	0	3607
11721	1	0	3789	0	0	3790
11722	1	10	0	3481	0	3492
11723	6	5	2	3476	0	3489
11724	0	11	0	3565	0	3576
11725	3735	1	9	0	0	3745
11726	0	1	3721	0	0	3722
11727	3768	0	4	5	0	3777
11728	1	8	2	3542	0	3553
11729	3604	0	20	1	0	3625
11730	2	8	6	3491	0	3507
11731	3443	3	9	4	0	3459
11732	4	6	2	3594	0	3606
11733	10	1	3510	0	0	3521
11734	3513	0	18	5	0	3536
11735	3397	0	19	0	0	3416
11736	0	16	0	3339	0	3355
11737	4	18	0	3523	0	3545
11738	0	3483	0	4	0	3487
11739	3449	5	22	3	0	3479
11740	0	3576	0	8	0	3584
11741	3196	3	21	8	0	3228
11742	2	0	3448	0	0	3450
11743	1	0	3285	0	0	3286
11744	4	0	3467	0	0	3471
11745	3474	1	9	2	0	3486
11746	0	3478	0	1	0	3479
11747	0	6	0	3360	0	3366
11748	3394	0	5	2	0	3401
11749	0	3465	0	1	0	3466
11750	15	11	1	3348	0	3375
11751	0	3188	0	4	0	3192
11752	1	3052	1	3	0	3057
11753	0	3206	0	7	0	3213
11754	3230	3	16	3	0	3252
11755	4	3323	0	4	0	3331
11756	1	3121	0	3	0	3125
11757	0	3157	6	0	0	3163
11758	3043	0	17	7	0	3067
11759	3023	1	25	5	0	3054
11760	1	0	3278	0	0	3279
11761	3261	1	13	4	0	3279
11762	2966	0	25	7	0	2998
11763	3	7	1	3261	0	3272
11764	3129	4	14	2	0	3149
11765	3	2	3302	1	0	3308
11766	0	3252	0	2	0	3254
11767	3136	0	25	7	0	3168
11768	0	11	0	3084	0	3095
11769	2917	2	14	4	0	2937
11770	3	0	2973	0	0	2976
11771	2874	0	7	1	0	2882
11772	0	18	0	2877	0	2895
11773	1	0	2844	0	0	2845
11774	4	3014	0	2	0	3020
11775	0	3007	0	1	0	3008
11776	0	18	1	2878	0	2897
11777	7	16	0	2908	0	2931
11778	0	2987	0	0	0	2987
11779	2833	0	51	3	0	2887
11780	2809	2	14	2	0	2827
11781	2859	2	8	1	0	2870
11782	0	3136	0	2	0	3138
11783	2	14	1	3049	0	3066
11784	0	3036	0	2	0	3038
11785	2953	0	13	6	0	2972
11786	3232	5	19	2	0	3258
11787	0	3573	0	2	0	3575
11788	3477	1	12	2	0	3492
11789	0	16	0	3214	0	3230
11790	18	2	1	3427	0	3448
11791	3385	0	11	6	0	3402
11792	3514	0	23	5	0	3542
11793	3412	0	20	2	0	3434
11794	2	12	0	3345	0	3359
11795	2	21	1	3575	0	3599
11796	3	1	3775	0	0	3779
11797	3	9	0	3501	0	3513
11798	5	9	1	3591	0	3606
11799	4	0	3630	0	0	3634
11800	9	1	3676	2	0	3688
11801	6	0	3927	0	0	3933
11802	4	14	2	3856	0	3876
11803	2	10	4038	0	0	4050
11804	1	15	2	3945	0	3963
11805	6	24	0	3883	0	3913
11806	1	0	3879	2	0	3882
11807	4	0	4060	0	0	4064
11808	5	9	0	4020	0	4034
11809	5	0	4016	0	0	4021
11810	2	0	4065	0	0	4067
11811	1	4065	0	3	0	4069
11812	4074	0	17	1	0	4092
11813	3977	0	10	0	0	3987
11814	4096	1	11	2	0	4110
11815	0	4246	0	1	0	4247
11816	0	4091	0	1	0	4092
11817	2	12	1	4094	0	4109
11818	1	23	0	3938	0	3962
11819	4	0	4344	0	0	4348
11820	2	7	0	4255	0	4264
11821	4183	1	5	0	0	4189
11822	14	9	0	4225	0	4248
11823	1	4247	0	4	0	4252
11824	4126	2	18	2	0	4148
11825	3972	1	19	0	0	3992
11826	4169	4	16	1	0	4190
11827	0	0	4382	0	0	4382
11828	17	8	0	4330	0	4355
11829	4292	0	15	3	0	4310
11830	4	0	4420	0	0	4424
11831	3	4411	0	3	0	4417
11832	0	4341	0	4	0	4345
11833	4471	6	4	8	0	4489
11834	0	4533	2	2	0	4537
11835	2	15	0	4286	0	4303
11836	7	0	4610	0	0	4617
11837	0	5	0	4485	0	4490
11838	4490	0	8	0	0	4498
11839	0	4553	2	1	0	4556
11840	4306	2	12	6	0	4326
11841	0	0	4516	0	0	4516
11842	5	6	1	4357	0	4369
11843	0	4406	0	2	0	4408
11844	1	2	1	4288	0	4292
11845	4298	0	3	0	0	4301
11846	4198	0	10	2	0	4210
11847	4093	0	9	0	0	4102
11848	4049	0	46	0	0	4095
11849	3	10	0	4232	0	4245
11850	0	0	4186	0	0	4186
11851	2	2	2	4030	0	4036
11852	0	4074	0	7	0	4081
11853	3848	0	13	3	0	3864
11854	0	0	3997	0	0	3997
11855	4003	0	12	0	0	4015
11856	1	3	2	3975	0	3981
11857	7	0	4128	0	0	4135
11858	2	4	0	3967	0	3973
11859	3973	0	5	0	0	3978
11860	3683	0	14	7	0	3704
11861	3901	1	16	2	0	3920
11862	0	1	4109	0	0	4110
11863	2	3	4	3949	0	3958
11864	2	0	3964	0	0	3966
11865	0	3949	2	2	0	3953
11866	3913	2	19	1	0	3935
11867	0	3996	0	8	0	4004
11868	3886	0	6	5	0	3897
11869	3	3	2	3887	0	3895
11870	1	3904	1	4	0	3910
11871	3833	0	15	1	0	3849
11872	3	0	3927	0	0	3930
11873	0	7	1	3839	0	3847
11874	3874	0	8	3	0	3885
11875	6	1	3950	1	0	3958
11876	1	14	1	3775	0	3791
11877	0	3754	0	1	0	3755
11878	2	8	0	3561	0	3571
11879	1	9	0	3681	0	3691
11880	3519	0	8	13	0	3540
11881	0	3680	0	0	0	3680
11882	2	5	0	3546	0	3553
11883	0	3596	1	5	0	3602
11884	5	10	0	3497	0	3512
11885	0	3546	1	2	0	3549
11886	3462	0	4	0	0	3466
11887	4	0	3597	0	0	3601
11888	1	3	2	3478	0	3484
11889	2	14	2	3294	0	3312
11890	1	16	4	3289	0	3310
11891	3	9	0	3451	0	3463
11892	7	1	3525	0	0	3533
11893	2	3481	0	5	0	3488
11894	3354	0	18	1	0	3373
11895	3281	1	15	3	0	3300
11896	0	3436	0	1	0	3437
11897	3291	0	12	5	0	3308
11898	3231	0	3	0	0	3234
11899	0	3376	0	4	0	3380
11900	2	9	0	3265	0	3276
11901	0	3325	1	5	0	3331
11902	3222	0	11	0	0	3233
11903	2	0	3312	1	0	3315
11904	3222	0	7	2	0	3231
11905	3	0	3341	0	0	3344
11906	2	4	3	3186	0	3195
11907	3074	0	2	1	0	3077
11908	1	0	2992	0	0	2993
11909	2966	0	9	2	0	2977
11910	2812	0	8	0	0	2820
11911	2	16	1	2854	0	2873
11912	0	2616	0	1	0	2617
11913	2540	1	12	0	0	2553
11914	2	7	1	2477	0	2487
11915	2	2418	0	4	0	2424
11916	2355	0	8	1	0	2364
11917	0	15	0	2379	0	2394
11918	1	2405	0	7	0	2413
11919	1	6	0	2378	0	2385
11920	2417	0	6	0	0	2423
11921	2359	1	7	3	0	2370
11922	2273	1	7	0	0	2281
11923	4	13	2	2124	0	2143
11924	1	6	0	2185	0	2192
11925	7	1	2245	1	0	2254
11926	6	14	4	2039	0	2063
11927	1	0	2008	0	0	2009
11928	3	0	1993	0	0	1996
11929	0	2	2058	0	0	2060
11930	0	2090	0	1	0	2091
11931	2	6	1	1997	0	2006
11932	0	1988	0	3	0	1991
11933	2027	0	6	1	0	2034
11934	1937	0	7	0	0	1944
11935	0	3	0	2058	0	2061
11936	3	0	2102	0	0	2105
11937	0	6	1	1903	0	1910
11938	1	0	1946	0	0	1947
11939	0	8	0	1867	0	1875
11940	0	1910	1	2	0	1913
11941	1	1845	0	7	0	1853
11942	1817	1	5	2	0	1825
11943	6	0	1891	0	0	1897
11944	0	7	1	1759	0	1767
11945	2	4	0	1794	0	1800
11946	1753	0	7	1	0	1761
11947	0	1795	0	1	0	1796
11948	1677	1	13	2	0	1693
11949	0	1767	2	2	0	1771
11950	1585	2	13	1	0	1601
11951	1556	0	11	0	0	1567
11952	2	10	1	1511	0	1524
11953	2	0	1567	0	0	1569
11954	1536	0	10	3	0	1549
11955	0	1555	0	2	0	1557
11956	1477	2	3	2	0	1484
11957	2	7	0	1370	0	1379
11958	3	7	0	1447	0	1457
11959	0	1454	0	1	0	1455
11960	2	7	0	1425	0	1434
11961	0	1459	0	1	0	1460
11962	0	13	0	1292	0	1305
11963	2	3	0	1398	0	1403
11964	1369	0	3	1	0	1373
11965	4	0	1430	0	0	1434
11966	0	1428	0	4	0	1432
11967	1	5	1	1312	0	1319
11968	1295	0	1	0	0	1296
11969	1173	0	8	1	0	1182
11970	1262	0	8	3	0	1273
11971	2	0	1342	0	0	1344
11972	1268	0	6	0	0	1274
11973	1	5	0	1266	0	1272
11974	1172	0	3	0	0	1175
11975	0	1241	0	2	0	1243
11976	0	1	0	1235	0	1236
11977	1178	0	0	1	0	1179
11978	0	1247	0	1	0	1248
11979	3	8	1	1086	0	1098
11980	0	0	1132	0	0	1132
11981	1027	0	3	1	0	1031
11982	993	0	5	1	0	999
11983	0	0	1094	0	0	1094
11984	0	1013	0	1	0	1014
11985	0	996	0	0	0	996
11986	1	5	0	923	0	929
11987	1	2	0	888	0	891
11988	0	7	1	945	0	953
11989	3	0	988	0	0	991
11990	976	0	7	0	0	983
11991	940	1	5	2	0	948
11992	916	0	4	1	0	921
11993	908	0	2	0	0	910
11994	864	0	4	0	0	868
11995	833	1	1	0	0	835
11996	0	2	1	934	0	937
11997	1	0	929	0	0	930
11998	0	0	963	0	0	963
11999	0	1	0	886	0	887
12000	0	4	1	844	0	849
12001	3	5	0	911	0	919
12002	0	932	0	1	0	933
12003	942	0	2	0	0	944
12004	0	944	0	0	0	944
12005	0	5	0	927	0	932
12006	915	0	1	0	0	916
12007	0	921	0	0	0	921
12008	0	5	0	847	0	852
12009	1	8	1	798	0	808
12010	1	4	0	861	0	866
12011	0	889	1	2	0	892
12012	0	3	0	869	0	872
12013	0	0	931	0	0	931
12014	0	3	1	846	0	850
12015	0	3	3	806	0	812
12016	1	6	0	814	0	821
12017	2	8	0	834	0	844
12018	1	0	869	0	0	870
12019	0	849	0	0	0	849
12020	0	4	0	801	0	805
12021	0	4	0	780	0	784
12022	0	3	0	843	0	846
12023	0	829	0	1	0	830
12024	0	839	0	1	0	840
12025	802	1	3	1	0	807
12026	2	10	4	815	0	831
12027	5	0	855	0	0	860
12028	0	830	0	0	0	830
12029	811	0	3	2	0	816
12030	2	0	831	2	0	835
12031	2	0	803	0	0	805
12032	8	0	794	0	0	802
12033	2	4	1	733	0	740
12034	0	0	779	0	0	779
12035	0	751	0	0	0	751
12036	0	4	0	689	0	693
12037	3	1	759	0	0	763
12038	2	2	0	724	0	728
12039	739	0	5	1	0	745
12040	1	0	770	0	0	771
12041	746	0	8	0	0	754
12042	0	777	0	5	0	782
12043	736	0	1	0	0	737
12044	0	3	0	733	0	736
12045	690	0	1	4	0	695
12046	680	0	6	2	0	688
12047	711	1	0	0	0	712
12048	0	770	0	1	0	771
12049	730	0	0	0	0	730
12050	702	0	5	0	0	707
12051	0	0	765	0	0	765
12052	0	749	0	2	0	751
12053	0	0	1	707	0	708
12054	4	5	0	664	0	673
12055	1	0	0	707	0	708
12056	0	0	759	0	0	759
12057	0	5	0	722	0	727
12058	0	0	732	0	0	732
12059	724	1	1	0	0	726
12060	713	0	0	1	0	714
12061	0	1	742	0	0	743
12062	728	1	0	1	0	730
12063	708	0	3	1	0	712
12064	688	0	0	0	0	688
12065	1	2	0	731	0	734
12066	1	0	737	0	0	738
12067	0	734	0	0	0	734
12068	0	2	0	713	0	715
12069	1	0	699	0	0	700
12070	7	0	740	0	0	747
12071	748	0	2	0	0	750
12072	0	759	0	2	0	761
12073	730	0	0	1	0	731
12074	735	0	2	1	0	738
12075	0	772	0	1	0	773
12076	733	0	0	0	0	733
12077	1	0	735	0	0	736
12078	0	0	733	0	0	733
12079	2	0	750	0	0	752
12080	0	737	0	0	0	737
12081	739	0	5	2	0	746
12082	742	0	1	1	0	744
12083	0	781	0	0	0	781
12084	0	747	0	5	0	752
12085	1	3	0	711	0	715
12086	0	2	0	746	0	748
12087	738	0	0	1	0	739
12088	0	770	0	0	0	770
12089	707	0	5	0	0	712
12090	705	0	2	1	0	708
12091	1	0	775	0	0	776
12092	0	730	0	0	0	730
12093	0	3	0	673	0	676
12094	680	0	4	0	0	684
12095	0	5	0	667	0	672
12096	658	0	3	0	0	661
12097	1	0	705	0	0	706
12098	1	691	0	2	0	694
12099	0	674	0	0	0	674
12100	0	5	1	630	0	636
12101	0	665	0	1	0	666
12102	625	1	3	0	0	629
12103	1	0	649	0	0	650
12104	630	0	4	1	0	635
12105	1	0	663	2	0	666
12106	1	2	0	597	0	600
12107	1	1	0	578	0	580
12108	0	2	0	618	0	620
12109	623	0	1	0	0	624
12110	0	0	634	0	0	634
12111	1	0	0	577	0	578
12112	0	2	0	576	0	578
12113	2	549	1	1	0	553
12114	0	574	0	0	0	574
12115	0	601	0	0	0	601
12116	0	1	0	575	0	576
12117	0	5	0	577	0	582
12118	0	586	1	1	0	588
12119	0	576	0	0	0	576
12120	573	0	3	1	0	577
12121	0	2	0	575	0	577
12122	0	588	0	0	0	588
12123	587	0	2	3	0	592
12124	1	2	0	569	0	572
12125	573	0	2	0	0	575
12126	0	0	0	585	0	585
12127	0	1	599	0	0	600
12128	0	597	0	0	0	597
12129	546	0	1	1	0	548
12130	1	0	586	0	0	587
12131	0	605	0	3	0	608
12132	0	14	0	566	0	580
12133	2	5	0	560	0	567
12134	1	1	0	561	0	563
12135	0	1	0	606	0	607
12136	0	0	622	0	0	622
12137	0	621	1	0	0	622
12138	0	1	0	632	0	633
12139	612	1	3	2	0	618
12140	1	629	0	0	0	630
12141	1	4	0	602	0	607
12142	0	1	632	0	0	633
12143	0	657	0	2	0	659
12144	2	3	0	627	0	632
12145	0	652	0	1	0	653
12146	637	0	2	2	0	641
12147	612	0	1	0	0	613
12148	1	0	655	0	0	656
12149	631	0	1	1	0	633
12150	625	0	1	0	0	626
12151	1	0	678	0	0	679
12152	0	699	0	1	0	700
12153	1	2	0	638	0	641
12154	1	0	0	596	0	597
12155	655	0	2	0	0	657
12156	0	1	0	670	0	671
12157	0	0	693	0	0	693
12158	670	1	3	0	0	674
12159	1	0	717	0	0	718
12160	0	711	0	1	0	712
12161	690	0	4	0	0	694
12162	0	0	679	0	0	679
12163	0	0	646	0	0	646
12164	0	712	0	0	0	712
12165	0	1	1	661	0	663
12166	0	0	721	0	0	721
12167	1	5	0	646	0	652
12168	7	1	0	705	0	713
12169	3	0	764	0	0	767
12170	0	770	0	1	0	771
12171	0	4	0	686	0	690
12172	725	0	5	1	0	731
12173	676	0	2	2	0	680
12174	0	1	0	744	0	745
12175	2	0	736	0	0	738
12176	0	0	759	0	0	759
12177	0	1	1	702	0	704
12178	0	0	714	0	0	714
12179	715	0	1	0	0	716
12180	1	1	1	665	0	668
12181	0	4	0	704	0	708
12182	0	718	0	0	0	718
12183	0	2	0	694	0	696
12184	2	0	717	0	0	719
12185	695	0	0	2	0	697
12186	663	0	3	0	0	666
12187	0	0	732	0	0	732
12188	0	3	0	648	0	651
12189	0	1	0	663	0	664
12190	0	0	702	0	0	702
12191	0	5	0	619	0	624
12192	1	3	0	633	0	637
12193	0	681	0	0	0	681
12194	2	5	0	642	0	649
12195	1	5	0	640	0	646
12196	666	0	2	0	0	668
12197	660	0	0	0	0	660
12198	663	0	1	0	0	664
12199	603	0	15	0	0	618
12200	665	0	2	0	0	667
12201	0	0	729	0	0	729
12202	1	1	0	695	0	697
12203	0	0	0	710	0	710
12204	0	0	730	0	0	730
12205	725	0	1	2	0	728
12206	690	0	4	2	0	696
12207	1	0	737	0	0	738
12208	725	0	4	0	0	729
12209	719	0	0	0	0	719
12210	1	1	841	0	0	843
12211	1	3	0	827	0	831
12212	0	889	0	0	0	889
12213	0	5	1	841	0	847
12214	0	4	0	785	0	789
12215	0	2	2	861	0	865
12216	1	0	886	0	0	887
12217	896	0	7	0	0	903
12218	833	0	3	0	0	836
12219	0	8	0	866	0	874
12220	1	0	898	0	0	899
12221	0	0	0	860	0	860
12222	0	0	849	1	0	850
12223	6	0	877	0	0	883
12224	0	894	0	2	0	896
12225	3	0	0	841	0	844
12226	887	0	0	0	0	887
12227	808	0	1	6	0	815
12228	842	0	0	1	0	843
12229	0	3	0	923	0	926
12230	0	929	0	2	0	931
12231	1	8	0	911	0	920
12232	1	0	938	0	0	939
12233	938	0	4	3	0	945
12234	901	2	1	0	0	904
12235	0	10	0	892	0	902
12236	4	3	0	880	0	887
12237	3	5	0	925	0	933
12238	1	0	975	0	0	976
12239	936	2	0	1	0	939
12240	0	980	0	1	0	981
12241	0	897	0	0	0	897
12242	1	0	966	0	0	967
12243	1	2	0	982	0	985
12244	5	0	967	1	0	973
12245	959	0	8	0	0	967
12246	7	1	0	999	0	1007
12247	6	0	1027	0	0	1033
12248	0	1027	0	0	0	1027
12249	979	0	6	0	0	985
12250	1	0	1051	0	0	1052
12251	0	1024	0	0	0	1024
12252	0	1026	0	0	0	1026
12253	1046	0	1	0	0	1047
12254	2	5	0	1030	0	1037
12255	1	0	1040	0	0	1041
12256	0	991	0	1	0	992
12257	1052	0	4	0	0	1056
12258	1043	0	4	1	0	1048
12259	0	1026	0	2	0	1028
12260	1	0	1036	0	0	1037
12261	0	0	0	983	0	983
12262	1018	0	3	0	0	1021
12263	1009	2	5	1	0	1017
12264	0	0	1053	0	0	1053
12265	1	0	0	1003	0	1004
12266	1	1	0	984	0	986
12267	1	0	1025	0	0	1026
12268	0	0	957	0	0	957
12269	1028	0	3	0	0	1031
12270	1000	0	0	0	0	1000
12271	998	0	2	0	0	1000
12272	1001	0	2	0	0	1003
12273	1	0	1011	0	0	1012
12274	977	0	3	0	0	980
12275	1	3	0	993	0	997
12276	1	0	992	0	0	993
12277	5	0	1008	2	0	1015
12278	0	998	0	1	0	999
12279	0	0	0	934	0	934
12280	3	0	973	0	0	976
12281	1006	0	6	0	0	1012
12282	1	3	0	986	0	990
12283	0	1004	0	1	0	1005
12284	1001	0	3	0	0	1004
12285	1020	0	2	0	0	1022
12286	3	0	992	0	0	995
12287	0	995	0	2	0	997
12288	1	0	0	930	0	931
12289	957	0	1	0	0	958
12290	0	0	1	931	0	932
12291	1	0	958	0	0	959
12292	932	0	3	0	0	935
12293	0	945	0	1	0	946
12294	1	877	0	0	0	878
12295	0	880	0	1	0	881
12296	898	0	0	0	0	898
12297	843	0	2	2	0	847
12298	789	0	1	0	0	790
12299	0	1	1	845	0	847
12300	0	0	884	0	0	884
12301	2	0	0	817	0	819
12302	818	0	1	0	0	819
12303	0	6	0	803	0	809
12304	799	0	2	1	0	802
12305	745	0	4	1	0	750
12306	730	0	0	0	0	730
12307	0	801	1	0	0	802
12308	689	0	2	7	0	698
12309	0	1	689	0	0	690
12310	5	0	690	0	0	695
12311	3	683	0	1	0	687
12312	0	2	4	646	0	652
12313	657	0	1	0	0	658
12314	0	0	662	3	0	665
12315	655	0	3	0	0	658
12316	0	1	0	646	0	647
12317	40	548	0	0	0	588
12318	1	1	0	464	0	466
12319	2	1	501	0	0	504
12320	491	0	2	0	0	493
12321	3	0	481	0	0	484
12322	12	0	480	0	0	492
12323	455	0	0	0	0	455
12324	0	453	0	0	0	453
12325	433	0	2	0	0	435
12326	423	0	1	0	0	424
12327	2	0	428	0	0	430
12328	415	0	0	0	0	415
12329	0	0	378	2	0	380
12330	0	0	332	0	0	332
12331	0	0	322	0	0	322
12332	3	285	0	0	0	288
12333	254	0	4	0	0	258
12334	240	0	3	0	0	243
12335	224	0	1	1	0	226
12336	237	0	2	0	0	239
12337	0	0	249	0	0	249
12338	1	2	0	215	0	218
12339	0	2	1	227	0	230
12340	238	0	1	0	0	239
12341	3	243	0	0	0	246
12342	0	0	1	241	0	242
12343	243	0	1	0	0	244
12344	0	0	250	0	0	250
12345	0	0	1	224	0	225
12346	0	0	226	0	0	226
12347	1	220	0	0	0	221
12348	0	0	0	206	0	206
12349	206	0	0	0	0	206
12350	0	1	0	206	0	207
12351	0	0	217	0	0	217
12352	0	206	0	1	0	207
12353	193	0	0	0	0	193
12354	0	0	184	0	0	184
12355	189	0	1	1	0	191
12356	0	184	0	3	0	187
12357	181	0	1	1	0	183
12358	162	0	0	0	0	162
12359	0	0	0	177	0	177
12360	0	1	183	26	0	210
12361	0	290	0	0	0	290
12362	0	2	0	273	0	275
12363	0	2	0	286	0	288
12364	1	1	0	301	0	303
12365	0	4	0	312	0	316
12366	0	330	0	0	0	330
12367	316	1	0	1	0	318
12368	0	334	0	1	0	335
12369	0	1	0	306	0	307
12370	307	0	0	0	0	307
12371	0	2	0	323	0	325
12372	1	0	318	0	0	319
12373	0	338	0	0	0	338
12374	0	0	1	318	0	319
12375	0	0	0	307	0	307
12376	327	0	0	1	0	328
12377	0	0	333	0	0	333
12378	311	0	2	0	0	313
12379	286	0	12	0	0	298
12380	313	0	1	0	0	314
12381	0	0	326	0	0	326
12382	0	3	0	305	0	308
12383	1	2	0	321	0	324
12384	0	0	320	0	0	320
12385	1	0	327	0	0	328
12386	333	0	2	1	0	336
12387	0	0	0	327	0	327
12388	336	0	2	0	0	338
12389	320	0	0	0	0	320
12390	0	0	0	360	0	360
12391	0	0	360	0	0	360
12392	364	0	0	0	0	364
12393	0	2	0	344	0	346
12394	1	0	333	0	0	334
12395	0	363	0	0	0	363
12396	357	0	0	1	0	358
12397	0	385	0	0	0	385
12398	2	1	0	350	0	353
12399	0	382	0	1	0	383
12400	349	1	1	0	0	351
12401	360	0	0	2	0	362
12402	0	387	0	1	0	388
12403	356	0	3	0	0	359
12404	354	0	2	0	0	356
12405	0	406	0	0	0	406
12406	412	0	1	0	0	413
12407	0	0	0	372	0	372
12408	0	1	0	407	0	408
12409	369	0	0	0	0	369
12410	0	3	0	411	0	414
12411	0	410	0	1	0	411
12412	391	0	0	0	0	391
12413	398	0	0	0	0	398
12414	0	426	0	0	0	426
12415	393	0	3	0	0	396
12416	398	0	3	0	0	401
12417	0	0	0	437	0	437
12418	2	2	405	0	0	409
12419	0	458	0	1	0	459
12420	440	0	1	1	0	442
12421	410	0	0	0	0	410
12422	2	0	453	0	0	455
12423	452	0	2	1	0	455
12424	2	0	476	0	0	478
12425	446	0	7	2	0	455
12426	0	0	0	452	0	452
12427	1	0	458	0	0	459
12428	2	0	483	0	0	485
12429	0	2	0	473	0	475
12430	0	2	0	479	0	481
12431	0	0	491	0	0	491
12432	0	2	0	495	0	497
12433	1	0	492	0	0	493
12434	0	1	0	436	0	437
12435	1	2	0	459	0	462
12436	0	453	0	0	0	453
12437	0	476	0	2	0	478
12438	0	505	0	0	0	505
12439	0	2	0	498	0	500
12440	1	2	0	488	0	491
12441	2	0	486	0	0	488
12442	496	0	2	0	0	498
12443	491	0	0	1	0	492
12444	1	559	1	0	0	561
12445	537	0	1	0	0	538
12446	0	3	1	508	0	512
12447	515	0	1	0	0	516
12448	509	0	6	0	0	515
12449	0	3	0	524	0	527
12450	529	0	4	1	0	534
12451	0	568	0	1	0	569
12452	0	538	0	1	0	539
12453	0	2	0	592	0	594
12454	0	621	0	0	0	621
12455	0	6	0	593	0	599
12456	0	0	0	616	0	616
12457	611	1	1	0	0	613
12458	0	658	0	1	0	659
12459	601	0	0	0	0	601
12460	594	0	3	3	0	600
12461	0	651	0	1	0	652
12462	620	0	3	0	0	623
12463	0	0	621	0	0	621
12464	0	639	0	0	0	639
12465	601	0	2	1	0	604
12466	0	0	642	0	0	642
12467	1	650	0	0	0	651
12468	0	640	0	2	0	642
12469	611	0	3	1	0	615
12470	617	0	2	0	0	619
12471	645	0	0	1	0	646
12472	0	691	0	3	0	694
12473	0	3	0	670	0	673
12474	664	0	0	0	0	664
12475	616	1	1	0	0	618
12476	0	2	0	682	0	684
12477	5	0	667	0	0	672
12478	0	0	686	0	0	686
12479	0	2	0	671	0	673
12480	1	1	0	687	0	689
12481	1	0	715	0	0	716
12482	3	2	0	681	0	686
12483	0	744	0	0	0	744
12484	723	0	3	2	0	728
12485	0	5	0	707	0	712
12486	702	0	0	1	0	703
12487	0	762	0	1	0	763
12488	1	723	0	3	0	727
12489	703	1	4	2	0	710
12490	0	0	762	0	0	762
12491	761	0	1	2	0	764
12492	0	871	0	0	0	871
12493	1	0	0	842	0	843
12494	839	0	2	1	0	842
12495	2	1	0	851	0	854
12496	838	0	3	1	0	842
12497	815	0	2	0	0	817
12498	0	883	0	0	0	883
12499	825	0	3	0	0	828
12500	0	874	0	0	0	874
12501	806	0	4	1	0	811
12502	10	2	0	795	0	807
12503	796	0	2	0	0	798
12504	0	4	0	844	0	848
12505	777	0	0	4	0	781
12506	786	0	3	0	0	789
12507	807	2	1	0	0	810
12508	797	0	4	0	0	801
12509	765	0	3	0	0	768
12510	0	0	0	822	0	822
12511	841	0	2	0	0	843
12512	0	860	0	1	0	861
12513	4	0	844	1	0	849
12514	0	7	1	838	0	846
12515	0	0	889	0	0	889
12516	0	4	0	860	0	864
12517	1	0	882	0	0	883
12518	886	0	6	1	0	893
12519	1	0	0	899	0	900
12520	4	1	891	0	0	896
12521	1	0	967	0	0	968
12522	0	3	0	948	0	951
12523	956	0	6	0	0	962
12524	0	978	0	2	0	980
12525	958	0	9	0	0	967
12526	1029	0	3	0	0	1032
12527	0	1111	0	0	0	1111
12528	1085	0	3	0	0	1088
12529	1	4	0	984	0	989
12530	0	6	0	1056	0	1062
12531	0	0	0	1115	0	1115
12532	1094	0	1	3	0	1098
12533	0	1153	0	0	0	1153
12534	2	9	0	1105	0	1116
12535	0	1	0	1122	0	1123
12536	1027	0	1	3	0	1031
12537	1	5	0	1142	0	1148
12538	0	0	1143	0	0	1143
12539	0	1187	0	1	0	1188
12540	1165	0	4	0	0	1169
12541	0	4	0	1129	0	1133
12542	1	1170	0	0	0	1171
12543	1150	1	8	4	0	1163
12544	2	0	1206	0	0	1208
12545	0	1183	0	2	0	1185
12546	1216	0	4	0	0	1220
12547	2	6	0	1091	0	1099
12548	4	2	0	1139	0	1145
12549	3	0	1186	0	0	1189
12550	0	1	0	1170	0	1171
12551	1	0	1178	0	0	1179
12552	0	0	1158	0	0	1158
12553	0	0	1118	0	0	1118
12554	1181	0	2	1	0	1184
12555	1094	0	6	0	0	1100
12556	1093	0	6	2	0	1101
12557	0	1	0	1198	0	1199
12558	0	1193	0	0	0	1193
12559	0	1132	0	2	0	1134
12560	1169	1	3	1	0	1174
12561	1123	0	7	0	0	1130
12562	0	1216	0	3	0	1219
12563	1153	0	2	2	0	1157
12564	0	0	1176	0	0	1176
12565	0	0	1196	0	0	1196
12566	1	10	0	1091	0	1102
12567	1	8	0	1095	0	1104
12568	2	0	1195	0	0	1197
12569	0	1	0	1148	0	1149
12570	1177	0	5	2	0	1184
12571	3	0	1173	0	0	1176
12572	1135	0	3	0	0	1138
12573	8	4	0	1081	0	1093
12574	2	0	1121	0	0	1123
12575	0	1126	1	1	0	1128
12576	1092	0	5	1	0	1098
12577	0	0	1088	0	0	1088
12578	1085	0	2	0	0	1087
12579	0	0	0	1040	0	1040
12580	1085	0	1	3	0	1089
12581	0	0	1133	0	0	1133
12582	5	3	0	1066	0	1074
12583	1093	0	2	0	0	1095
12584	1063	1	2	0	0	1066
12585	1027	0	5	0	0	1032
12586	1022	0	3	0	0	1025
12587	0	3	0	983	0	986
12588	1	4	0	1003	0	1008
12589	1	0	1032	0	0	1033
12590	0	9	0	925	0	934
12591	0	1	0	954	0	955
12592	1	985	0	3	0	989
12593	985	0	11	1	0	997
12594	974	0	5	1	0	980
12595	0	1020	0	0	0	1020
12596	0	4	1	944	0	949
12597	0	1	0	973	0	974
12598	986	1	2	2	0	991
12599	1	0	1040	0	0	1041
12600	0	5	0	1027	0	1032
12601	0	0	1025	1	0	1026
12602	1026	0	1	0	0	1027
12603	948	0	4	2	0	954
12604	945	1	3	0	0	949
12605	2	5	0	958	0	965
12606	1	3	0	1006	0	1010
12607	1087	1	2	0	0	1090
12608	1	0	1103	0	0	1104
12609	0	3	0	1056	0	1059
12610	1048	0	6	1	0	1055
12611	0	4	0	1060	0	1064
12612	0	0	1049	0	0	1049
12613	1	0	1099	0	0	1100
12614	1061	0	2	0	0	1063
12615	0	1110	0	1	0	1111
12616	1099	0	3	0	0	1102
12617	1024	0	3	1	0	1028
12618	0	1	0	1013	0	1014
12619	1	4	0	1112	0	1117
12620	0	1049	0	1	0	1050
12621	1120	1	6	0	0	1127
12622	0	1122	0	2	0	1124
12623	0	1100	0	1	0	1101
12624	0	1	0	1104	0	1105
12625	1135	0	2	1	0	1138
12626	1050	0	4	0	0	1054
12627	0	2	0	1074	0	1076
12628	1	4	0	1100	0	1105
12629	0	7	0	1135	0	1142
12630	1153	0	4	0	0	1157
12631	0	0	1171	0	0	1171
12632	0	1170	0	1	0	1171
12633	1100	1	2	0	0	1103
12634	1	3	1	1148	0	1153
12635	0	0	1117	1	0	1118
12636	0	0	1165	0	0	1165
12637	0	1161	3	5	0	1169
12638	0	1206	0	0	0	1206
12639	1	3	1	1132	0	1137
12640	0	1203	0	1	0	1204
12641	2	2	0	1132	0	1136
12642	0	1	0	1188	0	1189
12643	1168	0	1	3	0	1172
12644	0	3	0	1120	0	1123
12645	0	5	0	1168	0	1173
12646	2	0	1203	0	0	1205
12647	0	6	0	1156	0	1162
12648	1116	0	6	0	0	1122
12649	1049	0	6	3	0	1058
12650	0	1176	0	0	0	1176
12651	1100	1	3	0	0	1104
12652	1	0	1162	0	0	1163
12653	0	1207	0	0	0	1207
12654	2	5	0	1121	0	1128
12655	1	4	0	1079	0	1084
12656	1	2	0	1118	0	1121
12657	1103	0	2	3	0	1108
12658	1122	0	3	1	0	1126
12659	0	0	1210	0	0	1210
12660	2	0	1210	0	0	1212
12661	0	0	1249	0	0	1249
12662	0	1231	1	1	0	1233
12663	0	1191	0	0	0	1191
12664	1229	0	4	2	0	1235
12665	1218	0	4	1	0	1223
12666	0	4	0	1195	0	1199
12667	2	4	2	1241	0	1249
12668	0	1231	0	0	0	1231
12669	0	2	0	1190	0	1192
12670	0	0	1250	0	0	1250
12671	0	1218	0	5	0	1223
12672	2	12	1	1163	0	1178
12673	0	0	1254	0	0	1254
12674	0	3	0	1189	0	1192
12675	0	1220	0	0	0	1220
12676	1187	0	3	1	0	1191
12677	1113	0	5	1	0	1119
12678	1089	0	6	3	0	1098
12679	0	7	0	1119	0	1126
12680	0	3	0	1227	0	1230
12681	1219	0	4	0	0	1223
12682	3	1286	2	0	0	1291
12683	1221	2	7	1	0	1231
12684	0	0	1267	0	0	1267
12685	1273	2	8	0	0	1283
12686	1299	0	17	1	0	1317
12687	3	2	0	1380	0	1385
12688	1404	0	0	0	0	1404
12689	1236	0	7	0	0	1243
12690	0	7	1	1384	0	1392
12691	2	1	1423	0	0	1426
12692	1367	0	5	1	0	1373
12693	1	0	1495	0	0	1496
12694	0	1447	0	14	0	1461
12695	0	6	0	1369	0	1375
12696	5	0	0	1428	0	1433
12697	1440	0	4	1	0	1445
12698	1	0	1537	0	0	1538
12699	0	4	0	1497	0	1501
12700	0	1507	0	0	0	1507
12701	0	1498	0	2	0	1500
12702	1	1	0	1492	0	1494
12703	0	0	1605	0	0	1605
12704	1	9	2	1524	0	1536
12705	0	1	1	1568	0	1570
12706	2	1	1526	0	0	1529
12707	0	1611	0	3	0	1614
12708	1603	3	5	0	0	1611
12709	0	1635	0	3	0	1638
12710	0	3	0	1654	0	1657
12711	1650	0	3	1	0	1654
12712	0	1644	0	2	0	1646
12713	4	0	1673	2	0	1679
12714	1650	0	3	1	0	1654
12715	0	1677	0	3	0	1680
12716	1659	0	0	1	0	1660
12717	1	1	1621	0	0	1623
12718	1650	0	1	3	0	1654
12719	5	11	0	1651	0	1667
12720	1	0	1720	0	0	1721
12721	0	3	0	1687	0	1690
12722	0	1655	0	0	0	1655
12723	0	9	0	1639	0	1648
12724	1	7	0	1613	0	1621
12725	2	2	1748	0	0	1752
12726	0	5	0	1705	0	1710
12727	0	1	1769	0	0	1770
12728	0	1739	0	1	0	1740
12729	0	7	0	1599	0	1606
12730	2	0	1713	0	0	1715
12731	0	1709	0	2	0	1711
12732	1	1659	0	6	0	1666
12733	7	0	1616	0	0	1623
12734	0	1	1747	0	0	1748
12735	1	0	0	1724	0	1725
12736	1760	0	4	1	0	1765
12737	0	1796	0	2	0	1798
12738	0	2	0	1788	0	1790
12739	1792	0	2	4	0	1798
12740	0	1828	0	3	0	1831
12741	1785	0	6	0	0	1791
12742	0	1826	0	0	0	1826
12743	1723	0	3	1	0	1727
12744	1616	0	13	2	0	1631
12745	1644	0	4	0	0	1648
12746	0	1788	0	4	0	1792
12747	0	6	0	1729	0	1735
12748	0	2	1768	0	0	1770
12749	0	1709	0	10	0	1719
12750	1	7	0	1624	0	1632
12751	0	2	2	1671	0	1675
12752	1	0	1729	0	0	1730
12753	0	1682	1	0	0	1683
12754	1701	0	3	0	0	1704
12755	0	1704	2	1	0	1707
12756	2	4	0	1524	0	1530
12757	3	0	1592	0	0	1595
12758	1582	0	1	0	0	1583
12759	0	6	0	1573	0	1579
12760	1	0	1605	2	0	1608
12761	1560	0	8	1	0	1569
12762	0	1567	0	1	0	1568
12763	1549	0	5	1	0	1555
12764	1435	0	3	0	0	1438
12765	2	3	0	1519	0	1524
12766	7	0	1478	0	0	1485
12767	0	1424	0	5	0	1429
12768	0	1	1492	0	0	1493
12769	1	3	0	1396	0	1400
12770	1	4	0	1374	0	1379
12771	1436	0	3	0	0	1439
12772	0	0	1463	0	0	1463
12773	0	1454	1	1	0	1456
12774	1	8	0	1363	0	1372
12775	0	4	0	1274	0	1278
12776	1361	0	1	0	0	1362
12777	0	1358	0	1	0	1359
12778	2	0	0	1338	0	1340
12779	1301	0	6	0	0	1307
12780	0	1286	1	0	0	1287
12781	1175	0	7	0	0	1182
12782	1122	0	13	1	0	1136
12783	0	1219	1	1	0	1221
12784	1109	0	1	0	0	1110
12785	0	1151	2	1	0	1154
12786	1027	0	6	0	0	1033
12787	968	1	8	1	0	978
12788	0	1012	0	10	0	1022
12789	945	0	20	0	0	965
12790	818	0	3	0	0	821
12791	857	0	0	0	0	857
12792	2	0	880	2	0	884
12793	2	0	832	0	0	834
12794	6	3	765	0	0	774
12795	703	0	3	2	0	708
12796	1	0	665	0	0	666
12797	23	0	610	0	0	633
12798	4	2	0	542	0	548
12799	566	0	1	0	0	567
12800	0	0	538	0	0	538
12801	3	0	537	0	0	540
12802	0	4	1	499	0	504
12803	3	0	0	488	0	491
12804	0	1	0	496	0	497
12805	0	0	524	0	0	524
12806	0	2	0	503	0	505
12807	511	0	0	0	0	511
12808	0	520	0	0	0	520
12809	1	2	0	461	0	464
12810	0	0	0	481	0	481
12811	0	0	495	0	0	495
12812	0	466	0	0	0	466
12813	477	0	1	4	0	482
12814	0	494	0	0	0	494
12815	0	0	0	470	0	470
12816	0	0	492	1	0	493
12817	0	1	0	442	0	443
12818	1	0	0	461	0	462
12819	461	0	3	0	0	464
12820	0	0	0	466	0	466
12821	0	470	0	0	0	470
12822	0	453	1	0	0	454
12823	2	0	472	0	0	474
12824	474	0	0	0	0	474
12825	0	0	0	427	0	427
12826	0	1	0	406	0	407
12827	0	0	0	446	0	446
12828	428	0	0	0	0	428
12829	0	449	0	0	0	449
12830	441	1	4	0	0	446
12831	0	0	441	0	0	441
12832	1	0	430	0	0	431
12833	434	0	2	0	0	436
12834	0	2	0	415	0	417
12835	0	0	0	408	0	408
12836	0	0	0	380	0	380
12837	0	0	410	0	0	410
12838	424	0	0	0	0	424
12839	401	0	0	3	0	404
12840	369	0	1	0	0	370
12841	0	0	0	365	0	365
12842	8	0	354	0	0	362
12843	1	0	363	0	0	364
12844	1	0	373	0	0	374
12845	2	369	1	0	0	372
12846	4	2	2	352	0	360
12847	378	0	0	0	0	378
12848	1	0	371	0	0	372
12849	354	0	1	0	0	355
12850	1	3	0	332	0	336
12851	23	0	0	278	0	301
12852	0	270	0	0	0	270
12853	0	273	0	0	0	273
12854	0	281	0	0	0	281
12855	0	4	0	255	0	259
12856	269	0	0	0	0	269
12857	257	0	2	0	0	259
12858	1	0	277	0	0	278
12859	270	0	0	0	0	270
12860	0	0	282	3	0	285
12861	0	0	0	221	0	221
12862	0	0	220	0	0	220
12863	216	0	0	0	0	216
12864	0	0	0	218	0	218
12865	2	0	221	0	0	223
12866	0	0	217	0	0	217
12867	210	0	1	1	0	212
12868	194	0	6	0	0	200
12869	0	221	0	0	0	221
12870	0	0	0	204	0	204
12871	0	0	224	0	0	224
12872	2	1	227	0	0	230
12873	0	1	0	221	0	222
12874	215	0	0	0	0	215
12875	0	224	0	1	0	225
12876	0	1	0	217	0	218
12877	213	0	2	1	0	216
12878	0	0	0	224	0	224
12879	0	225	0	0	0	225
12880	0	1	0	222	0	223
12881	208	0	1	0	0	209
12882	0	0	0	221	0	221
12883	208	0	1	0	0	209
12884	0	221	0	0	0	221
12885	186	0	0	0	0	186
12886	0	0	190	0	0	190
12887	180	0	1	0	0	181
12888	175	0	1	0	0	176
12889	0	188	0	0	0	188
12890	0	0	0	170	0	170
12891	0	0	182	0	0	182
12892	0	0	175	0	0	175
12893	169	0	0	0	0	169
12894	163	0	0	4	0	167
12895	0	172	0	0	0	172
12896	0	164	0	1	0	165
12897	165	0	0	0	0	165
12898	0	178	0	0	0	178
12899	0	175	0	0	0	175
12900	0	0	0	165	0	165
12901	1	0	0	164	0	165
12902	1	3	174	0	0	178
12903	0	0	0	177	0	177
12904	174	2	0	0	0	176
12905	0	0	176	0	0	176
12906	0	0	181	0	0	181
12907	0	2	0	157	0	159
12908	0	0	0	165	0	165
12909	1	0	0	167	0	168
12910	6	0	175	0	0	181
12911	0	0	0	166	0	166
12912	0	0	0	172	0	172
12913	174	0	0	0	0	174
12914	0	179	0	0	0	179
12915	173	1	1	0	0	175
12916	0	0	176	0	0	176
12917	167	0	0	1	0	168
12918	0	175	0	0	0	175
12919	163	0	1	0	0	164
12920	0	184	0	0	0	184
12921	185	0	0	0	0	185
12922	0	202	0	0	0	202
12923	0	200	0	0	0	200
12924	0	1	0	179	0	180
12925	184	0	0	1	0	185
12926	178	0	2	0	0	180
12927	188	3	0	1	0	192
12928	0	0	199	0	0	199
12929	0	0	191	0	0	191
12930	0	0	0	183	0	183
12931	0	173	0	0	0	173
12932	0	169	0	0	0	169
12933	0	1	0	148	0	149
12934	172	0	0	0	0	172
12935	166	0	0	0	0	166
12936	165	0	0	0	0	165
12937	0	0	177	0	0	177
12938	0	1	0	169	0	170
12939	0	0	156	0	0	156
12940	164	0	0	1	0	165
12941	155	0	0	0	0	155
12942	0	0	175	0	0	175
12943	0	0	0	168	0	168
12944	161	0	1	0	0	162
12945	0	3	0	150	0	153
12946	0	3	0	159	0	162
12947	0	0	0	165	0	165
12948	163	0	1	0	0	164
12949	0	0	0	160	0	160
12950	165	0	0	0	0	165
12951	0	174	0	0	0	174
12952	0	0	0	155	0	155
12953	0	0	0	158	0	158
12954	0	0	0	178	0	178
12955	182	0	0	1	0	183
12956	0	1	0	175	0	176
12957	0	0	0	182	0	182
12958	182	0	0	0	0	182
12959	179	0	0	0	0	179
12960	190	0	0	1	0	191
12961	1	0	197	0	0	198
12962	0	0	198	0	0	198
12963	199	0	0	0	0	199
12964	0	0	0	186	0	186
12965	0	0	0	202	0	202
12966	196	0	1	0	0	197
12967	196	0	1	0	0	197
12968	195	0	3	0	0	198
12969	0	216	0	0	0	216
12970	211	0	1	0	0	212
12971	219	1	1	0	0	221
12972	0	253	0	0	0	253
12973	0	240	0	0	0	240
12974	1	2	0	248	0	251
12975	280	0	0	1	0	281
12976	261	0	2	0	0	263
12977	257	0	0	0	0	257
12978	0	0	0	276	0	276
12979	285	0	0	0	0	285
12980	0	0	291	0	0	291
12981	280	0	2	1	0	283
12982	0	0	293	0	0	293
12983	0	1	318	0	0	319
12984	0	0	0	317	0	317
12985	315	0	0	1	0	316
12986	0	1	0	317	0	318
12987	0	0	321	0	0	321
12988	0	0	338	0	0	338
12989	0	0	0	341	0	341
12990	343	0	0	0	0	343
12991	0	348	0	0	0	348
12992	0	0	1	320	0	321
12993	0	5	0	330	0	335
12994	0	0	344	0	0	344
12995	0	0	347	0	0	347
12996	0	0	0	351	0	351
12997	345	0	0	0	0	345
12998	0	0	351	0	0	351
12999	0	6	0	329	0	335
13000	0	0	0	330	0	330
13001	0	0	0	341	0	341
13002	343	0	0	0	0	343
13003	1	0	346	0	0	347
13004	0	353	0	0	0	353
13005	0	3	0	343	0	346
13006	0	0	352	0	0	352
13007	0	358	0	0	0	358
13008	0	344	0	2	0	346
13009	354	0	5	0	0	359
13010	0	357	0	0	0	357
13011	347	0	1	0	0	348
13012	0	0	353	0	0	353
13013	0	1	0	351	0	352
13014	361	0	0	2	0	363
13015	0	361	0	0	0	361
13016	0	0	352	0	0	352
13017	2	0	0	355	0	357
13018	2	367	0	0	0	369
13019	0	0	0	368	0	368
13020	371	0	0	0	0	371
13021	1	369	0	1	0	371
13022	347	0	2	0	0	349
13023	342	0	3	0	0	345
13024	0	0	353	0	0	353
13025	0	342	0	0	0	342
13026	0	0	0	327	0	327
13027	2	0	324	0	0	326
13028	2	0	328	0	0	330
13029	0	2	0	316	0	318
13030	323	0	0	0	0	323
13031	282	0	7	0	0	289
13032	0	0	0	318	0	318
13033	0	0	324	0	0	324
13034	0	327	0	2	0	329
13035	316	0	0	0	0	316
13036	301	0	1	0	0	302
13037	0	320	0	1	0	321
13038	306	0	1	0	0	307
13039	0	0	308	0	0	308
13040	297	0	1	0	0	298
13041	289	0	1	0	0	290
13042	0	0	316	0	0	316
13043	0	3	0	301	0	304
13044	0	0	303	0	0	303
13045	0	294	0	0	0	294
13046	0	288	0	0	0	288
13047	0	2	0	277	0	279
13048	0	0	289	0	0	289
13049	0	288	0	0	0	288
13050	0	273	0	0	0	273
13051	283	0	1	0	0	284
13052	272	0	0	1	0	273
13053	0	0	0	276	0	276
13054	0	0	1	289	0	290
13055	0	284	0	0	0	284
13056	282	0	1	0	0	283
13057	292	0	1	0	0	293
13058	0	290	0	0	0	290
13059	0	1	0	274	0	275
13060	0	0	299	0	0	299
13061	0	0	0	284	0	284
13062	294	0	0	0	0	294
13063	0	2	0	248	0	250
13064	0	1	0	278	0	279
13065	267	0	1	0	0	268
13066	0	0	0	274	0	274
13067	0	276	0	1	0	277
13068	0	1	0	245	0	246
13069	0	0	0	215	0	215
13070	2	0	0	219	0	221
13071	0	199	0	0	0	199
13072	1	0	0	191	0	192
13073	0	0	205	0	0	205
13074	0	1	0	193	0	194
13075	3	0	193	0	0	196
13076	0	195	0	0	0	195
13077	0	1	0	189	0	190
13078	0	0	0	179	0	179
13079	0	1	0	181	0	182
13080	0	0	0	191	0	191
13081	1	0	195	0	0	196
13082	0	204	0	0	0	204
13083	0	0	0	193	0	193
13084	1	0	206	0	0	207
13085	0	2	0	196	0	198
13086	201	0	0	0	0	201
13087	0	0	204	0	0	204
13088	202	0	1	0	0	203
13089	0	0	1	204	0	205
13090	0	0	199	0	0	199
13091	0	215	0	0	0	215
13092	0	0	0	214	0	214
13093	0	0	217	0	0	217
13094	0	223	0	3	0	226
13095	0	0	0	205	0	205
13096	220	0	0	1	0	221
13097	197	0	2	0	0	199
13098	221	1	1	0	0	223
13099	0	0	229	0	0	229
13100	0	231	0	0	0	231
13101	0	1	0	226	0	227
13102	0	5	0	217	0	222
13103	235	0	1	0	0	236
13104	0	237	0	1	0	238
13105	231	0	1	0	0	232
13106	216	0	2	0	0	218
13107	224	1	1	0	0	226
13108	0	0	236	0	0	236
13109	232	0	0	0	0	232
13110	0	2	0	204	0	206
13111	0	1	0	228	0	229
13112	234	0	0	0	0	234
13113	0	1	0	244	0	245
13114	0	251	0	0	0	251
13115	2	0	0	243	0	245
13116	239	0	2	0	0	241
13117	0	0	257	0	0	257
13118	0	253	0	0	0	253
13119	0	0	0	248	0	248
13120	252	0	0	0	0	252
13121	1	0	267	0	0	268
13122	1	1	0	257	0	259
13123	0	0	259	0	0	259
13124	0	0	258	0	0	258
13125	0	0	252	0	0	252
13126	0	0	246	0	0	246
13127	1	0	258	0	0	259
13128	250	0	0	0	0	250
13129	0	247	0	1	0	248
13130	235	0	1	0	0	236
13131	239	0	0	0	0	239
13132	0	252	0	0	0	252
13133	0	244	0	0	0	244
13134	235	0	0	0	0	235
13135	239	0	1	0	0	240
13136	1	1	0	252	0	254
13137	0	269	0	0	0	269
13138	253	0	0	0	0	253
13139	0	269	0	1	0	270
13140	0	1	0	254	0	255
13141	246	0	1	0	0	247
13142	237	0	1	0	0	238
13143	0	0	0	246	0	246
13144	0	1	0	262	0	263
13145	0	0	295	0	0	295
13146	0	4	0	275	0	279
13147	1	0	311	0	0	312
13148	7	0	0	286	0	293
13149	1	3	0	273	0	277
13150	303	0	1	2	0	306
13151	292	0	5	1	0	298
13152	1	0	318	0	0	319
13153	317	0	3	2	0	322
13154	1	3	0	312	0	316
13155	0	0	324	0	0	324
13156	0	2	0	317	0	319
13157	0	2	0	332	0	334
13158	0	0	385	0	0	385
13159	0	0	1	384	0	385
13160	0	1	417	0	0	418
13161	0	1	0	422	0	423
13162	433	0	1	2	0	436
13163	0	446	0	1	0	447
13164	432	0	6	0	0	438
13165	0	464	1	0	0	465
13166	457	0	0	0	0	457
13167	0	561	0	0	0	561
13168	548	0	1	1	0	550
13169	0	581	0	3	0	584
13170	0	1	0	548	0	549
13171	0	0	583	0	0	583
13172	1	0	620	0	0	621
13173	1	0	0	591	0	592
13174	616	0	1	0	0	617
13175	0	632	0	0	0	632
13176	0	4	0	599	0	603
13177	0	0	629	0	0	629
13178	1	0	633	0	0	634
13179	6	2	0	612	0	620
13180	0	649	0	0	0	649
13181	640	0	0	0	0	640
13182	0	0	657	0	0	657
13183	0	0	658	0	0	658
13184	0	661	0	1	0	662
13185	665	0	1	0	0	666
13186	597	0	0	0	0	597
13187	0	3	0	656	0	659
13188	648	0	0	0	0	648
13189	639	0	0	0	0	639
13190	0	702	0	1	0	703
13191	680	0	2	0	0	682
13192	0	0	697	0	0	697
13193	0	4	0	688	0	692
13194	0	1	0	698	0	699
13195	684	0	1	0	0	685
13196	0	726	0	0	0	726
13197	707	2	2	0	0	711
13198	0	722	0	0	0	722
13199	0	673	0	0	0	673
13200	0	0	681	0	0	681
13201	0	0	699	0	0	699
13202	694	0	2	0	0	696
13203	694	0	2	0	0	696
13204	3	0	739	0	0	742
13205	0	741	0	0	0	741
13206	0	724	0	1	0	725
13207	743	0	3	3	0	749
13208	714	0	2	0	0	716
13209	0	1	0	733	0	734
13210	737	0	0	1	0	738
13211	0	0	0	751	0	751
13212	0	0	723	0	0	723
13213	2	0	734	0	0	736
13214	739	0	1	0	0	740
13215	0	1	0	722	0	723
13216	0	749	0	0	0	749
13217	732	0	6	0	0	738
13218	709	0	0	1	0	710
13219	0	0	748	0	0	748
13220	746	1	0	2	0	749
13221	689	0	1	0	0	690
13222	0	1	0	782	0	783
13223	0	797	0	0	0	797
13224	0	788	0	10	0	798
13225	0	2	0	782	0	784
13226	0	3	0	770	0	773
13227	9	2	0	827	0	838
13228	1	0	840	0	0	841
13229	2	0	872	0	0	874
13230	4	5	0	849	0	858
13231	0	0	850	0	0	850
13232	0	0	875	0	0	875
13233	2	2	0	858	0	862
13234	0	0	877	0	0	877
13235	0	865	0	2	0	867
13236	876	0	7	0	0	883
13237	0	0	0	861	0	861
13238	0	876	0	0	0	876
13239	0	0	886	2	0	888
13240	0	3	0	884	0	887
13241	2	0	901	0	0	903
13242	0	1	0	863	0	864
13243	0	3	0	878	0	881
13244	0	0	914	0	0	914
13245	0	4	0	896	0	900
13246	0	916	0	0	0	916
13247	0	6	0	900	0	906
13248	0	0	929	0	0	929
13249	0	4	0	921	0	925
13250	911	0	1	0	0	912
13251	0	920	0	0	0	920
13252	0	3	0	901	0	904
13253	0	0	891	0	0	891
13254	0	885	0	0	0	885
13255	0	844	0	0	0	844
13256	0	0	887	0	0	887
13257	1	0	0	874	0	875
13258	0	2	0	875	0	877
13259	0	0	890	0	0	890
13260	0	911	0	2	0	913
13261	0	897	0	0	0	897
13262	899	1	3	2	0	905
13263	0	925	0	0	0	925
13264	912	0	1	0	0	913
13265	0	0	0	887	0	887
13266	872	0	0	0	0	872
13267	1	0	890	2	0	893
13268	889	0	0	0	0	889
13269	2	1	0	888	0	891
13270	1	844	0	1	0	846
13271	846	0	0	0	0	846
13272	0	0	0	876	0	876
13273	0	827	0	1	0	828
13274	0	849	0	1	0	850
13275	817	2	6	2	0	827
13276	828	3	0	1	0	832
13277	817	0	2	0	0	819
13278	2	2	0	869	0	873
13279	0	867	0	0	0	867
13280	0	864	0	1	0	865
13281	0	0	0	844	0	844
13282	819	0	0	0	0	819
13283	753	0	1	2	0	756
13284	807	0	0	0	0	807
13285	0	0	845	0	0	845
13286	0	0	833	2	0	835
13287	833	0	0	1	0	834
13288	0	2	1	777	0	780
13289	0	4	0	786	0	790
13290	0	2	0	797	0	799
13291	0	1	0	780	0	781
13292	0	0	829	0	0	829
13293	0	3	0	793	0	796
13294	0	0	824	0	0	824
13295	826	0	1	0	0	827
13296	0	810	0	0	0	810
13297	1	0	0	770	0	771
13298	0	5	0	755	0	760
13299	779	0	0	0	0	779
13300	768	0	2	0	0	770
13301	744	0	6	0	0	750
13302	775	0	1	0	0	776
13303	0	0	798	0	0	798
13304	0	0	819	0	0	819
13305	0	0	0	766	0	766
13306	769	0	1	0	0	770
13307	760	1	2	0	0	763
13308	0	0	814	0	0	814
13309	0	0	0	745	0	745
13310	759	0	0	0	0	759
13311	0	2	0	709	0	711
13312	0	0	736	0	0	736
13313	0	4	0	714	0	718
13314	719	0	2	0	0	721
13315	0	728	0	1	0	729
13316	679	0	4	0	0	683
13317	617	0	1	2	0	620
13318	556	0	4	0	0	560
13319	0	4	0	594	0	598
13320	588	0	2	0	0	590
13321	0	614	0	11	0	625
13322	0	591	0	1	0	592
13323	0	0	0	584	0	584
13324	569	0	1	0	0	570
13325	0	597	0	0	0	597
13326	566	0	1	0	0	567
13327	550	0	1	0	0	551
13328	0	593	0	0	0	593
13329	1	6	0	538	0	545
13330	0	5	0	519	0	524
13331	0	4	553	0	0	557
13332	2	1	0	528	0	531
13333	0	0	563	0	0	563
13334	0	558	0	0	0	558
13335	1	1	0	526	0	528
13336	543	0	0	0	0	543
13337	528	0	1	0	0	529
13338	0	1	0	558	0	559
13339	1	0	560	0	0	561
13340	499	0	1	0	0	500
13341	0	550	0	0	0	550
13342	0	508	0	1	0	509
13343	0	518	0	0	0	518
13344	1	0	0	495	0	496
13345	0	0	530	0	0	530
13346	0	3	3	501	0	507
13347	0	0	505	0	0	505
13348	0	0	502	0	0	502
13349	0	0	506	0	0	506
13350	0	1	0	479	0	480
13351	2	4	0	460	0	466
13352	0	0	0	474	0	474
13353	0	1	0	488	0	489
13354	485	0	2	0	0	487
13355	0	493	0	8	0	501
13356	468	0	5	0	0	473
13357	0	519	0	0	0	519
13358	0	7	0	466	0	473
13359	1	1	0	494	0	496
13360	485	0	1	1	0	487
13361	500	0	1	0	0	501
13362	518	0	2	1	0	521
13363	497	0	3	0	0	500
13364	513	0	1	0	0	514
13365	0	579	0	0	0	579
13366	558	0	1	0	0	559
13367	0	617	0	1	0	618
13368	617	3	4	2	0	626
13369	0	0	711	0	0	711
13370	0	2	0	722	0	724
13371	0	714	0	2	0	716
13372	1	2	0	733	0	736
13373	2	0	767	0	0	769
13374	0	2	0	762	0	764
13375	762	1	5	0	0	768
13376	0	787	0	0	0	787
13377	0	723	0	1	0	724
13378	0	0	770	0	0	770
13379	0	5	0	722	0	727
13380	0	773	0	1	0	774
13381	0	1	0	752	0	753
13382	0	0	787	0	0	787
13383	0	775	0	0	0	775
13384	1	0	731	0	0	732
13385	3	0	805	0	0	808
13386	0	5	0	777	0	782
13387	863	0	2	0	0	865
13388	0	4	0	836	0	840
13389	0	0	912	0	0	912
13390	0	4	0	865	0	869
13391	0	0	892	0	0	892
13392	0	0	895	0	0	895
13393	877	0	2	0	0	879
13394	832	0	6	0	0	838
13395	855	0	4	0	0	859
13396	1	0	924	0	0	925
13397	0	0	930	0	0	930
13398	0	2	0	874	0	876
13399	1	0	0	879	0	880
13400	880	0	2	0	0	882
13401	2	2	0	928	0	932
13402	0	0	927	0	0	927
13403	1	0	946	0	0	947
13404	0	980	0	0	0	980
13405	0	1	0	969	0	970
13406	0	0	994	0	0	994
13407	0	1	0	977	0	978
13408	976	0	2	0	0	978
13409	0	0	1012	0	0	1012
13410	1	5	0	958	0	964
13411	1	2	1	981	0	985
13412	1	0	1001	0	0	1002
13413	0	3	0	991	0	994
13414	0	0	999	0	0	999
13415	970	0	1	0	0	971
13416	0	3	0	1000	0	1003
13417	0	990	0	1	0	991
13418	963	0	5	0	0	968
13419	968	0	1	0	0	969
13420	0	1015	0	0	0	1015
13421	0	2	0	1002	0	1004
13422	0	989	1	0	0	990
13423	0	970	0	0	0	970
13424	2	0	987	0	0	989
13425	0	995	0	2	0	997
13426	1	0	1003	0	0	1004
13427	1010	0	3	0	0	1013
13428	976	0	4	0	0	980
13429	0	1032	0	2	0	1034
13430	0	1014	0	0	0	1014
13431	0	1025	0	4	0	1029
13432	987	0	0	0	0	987
13433	0	4	0	1037	0	1041
13434	0	0	1027	2	0	1029
13435	0	1048	0	0	0	1048
13436	0	3	0	995	0	998
13437	0	0	0	1029	0	1029
13438	0	1045	0	0	0	1045
13439	1001	0	7	0	0	1008
13440	0	0	1052	0	0	1052
13441	0	3	0	1024	0	1027
13442	0	1046	0	1	0	1047
13443	999	0	2	1	0	1002
13444	2	0	1062	0	0	1064
13445	0	1055	0	0	0	1055
13446	0	1	1	1032	0	1034
13447	1	0	1049	0	0	1050
13448	1044	0	3	1	0	1048
13449	0	3	0	1033	0	1036
13450	0	0	1059	0	0	1059
13451	0	1051	0	0	0	1051
13452	1046	2	0	0	0	1048
13453	0	1053	0	0	0	1053
13454	1003	0	2	0	0	1005
13455	979	0	0	0	0	979
13456	0	7	0	1029	0	1036
13457	0	1017	0	0	0	1017
13458	1	0	1030	0	0	1031
13459	0	3	2	945	0	950
13460	1	1	0	939	0	941
13461	1	2	0	937	0	940
13462	2	1	0	945	0	948
13463	0	1	2	999	0	1002
13464	980	0	0	1	0	981
13465	920	0	7	0	0	927
13466	950	0	2	0	0	952
13467	0	1010	0	0	0	1010
13468	1	0	978	0	0	979
13469	0	0	982	0	0	982
13470	0	0	1026	0	0	1026
13471	0	0	0	969	0	969
13472	0	0	0	935	0	935
13473	0	4	0	972	0	976
13474	0	0	1003	0	0	1003
13475	2	991	0	1	0	994
13476	0	0	933	0	0	933
13477	0	0	973	0	0	973
13478	1	0	0	1002	0	1003
13479	1	0	1020	0	0	1021
13480	0	0	0	924	0	924
13481	1036	0	0	0	0	1036
13482	1021	0	4	0	0	1025
13483	2	0	1039	0	0	1041
13484	0	2	0	1021	0	1023
13485	3	0	1024	0	0	1027
13486	0	1021	0	0	0	1021
13487	968	0	1	0	0	969
13488	0	0	1010	0	0	1010
13489	0	996	0	0	0	996
13490	0	977	0	0	0	977
13491	0	937	0	1	0	938
13492	5	0	1054	0	0	1059
13493	0	6	1	1021	0	1028
13494	0	1061	0	0	0	1061
13495	0	3	0	1024	0	1027
13496	0	3	0	1039	0	1042
13497	1036	0	0	0	0	1036
13498	0	1060	0	1	0	1061
13499	994	0	11	0	0	1005
13500	0	1030	0	1	0	1031
13501	0	846	0	0	0	846
13502	1	0	879	0	0	880
13503	0	5	0	851	0	856
13504	0	0	866	0	0	866
13505	0	838	0	3	0	841
13506	0	0	844	0	0	844
13507	1	0	867	0	0	868
13508	0	852	0	0	0	852
13509	834	0	5	0	0	839
13510	0	853	0	0	0	853
13511	797	0	3	0	0	800
13512	0	0	780	0	0	780
13513	0	0	807	0	0	807
13514	0	820	0	6	0	826
13515	820	0	1	0	0	821
13516	0	793	0	0	0	793
13517	0	2	0	756	0	758
13518	777	0	3	0	0	780
13519	0	3	762	1	0	766
13520	1	0	0	726	0	727
13521	680	0	3	0	0	683
13522	0	697	1	12	0	710
13523	2	0	0	647	0	649
13524	2	0	644	0	0	646
13525	621	0	0	0	0	621
13526	1	3	0	610	0	614
13527	1	0	617	0	0	618
13528	1	5	0	554	0	560
13529	0	576	0	1	0	577
13530	0	0	580	1	0	581
13531	0	1	0	565	0	566
13532	558	0	0	0	0	558
13533	0	2	0	542	0	544
13534	523	1	3	1	0	528
13535	0	552	0	1	0	553
13536	412	0	0	2	0	414
13537	0	0	416	0	0	416
13538	1	0	392	0	0	393
13539	0	0	393	0	0	393
13540	0	392	0	0	0	392
13541	0	2	0	352	0	354
13542	0	2	0	340	0	342
13543	0	1	0	357	0	358
13544	0	2	0	365	0	367
13545	0	0	375	0	0	375
13546	360	0	1	0	0	361
13547	0	362	0	4	0	366
13548	336	0	4	0	0	340
13549	0	0	0	332	0	332
13550	0	338	0	0	0	338
13551	0	0	0	339	0	339
13552	334	0	0	0	0	334
13553	0	334	0	0	0	334
13554	329	0	1	0	0	330
13555	300	2	1	1	0	304
13556	1	1	0	313	0	315
13557	0	0	326	0	0	326
13558	308	0	1	0	0	309
13559	0	0	0	263	0	263
13560	264	0	1	0	0	265
13561	244	0	1	0	0	245
13562	261	0	4	0	0	265
13563	0	0	280	0	0	280
13564	3	0	0	253	0	256
13565	229	0	0	0	0	229
13566	0	0	228	0	0	228
13567	0	229	0	1	0	230
13568	4	0	0	216	0	220
13569	0	0	227	0	0	227
13570	0	0	219	0	0	219
13571	0	0	0	208	0	208
13572	0	0	0	196	0	196
13573	0	1	1	193	0	195
13574	0	2	0	216	0	218
13575	0	0	220	0	0	220
13576	0	226	0	0	0	226
13577	0	1	0	221	0	222
13578	224	0	1	0	0	225
13579	217	0	0	1	0	218
13580	213	0	0	0	0	213
13581	0	1	0	221	0	222
13582	0	1	0	230	0	231
13583	0	221	0	0	0	221
13584	0	225	0	1	0	226
13585	0	0	0	237	0	237
13586	225	0	0	0	0	225
13587	219	0	1	0	0	220
13588	218	0	3	1	0	222
13589	208	0	1	0	0	209
13590	224	1	2	0	0	227
13591	0	243	0	0	0	243
13592	1	0	0	237	0	238
13593	238	0	0	0	0	238
13594	210	0	1	0	0	211
13595	0	2	1	221	0	224
13596	0	0	0	236	0	236
13597	0	0	242	0	0	242
13598	0	1	0	233	0	234
13599	1	0	0	230	0	231
13600	0	0	238	0	0	238
13601	0	0	0	230	0	230
13602	0	225	0	0	0	225
13603	0	0	222	0	0	222
13604	0	238	0	0	0	238
13605	0	1	0	229	0	230
13606	2	0	0	221	0	223
13607	0	242	0	0	0	242
13608	0	234	0	0	0	234
13609	234	0	0	0	0	234
13610	221	0	2	2	0	225
13611	0	0	243	0	0	243
13612	237	0	1	0	0	238
13613	223	0	3	0	0	226
13614	213	0	0	0	0	213
13615	226	0	0	1	0	227
13616	0	0	242	0	0	242
13617	2	0	237	0	0	239
13618	232	0	1	0	0	233
13619	0	234	0	0	0	234
13620	0	0	231	0	0	231
13621	237	0	0	1	0	238
13622	230	0	0	0	0	230
13623	0	0	232	0	0	232
13624	230	0	1	0	0	231
13625	0	1	0	231	0	232
13626	0	0	236	0	0	236
13627	223	0	3	0	0	226
13628	0	225	0	3	0	228
13629	230	0	0	0	0	230
13630	209	0	0	0	0	209
13631	1	0	0	228	0	229
13632	1	1	0	230	0	232
13633	0	0	0	234	0	234
13634	237	0	1	0	0	238
13635	227	1	1	0	0	229
13636	0	3	0	228	0	231
13637	0	0	0	228	0	228
13638	0	0	249	0	0	249
13639	248	0	1	0	0	249
13640	1	0	0	225	0	226
13641	1	3	0	239	0	243
13642	0	208	0	0	0	208
13643	1	0	0	191	0	192
13644	0	0	0	206	0	206
13645	208	0	0	0	0	208
13646	0	214	0	0	0	214
13647	4	1	1	193	0	199
13648	1	1	0	194	0	196
13649	0	0	0	200	0	200
13650	1	0	212	0	0	213
13651	0	0	0	215	0	215
13652	215	0	0	0	0	215
13653	0	0	233	0	0	233
13654	0	0	0	215	0	215
13655	0	1	0	204	0	205
13656	218	0	1	0	0	219
13657	217	0	3	0	0	220
13658	0	0	224	0	0	224
13659	225	0	1	0	0	226
13660	0	0	235	0	0	235
13661	219	0	2	0	0	221
13662	0	230	0	0	0	230
13663	231	0	0	0	0	231
13664	0	249	0	0	0	249
13665	243	1	2	1	0	247
13666	0	253	0	0	0	253
13667	0	5	0	230	0	235
13668	0	2	0	238	0	240
13669	0	4	0	254	0	258
13670	0	266	0	0	0	266
13671	0	1	0	261	0	262
13672	0	276	0	0	0	276
13673	0	3	0	265	0	268
13674	266	0	1	0	0	267
13675	261	0	0	2	0	263
13676	0	283	0	0	0	283
13677	0	0	0	274	0	274
13678	277	0	2	0	0	279
13679	0	288	0	0	0	288
13680	0	271	0	0	0	271
13681	273	0	2	0	0	275
13682	282	0	3	0	0	285
13683	0	289	0	1	0	290
13684	285	0	2	0	0	287
13685	1	3	0	282	0	286
13686	0	0	296	0	0	296
13687	282	0	0	0	0	282
13688	283	0	0	0	0	283
13689	0	0	301	0	0	301
13690	299	1	0	0	0	300
13691	271	0	1	0	0	272
13692	273	0	3	0	0	276
13693	0	313	0	0	0	313
13694	296	0	2	1	0	299
13695	301	0	1	1	0	303
13696	0	1	0	304	0	305
13697	0	2	0	329	0	331
13698	0	0	0	328	0	328
13699	333	0	2	0	0	335
13700	5	0	0	321	0	326
13701	324	0	0	5	0	329
13702	295	0	0	0	0	295
13703	1	1	0	319	0	321
13704	0	1	0	314	0	315
13705	0	2	0	336	0	338
13706	339	0	1	0	0	340
13707	0	358	0	0	0	358
13708	0	1	0	324	0	325
13709	0	0	0	328	0	328
13710	307	0	1	1	0	309
13711	337	0	0	1	0	338
13712	0	0	344	0	0	344
13713	0	0	353	0	0	353
13714	357	0	0	0	0	357
13715	0	0	0	340	0	340
13716	3	4	0	337	0	344
13717	0	0	369	0	0	369
13718	0	3	0	357	0	360
13719	0	360	0	0	0	360
13720	0	345	0	0	0	345
13721	348	0	7	0	0	355
13722	0	0	378	0	0	378
13723	0	382	0	0	0	382
13724	0	0	0	366	0	366
13725	0	7	379	0	0	386
13726	0	2	0	378	0	380
13727	0	3	2	393	0	398
13728	4	0	404	1	0	409
13729	1	409	0	7	0	417
13730	3	1	0	401	0	405
13731	416	0	1	0	0	417
13732	392	0	2	0	0	394
13733	402	0	8	1	0	411
13734	0	431	0	0	0	431
13735	415	0	3	0	0	418
13736	0	0	0	420	0	420
13737	0	0	416	0	0	416
13738	424	0	0	1	0	425
13739	0	446	0	0	0	446
13740	0	3	0	406	0	409
13741	1	0	0	443	0	444
13742	0	473	0	0	0	473
13743	3	3	0	449	0	455
13744	0	4	0	442	0	446
13745	0	1	0	471	0	472
13746	471	0	0	1	0	472
13747	497	0	0	0	0	497
13748	0	0	524	0	0	524
13749	2	1	1	506	0	510
13750	0	0	0	484	0	484
13751	1	0	0	493	0	494
13752	520	0	1	0	0	521
13753	0	0	530	0	0	530
13754	518	0	1	0	0	519
13755	502	0	1	0	0	503
13756	0	0	0	533	0	533
13757	537	0	0	2	0	539
13758	1	0	537	0	0	538
13759	516	0	0	1	0	517
13760	0	532	0	0	0	532
13761	2	0	499	0	0	501
13762	0	0	543	0	0	543
13763	1	0	0	544	0	545
13764	2	0	541	0	0	543
13765	531	0	5	0	0	536
13766	0	540	0	0	0	540
13767	533	0	0	0	0	533
13768	0	3	0	538	0	541
13769	0	0	530	2	0	532
13770	3	0	569	0	0	572
13771	0	2	0	561	0	563
13772	565	0	2	0	0	567
13773	0	583	0	0	0	583
13774	0	564	0	1	0	565
13775	585	0	0	0	0	585
13776	0	594	0	1	0	595
13777	584	0	0	1	0	585
13778	1	0	4	578	0	583
13779	554	0	1	0	0	555
13780	2	1	0	578	0	581
13781	545	0	2	1	0	548
13782	0	2	0	601	0	603
13783	0	564	0	3	0	567
13784	558	0	6	4	0	568
13785	0	554	1	2	0	557
13786	0	0	592	0	0	592
13787	0	1	0	570	0	571
13788	1	571	0	4	0	576
13789	559	1	2	2	0	564
13790	578	0	4	0	0	582
13791	1	573	0	0	0	574
13792	0	0	577	0	0	577
13793	0	2	0	538	0	540
13794	0	585	0	0	0	585
13795	3	2	0	561	0	566
13796	0	3	0	568	0	571
13797	589	0	2	0	0	591
13798	0	603	0	0	0	603
13799	0	1	0	589	0	590
13800	570	0	3	0	0	573
13801	565	0	1	0	0	566
13802	548	0	4	0	0	552
13803	0	2	0	581	0	583
13804	561	0	4	0	0	565
13805	0	589	1	0	0	590
13806	563	0	2	0	0	565
13807	0	588	0	0	0	588
13808	550	0	3	0	0	553
13809	527	0	2	0	0	529
13810	0	0	4	569	0	573
13811	2	0	543	0	0	545
13812	2	0	568	0	0	570
13813	0	576	0	0	0	576
13814	532	0	2	0	0	534
13815	0	0	546	0	0	546
13816	524	0	0	0	0	524
13817	0	554	0	11	0	565
13818	5	573	0	0	0	578
13819	0	0	0	664	0	664
13820	0	754	0	1	0	755
13821	1	0	791	1	0	793
13822	2	5	1	772	0	780
13823	2	784	5	14	0	805
13824	21	12	3	784	0	820
13825	760	15	7	28	0	810
13826	0	14	0	805	0	819
13827	0	1	830	0	0	831
13828	0	878	7	0	0	885
13829	1	3	0	794	0	798
13830	0	5	1	777	0	783
13831	1	5	0	794	0	800
13832	769	0	6	2	0	777
13833	804	0	6	0	0	810
13834	0	0	827	0	0	827
13835	1	0	842	0	0	843
13836	0	852	0	1	0	853
13837	806	0	2	0	0	808
13838	0	7	0	758	0	765
13839	1	5	0	769	0	775
13840	0	5	0	816	0	821
13841	0	6	0	817	0	823
13842	0	0	842	0	0	842
13843	824	0	4	1	0	829
13844	1	4	0	809	0	814
13845	1	0	809	0	0	810
13846	775	0	8	0	0	783
13847	811	0	6	0	0	817
13848	1	1	877	0	0	879
13849	1	2	883	0	0	886
13850	1	0	0	867	0	868
13851	887	0	2	1	0	890
13852	833	0	2	2	0	837
13853	0	2	1	901	0	904
13854	1	2	0	924	0	927
13855	3	0	932	0	0	935
13856	0	8	3	892	0	903
13857	0	0	918	0	0	918
13858	873	0	5	2	0	880
13859	0	935	0	2	0	937
13860	886	0	4	2	0	892
13861	0	996	0	1	0	997
13862	935	0	5	0	0	940
13863	0	0	1	872	0	873
13864	1	3	0	923	0	927
13865	819	0	2	3	0	824
13866	893	1	5	2	0	901
13867	861	0	3	0	0	864
13868	915	0	9	1	0	925
13869	0	0	959	0	0	959
13870	929	1	7	1	0	938
13871	860	0	4	1	0	865
13872	849	0	3	0	0	852
13873	1	4	0	931	0	936
13874	933	0	8	0	0	941
13875	0	976	0	1	0	977
13876	0	0	0	901	0	901
13877	1	4	0	904	0	909
13878	2	0	906	0	0	908
13879	1	2	0	960	0	963
13880	0	941	1	0	0	942
13881	938	0	4	1	0	943
13882	0	995	0	0	0	995
13883	996	0	5	1	0	1002
13884	1	1	0	998	0	1000
13885	954	0	1	2	0	957
13886	0	1113	0	3	0	1116
13887	1053	0	3	3	0	1059
13888	936	1	4	1	0	942
13889	0	3	0	1024	0	1027
13890	0	4	0	1092	0	1096
13891	1	0	1116	0	0	1117
13892	2	7	0	993	0	1002
13893	0	3	0	1013	0	1016
13894	1	0	1096	0	0	1097
13895	0	6	0	1030	0	1036
13896	5	0	1056	0	0	1061
13897	1048	0	8	2	0	1058
13898	1	5	1	1002	0	1009
13899	3	0	1078	0	0	1081
13900	1083	0	6	0	0	1089
13901	0	5	1	1045	0	1051
13902	0	0	1104	2	0	1106
13903	1108	0	6	0	0	1114
13904	1	4	0	1003	0	1008
13905	0	2	0	1089	0	1091
13906	1107	0	2	0	0	1109
13907	0	3	0	1055	0	1058
13908	2	5	0	1044	0	1051
13909	2	3	0	1096	0	1101
13910	0	1097	0	0	0	1097
13911	1063	0	5	1	0	1069
13912	1010	0	6	0	0	1016
13913	0	2	0	1086	0	1088
13914	1134	0	0	0	0	1134
13915	1071	0	2	1	0	1074
13916	1045	0	10	1	0	1056
13917	1075	1	8	0	0	1084
13918	1098	0	2	0	0	1100
13919	0	0	1159	0	0	1159
13920	2	0	1160	0	0	1162
13921	1144	0	2	2	0	1148
13922	0	1223	0	0	0	1223
13923	1	7	1	1128	0	1137
13924	1	0	1238	0	0	1239
13925	4	1	1280	1	0	1286
13926	4	4	0	1234	0	1242
13927	1276	0	1	0	0	1277
13928	2	10	1	1231	0	1244
13929	3	0	1300	1	0	1304
13930	1351	0	4	0	0	1355
13931	1	6	0	1234	0	1241
13932	1	2	0	1248	0	1251
13933	1	5	0	1304	0	1310
13934	0	13	5	1326	0	1344
13935	1	1	1395	0	0	1397
13936	1	6	0	1349	0	1356
13937	1376	0	3	0	0	1379
13938	0	0	1359	0	0	1359
13939	1344	0	3	2	0	1349
13940	1307	1	6	2	0	1316
13941	1307	0	10	1	0	1318
13942	1399	3	8	0	0	1410
13943	1	1603	0	0	0	1604
13944	0	1496	9	4	0	1509
13945	1	1635	0	2	0	1638
13946	1641	0	6	3	0	1650
13947	1	2	1862	0	0	1865
13948	1885	2	9	1	0	1897
13949	1	9	0	1809	0	1819
13950	2008	0	12	1	0	2021
13951	0	3	0	2088	0	2091
13952	2057	60	4	4	0	2125
13953	0	14	0	2065	0	2079
13954	3	4	0	2155	0	2162
13955	1885	1	2	1	0	1889
13956	0	2123	0	6	0	2129
13957	5	2	2065	0	0	2072
13958	0	2225	0	0	0	2225
13959	3	0	2188	0	0	2191
13960	4	2	1	2244	0	2251
13961	2296	0	2	1	0	2299
13962	5	4	0	2280	0	2289
13963	2328	0	4	1	0	2333
13964	0	2369	1	6	0	2376
13965	8	1	2212	0	0	2221
13966	0	2391	0	1	0	2392
13967	0	2286	0	2	0	2288
13968	2374	0	5	3	0	2382
13969	2404	1	5	6	0	2416
13970	0	2493	0	0	0	2493
13971	2	5	0	2307	0	2314
13972	1	4	0	2331	0	2336
13973	2381	0	4	1	0	2386
13974	4	0	2475	2	0	2481
13975	0	0	2530	0	0	2530
13976	0	10	0	2502	0	2512
13977	2	0	2501	0	0	2503
13978	2517	0	5	3	0	2525
13979	2422	0	12	0	0	2434
13980	0	2662	2	4	0	2668
13981	6	0	2597	0	0	2603
13982	13	9	0	2645	0	2667
13983	2	0	2738	0	0	2740
13984	0	8	0	2711	0	2719
13985	2628	0	7	1	0	2636
13986	0	2791	1	1	0	2793
13987	2	0	2632	0	0	2634
13988	0	2769	1	2	0	2772
13989	1	2668	1	6	0	2676
13990	2691	0	15	5	0	2711
13991	2633	0	4	0	0	2637
13992	0	0	2793	0	0	2793
13993	0	2819	14	1	0	2834
13994	1	12	3	2680	0	2696
13995	2	19	0	2599	0	2620
13996	14	26	0	2738	0	2778
13997	5	0	3088	1	0	3094
13998	7	10	2	2834	0	2853
13999	0	17	0	2815	0	2832
14000	2863	2	13	2	0	2880
14001	2797	0	9	1	0	2807
14002	2898	0	14	0	0	2912
14003	2887	0	27	2	0	2916
14004	2929	12	30	0	0	2971
14005	2	3233	0	3	0	3238
14006	3070	2	19	2	0	3093
14007	1	0	3307	0	0	3308
14008	1	17	2	3406	0	3426
14009	3420	1	11	1	0	3433
14010	0	3572	0	4	0	3576
14011	3509	2	33	9	0	3553
14012	3338	0	7	2	0	3347
14013	0	13	1	3448	0	3462
14014	3	17	0	3624	0	3644
14015	1	3744	0	8	0	3753
14016	3	23	0	3643	0	3669
14017	4	25	3886	1	0	3916
14018	3	7	0	3861	0	3871
14019	4	0	3889	0	0	3893
14020	3907	1	6	5	0	3919
14021	3	14	0	3932	0	3949
14022	4	0	3982	0	0	3986
14023	0	4087	0	1	0	4088
14024	0	4077	1	9	0	4087
14025	4080	0	8	4	0	4092
14026	1	13	0	4012	0	4026
14027	3	0	4097	0	0	4100
14028	0	4197	0	0	0	4197
14029	13	0	4135	1	0	4149
14030	4300	2	4	1	0	4307
14031	4047	0	13	4	0	4064
14032	3892	0	19	0	0	3911
14033	0	10	20	4266	0	4296
14034	1	0	4386	0	0	4387
14035	0	4346	0	3	0	4349
14036	7	12	2	4164	0	4185
14037	9	0	4175	8	0	4192
14038	3	0	4401	0	0	4404
14039	3	12	1	4232	0	4248
14040	4382	0	9	1	0	4392
14041	2	25	1	4094	0	4122
14042	2	7	0	4404	0	4413
14043	4	1	4610	2	0	4617
14044	3	15	0	4472	0	4490
14045	5	11	0	4534	0	4550
14046	9	1	4368	2	0	4380
14047	1	1	4763	0	0	4765
14048	1	15	3	4726	0	4745
14049	22	0	4836	0	0	4858
14050	0	7	0	4758	0	4765
14051	4777	0	10	1	0	4788
14052	0	4819	0	2	0	4821
14053	5	18	0	4557	0	4580
14054	7	0	4784	0	0	4791
14055	4773	2	20	7	0	4802
14056	0	4863	0	3	0	4866
14057	4802	0	8	1	0	4811
14058	1	11	0	4430	0	4442
14059	1	8	0	4682	0	4691
14060	4734	0	8	5	0	4747
14061	3	0	4852	0	0	4855
14062	4781	0	24	4	0	4809
14063	0	10	0	4613	0	4623
14064	4605	0	17	40	0	4662
14065	4237	0	17	1	0	4255
14066	25	5	0	4747	0	4777
14067	0	4837	0	5	0	4842
14068	4667	1	10	0	0	4678
14069	4580	0	13	0	0	4593
14070	0	0	4801	19	0	4820
14071	4697	0	12	1	0	4710
14072	5	12	0	4902	0	4919
14073	128	4770	0	3	0	4901
14074	3	15	3	4840	0	4861
14075	0	4880	8	6	0	4894
14076	4936	4	11	2	0	4953
14077	4704	0	15	1	0	4720
14078	0	29	2	5007	0	5038
14079	2	0	5013	2	0	5017
14080	8	2	5129	2	0	5141
14081	4	10	0	4764	0	4778
14082	4872	0	12	0	0	4884
14083	4759	0	11	0	0	4770
14084	0	5051	0	1	0	5052
14085	7	7	2	4886	0	4902
14086	3	0	4921	6	0	4930
14087	3	2	5060	0	0	5065
14088	2	7	0	4817	0	4826
14089	4805	0	26	2	0	4833
14090	1	24	2	4876	0	4903
14091	6	0	5048	0	0	5054
14092	4961	2	7	2	0	4972
14093	0	12	1	4498	0	4511
14094	19	11	2	4513	0	4545
14095	3	8	2	4668	0	4681
14096	1	4559	0	3	0	4563
14097	4	1	4364	0	0	4369
14098	4	0	4591	0	0	4595
14099	1	12	3	4497	0	4513
14100	5	0	4429	0	0	4434
14101	4392	0	15	1	0	4408
14102	0	11	1	4052	0	4064
14103	1	17	0	4140	0	4158
14104	5	25	1	4276	0	4307
14105	0	4361	0	17	0	4378
14106	4303	0	20	0	0	4323
14107	0	20	1	4245	0	4266
14108	4240	0	6	4	0	4250
14109	0	4251	2	10	0	4263
14110	3997	1	19	1	0	4018
14111	3899	0	19	2	0	3920
14112	3877	0	4	3	0	3884
14113	0	4073	1	0	0	4074
14114	0	3928	0	2	0	3930
14115	3806	0	9	2	0	3817
14116	0	3786	18	6	0	3810
14117	6	0	3739	0	0	3745
14118	0	3816	0	4	0	3820
14119	0	3703	0	6	0	3709
14120	3591	0	19	2	0	3612
14121	4	0	3663	0	0	3667
14122	20	2	3716	0	0	3738
14123	3	8	2	3554	0	3567
14124	3597	0	12	1	0	3610
14125	6	0	3585	0	0	3591
14126	20	16	0	3401	0	3437
14127	3	0	3352	0	0	3355
14128	1	0	3373	0	0	3374
14129	3131	1	19	10	0	3161
14130	5	0	3202	2	0	3209
14131	3	18	1	2699	0	2721
14132	3	17	0	2700	0	2720
14133	0	2656	13	8	0	2677
14134	1	2657	0	1	0	2659
14135	3	24	0	2580	0	2607
14136	5	0	2700	1	0	2706
14137	4	23	8	2381	0	2416
14138	3	15	2	2448	0	2468
14139	4	0	2590	0	0	2594
14140	0	5	0	2529	0	2534
14141	2532	0	8	2	0	2542
14142	3	0	2566	0	0	2569
14143	2449	0	8	0	0	2457
14144	0	17	0	2274	0	2291
14145	1	11	1	2400	0	2413
14146	0	2431	0	3	0	2434
14147	2	17	0	2268	0	2287
14148	0	8	0	2326	0	2334
14149	2369	0	6	2	0	2377
14150	4	12	0	2109	0	2125
14151	2	7	1	2347	0	2357
14152	2326	0	3	0	0	2329
14153	18	12	0	2136	0	2166
14154	4	5	1	2287	0	2297
14155	1	2248	0	5	0	2254
14156	2078	1	7	1	0	2087
14157	2	7	2	1927	0	1938
14158	1	7	0	2061	0	2069
14159	2	0	2258	0	0	2260
14160	6	19	0	2106	0	2131
14161	4	6	0	1991	0	2001
14162	2088	0	5	1	0	2094
14163	1949	2	10	0	0	1961
14164	0	3	1	2258	0	2262
14165	10	0	2268	0	0	2278
14166	0	2198	0	1	0	2199
14167	0	2198	4	0	0	2202
14168	0	8	1	2033	0	2042
14169	2404	0	1	2	0	2407
14170	1	5	0	2450	0	2456
14171	2437	0	8	0	0	2445
14172	4	10	0	2370	0	2384
14173	1	13	0	2353	0	2367
14174	2099	0	1	9	0	2109
14175	2319	0	5	6	0	2330
14176	0	2497	0	15	0	2512
14177	7	2430	0	2	0	2439
14178	0	2	0	2185	0	2187
14179	4	10	0	2165	0	2179
14180	4	1	2270	0	0	2275
14181	2213	0	7	2	0	2222
14182	0	2312	0	4	0	2316
14183	0	2184	0	2	0	2186
14184	2097	0	1	2	0	2100
14185	3	2	2199	0	0	2204
14186	1	0	2172	0	0	2173
14187	7	0	2102	0	0	2109
14188	17	2027	5	4	0	2053
14189	1	7	6	1890	0	1904
14190	14	7	2	1762	0	1785
14191	2	3	0	1857	0	1862
14192	1745	0	5	2	0	1752
14193	1877	0	3	12	0	1892
14194	0	1999	0	0	0	1999
14195	2	3	1	1919	0	1925
14196	1	0	1953	0	0	1954
14197	0	1933	3	1	0	1937
14198	1850	0	7	1	0	1858
14199	0	0	1923	0	0	1923
14200	1869	0	3	1	0	1873
14201	11	3	1964	1	0	1979
14202	4	8	0	1948	0	1960
14203	0	1980	0	3	0	1983
14204	1914	1	6	3	0	1924
14205	0	2035	0	0	0	2035
14206	1971	1	6	1	0	1979
14207	4	4	1	2061	0	2070
14208	3	0	2088	1	0	2092
14209	2	4	0	2008	0	2014
14210	1	14	1	1952	0	1968
14211	1	0	1971	1	0	1973
14212	1978	0	6	0	0	1984
14213	0	2031	0	7	0	2038
14214	1936	1	5	0	0	1942
14215	0	1960	0	0	0	1960
14216	0	7	0	1827	0	1834
14217	2	0	1882	0	0	1884
14218	1896	0	4	3	0	1903
14219	2	1916	0	0	0	1918
14220	1	9	0	1823	0	1833
14221	3	3	0	1814	0	1820
14222	1685	1	2	4	0	1692
14223	1773	1	2	0	0	1776
14224	0	1858	0	5	0	1863
14225	1693	0	5	1	0	1699
14226	1576	2	9	1	0	1588
14227	1568	0	9	0	0	1577
14228	5	0	1632	0	0	1637
14229	0	1638	0	0	0	1638
14230	0	1579	0	6	0	1585
14231	2	3	1	1522	0	1528
14232	4	2	0	1524	0	1530
14233	1515	0	3	1	0	1519
14234	3	1658	0	1	0	1662
14235	1578	0	7	0	0	1585
14236	2	4	0	1437	0	1443
14237	0	8	0	1321	0	1329
14238	1211	0	6	6	0	1223
14239	1293	1	6	1	0	1301
14240	10	2	1391	0	0	1403
14241	19	3	10	1319	0	1351
14242	1	0	1294	0	0	1295
14243	7	1	1173	0	0	1181
14244	0	0	1167	1	0	1168
14245	1159	1	6	0	0	1166
14246	1	4	0	1022	0	1027
14247	9	2	0	991	0	1002
14248	0	3	2	1086	0	1091
14249	0	0	1154	0	0	1154
14250	2	3	0	1080	0	1085
14251	2	3	0	1010	0	1015
14252	1043	0	5	2	0	1050
14253	1092	0	8	1	0	1101
14254	1076	0	9	0	0	1085
14255	1091	1	8	0	0	1100
14256	6	6	0	1097	0	1109
14257	1125	0	2	1	0	1128
14258	1	5	0	1138	0	1144
14259	1	0	1148	0	0	1149
14260	1133	0	3	3	0	1139
14261	0	1187	0	1	0	1188
14262	1	3	0	1073	0	1077
14263	3	1	0	1157	0	1161
14264	0	1121	0	0	0	1121
14265	1160	1	14	0	0	1175
14266	0	1192	0	1	0	1193
14267	3	1	1106	0	0	1110
14268	0	0	1172	0	0	1172
14269	1157	0	2	3	0	1162
14270	1150	0	7	1	0	1158
14271	1	0	1199	0	0	1200
14272	1200	1	7	0	0	1208
14273	0	0	1185	0	0	1185
14274	1178	0	8	0	0	1186
14275	2	0	1209	0	0	1211
14276	0	0	1296	0	0	1296
14277	0	3	0	1223	0	1226
14278	2	4	0	1162	0	1168
14279	1277	0	6	2	0	1285
14280	1187	2	9	0	0	1198
14281	1232	0	3	0	0	1235
14282	1256	4	8	1	0	1269
14283	0	1382	0	2	0	1384
14284	2	7	0	1264	0	1273
14285	1	1359	0	0	0	1360
14286	3	6	0	1246	0	1255
14287	1	2	0	1212	0	1215
14288	1	7	1	1324	0	1333
14289	0	1	1346	0	0	1347
14290	1362	1	1	2	0	1366
14291	0	1385	0	2	0	1387
14292	2	1221	0	2	0	1225
14293	0	0	1336	0	0	1336
14294	2	3	0	1290	0	1295
14295	2	5	0	1283	0	1290
14296	1354	0	2	1	0	1357
14297	0	3	0	1291	0	1294
14298	0	9	0	1307	0	1316
14299	1	12	0	1327	0	1340
14300	4	0	0	1328	0	1332
14301	1317	0	4	2	0	1323
14302	1381	0	7	1	0	1389
14303	1322	0	4	1	0	1327
14304	0	4	0	1370	0	1374
14305	1365	0	3	1	0	1369
14306	3	1	0	1334	0	1338
14307	2	2	0	1379	0	1383
14308	1	0	1353	1	0	1355
14309	1	0	1375	0	0	1376
14310	0	0	1387	6	0	1393
14311	1386	0	6	0	0	1392
14312	0	2	0	1370	0	1372
14313	0	1468	0	2	0	1470
14314	1402	0	4	2	0	1408
14315	0	0	1447	0	0	1447
14316	1373	0	5	3	0	1381
14317	0	1438	1	4	0	1443
14318	1359	1	6	1	0	1367
14319	0	2	2	1301	0	1305
14320	1216	4	6	5	0	1231
14321	0	1312	0	3	0	1315
14322	0	1203	0	3	0	1206
14323	1257	0	0	1	0	1258
14324	0	1283	0	1	0	1284
14325	0	1200	0	0	0	1200
14326	0	1234	0	0	0	1234
14327	1242	0	2	0	0	1244
14328	1161	1	5	0	0	1167
14329	1151	0	6	0	0	1157
14330	0	5	1	1144	0	1150
14331	0	2	0	1216	0	1218
14332	1	0	1284	0	0	1285
14333	1	1	0	1190	0	1192
14334	2	0	1252	0	0	1254
14335	2	5	0	1144	0	1151
14336	2	6	0	1101	0	1109
14337	1083	0	4	5	0	1092
14338	1152	0	2	0	0	1154
14339	0	1256	0	0	0	1256
14340	1	7	0	1153	0	1161
14341	0	0	1245	0	0	1245
14342	0	2	1	1105	0	1108
14343	0	4	0	1060	0	1064
14344	2	6	0	1142	0	1150
14345	1	2	1141	0	0	1144
14346	1	0	1156	0	0	1157
14347	1190	0	1	0	0	1191
14348	0	11	0	1147	0	1158
14349	1	0	1177	1	0	1179
14350	1153	0	2	1	0	1156
14351	1	1192	0	2	0	1195
14352	1124	0	2	2	0	1128
14353	1	0	1181	0	0	1182
14354	1167	0	4	3	0	1174
14355	1	4	1	1221	0	1227
14356	2	0	1196	0	0	1198
14357	0	1185	0	4	0	1189
14358	1225	0	9	2	0	1236
14359	1	10	0	1112	0	1123
14360	2	3	0	1219	0	1224
14361	1	1247	0	0	0	1248
14362	2	3	4	1230	0	1239
14363	0	0	1263	0	0	1263
14364	0	1175	1	1	0	1177
14365	1263	0	6	1	0	1270
14366	2	4	0	1172	0	1178
14367	1	4	0	1169	0	1174
14368	1	0	1261	0	0	1262
14369	1	3	0	1221	0	1225
14370	1	0	1263	0	0	1264
14371	0	1227	0	1	0	1228
14372	1215	0	4	0	0	1219
14373	1166	0	6	1	0	1173
14374	1183	2	3	0	0	1188
14375	0	1280	0	5	0	1285
14376	1	2	1	1199	0	1203
14377	2	5	2	1147	0	1156
14378	9	1	1	1101	0	1112
14379	1200	0	2	1	0	1203
14380	1095	0	5	0	0	1100
14381	1	1	0	1223	0	1225
14382	0	0	1299	0	0	1299
14383	0	3	0	1235	0	1238
14384	0	5	0	1187	0	1192
14385	1	5	1	1218	0	1225
14386	0	3	0	1268	0	1271
14387	1287	0	2	1	0	1290
14388	0	4	0	1239	0	1243
14389	0	2	0	1375	0	1377
14390	0	1358	0	1	0	1359
14391	1	11	0	1357	0	1369
14392	0	1420	0	1	0	1421
14393	0	5	0	1427	0	1432
14394	1379	0	2	0	0	1381
14395	0	1447	1	2	0	1450
14396	1333	0	6	2	0	1341
14397	1	0	1459	0	0	1460
14398	2	6	1	1427	0	1436
14399	2	0	1483	0	0	1485
14400	2	3	0	1336	0	1341
14401	3	6	2	1350	0	1361
14402	0	1310	2	2	0	1314
14403	2	1343	0	1	0	1346
14404	3	1369	0	0	0	1372
14405	1362	0	5	0	0	1367
14406	0	1400	0	1	0	1401
14407	0	1353	0	0	0	1353
14408	0	2	0	1382	0	1384
14409	1343	0	1	2	0	1346
14410	0	1396	0	0	0	1396
14411	1313	0	2	1	0	1316
14412	1278	0	5	0	0	1283
14413	1	0	1415	0	0	1416
14414	1	6	0	1306	0	1313
14415	1	6	0	1271	0	1278
14416	1	5	0	1288	0	1294
14417	1	5	0	1350	0	1356
14418	2	0	1322	0	0	1324
14419	1	0	1368	0	0	1369
14420	1318	1	7	1	0	1327
14421	0	1382	0	5	0	1387
14422	0	1311	0	0	0	1311
14423	1334	0	2	2	0	1338
14424	0	1380	0	0	0	1380
14425	1	3	0	1318	0	1322
14426	1323	0	0	0	0	1323
14427	1	1	1387	0	0	1389
14428	9	6	0	1284	0	1299
14429	3	0	1333	0	0	1336
14430	1273	0	4	1	0	1278
14431	0	0	1287	0	0	1287
14432	1271	0	5	2	0	1278
14433	1193	0	8	0	0	1201
14434	1203	0	9	1	0	1213
14435	1189	0	3	0	0	1192
14436	1175	0	4	1	0	1180
14437	0	3	0	1224	0	1227
14438	1230	0	2	0	0	1232
14439	0	2	0	1165	0	1167
14440	1	5	0	1152	0	1158
14441	1	4	0	1223	0	1228
14442	2	0	1302	0	0	1304
14443	3	6	0	1220	0	1229
14444	1	4	0	1226	0	1231
14445	1	0	1296	0	0	1297
14446	1272	0	5	3	0	1280
14447	0	4	1	1297	0	1302
14448	2	2	1230	0	0	1234
14449	1	0	1363	0	0	1364
14450	0	4	1	1343	0	1348
14451	1	0	1390	0	0	1391
14452	0	9	0	1291	0	1300
14453	4	3	0	1309	0	1316
14454	0	1368	0	1	0	1369
14455	0	1423	0	0	0	1423
14456	1455	0	3	0	0	1458
14457	0	7	0	1331	0	1338
14458	2	3	0	1374	0	1379
14459	1	3	0	1427	0	1431
14460	4	1	1461	0	0	1466
14461	0	2	0	1449	0	1451
14462	1452	0	2	1	0	1455
14463	2	0	1483	0	0	1485
14464	1	5	0	1335	0	1341
14465	0	3	0	1323	0	1326
14466	3	4	0	1428	0	1435
14467	0	1460	0	1	0	1461
14468	1408	0	6	0	0	1414
14469	1417	0	2	2	0	1421
14470	0	1536	0	0	0	1536
14471	3	2	0	1453	0	1458
14472	2	0	1454	0	0	1456
14473	1	0	1505	0	0	1506
14474	1518	0	3	0	0	1521
14475	0	6	0	1466	0	1472
14476	1496	0	2	2	0	1500
14477	0	1609	1	4	0	1614
14478	1	1495	0	1	0	1497
14479	1623	1	3	0	0	1627
14480	0	1714	2	3	0	1719
14481	3	7	0	1545	0	1555
14482	1	5	1	1661	0	1668
14483	1	1714	0	5	0	1720
14484	1640	2	6	5	0	1653
14485	2	0	1696	0	0	1698
14486	1645	0	5	1	0	1651
14487	3	0	1736	0	0	1739
14488	1674	0	6	3	0	1683
14489	1	0	1752	0	0	1753
14490	0	1756	0	3	0	1759
14491	1	4	0	1618	0	1623
14492	1679	0	7	2	0	1688
14493	0	0	1711	0	0	1711
14494	0	1	1781	0	0	1782
14495	1	5	0	1743	0	1749
14496	3	0	1804	0	0	1807
14497	1	6	0	1632	0	1639
14498	2	13	1	1676	0	1692
14499	9	1	1802	2	0	1814
14500	3	9	0	1803	0	1815
14501	1819	0	6	4	0	1829
14502	0	1865	1	2	0	1868
14503	1774	1	5	2	0	1782
14504	2	6	0	1757	0	1765
14505	1619	0	5	4	0	1628
14506	1667	0	5	0	0	1672
14507	1	5	0	1812	0	1818
14508	0	1777	0	3	0	1780
14509	1650	0	8	2	0	1660
14510	4	2	1688	0	0	1694
14511	0	0	1659	0	0	1659
14512	1740	0	6	2	0	1748
14513	3	5	0	1755	0	1763
14514	1	0	1805	0	0	1806
14515	0	2	0	1760	0	1762
14516	1715	0	3	1	0	1719
14517	1659	1	4	0	0	1664
14518	1723	1	7	0	0	1731
14519	0	1830	2	1	0	1833
14520	1	8	0	1691	0	1700
14521	0	3	0	1718	0	1721
14522	1751	0	4	1	0	1756
14523	0	1823	0	2	0	1825
14524	1774	0	9	1	0	1784
14525	1	9	0	1733	0	1743
14526	1634	0	7	5	0	1646
14527	3	0	1860	0	0	1863
14528	0	1876	0	2	0	1878
14529	0	1	0	1756	0	1757
14530	0	1832	3	2	0	1837
14531	0	5	1	1850	0	1856
14532	1779	0	7	2	0	1788
14533	1	2	1814	0	0	1817
14534	1814	0	10	2	0	1826
14535	0	1879	1	2	0	1882
14536	3	7	0	1666	0	1676
14537	1	7	0	1648	0	1656
14538	1597	0	8	3	0	1608
14539	2	0	1820	0	0	1822
14540	0	4	2	1679	0	1685
14541	1	12	0	1578	0	1591
14542	1	8	0	1624	0	1633
14543	4	1	0	1667	0	1672
14544	1585	0	8	2	0	1595
14545	1682	0	7	0	0	1689
14546	0	0	1771	0	0	1771
14547	2	0	1750	0	0	1752
14548	1772	0	11	2	0	1785
14549	1665	0	7	1	0	1673
14550	1	2	0	1659	0	1662
14551	1	4	0	1872	0	1877
14552	1879	0	8	9	0	1896
14553	0	2045	0	3	0	2048
14554	1	5	0	1923	0	1929
14555	6	8	2	1982	0	1998
14556	7	2	2134	0	0	2143
14557	1	14	0	2065	0	2080
14558	0	1	2168	0	0	2169
14559	9	7	0	2132	0	2148
14560	2099	0	9	0	0	2108
14561	0	0	1	2178	0	2179
14562	3	0	2174	1	0	2178
14563	0	2226	1	5	0	2232
14564	1	10	6	2137	0	2154
14565	4	0	2188	0	0	2192
14566	0	2213	0	1	0	2214
14567	0	6	4	2178	0	2188
14568	1	0	2226	0	0	2227
14569	2182	6	5	1	0	2194
14570	0	2325	0	5	0	2330
14571	4	2148	0	0	0	2152
14572	2	2278	0	1	0	2281
14573	0	6	0	2257	0	2263
14574	3	0	2326	0	0	2329
14575	0	2392	0	6	0	2398
14576	0	4	0	2352	0	2356
14577	2323	0	1	1	0	2325
14578	1	8	0	2374	0	2383
14579	3	0	2383	0	0	2386
14580	0	2377	0	1	0	2378
14581	2361	2	12	1	0	2376
14582	1	2327	0	7	0	2335
14583	3	0	2289	0	0	2292
14584	0	2357	0	13	0	2370
14585	0	20	0	2279	0	2299
14586	2	0	2301	0	0	2303
14587	0	2371	0	0	0	2371
14588	5	4	0	2244	0	2253
14589	1	12	0	2249	0	2262
14590	0	2364	0	2	0	2366
14591	2	6	2	2316	0	2326
14592	3	1	2316	0	0	2320
14593	1	0	2395	0	0	2396
14594	3	4	0	2337	0	2344
14595	2239	0	4	0	0	2243
14596	2112	0	6	1	0	2119
14597	1	5	0	2292	0	2298
14598	0	2296	0	2	0	2298
14599	0	6	1	2246	0	2253
14600	2184	0	7	1	0	2192
14601	2	9	0	2004	0	2015
14602	0	1	0	2207	0	2208
14603	2150	0	9	2	0	2161
14604	0	2220	0	1	0	2221
14605	0	4	0	2142	0	2146
14606	2100	2	7	4	0	2113
14607	1	0	2080	1	0	2082
14608	2059	0	8	3	0	2070
14609	0	4	0	2056	0	2060
14610	1979	0	6	2	0	1987
14611	1947	0	5	1	0	1953
14612	1906	1	9	1	0	1917
14613	0	1961	1	2	0	1964
14614	1	0	1939	0	0	1940
14615	0	2005	0	1	0	2006
14616	1915	1	2	0	0	1918
14617	0	1980	0	3	0	1983
14618	3	1	0	1917	0	1921
14619	1865	1	3	3	0	1872
14620	1	1863	0	15	0	1879
14621	5	0	1852	1	0	1858
14622	0	9	1	1832	0	1842
14623	2	0	1826	1	0	1829
14624	1	1824	2	1	0	1828
14625	1	15	0	1702	0	1718
14626	12	17	1	1613	0	1643
14627	2	7	0	1700	0	1709
14628	6	11	0	1709	0	1726
14629	1	1755	0	6	0	1762
14630	1643	2	28	0	0	1673
14631	2	1	1702	0	0	1705
14632	4	7	0	1723	0	1734
14633	1629	0	3	0	0	1632
14634	0	0	1662	0	0	1662
14635	0	1638	0	4	0	1642
14636	2	18	1	1552	0	1573
14637	1	0	1628	0	0	1629
14638	0	1580	0	2	0	1582
14639	1577	0	3	0	0	1580
14640	0	1585	0	1	0	1586
14641	1	15	0	1417	0	1433
14642	3	10	0	1445	0	1458
14643	1427	0	2	2	0	1431
14644	0	1477	0	0	0	1477
14645	0	5	0	1439	0	1444
14646	1381	0	3	0	0	1384
14647	1297	1	3	1	0	1302
14648	5	1397	1	0	0	1403
14649	1348	0	3	3	0	1354
14650	1182	0	6	0	0	1188
14651	0	5	0	1253	0	1258
14652	0	1	1289	0	0	1290
14653	3	3	1	1168	0	1175
14654	0	5	0	1206	0	1211
14655	3	0	1206	0	0	1209
14656	0	1221	0	1	0	1222
14657	1	11	2	1127	0	1141
14658	1	6	1	1065	0	1073
14659	1	11	1	1096	0	1109
14660	2	1	0	1172	0	1175
14661	0	1165	0	0	0	1165
14662	1129	2	13	1	0	1145
14663	1096	0	2	0	0	1098
14664	1095	2	2	0	0	1099
14665	1	1162	0	2	0	1165
14666	1	8	1	1076	0	1086
14667	0	0	1156	1	0	1157
14668	0	7	0	1126	0	1133
14669	0	1161	0	1	0	1162
14670	1083	1	5	0	0	1089
14671	1025	0	6	0	0	1031
14672	1060	0	8	1	0	1069
14673	0	1140	0	1	0	1141
14674	1	1101	0	1	0	1103
14675	0	1033	0	4	0	1037
14676	1	1	1031	1	0	1034
14677	0	0	1123	0	0	1123
14678	0	1	0	1037	0	1038
14679	1076	0	6	0	0	1082
14680	1008	0	3	0	0	1011
14681	0	6	0	999	0	1005
14682	1	3	0	1027	0	1031
14683	1	2	0	1023	0	1026
14684	3	4	1	1012	0	1020
14685	1053	0	2	1	0	1056
14686	1059	0	0	0	0	1059
14687	0	1172	0	2	0	1174
14688	1142	0	2	0	0	1144
14689	1053	0	8	0	0	1061
14690	1092	1	4	1	0	1098
14691	0	0	1167	0	0	1167
14692	1125	1	7	0	0	1133
14693	0	1173	0	0	0	1173
14694	0	3	0	1066	0	1069
14695	1	6	0	1128	0	1135
14696	0	1161	1	1	0	1163
14697	0	3	0	1094	0	1097
14698	1070	0	5	0	0	1075
14699	2	6	0	1133	0	1141
14700	4	0	1166	0	0	1170
14701	1109	0	4	3	0	1116
14702	0	1113	0	0	0	1113
14703	3	5	1	939	0	948
14704	0	1	0	895	0	896
14705	1	4	0	961	0	966
14706	0	0	991	0	0	991
14707	0	984	3	0	0	987
14708	3	2	0	914	0	919
14709	4	0	1002	0	0	1006
14710	2	3	2	913	0	920
14711	0	0	978	0	0	978
14712	0	3	0	920	0	923
14713	0	949	0	0	0	949
14714	8	0	0	824	0	832
14715	890	0	1	0	0	891
14716	880	0	6	0	0	886
14717	3	0	929	0	0	932
14718	3	0	888	0	0	891
14719	2	0	931	1	0	934
14720	0	0	0	748	0	748
14721	0	2	0	738	0	740
14722	1	3	0	767	0	771
14723	0	775	0	1	0	776
14724	0	2	0	751	0	753
14725	2	2	0	712	0	716
14726	2	1	0	700	0	703
14727	726	0	2	2	0	730
14728	734	0	3	1	0	738
14729	1	0	750	0	0	751
14730	1	0	766	0	0	767
14731	730	0	2	0	0	732
14732	691	0	4	0	0	695
14733	2	0	708	0	0	710
14734	1	0	710	0	0	711
14735	701	0	3	0	0	704
14736	681	0	5	0	0	686
14737	5	0	743	0	0	748
14738	0	2	1	661	0	664
14739	1	3	0	688	0	692
14740	0	693	0	0	0	693
14741	2	2	0	677	0	681
14742	0	0	722	0	0	722
14743	0	2	0	682	0	684
14744	1	2	0	668	0	671
14745	0	0	698	0	0	698
14746	718	0	4	1	0	723
14747	704	0	5	0	0	709
14748	1	6	0	648	0	655
14749	4	0	0	699	0	703
14750	729	0	0	1	0	730
14751	694	1	4	1	0	700
14752	642	0	3	0	0	645
14753	685	0	7	0	0	692
14754	0	758	0	0	0	758
14755	736	1	2	1	0	740
14756	0	762	0	0	0	762
14757	2	1	0	688	0	691
14758	0	3	0	738	0	741
14759	0	749	0	3	0	752
14760	0	3	0	693	0	696
14761	0	0	0	758	0	758
14762	0	783	0	0	0	783
14763	1	4	0	730	0	735
14764	1	4	0	682	0	687
14765	0	1	0	756	0	757
14766	0	0	790	0	0	790
14767	0	783	0	0	0	783
14768	3	4	0	745	0	752
14769	3	783	1	4	0	791
14770	735	0	6	3	0	744
14771	2	1	788	0	0	791
14772	2	2	718	0	0	722
14773	739	0	4	0	0	743
14774	1	0	1	747	0	749
14775	0	0	679	0	0	679
14776	39	1	632	0	0	672
14777	9	3	0	553	0	565
14778	584	0	1	0	0	585
14779	484	0	5	0	0	489
14780	0	0	0	527	0	527
14781	1	0	521	0	0	522
14782	0	528	0	0	0	528
14783	1	1	0	499	0	501
14784	0	0	520	0	0	520
14785	0	514	0	0	0	514
14786	1	0	1	509	0	511
14787	492	0	2	2	0	496
14788	1	0	0	515	0	516
14789	0	518	0	0	0	518
14790	508	0	0	0	0	508
14791	0	0	538	0	0	538
14792	0	493	0	3	0	496
14793	0	0	512	0	0	512
14794	555	0	1	0	0	556
14795	0	1	0	535	0	536
14796	1	2	0	485	0	488
14797	545	0	1	1	0	547
14798	0	0	0	516	0	516
14799	1	0	558	0	0	559
14800	542	1	2	2	0	547
14801	0	564	0	0	0	564
14802	2	0	1	549	0	552
14803	535	0	0	0	0	535
14804	0	537	0	3	0	540
14805	0	2	0	533	0	535
14806	500	0	0	0	0	500
14807	0	0	0	536	0	536
14808	0	522	0	0	0	522
14809	0	0	548	0	0	548
14810	0	2	0	507	0	509
14811	0	0	0	507	0	507
14812	509	0	1	0	0	510
14813	0	0	0	510	0	510
14814	505	0	0	1	0	506
14815	486	0	1	0	0	487
14816	0	0	0	519	0	519
14817	2	507	0	1	0	510
14818	1	1	0	478	0	480
14819	471	0	0	0	0	471
14820	0	489	0	0	0	489
14821	0	467	0	1	0	468
14822	461	0	5	0	0	466
14823	446	2	0	1	0	449
14824	0	490	0	0	0	490
14825	467	0	1	0	0	468
14826	426	0	8	0	0	434
14827	9	5	3	416	0	433
14828	9	2	440	0	0	451
14829	8	9	3	397	0	417
14830	9	1	417	1	0	428
14831	17	5	1	373	0	396
14832	0	0	393	0	0	393
14833	363	0	1	0	0	364
14834	0	0	0	326	0	326
14835	306	0	0	0	0	306
14836	1	0	0	276	0	277
14837	0	223	0	3	0	226
14838	161	0	0	1	0	162
14839	1	0	183	0	0	184
14840	166	0	0	0	0	166
14841	0	179	0	0	0	179
14842	168	0	0	0	0	168
14843	159	0	1	0	0	160
14844	0	172	0	0	0	172
14845	0	1	0	169	0	170
14846	171	0	0	0	0	171
14847	0	173	0	0	0	173
14848	0	0	0	163	0	163
14849	155	0	0	0	0	155
14850	0	0	0	141	0	141
14851	0	0	0	152	0	152
14852	0	1	0	158	0	159
14853	0	0	149	0	0	149
14854	0	1	0	143	0	144
14855	144	0	0	0	0	144
14856	0	0	149	0	0	149
14857	0	0	0	142	0	142
14858	0	0	0	142	0	142
14859	0	0	126	0	0	126
14860	136	0	0	0	0	136
14861	137	0	0	1	0	138
14862	0	0	135	0	0	135
14863	0	0	0	130	0	130
14864	0	1	0	123	0	124
14865	0	0	133	0	0	133
14866	2	0	0	121	0	123
14867	0	0	0	130	0	130
14868	0	0	138	0	0	138
14869	134	0	0	0	0	134
14870	0	2	0	130	0	132
14871	136	0	1	0	0	137
14872	133	0	0	0	0	133
14873	0	0	146	0	0	146
14874	1	2	0	139	0	142
14875	133	0	0	0	0	133
14876	0	140	1	0	0	141
14877	0	0	0	125	0	125
14878	0	2	0	118	0	120
14879	0	1	0	135	0	136
14880	0	0	134	0	0	134
14881	133	0	0	1	0	134
14882	0	0	0	120	0	120
14883	2	0	0	122	0	124
14884	2	0	125	0	0	127
14885	0	0	0	125	0	125
14886	0	0	0	135	0	135
14887	130	0	0	0	0	130
14888	0	131	0	0	0	131
14889	0	0	124	0	0	124
14890	134	0	0	0	0	134
14891	0	1	0	127	0	128
14892	0	0	134	0	0	134
14893	1	0	127	0	0	128
14894	0	0	0	125	0	125
14895	1	0	126	0	0	127
14896	0	0	124	0	0	124
14897	0	128	0	0	0	128
14898	1	2	0	121	0	124
14899	0	0	134	0	0	134
14900	0	1	0	125	0	126
14901	130	0	0	0	0	130
14902	0	0	0	120	0	120
14903	0	0	0	119	0	119
14904	116	0	1	0	0	117
14905	116	0	1	0	0	117
14906	0	0	0	130	0	130
14907	0	0	128	0	0	128
14908	0	120	2	1	0	123
14909	0	0	0	111	0	111
14910	111	0	0	0	0	111
14911	113	0	0	0	0	113
14912	0	121	0	0	0	121
14913	0	114	0	0	0	114
14914	112	0	0	0	0	112
14915	115	0	1	1	0	117
14916	0	0	119	0	0	119
14917	0	0	0	117	0	117
14918	0	117	0	0	0	117
14919	115	0	0	0	0	115
14920	0	0	0	117	0	117
14921	0	114	0	0	0	114
14922	0	0	116	0	0	116
14923	0	0	0	119	0	119
14924	0	114	1	1	0	116
14925	118	0	0	0	0	118
14926	111	0	0	0	0	111
14927	0	125	0	0	0	125
14928	119	0	0	0	0	119
14929	124	0	1	2	0	127
14930	0	126	0	0	0	126
14931	0	115	0	0	0	115
14932	0	0	0	124	0	124
14933	123	0	0	0	0	123
14934	0	0	121	0	0	121
14935	122	0	0	0	0	122
14936	0	123	0	0	0	123
14937	114	0	0	0	0	114
14938	98	0	0	1	0	99
14939	109	0	0	0	0	109
14940	0	2	0	114	0	116
14941	0	119	0	0	0	119
14942	115	0	0	0	0	115
14943	0	0	112	0	0	112
14944	0	116	0	0	0	116
14945	0	0	0	114	0	114
14946	0	0	109	0	0	109
14947	0	0	116	0	0	116
14948	0	0	0	102	0	102
14949	0	1	0	103	0	104
14950	0	2	0	105	0	107
14951	0	0	0	110	0	110
14952	0	106	0	0	0	106
14953	0	105	0	0	0	105
14954	110	0	1	0	0	111
14955	0	0	0	97	0	97
14956	0	0	0	99	0	99
14957	0	0	0	97	0	97
14958	97	0	0	0	0	97
14959	85	0	0	0	0	85
14960	2	0	0	91	0	93
14961	90	0	1	0	0	91
14962	91	0	0	0	0	91
14963	86	0	0	0	0	86
14964	0	0	0	91	0	91
14965	0	0	84	0	0	84
14966	0	0	85	0	0	85
14967	0	0	83	0	0	83
14968	0	0	91	0	0	91
14969	0	0	0	82	0	82
14970	92	0	0	0	0	92
14971	83	0	1	0	0	84
14972	0	0	95	0	0	95
14973	0	0	96	0	0	96
14974	0	92	0	0	0	92
14975	0	0	0	89	0	89
14976	93	0	0	0	0	93
14977	0	0	95	0	0	95
14978	91	0	0	1	0	92
14979	0	94	0	1	0	95
14980	0	0	0	82	0	82
14981	0	0	0	86	0	86
14982	0	0	0	82	0	82
14983	90	0	0	0	0	90
14984	0	0	0	83	0	83
14985	0	0	0	89	0	89
14986	90	0	0	0	0	90
14987	0	0	0	90	0	90
14988	0	0	96	0	0	96
14989	91	0	1	0	0	92
14990	0	0	0	89	0	89
14991	0	2	0	88	0	90
14992	0	93	0	0	0	93
14993	91	0	0	0	0	91
14994	86	0	0	0	0	86
14995	0	0	0	87	0	87
14996	0	0	93	0	0	93
14997	89	0	0	0	0	89
14998	0	0	97	0	0	97
14999	2	0	0	94	0	96
15000	0	0	0	96	0	96
15001	89	0	0	0	0	89
15002	0	0	0	99	0	99
15003	0	0	105	0	0	105
15004	108	0	0	0	0	108
15005	0	0	104	0	0	104
15006	0	0	103	0	0	103
15007	106	0	0	0	0	106
15008	0	0	0	102	0	102
15009	0	105	0	0	0	105
15010	107	0	0	0	0	107
15011	108	0	1	0	0	109
15012	0	0	110	0	0	110
15013	111	0	0	0	0	111
15014	2	0	0	101	0	103
15015	0	0	107	0	0	107
15016	0	107	0	0	0	107
15017	103	0	1	2	0	106
15018	0	109	0	0	0	109
15019	0	1	0	96	0	97
15020	0	0	0	92	0	92
15021	0	0	0	99	0	99
15022	0	0	0	106	0	106
15023	0	99	0	0	0	99
15024	0	0	102	0	0	102
15025	0	100	0	0	0	100
15026	103	1	0	0	0	104
15027	0	2	0	92	0	94
15028	95	0	1	0	0	96
15029	0	0	0	97	0	97
15030	94	0	1	0	0	95
15031	0	98	0	0	0	98
15032	98	0	0	0	0	98
15033	92	0	0	0	0	92
15034	86	0	0	0	0	86
15035	95	0	0	0	0	95
15036	0	97	0	0	0	97
15037	0	0	99	0	0	99
15038	0	0	0	91	0	91
15039	97	0	0	0	0	97
15040	87	0	0	0	0	87
15041	0	0	0	91	0	91
15042	0	0	98	0	0	98
15043	0	0	0	98	0	98
15044	0	94	0	0	0	94
15045	96	0	1	0	0	97
15046	0	0	0	99	0	99
15047	0	102	0	0	0	102
15048	0	98	0	2	0	100
15049	0	100	0	0	0	100
15050	0	1	0	99	0	100
15051	99	0	0	0	0	99
15052	0	109	0	0	0	109
15053	0	0	0	103	0	103
15054	103	0	0	0	0	103
15055	0	0	0	99	0	99
15056	96	0	0	0	0	96
15057	89	0	0	0	0	89
15058	0	102	0	0	0	102
15059	0	1	0	102	0	103
15060	0	100	0	0	0	100
15061	89	0	0	0	0	89
15062	89	0	2	0	0	91
15063	86	0	0	0	0	86
15064	0	0	0	94	0	94
15065	0	0	99	0	0	99
15066	93	0	0	0	0	93
15067	87	0	0	0	0	87
15068	0	0	0	92	0	92
15069	0	98	0	0	0	98
15070	0	1	0	89	0	90
15071	2	0	0	75	0	77
15072	91	0	0	0	0	91
15073	91	0	0	0	0	91
15074	0	0	96	0	0	96
15075	0	2	0	94	0	96
15076	86	0	0	0	0	86
15077	0	0	0	101	0	101
15078	0	0	101	0	0	101
15079	0	98	0	0	0	98
15080	0	100	0	0	0	100
15081	98	0	2	0	0	100
15082	0	2	0	89	0	91
15083	0	0	0	99	0	99
15084	92	0	0	0	0	92
15085	0	0	104	0	0	104
15086	0	0	0	105	0	105
15087	0	1	107	0	0	108
15088	0	102	1	0	0	103
15089	101	0	0	0	0	101
15090	98	0	0	0	0	98
15091	98	0	0	0	0	98
15092	0	0	104	0	0	104
15093	103	0	0	0	0	103
15094	92	0	0	0	0	92
15095	0	0	0	99	0	99
15096	97	0	0	0	0	97
15097	0	0	99	0	0	99
15098	100	0	1	0	0	101
15099	0	0	107	0	0	107
15100	0	106	0	0	0	106
15101	0	0	0	102	0	102
15102	0	100	0	0	0	100
15103	0	0	101	0	0	101
15104	0	106	0	0	0	106
15105	98	1	0	0	0	99
15106	0	110	0	0	0	110
15107	0	102	0	0	0	102
15108	0	0	110	0	0	110
15109	0	0	0	110	0	110
15110	112	0	0	0	0	112
15111	0	0	116	1	0	117
15112	0	118	0	0	0	118
15113	0	2	0	106	0	108
15114	0	0	109	0	0	109
15115	0	0	115	0	0	115
15116	0	0	1	110	0	111
15117	1	0	113	0	0	114
15118	0	1	0	120	0	121
15119	0	124	0	0	0	124
15120	0	0	0	118	0	118
15121	0	128	0	0	0	128
15122	0	0	0	137	0	137
15123	141	0	0	1	0	142
15124	1	0	0	147	0	148
15125	0	179	0	0	0	179
15126	3	3	0	156	0	162
15127	1	1	199	1	0	202
15128	2	1	0	184	0	187
15129	181	4	3	5	0	193
15130	8	0	199	5	0	212
15131	0	2	0	206	0	208
15132	209	0	0	0	0	209
15133	0	223	0	1	0	224
15134	0	1	0	209	0	210
15135	202	0	3	0	0	205
15136	0	1	0	198	0	199
15137	3	0	198	0	0	201
15138	204	0	0	0	0	204
15139	0	233	0	0	0	233
15140	0	224	0	0	0	224
15141	223	0	0	0	0	223
15142	214	0	1	0	0	215
15143	0	1	0	227	0	228
15144	233	0	1	0	0	234
15145	0	0	233	0	0	233
15146	223	0	0	1	0	224
15147	0	236	0	0	0	236
15148	214	0	0	0	0	214
15149	0	0	224	0	0	224
15150	1	0	0	211	0	212
15151	1	2	0	207	0	210
15152	0	1	0	220	0	221
15153	0	232	0	0	0	232
15154	231	0	0	0	0	231
15155	0	0	0	214	0	214
15156	0	233	0	0	0	233
15157	213	0	2	0	0	215
15158	213	0	1	0	0	214
15159	213	0	0	0	0	213
15160	220	0	1	0	0	221
15161	208	0	2	0	0	210
15162	0	0	0	217	0	217
15163	0	0	0	235	0	235
15164	237	0	0	2	0	239
15165	0	0	0	228	0	228
15166	0	0	0	234	0	234
15167	0	0	227	0	0	227
15168	241	0	1	0	0	242
15169	223	0	0	4	0	227
15170	246	0	2	0	0	248
15171	0	0	0	268	0	268
15172	0	280	0	0	0	280
15173	276	0	0	0	0	276
15174	268	0	1	0	0	269
15175	0	0	1	271	0	272
15176	279	0	0	0	0	279
15177	0	0	289	0	0	289
15178	0	289	0	0	0	289
15179	0	280	0	0	0	280
15180	2	0	274	0	0	276
15181	0	299	0	0	0	299
15182	0	308	0	0	0	308
15183	316	1	0	0	0	317
15184	0	340	0	1	0	341
15185	0	0	0	331	0	331
15186	333	0	3	1	0	337
15187	1	0	342	0	0	343
15188	331	0	0	1	0	332
15189	2	0	336	0	0	338
15190	0	0	334	0	0	334
15191	337	0	0	0	0	337
15192	1	1	353	0	0	355
15193	0	358	0	0	0	358
15194	0	3	0	347	0	350
15195	353	0	1	3	0	357
15196	0	441	0	0	0	441
15197	1	1	2	420	0	424
15198	0	0	454	0	0	454
15199	0	2	0	431	0	433
15200	451	0	0	0	0	451
15201	0	0	464	0	0	464
15202	0	2	0	458	0	460
15203	465	0	4	4	0	473
15204	421	0	2	0	0	423
15205	0	1	0	468	0	469
15206	0	3	0	505	0	508
15207	0	0	505	0	0	505
15208	0	0	539	0	0	539
15209	530	0	2	1	0	533
15210	519	0	1	0	0	520
15211	0	568	0	2	0	570
15212	550	2	2	0	0	554
15213	552	0	0	2	0	554
15214	0	0	585	0	0	585
15215	0	590	1	0	0	591
15216	582	0	1	3	0	586
15217	549	0	1	0	0	550
15218	630	0	3	5	0	638
15219	23	3	0	641	0	667
15220	0	0	0	953	0	953
15221	0	1035	1	3	0	1039
15222	0	5	1	1037	0	1043
15223	1064	0	0	4	0	1068
15224	1	2	0	1098	0	1101
15225	1	0	1093	0	0	1094
15226	0	0	1122	4	0	1126
15227	0	2	1	1131	0	1134
15228	2	0	1133	3	0	1138
15229	0	0	1151	0	0	1151
15230	1	1	3	1096	0	1101
15231	0	6	0	1138	0	1144
15232	0	0	1183	2	0	1185
15233	2	0	1183	0	0	1185
15234	0	1205	0	3	0	1208
15235	1205	0	1	0	0	1206
15236	0	1221	0	1	0	1222
15237	1188	0	5	0	0	1193
15238	1171	0	4	0	0	1175
15239	1	1239	0	1	0	1241
15240	1223	0	2	0	0	1225
15241	0	0	0	1206	0	1206
15242	0	0	1289	0	0	1289
15243	0	1	0	1227	0	1228
15244	0	2	0	1256	0	1258
15245	1218	0	1	1	0	1220
15246	1209	0	2	1	0	1212
15247	1232	0	2	0	0	1234
15248	1210	0	5	0	0	1215
15249	1242	3	1	0	0	1246
15250	0	1351	1	0	0	1352
15251	0	3	1	1285	0	1289
15252	1	0	1393	0	0	1394
15253	0	8	1	1312	0	1321
15254	5	6	0	1271	0	1282
15255	0	0	0	1362	0	1362
15256	1372	0	1	0	0	1373
15257	0	0	0	1376	0	1376
15258	1394	0	1	0	0	1395
15259	0	0	1415	0	0	1415
15260	0	2	0	1370	0	1372
15261	0	0	1336	0	0	1336
15262	1377	0	1	1	0	1379
15263	0	5	0	1368	0	1373
15264	1	0	1433	0	0	1434
15265	8	0	0	1416	0	1424
15266	1434	0	2	0	0	1436
15267	1	0	1420	2	0	1423
15268	1392	0	5	0	0	1397
15269	1354	0	4	1	0	1359
15270	1309	0	0	1	0	1310
15271	1363	1	0	0	0	1364
15272	0	1441	0	0	0	1441
15273	0	1367	0	0	0	1367
15274	0	1385	0	0	0	1385
15275	2	0	0	1389	0	1391
15276	0	1370	0	2	0	1372
15277	1346	0	8	0	0	1354
15278	0	1442	0	0	0	1442
15279	0	1408	0	0	0	1408
15280	1	8	0	1320	0	1329
15281	1	2	0	1263	0	1266
15282	1323	0	2	0	0	1325
15283	0	1	1	1367	0	1369
15284	0	0	1404	0	0	1404
15285	2	0	1377	1	0	1380
15286	0	0	1413	0	0	1413
15287	0	2	0	1293	0	1295
15288	1	2	0	1301	0	1304
15289	0	0	1326	0	0	1326
15290	0	0	1289	0	0	1289
15291	0	0	1302	0	0	1302
15292	1339	0	2	0	0	1341
15293	0	3	0	1196	0	1199
15294	1	1	0	1270	0	1272
15295	1253	0	6	0	0	1259
15296	1	2	0	1323	0	1326
15297	0	1326	0	0	0	1326
15298	0	1312	4	3	0	1319
15299	1	0	0	1288	0	1289
15300	1294	0	1	1	0	1296
15301	1250	0	4	0	0	1254
15302	1221	0	3	1	0	1225
15303	1	3	0	1304	0	1308
15304	0	1	1326	0	0	1327
15305	0	4	0	1254	0	1258
15306	0	0	1260	0	0	1260
15307	1243	0	1	2	0	1246
15308	0	0	0	1233	0	1233
15309	1234	1	0	0	0	1235
15310	1	0	1261	0	0	1262
15311	1168	0	9	2	0	1179
15312	1	0	1244	0	0	1245
15313	0	1231	0	1	0	1232
15314	0	1190	2	1	0	1193
15315	1160	1	5	0	0	1166
15316	0	5	1	1192	0	1198
15317	0	1	1201	0	0	1202
15318	0	1215	0	1	0	1216
15319	0	1201	0	7	0	1208
15320	1	4	0	1126	0	1131
15321	1170	0	0	0	0	1170
15322	1110	0	4	2	0	1116
15323	0	1199	0	0	0	1199
15324	1143	0	6	1	0	1150
15325	1	9	0	1077	0	1087
15326	4	0	1100	1	0	1105
15327	0	1122	0	0	0	1122
15328	5	4	0	1040	0	1049
15329	0	5	0	1046	0	1051
15330	1083	0	1	0	0	1084
15331	0	0	1105	0	0	1105
15332	1091	0	6	0	0	1097
15333	1000	2	9	0	0	1011
15334	1	3	0	1002	0	1006
15335	0	1	0	957	0	958
15336	941	0	5	1	0	947
15337	1	3	2	999	0	1005
15338	0	0	999	0	0	999
15339	0	0	985	0	0	985
15340	0	984	0	1	0	985
15341	0	955	0	1	0	956
15342	0	11	0	886	0	897
15343	0	997	0	1	0	998
15344	997	0	4	0	0	1001
15345	0	1022	0	0	0	1022
15346	0	7	0	946	0	953
15347	1	0	0	966	0	967
15348	0	0	1022	0	0	1022
15349	1	6	0	953	0	960
15350	0	3	0	1013	0	1016
15351	0	977	0	1	0	978
15352	0	5	0	950	0	955
15353	1	4	0	973	0	978
15354	1	0	980	0	0	981
15355	1	1004	0	0	0	1005
15356	1	7	0	986	0	994
15357	0	982	0	1	0	983
15358	2	0	964	0	0	966
15359	0	1008	0	0	0	1008
15360	997	0	1	0	0	998
15361	959	0	5	4	0	968
15362	998	1	1	2	0	1002
15363	0	1081	0	16	0	1097
15364	1069	0	1	1	0	1071
15365	0	3	0	1098	0	1101
15366	1014	7	4	1	0	1026
15367	0	1131	1	1	0	1133
15368	1030	1	3	1	0	1035
15369	976	1	7	3	0	987
15370	0	1078	0	0	0	1078
15371	0	0	1068	1	0	1069
15372	1	2	0	1035	0	1038
15373	0	0	1075	0	0	1075
15374	0	2	0	997	0	999
15375	0	2	0	1021	0	1023
15376	0	0	1090	0	0	1090
15377	0	4	1	1058	0	1063
15378	1040	0	6	1	0	1047
15379	0	4	1054	3	0	1061
15380	0	1037	0	0	0	1037
15381	0	4	0	978	0	982
15382	0	10	2	944	0	956
15383	0	0	1018	0	0	1018
15384	1	10	0	987	0	998
15385	0	1005	0	2	0	1007
15386	977	1	5	0	0	983
15387	0	1006	0	3	0	1009
15388	962	0	3	1	0	966
15389	1	1012	0	1	0	1014
15390	0	906	0	2	0	908
15391	2	0	969	0	0	971
15392	2	4	0	896	0	902
15393	0	6	0	878	0	884
15394	0	7	0	953	0	960
15395	1	993	0	3	0	997
15396	3	3	1	956	0	963
15397	937	0	7	2	0	946
15398	0	5	2	938	0	945
15399	943	0	2	0	0	945
15400	1	0	957	1	0	959
15401	932	0	2	0	0	934
15402	1	3	0	833	0	837
15403	3	1	0	927	0	931
15404	892	1	1	0	0	894
15405	0	0	954	0	0	954
15406	0	967	0	0	0	967
15407	1	5	1	905	0	912
15408	945	0	3	0	0	948
15409	860	0	5	0	0	865
15410	1	5	0	977	0	983
15411	0	0	1027	0	0	1027
15412	988	0	3	4	0	995
15413	8	0	1037	0	0	1045
15414	2	8	1	967	0	978
15415	3	0	1036	0	0	1039
15416	0	9	0	1021	0	1030
15417	1	0	1064	0	0	1065
15418	0	1199	0	2	0	1201
15419	0	8	0	1154	0	1162
15420	0	1176	0	1	0	1177
15421	1173	1	6	0	0	1180
15422	1192	0	7	0	0	1199
15423	1	0	1282	0	0	1283
15424	1	3	0	1216	0	1220
15425	1231	0	9	0	0	1240
15426	0	2	0	1164	0	1166
15427	1	4	0	1221	0	1226
15428	3	0	1223	0	0	1226
15429	1245	0	6	1	0	1252
15430	0	0	1291	0	0	1291
15431	0	3	0	1243	0	1246
15432	0	0	1251	0	0	1251
15433	1273	0	3	2	0	1278
15434	1193	0	15	1	0	1209
15435	1186	1	4	0	0	1191
15436	0	4	0	1276	0	1280
15437	2	0	1277	0	0	1279
15438	0	0	1335	0	0	1335
15439	1	6	0	1316	0	1323
15440	0	1264	0	1	0	1265
15441	1292	0	8	0	0	1300
15442	0	6	0	1329	0	1335
15443	2	0	1384	0	0	1386
15444	0	5	0	1361	0	1366
15445	1	0	1394	0	0	1395
15446	0	1	4	1339	0	1344
15447	2	0	1325	1	0	1328
15448	1	0	1332	0	0	1333
15449	0	1312	0	1	0	1313
15450	4	1	1205	0	0	1210
15451	4	0	1348	0	0	1352
15452	0	7	1	1271	0	1279
15453	0	5	0	1328	0	1333
15454	0	1366	0	4	0	1370
15455	1369	0	5	0	0	1374
15456	0	1468	0	1	0	1469
15457	0	2	0	1422	0	1424
15458	1400	0	4	0	0	1404
15459	0	0	0	1348	0	1348
15460	1420	0	3	1	0	1424
15461	0	4	0	1478	0	1482
15462	0	0	1499	0	0	1499
15463	0	6	0	1409	0	1415
15464	0	3	0	1439	0	1442
15465	1258	0	0	5	0	1263
15466	1310	0	5	1	0	1316
15467	1349	2	2	2	0	1355
15468	0	1413	0	5	0	1418
15469	0	1357	0	1	0	1358
15470	1288	0	2	0	0	1290
15471	3	0	1307	0	0	1310
15472	0	0	1386	0	0	1386
15473	0	13	0	1354	0	1367
15474	1	0	1373	0	0	1374
15475	0	0	1364	0	0	1364
15476	1374	0	5	0	0	1379
15477	1369	0	0	0	0	1369
15478	0	1421	0	0	0	1421
15479	0	1367	0	1	0	1368
15480	3	3	0	1358	0	1364
15481	0	1373	0	2	0	1375
15482	1385	0	3	0	0	1388
15483	1	1	0	1329	0	1331
15484	0	1345	0	2	0	1347
15485	1294	1	3	0	0	1298
15486	0	0	1344	0	0	1344
15487	1	0	1318	0	0	1319
15488	1296	0	5	2	0	1303
15489	0	0	1331	0	0	1331
15490	1250	0	6	0	0	1256
15491	2	10	0	1291	0	1303
15492	6	2	1307	0	0	1315
15493	0	1281	0	0	0	1281
15494	0	1236	0	1	0	1237
15495	1257	0	6	0	0	1263
15496	0	1309	0	0	0	1309
15497	1238	0	5	0	0	1243
15498	1246	0	2	3	0	1251
15499	0	1288	0	0	0	1288
15500	1	5	0	1166	0	1172
15501	1	0	1235	0	0	1236
15502	0	1208	0	0	0	1208
15503	1	5	2	1133	0	1141
15504	0	5	0	1117	0	1122
15505	1094	0	2	1	0	1097
15506	3	4	2	1195	0	1204
15507	1	0	1201	0	0	1202
15508	0	1192	0	0	0	1192
15509	3	4	4	1036	0	1047
15510	1083	0	5	0	0	1088
15511	994	0	3	1	0	998
15512	2	2	0	1058	0	1062
15513	1065	0	2	2	0	1069
15514	4	0	1048	0	0	1052
15515	0	7	0	884	0	891
15516	0	0	898	0	0	898
15517	0	9	6	791	0	806
15518	2	7	0	775	0	784
15519	1	1	1	790	0	793
15520	1	1	0	777	0	779
15521	2	2	0	799	0	803
15522	789	0	2	3	0	794
15523	801	0	6	0	0	807
15524	0	870	0	1	0	871
15525	826	0	4	0	0	830
15526	0	5	0	788	0	793
15527	0	3	0	771	0	774
15528	0	3	0	816	0	819
15529	1	0	860	0	0	861
15530	0	3	1	843	0	847
15531	0	855	0	2	0	857
15532	789	0	4	1	0	794
15533	801	0	4	0	0	805
15534	0	0	849	0	0	849
15535	0	857	0	5	0	862
15536	1	0	0	833	0	834
15537	2	0	865	0	0	867
15538	0	1	1	833	0	835
15539	0	833	0	1	0	834
15540	822	1	2	1	0	826
15541	0	822	0	0	0	822
15542	1	0	770	0	0	771
15543	2	0	827	0	0	829
15544	0	830	2	1	0	833
15545	0	790	0	1	0	791
15546	829	0	0	0	0	829
15547	757	0	3	1	0	761
15548	0	3	0	837	0	840
15549	1	0	868	0	0	869
15550	2	2	0	789	0	793
15551	3	1	0	743	0	747
15552	804	0	4	1	0	809
15553	736	0	4	2	0	742
15554	0	5	0	831	0	836
15555	0	0	832	0	0	832
15556	0	822	0	1	0	823
15557	805	0	1	2	0	808
15558	0	836	0	1	0	837
15559	0	2	1	750	0	753
15560	0	4	0	785	0	789
15561	2	7	0	764	0	773
15562	1	1	0	828	0	830
15563	793	0	9	2	0	804
15564	0	4	0	860	0	864
15565	0	867	0	0	0	867
15566	3	3	0	859	0	865
15567	789	0	2	0	0	791
15568	0	820	0	2	0	822
15569	1	1	0	707	0	709
15570	3	0	722	0	0	725
15571	692	0	4	0	0	696
15572	2	4	0	696	0	702
15573	1	0	683	0	0	684
15574	0	1	718	0	0	719
15575	1	3	0	694	0	698
15576	675	0	3	1	0	679
15577	679	0	2	0	0	681
15578	0	709	0	0	0	709
15579	665	0	1	1	0	667
15580	703	0	1	1	0	705
15581	650	0	2	1	0	653
15582	657	0	3	0	0	660
15583	0	4	0	589	0	593
15584	0	2	0	684	0	686
15585	2	0	683	0	0	685
15586	0	684	0	0	0	684
15587	0	623	0	3	0	626
15588	0	0	689	0	0	689
15589	683	0	0	1	0	684
15590	3	1	0	622	0	626
15591	674	0	3	1	0	678
15592	652	0	3	0	0	655
15593	0	0	745	0	0	745
15594	0	0	0	692	0	692
15595	672	0	3	0	0	675
15596	0	1	0	706	0	707
15597	0	0	735	0	0	735
15598	1	0	0	692	0	693
15599	0	698	0	0	0	698
15600	0	634	0	1	0	635
15601	0	0	678	0	0	678
15602	0	682	0	1	0	683
15603	681	0	0	1	0	682
15604	668	0	3	0	0	671
15605	0	8	0	642	0	650
15606	1	5	0	674	0	680
15607	1	5	0	706	0	712
15608	717	0	2	1	0	720
15609	0	724	0	1	0	725
15610	691	0	2	0	0	693
15611	663	1	4	2	0	670
15612	0	728	0	1	0	729
15613	668	0	2	0	0	670
15614	0	713	0	3	0	716
15615	655	0	4	0	0	659
15616	0	0	716	0	0	716
15617	677	0	2	0	0	679
15618	0	746	0	1	0	747
15619	3	4	0	676	0	683
15620	0	5	0	651	0	656
15621	2	2	0	663	0	667
15622	662	0	5	0	0	667
15623	0	1	0	713	0	714
15624	0	0	744	0	0	744
15625	660	0	2	0	0	662
15626	1	0	716	0	0	717
15627	2	1	1	641	0	645
15628	0	0	654	0	0	654
15629	5	2	0	645	0	652
15630	0	653	0	3	0	656
15631	1	1	0	641	0	643
15632	0	690	0	2	0	692
15633	1	3	0	670	0	674
15634	646	0	4	0	0	650
15635	0	2	0	665	0	667
15636	674	0	0	2	0	676
15637	0	0	685	0	0	685
15638	661	0	3	2	0	666
15639	628	0	0	0	0	628
15640	622	2	8	1	0	633
15641	1	5	1	665	0	672
15642	686	0	0	0	0	686
15643	3	1	707	0	0	711
15644	652	0	9	2	0	663
15645	1	0	672	0	0	673
15646	682	0	4	1	0	687
15647	1	2	0	707	0	710
15648	0	1	724	0	0	725
15649	0	10	0	660	0	670
15650	1	3	0	647	0	651
15651	1	0	716	0	0	717
15652	700	0	1	2	0	703
15653	0	755	0	0	0	755
15654	700	0	1	0	0	701
15655	0	732	0	4	0	736
15656	692	0	7	1	0	700
15657	0	0	720	1	0	721
15658	704	0	1	0	0	705
15659	0	735	0	1	0	736
15660	0	5	0	653	0	658
15661	2	2	0	627	0	631
15662	1	0	0	692	0	693
15663	0	0	731	0	0	731
15664	0	1	2	711	0	714
15665	2	0	694	0	0	696
15666	686	1	2	1	0	690
15667	647	0	2	2	0	651
15668	0	2	0	684	0	686
15669	0	0	706	0	0	706
15670	613	0	2	0	0	615
15671	0	0	716	0	0	716
15672	0	3	0	695	0	698
15673	1	3	0	684	0	688
15674	0	8	0	660	0	668
15675	0	2	0	703	0	705
15676	646	0	2	1	0	649
15677	0	691	0	2	0	693
15678	0	0	656	0	0	656
15679	0	689	0	0	0	689
15680	691	0	5	1	0	697
15681	0	1	0	657	0	658
15682	686	0	6	0	0	692
15683	0	3	0	638	0	641
15684	0	4	0	648	0	652
15685	0	4	0	664	0	668
15686	1	1	666	0	0	668
15687	0	653	0	3	0	656
15688	0	0	676	0	0	676
15689	3	2	0	673	0	678
15690	689	0	2	0	0	691
15691	677	0	2	0	0	679
15692	686	0	4	2	0	692
15693	0	699	0	1	0	700
15694	688	0	0	0	0	688
15695	0	2	0	645	0	647
15696	0	1	0	635	0	636
15697	0	0	0	632	0	632
15698	0	645	0	0	0	645
15699	0	2	0	639	0	641
15700	0	643	0	0	0	643
15701	647	0	2	0	0	649
15702	575	0	2	0	0	577
15703	0	1	2	633	0	636
15704	0	0	641	1	0	642
15705	632	0	2	0	0	634
15706	1	1	0	617	0	619
15707	1	0	650	0	0	651
15708	628	0	1	1	0	630
15709	1	1	0	603	0	605
15710	569	0	2	4	0	575
15711	0	604	0	0	0	604
15712	0	3	0	563	0	566
15713	0	593	0	0	0	593
15714	1	1	0	569	0	571
15715	0	573	0	0	0	573
15716	2	5	1	552	0	560
15717	0	0	593	0	0	593
15718	546	0	3	2	0	551
15719	0	558	0	0	0	558
15720	1	0	545	0	0	546
15721	511	0	3	0	0	514
15722	1	1	0	506	0	508
15723	0	1	509	0	0	510
15724	1	516	1	0	0	518
15725	0	3	0	484	0	487
15726	3	0	526	0	0	529
15727	0	5	2	470	0	477
15728	3	7	0	462	0	472
15729	4	0	532	0	0	536
15730	1	3	0	470	0	474
15731	2	0	519	0	0	521
15732	0	3	0	473	0	476
15733	0	0	505	0	0	505
15734	1	1	1	463	0	466
15735	2	2	1	449	0	454
15736	0	4	0	476	0	480
15737	0	498	1	3	0	502
15738	496	0	0	0	0	496
15739	473	0	2	0	0	475
15740	0	0	0	501	0	501
15741	505	0	1	1	0	507
15742	1	0	516	1	0	518
15743	0	533	0	0	0	533
15744	546	0	1	1	0	548
15745	1	564	0	0	0	565
15746	1	2	0	511	0	514
15747	1	0	0	513	0	514
15748	519	0	0	0	0	519
15749	1	0	0	541	0	542
15750	1	0	558	0	0	559
15751	0	550	0	1	0	551
15752	547	0	3	0	0	550
15753	0	1	0	550	0	551
15754	3	552	0	1	0	556
15755	1	0	0	539	0	540
15756	1	556	0	1	0	558
15757	527	0	2	0	0	529
15758	526	0	1	5	0	532
15759	0	0	521	0	0	521
15760	1	0	562	0	0	563
15761	0	2	2	548	0	552
15762	0	532	1	4	0	537
15763	0	4	0	548	0	552
15764	544	0	1	0	0	545
15765	0	1	563	0	0	564
15766	1	0	1	549	0	551
15767	1	0	537	0	0	538
15768	1	0	542	0	0	543
15769	6	517	0	0	0	523
15770	1	0	0	510	0	511
15771	520	0	4	0	0	524
15772	0	0	523	0	0	523
15773	0	512	0	0	0	512
15774	512	0	0	0	0	512
15775	2	1	0	500	0	503
15776	477	2	0	0	0	479
15777	461	0	4	0	0	465
15778	473	0	9	1	0	483
15779	2	0	492	0	0	494
15780	479	0	0	0	0	479
15781	405	0	4	0	0	409
15782	0	435	0	0	0	435
15783	0	0	0	397	0	397
15784	0	0	0	372	0	372
15785	0	0	0	375	0	375
15786	377	0	0	1	0	378
15787	391	0	5	0	0	396
15788	0	0	418	0	0	418
15789	1	4	0	385	0	390
15790	0	396	0	0	0	396
15791	325	0	4	0	0	329
15792	0	0	359	0	0	359
15793	0	3	0	309	0	312
15794	1	2	0	336	0	339
15795	1	353	0	0	0	354
15796	1	10	0	326	0	337
15797	0	3	0	323	0	326
15798	0	0	0	332	0	332
15799	335	0	1	0	0	336
15800	0	4	0	324	0	328
15801	0	2	0	311	0	313
15802	311	0	1	1	0	313
15803	1	2	0	325	0	328
15804	0	305	0	0	0	305
15805	299	0	1	1	0	301
15806	301	0	1	0	0	302
15807	286	1	0	1	0	288
15808	293	0	2	1	0	296
15809	0	317	0	0	0	317
15810	305	0	2	0	0	307
15811	278	0	2	0	0	280
15812	0	3	0	333	0	336
15813	0	1	446	0	0	447
15814	0	0	0	429	0	429
15815	2	6	0	442	0	450
15816	3	1	0	442	0	446
15817	2	6	0	432	0	440
15818	1	4	0	425	0	430
15819	471	0	3	0	0	474
15820	0	2	0	491	0	493
15821	1	0	518	0	0	519
15822	0	6	0	493	0	499
15823	0	498	1	0	0	499
15824	0	3	0	473	0	476
15825	2	0	516	0	0	518
15826	491	0	3	1	0	495
15827	488	0	2	0	0	490
15828	1	0	542	0	0	543
15829	0	515	0	1	0	516
15830	537	0	4	0	0	541
15831	508	0	6	0	0	514
15832	524	1	1	2	0	528
15833	565	1	1	0	0	567
15834	1	2	0	586	0	589
15835	2	1	638	0	0	641
15836	0	1	0	592	0	593
15837	4	5	2	606	0	617
15838	0	0	598	0	0	598
15839	4	0	693	0	0	697
15840	687	0	2	0	0	689
15841	0	701	0	0	0	701
15842	2	2	0	667	0	671
15843	1	0	728	0	0	729
15844	706	0	3	3	0	712
15845	0	0	750	0	0	750
15846	716	0	8	1	0	725
15847	0	746	0	1	0	747
15848	1	4	0	718	0	723
15849	0	0	756	0	0	756
15850	740	0	1	0	0	741
15851	0	766	0	0	0	766
15852	0	747	0	0	0	747
15853	0	0	0	702	0	702
15854	2	4	0	837	0	843
15855	853	2	4	0	0	859
15856	0	914	0	0	0	914
15857	0	5	0	890	0	895
15858	880	0	6	0	0	886
15859	817	0	3	0	0	820
15860	849	2	7	0	0	858
15861	2	0	884	0	0	886
15862	0	0	901	0	0	901
15863	880	0	1	0	0	881
15864	0	892	1	0	0	893
15865	0	872	0	2	0	874
15866	0	11	0	856	0	867
15867	0	902	0	0	0	902
15868	873	0	5	2	0	880
15869	1	0	0	873	0	874
15870	0	0	892	0	0	892
15871	897	0	2	1	0	900
15872	850	0	3	0	0	853
15873	0	3	0	864	0	867
15874	1	0	0	859	0	860
15875	1	2	0	860	0	863
15876	1	1	0	872	0	874
15877	0	0	893	0	0	893
15878	1	901	0	0	0	902
15879	1	2	0	868	0	871
15880	1	899	0	0	0	900
15881	1	1	0	885	0	887
15882	0	885	0	0	0	885
15883	877	0	5	1	0	883
15884	893	0	2	0	0	895
15885	0	928	0	1	0	929
15886	914	0	5	1	0	920
15887	0	2	0	911	0	913
15888	900	0	1	2	0	903
15889	0	917	0	4	0	921
15890	879	0	2	0	0	881
15891	793	0	1	0	0	794
15892	0	2	0	833	0	835
15893	0	0	814	0	0	814
15894	0	809	0	0	0	809
15895	0	2	0	767	0	769
15896	773	0	1	1	0	775
15897	0	0	794	0	0	794
15898	4	4	0	742	0	750
15899	0	2	0	739	0	741
15900	701	0	0	0	0	701
15901	690	2	3	0	0	695
15902	683	0	0	0	0	683
15903	7	715	0	2	0	724
15904	624	0	2	0	0	626
15905	0	0	652	0	0	652
15906	2	0	638	2	0	642
15907	7	0	630	1	0	638
15908	5	4	2	536	0	547
15909	1	0	534	0	0	535
15910	508	0	6	0	0	514
15911	0	1	0	510	0	511
15912	32	0	288	0	0	320
15913	304	0	0	0	0	304
15914	0	2	0	282	0	284
15915	7	3	0	270	0	280
15916	292	0	2	0	0	294
15917	0	0	0	302	0	302
15918	1	0	318	0	0	319
15919	0	0	0	318	0	318
15920	1	0	325	0	0	326
15921	0	0	0	313	0	313
15922	309	1	2	0	0	312
15923	0	327	0	0	0	327
15924	0	318	0	0	0	318
15925	0	0	0	319	0	319
15926	0	0	0	363	0	363
15927	0	361	0	0	0	361
15928	0	379	0	0	0	379
15929	0	0	0	354	0	354
15930	0	2	0	377	0	379
15931	358	0	0	0	0	358
15932	0	398	0	0	0	398
15933	0	384	0	0	0	384
15934	0	388	0	0	0	388
15935	378	0	2	1	0	381
15936	0	0	394	0	0	394
15937	382	0	1	0	0	383
15938	0	0	0	387	0	387
15939	0	390	0	0	0	390
15940	0	394	0	0	0	394
15941	390	0	1	0	0	391
15942	1	3	0	382	0	386
15943	0	382	0	1	0	383
15944	390	0	0	0	0	390
15945	379	0	1	0	0	380
15946	0	0	395	0	0	395
15947	381	0	3	0	0	384
15948	366	0	1	2	0	369
15949	0	0	0	382	0	382
15950	0	389	0	0	0	389
15951	1	380	0	0	0	381
15952	0	1	0	380	0	381
15953	382	0	2	0	0	384
15954	0	0	394	0	0	394
15955	0	0	386	0	0	386
15956	0	0	384	0	0	384
15957	0	0	397	0	0	397
15958	0	396	0	0	0	396
15959	0	387	0	3	0	390
15960	0	0	367	0	0	367
15961	0	0	391	0	0	391
15962	0	397	0	0	0	397
15963	0	1	0	381	0	382
15964	1	0	396	0	0	397
15965	0	2	0	361	0	363
15966	2	0	0	365	0	367
15967	0	3	0	376	0	379
15968	0	0	0	385	0	385
15969	0	0	403	1	0	404
15970	0	0	0	402	0	402
15971	404	0	0	0	0	404
15972	1	0	397	0	0	398
15973	394	0	0	0	0	394
15974	0	4	1	382	0	387
15975	0	0	378	0	0	378
15976	391	0	3	0	0	394
15977	0	2	0	369	0	371
15978	359	0	1	0	0	360
15979	1	1	0	392	0	394
15980	0	378	0	0	0	378
15981	0	0	399	0	0	399
15982	0	0	0	394	0	394
15983	396	0	0	0	0	396
15984	380	0	0	1	0	381
15985	370	1	1	5	0	377
15986	375	0	1	0	0	376
15987	379	1	0	0	0	380
15988	0	405	0	0	0	405
15989	390	0	3	0	0	393
15990	0	0	358	0	0	358
15991	387	0	1	0	0	388
15992	0	0	0	383	0	383
15993	0	0	376	0	0	376
15994	0	0	383	0	0	383
15995	0	0	0	385	0	385
15996	387	0	0	0	0	387
15997	0	391	0	0	0	391
15998	388	0	1	0	0	389
15999	0	390	0	0	0	390
16000	0	0	0	367	0	367
16001	0	2	0	350	0	352
16002	357	0	0	0	0	357
16003	0	1	0	353	0	354
16004	0	0	358	0	0	358
16005	348	1	0	0	0	349
16006	0	2	0	328	0	330
16007	0	0	0	331	0	331
16008	0	0	314	0	0	314
16009	311	0	0	0	0	311
16010	303	0	0	0	0	303
16011	0	319	0	1	0	320
16012	0	0	298	0	0	298
16013	0	0	316	0	0	316
16014	1	2	0	301	0	304
16015	1	2	0	305	0	308
16016	0	297	0	0	0	297
16017	0	0	306	0	0	306
16018	0	0	0	302	0	302
16019	1	0	309	0	0	310
16020	0	2	0	296	0	298
16021	0	299	0	0	0	299
16022	1	4	0	255	0	260
16023	0	30	0	231	0	261
16024	0	1	0	259	0	260
16025	266	0	3	0	0	269
16026	0	0	282	0	0	282
16027	0	279	0	0	0	279
16028	0	1	0	262	0	263
16029	264	0	0	0	0	264
16030	0	0	0	261	0	261
16031	259	0	0	0	0	259
16032	2	0	258	0	0	260
16033	245	0	2	0	0	247
16034	0	1	0	238	0	239
16035	0	0	231	0	0	231
16036	0	209	0	2	0	211
16037	0	0	0	200	0	200
16038	0	1	0	207	0	208
16039	202	0	0	0	0	202
16040	0	209	0	0	0	209
16041	0	197	0	0	0	197
16042	0	203	0	0	0	203
16043	204	0	1	1	0	206
16044	0	210	0	0	0	210
16045	0	0	0	195	0	195
16046	0	3	0	207	0	210
16047	210	0	0	0	0	210
16048	0	208	0	0	0	208
16049	0	0	0	209	0	209
16050	204	0	0	3	0	207
16051	185	0	1	0	0	186
16052	195	0	0	0	0	195
16053	0	209	0	2	0	211
16054	209	0	3	0	0	212
16055	0	0	0	207	0	207
16056	0	207	0	0	0	207
16057	0	205	1	0	0	206
16058	0	1	0	202	0	203
16059	207	0	0	1	0	208
16060	179	0	0	0	0	179
16061	0	0	1	208	0	209
16062	0	209	0	0	0	209
16063	190	0	1	0	0	191
16064	0	0	198	0	0	198
16065	0	0	189	0	0	189
16066	195	0	2	0	0	197
16067	0	0	196	0	0	196
16068	0	0	1	173	0	174
16069	170	0	0	0	0	170
16070	0	1	0	169	0	170
16071	0	0	177	1	0	178
16072	0	180	0	0	0	180
16073	8	2	0	162	0	172
16074	0	0	167	0	0	167
16075	173	0	1	0	0	174
16076	0	1	2	165	0	168
16077	10	0	161	0	0	171
16078	0	0	0	172	0	172
16079	0	181	0	0	0	181
16080	0	0	1	164	0	165
16081	0	0	0	160	0	160
16082	0	1	0	173	0	174
16083	0	182	0	0	0	182
16084	181	0	2	0	0	183
16085	0	0	0	175	0	175
16086	0	2	0	168	0	170
16087	2	2	0	167	0	171
16088	0	0	177	0	0	177
16089	0	0	0	178	0	178
16090	176	0	0	0	0	176
16091	0	179	0	0	0	179
16092	0	1	0	162	0	163
16093	0	0	0	168	0	168
16094	157	0	0	1	0	158
16095	0	178	0	0	0	178
16096	175	0	2	0	0	177
16097	173	0	0	0	0	173
16098	0	0	0	180	0	180
16099	193	0	0	0	0	193
16100	0	203	0	0	0	203
16101	196	0	0	0	0	196
16102	0	0	0	200	0	200
16103	180	0	1	0	0	181
16104	185	0	0	0	0	185
16105	1	0	204	0	0	205
16106	184	0	1	0	0	185
16107	175	0	2	0	0	177
16108	173	0	0	1	0	174
16109	0	0	188	0	0	188
16110	0	191	0	1	0	192
16111	0	0	0	186	0	186
16112	184	0	0	0	0	184
16113	0	199	0	0	0	199
16114	187	0	0	0	0	187
16115	0	1	0	185	0	186
16116	0	0	186	0	0	186
16117	183	0	1	0	0	184
16118	0	0	0	180	0	180
16119	0	0	194	0	0	194
16120	195	0	2	0	0	197
16121	0	1	208	0	0	209
16122	1	0	0	196	0	197
16123	0	0	0	201	0	201
16124	182	0	1	0	0	183
16125	188	0	2	0	0	190
16126	0	210	0	0	0	210
16127	199	0	0	0	0	199
16128	0	0	216	0	0	216
16129	0	0	213	0	0	213
16130	200	0	1	0	0	201
16131	0	219	0	0	0	219
16132	210	0	0	0	0	210
16133	0	231	0	0	0	231
16134	237	0	3	0	0	240
16135	0	0	0	258	0	258
16136	0	0	265	0	0	265
16137	0	1	0	244	0	245
16138	0	0	0	257	0	257
16139	254	0	2	0	0	256
16140	0	0	280	0	0	280
16141	276	0	0	0	0	276
16142	0	295	0	1	0	296
16143	284	0	1	1	0	286
16144	0	2	0	273	0	275
16145	0	0	289	0	0	289
16146	0	1	0	279	0	280
16147	288	0	0	1	0	289
16148	0	0	0	271	0	271
16149	0	0	0	299	0	299
16150	0	295	0	0	0	295
16151	0	2	0	301	0	303
16152	0	1	309	0	0	310
16153	0	1	0	295	0	296
16154	0	1	0	278	0	279
16155	283	0	1	0	0	284
16156	0	1	0	301	0	302
16157	0	0	306	0	0	306
16158	0	313	0	0	0	313
16159	0	1	0	280	0	281
16160	0	2	0	295	0	297
16161	297	0	2	0	0	299
16162	0	313	0	1	0	314
16163	0	4	0	322	0	326
16164	336	0	3	0	0	339
16165	317	0	2	0	0	319
16166	1	0	0	373	0	374
16167	0	0	389	0	0	389
16168	373	0	3	0	0	376
16169	0	0	0	372	0	372
16170	355	0	3	1	0	359
16171	384	0	0	0	0	384
16172	0	412	0	0	0	412
16173	400	0	10	0	0	410
16174	0	438	0	0	0	438
16175	0	3	0	415	0	418
16176	0	0	0	433	0	433
16177	0	431	0	1	0	432
16178	430	0	0	1	0	431
16179	429	0	0	0	0	429
16180	0	0	443	0	0	443
16181	0	0	473	0	0	473
16182	1	0	0	480	0	481
16183	486	0	0	0	0	486
16184	0	4	0	464	0	468
16185	0	1	0	492	0	493
16186	0	0	486	1	0	487
16187	0	0	479	0	0	479
16188	0	0	483	0	0	483
16189	483	0	5	0	0	488
16190	466	0	0	2	0	468
16191	0	512	0	2	0	514
16192	0	500	0	1	0	501
16193	0	2	5	498	0	505
16194	1	0	528	0	0	529
16195	529	0	3	1	0	533
16196	0	0	536	0	0	536
16197	0	0	0	519	0	519
16198	1	3	0	490	0	494
16199	0	3	0	510	0	513
16200	0	0	0	532	0	532
16201	520	0	1	0	0	521
16202	0	1	0	546	0	547
16203	0	0	553	0	0	553
16204	535	0	2	4	0	541
16205	1	0	556	0	0	557
16206	0	0	567	0	0	567
16207	0	593	0	0	0	593
16208	0	0	0	566	0	566
16209	646	0	0	0	0	646
16210	0	3	0	678	0	681
16211	2	0	706	0	0	708
16212	0	0	0	708	0	708
16213	702	0	0	0	0	702
16214	0	717	0	0	0	717
16215	699	3	0	2	0	704
16216	0	727	0	1	0	728
16217	705	0	1	0	0	706
16218	0	730	0	0	0	730
16219	0	688	0	1	0	689
16220	0	0	700	0	0	700
16221	0	734	0	0	0	734
16222	714	0	2	0	0	716
16223	0	1	0	720	0	721
16224	722	0	0	0	0	722
16225	0	752	0	0	0	752
16226	703	0	8	2	0	713
16227	0	0	759	0	0	759
16228	0	1	0	745	0	746
16229	0	765	0	0	0	765
16230	0	0	0	708	0	708
16231	0	0	0	737	0	737
16232	735	0	0	0	0	735
16233	0	773	0	1	0	774
16234	727	0	5	0	0	732
16235	0	0	752	0	0	752
16236	0	0	747	0	0	747
16237	0	776	0	1	0	777
16238	0	4	0	740	0	744
16239	0	0	784	0	0	784
16240	0	0	0	710	0	710
16241	0	0	0	725	0	725
16242	0	0	762	0	0	762
16243	0	0	752	0	0	752
16244	0	0	762	0	0	762
16245	0	0	769	0	0	769
16246	0	772	0	2	0	774
16247	0	8	0	743	0	751
16248	0	1	0	709	0	710
16249	0	0	774	0	0	774
16250	0	1	0	743	0	744
16251	0	0	767	0	0	767
16252	1	2	0	710	0	713
16253	0	0	0	709	0	709
16254	0	730	0	0	0	730
16255	0	1	0	703	0	704
16256	0	0	0	696	0	696
16257	2	2	0	715	0	719
16258	1	0	722	0	0	723
16259	0	716	0	0	0	716
16260	703	0	2	0	0	705
16261	659	0	2	0	0	661
16262	0	2	0	676	0	678
16263	0	0	0	719	0	719
16264	0	695	0	0	0	695
16265	709	0	4	0	0	713
16266	0	728	0	1	0	729
16267	684	0	4	3	0	691
16268	0	0	721	0	0	721
16269	706	1	1	0	0	708
16270	0	706	0	0	0	706
16271	0	1	0	642	0	643
16272	0	1	0	682	0	683
16273	0	711	0	0	0	711
16274	693	1	1	2	0	697
16275	0	3	0	621	0	624
16276	0	5	0	664	0	669
16277	656	0	0	1	0	657
16278	685	2	5	0	0	692
16279	3	0	692	0	0	695
16280	709	0	2	0	0	711
16281	0	5	0	683	0	688
16282	3	0	700	0	0	703
16283	2	5	1	664	0	672
16284	2	0	657	0	0	659
16285	1	0	691	0	0	692
16286	0	6	0	641	0	647
16287	2	0	662	0	0	664
16288	0	662	0	0	0	662
16289	3	5	6	629	0	643
16290	0	2	0	647	0	649
16291	7	0	664	0	0	671
16292	0	666	0	2	0	668
16293	663	0	6	0	0	669
16294	0	0	0	690	0	690
16295	704	0	0	0	0	704
16296	0	708	0	1	0	709
16297	2	0	717	0	0	719
16298	3	1	0	718	0	722
16299	707	0	1	0	0	708
16300	0	0	742	0	0	742
16301	736	1	2	0	0	739
16302	0	749	0	1	0	750
16303	0	718	0	0	0	718
16304	733	0	4	0	0	737
16305	0	4	0	683	0	687
16306	0	0	0	759	0	759
16307	0	766	0	0	0	766
16308	0	0	0	730	0	730
16309	1	1	0	731	0	733
16310	740	0	0	0	0	740
16311	1	4	0	759	0	764
16312	0	0	781	0	0	781
16313	0	2	0	752	0	754
16314	0	1	0	728	0	729
16315	0	0	749	0	0	749
16316	0	1	0	730	0	731
16317	711	0	0	0	0	711
16318	700	0	2	0	0	702
16319	670	0	6	0	0	676
16320	0	0	0	731	0	731
16321	6	0	717	0	0	723
16322	0	711	0	7	0	718
16323	1	0	0	713	0	714
16324	0	0	744	0	0	744
16325	0	3	0	673	0	676
16326	0	2	0	715	0	717
16327	711	0	1	0	0	712
16328	0	722	0	1	0	723
16329	1	2	700	0	0	703
16330	698	0	6	2	0	706
16331	0	715	0	0	0	715
16332	0	678	0	0	0	678
16333	664	0	3	0	0	667
16334	0	4	0	674	0	678
16335	0	0	696	0	0	696
16336	0	4	0	672	0	676
16337	0	672	0	0	0	672
16338	680	0	1	0	0	681
16339	0	4	0	652	0	656
16340	658	0	2	1	0	661
16341	0	2	0	674	0	676
16342	0	663	0	2	0	665
16343	619	0	1	0	0	620
16344	594	0	0	0	0	594
16345	0	635	0	0	0	635
16346	598	0	0	0	0	598
16347	0	4	0	607	0	611
16348	0	588	0	0	0	588
16349	597	0	0	0	0	597
16350	0	605	0	1	0	606
16351	592	0	2	0	0	594
16352	2	3	0	579	0	584
16353	559	0	3	0	0	562
16354	552	0	3	0	0	555
16355	543	0	0	0	0	543
16356	0	1	0	527	0	528
16357	1	3	1	559	0	564
16358	534	0	0	0	0	534
16359	1	0	546	0	0	547
16360	0	6	1	500	0	507
16361	0	503	0	1	0	504
16362	1	5	0	455	0	461
16363	0	2	0	451	0	453
16364	0	0	477	0	0	477
16365	0	0	0	472	0	472
16366	0	465	0	0	0	465
16367	0	3	0	451	0	454
16368	0	0	466	0	0	466
16369	0	0	0	436	0	436
16370	0	2	0	429	0	431
16371	416	0	5	0	0	421
16372	408	0	4	1	0	413
16373	0	1	0	437	0	438
16374	0	433	0	0	0	433
16375	0	392	0	1	0	393
16376	1	0	406	0	0	407
16377	1	1	0	393	0	395
16378	373	0	0	0	0	373
16379	0	1	1	392	0	394
16380	2	0	397	0	0	399
16381	0	2	2	364	0	368
16382	0	19	1	348	0	368
16383	0	7	0	367	0	374
16384	0	2	381	0	0	383
16385	0	371	0	0	0	371
16386	370	0	2	0	0	372
16387	345	0	1	0	0	346
16388	0	3	2	355	0	360
16389	0	0	355	0	0	355
16390	0	362	0	0	0	362
16391	2	2	0	346	0	350
16392	0	361	0	0	0	361
16393	0	349	0	1	0	350
16394	353	0	0	1	0	354
16395	0	0	352	0	0	352
16396	1	0	368	0	0	369
16397	0	0	0	360	0	360
16398	0	2	0	343	0	345
16399	1	0	369	0	0	370
16400	0	2	0	357	0	359
16401	0	0	345	0	0	345
16402	345	0	0	0	0	345
16403	0	2	0	366	0	368
16404	0	0	372	0	0	372
16405	26	2	0	338	0	366
16406	0	372	0	0	0	372
16407	356	0	2	0	0	358
16408	0	375	2	0	0	377
16409	366	0	0	0	0	366
16410	1	0	356	0	0	357
16411	365	0	0	0	0	365
16412	1	0	0	357	0	358
16413	0	0	369	0	0	369
16414	0	4	0	350	0	354
16415	1	0	356	0	0	357
16416	354	0	2	1	0	357
16417	0	362	0	0	0	362
16418	0	4	0	333	0	337
16419	0	348	0	0	0	348
16420	353	0	0	1	0	354
16421	354	0	4	0	0	358
16422	0	350	0	0	0	350
16423	0	3	1	329	0	333
16424	0	2	0	330	0	332
16425	0	0	0	345	0	345
16426	337	0	1	1	0	339
16427	0	342	0	1	0	343
16428	4	0	0	305	0	309
16429	0	3	0	321	0	324
16430	288	0	1	0	0	289
16431	0	0	298	0	0	298
16432	0	0	298	0	0	298
16433	284	2	1	0	0	287
16434	0	0	276	0	0	276
16435	3	0	276	0	0	279
16436	7	0	0	250	0	257
16437	239	0	0	0	0	239
16438	0	2	0	252	0	254
16439	0	0	259	0	0	259
16440	239	0	2	0	0	241
16441	1	0	253	0	0	254
16442	0	253	0	2	0	255
16443	3	1	0	240	0	244
16444	231	0	1	0	0	232
16445	0	0	0	207	0	207
16446	0	1	0	227	0	228
16447	231	0	0	0	0	231
16448	0	0	0	211	0	211
16449	0	0	0	214	0	214
16450	0	0	221	0	0	221
16451	0	0	0	188	0	188
16452	189	0	1	0	0	190
16453	190	0	0	0	0	190
16454	174	0	0	0	0	174
16455	1	0	0	189	0	190
16456	0	183	0	0	0	183
16457	175	0	3	0	0	178
16458	0	179	0	0	0	179
16459	172	0	2	0	0	174
16460	0	0	0	173	0	173
16461	166	0	2	0	0	168
16462	163	0	0	0	0	163
16463	166	0	1	0	0	167
16464	0	176	0	0	0	176
16465	0	173	0	0	0	173
16466	165	0	1	1	0	167
16467	0	173	0	0	0	173
16468	0	165	0	0	0	165
16469	0	169	0	1	0	170
16470	170	0	0	0	0	170
16471	0	0	0	140	0	140
16472	0	0	1	168	0	169
16473	168	0	1	0	0	169
16474	1	0	174	0	0	175
16475	0	0	0	163	0	163
16476	0	1	0	150	0	151
16477	0	1	0	157	0	158
16478	0	0	0	156	0	156
16479	0	155	0	0	0	155
16480	0	156	0	0	0	156
16481	154	0	2	0	0	156
16482	0	1	0	144	0	145
16483	0	2	0	137	0	139
16484	0	0	146	0	0	146
16485	1	0	0	141	0	142
16486	0	0	151	0	0	151
16487	1	2	0	140	0	143
16488	1	0	144	0	0	145
16489	0	147	0	0	0	147
16490	0	0	0	129	0	129
16491	141	0	0	0	0	141
16492	126	0	0	0	0	126
16493	0	0	0	134	0	134
16494	0	0	125	0	0	125
16495	0	0	132	0	0	132
16496	132	0	0	0	0	132
16497	0	131	0	0	0	131
16498	127	0	0	1	0	128
16499	126	0	1	0	0	127
16500	0	0	132	0	0	132
16501	0	0	0	121	0	121
16502	1	0	0	115	0	116
16503	0	1	0	113	0	114
16504	1	0	0	112	0	113
16505	0	0	0	127	0	127
16506	0	0	126	0	0	126
16507	1	0	128	0	0	129
16508	0	0	1	115	0	116
16509	7	0	0	116	0	123
16510	2	0	0	117	0	119
16511	126	0	0	1	0	127
16512	0	0	0	126	0	126
16513	131	0	0	0	0	131
16514	0	0	0	118	0	118
16515	123	0	0	1	0	124
16516	124	0	0	0	0	124
16517	130	0	0	0	0	130
16518	129	0	0	0	0	129
16519	129	0	0	0	0	129
16520	0	0	0	127	0	127
16521	127	0	1	0	0	128
16522	0	131	0	0	0	131
16523	121	0	1	0	0	122
16524	0	3	0	127	0	130
16525	0	0	130	0	0	130
16526	0	0	1	127	0	128
16527	0	0	132	0	0	132
16528	0	0	0	107	0	107
16529	0	0	0	114	0	114
16530	1	0	113	1	0	115
16531	1	0	121	0	0	122
16532	0	0	0	109	0	109
16533	117	0	0	0	0	117
16534	1	0	116	0	0	117
16535	0	102	0	1	0	103
16536	1	0	101	0	0	102
16537	109	0	1	0	0	110
16538	0	0	0	90	0	90
16539	103	0	0	0	0	103
16540	88	0	1	0	0	89
16541	0	0	0	107	0	107
16542	0	0	114	0	0	114
16543	2	0	0	95	0	97
16544	0	0	0	96	0	96
16545	92	0	0	0	0	92
16546	0	97	0	7	0	104
16547	0	0	0	97	0	97
16548	0	0	101	0	0	101
16549	100	0	0	0	0	100
16550	0	103	0	0	0	103
16551	0	1	1	98	0	100
16552	0	0	0	95	0	95
16553	0	0	0	85	0	85
16554	100	0	0	0	0	100
16555	96	0	0	0	0	96
16556	0	0	0	100	0	100
16557	0	0	97	0	0	97
16558	0	97	0	0	0	97
16559	96	0	0	0	0	96
16560	86	0	0	0	0	86
16561	0	0	0	91	0	91
16562	0	1	0	94	0	95
16563	0	0	100	0	0	100
16564	0	93	0	2	0	95
16565	99	0	0	0	0	99
16566	104	0	0	0	0	104
16567	0	103	0	0	0	103
16568	100	0	1	0	0	101
16569	0	1	0	98	0	99
16570	0	0	100	0	0	100
16571	0	0	0	97	0	97
16572	0	0	100	0	0	100
16573	96	0	0	0	0	96
16574	1	104	0	0	0	105
16575	0	0	0	93	0	93
16576	0	0	90	1	0	91
16577	0	0	96	0	0	96
16578	93	0	0	0	0	93
16579	0	95	0	0	0	95
16580	91	0	0	0	0	91
16581	86	0	0	0	0	86
16582	82	0	1	0	0	83
16583	0	0	0	89	0	89
16584	0	0	93	0	0	93
16585	0	91	0	0	0	91
16586	0	0	0	88	0	88
16587	0	0	91	0	0	91
16588	0	0	90	0	0	90
16589	0	1	0	88	0	89
16590	0	0	92	0	0	92
16591	95	0	0	0	0	95
16592	0	0	0	79	0	79
16593	0	0	0	85	0	85
16594	87	0	0	0	0	87
16595	0	92	0	0	0	92
16596	89	0	2	0	0	91
16597	0	1	0	82	0	83
16598	0	0	0	86	0	86
16599	0	0	0	91	0	91
16600	0	0	0	94	0	94
16601	92	0	0	0	0	92
16602	0	0	106	0	0	106
16603	0	107	0	0	0	107
16604	0	0	0	104	0	104
16605	100	0	0	0	0	100
16606	96	0	4	1	0	101
16607	0	123	0	0	0	123
16608	119	0	0	1	0	120
16609	0	130	0	0	0	130
16610	0	121	0	0	0	121
16611	0	1	0	120	0	121
16612	0	0	137	0	0	137
16613	1	0	0	135	0	136
16614	136	0	0	0	0	136
16615	0	140	0	0	0	140
16616	0	0	0	135	0	135
16617	0	0	137	0	0	137
16618	131	0	0	0	0	131
16619	124	0	2	0	0	126
16620	125	0	4	0	0	129
16621	0	0	140	0	0	140
16622	138	0	0	0	0	138
16623	0	142	0	0	0	142
16624	0	0	0	138	0	138
16625	0	137	0	1	0	138
16626	128	0	0	0	0	128
16627	128	0	0	0	0	128
16628	0	0	137	0	0	137
16629	0	137	0	0	0	137
16630	0	0	0	130	0	130
16631	0	0	0	135	0	135
16632	0	0	0	129	0	129
16633	0	0	0	133	0	133
16634	1	0	0	136	0	137
16635	0	0	139	0	0	139
16636	0	138	0	0	0	138
16637	135	0	2	0	0	137
16638	0	0	142	0	0	142
16639	0	138	0	0	0	138
16640	134	0	0	0	0	134
16641	0	0	134	0	0	134
16642	137	0	0	0	0	137
16643	128	0	1	0	0	129
16644	133	0	0	0	0	133
16645	0	136	0	0	0	136
16646	0	0	133	0	0	133
16647	0	141	0	0	0	141
16648	0	0	0	130	0	130
16649	0	133	0	0	0	133
16650	140	0	1	0	0	141
16651	125	0	0	0	0	125
16652	141	0	0	0	0	141
16653	0	0	142	0	0	142
16654	0	140	0	0	0	140
16655	0	0	0	134	0	134
16656	144	0	0	0	0	144
16657	0	142	0	0	0	142
16658	0	0	0	138	0	138
16659	0	0	142	0	0	142
16660	121	0	0	0	0	121
16661	0	0	135	0	0	135
16662	0	0	131	0	0	131
16663	124	0	2	0	0	126
16664	0	0	129	0	0	129
16665	126	0	0	0	0	126
16666	0	135	0	0	0	135
16667	134	0	0	0	0	134
16668	0	0	0	120	0	120
16669	0	2	0	113	0	115
16670	0	1	0	124	0	125
16671	117	0	0	1	0	118
16672	113	0	0	0	0	113
16673	123	0	0	0	0	123
16674	0	125	0	0	0	125
16675	0	0	0	119	0	119
16676	0	0	127	0	0	127
16677	0	0	0	122	0	122
16678	0	127	0	0	0	127
16679	0	0	0	120	0	120
16680	0	0	0	123	0	123
16681	124	0	0	0	0	124
16682	0	0	0	129	0	129
16683	0	0	130	0	0	130
16684	0	0	128	0	0	128
16685	0	1	0	117	0	118
16686	117	0	0	0	0	117
16687	0	0	0	107	0	107
16688	0	0	0	113	0	113
16689	0	0	117	0	0	117
16690	0	115	0	0	0	115
16691	0	0	0	111	0	111
16692	102	0	0	3	0	105
16693	0	111	0	0	0	111
16694	0	1	0	96	0	97
16695	0	0	101	0	0	101
16696	0	0	0	89	0	89
16697	85	0	0	0	0	85
16698	0	88	0	0	0	88
16699	0	0	87	0	0	87
16700	0	0	0	83	0	83
16701	0	0	83	0	0	83
16702	80	1	0	0	0	81
16703	80	0	0	0	0	80
16704	0	0	83	0	0	83
16705	0	1	0	72	0	73
16706	0	0	75	0	0	75
16707	0	59	0	1	0	60
16708	0	0	0	54	0	54
16709	0	0	56	0	0	56
16710	0	0	0	55	0	55
16711	0	54	0	0	0	54
16712	0	0	0	55	0	55
16713	0	0	52	0	0	52
16714	52	0	0	0	0	52
16715	0	51	0	0	0	51
16716	48	0	0	0	0	48
16717	0	0	49	0	0	49
16718	39	0	0	0	0	39
16719	0	0	36	0	0	36
16720	38	0	0	0	0	38
16721	30	0	1	0	0	31
16722	0	0	0	28	0	28
16723	0	0	0	31	0	31
16724	34	0	0	0	0	34
16725	0	34	0	1	0	35
16726	41	0	0	0	0	41
16727	0	0	0	39	0	39
16728	0	42	0	0	0	42
16729	0	1	0	38	0	39
16730	0	0	0	40	0	40
16731	0	0	0	43	0	43
16732	0	42	0	0	0	42
16733	44	0	0	0	0	44
16734	0	2	0	42	0	44
16735	1	0	43	0	0	44
16736	0	0	41	0	0	41
16737	0	0	43	0	0	43
16738	42	0	0	0	0	42
16739	42	0	0	0	0	42
16740	0	0	42	0	0	42
16741	0	1	0	34	0	35
16742	0	0	0	39	0	39
16743	0	0	41	0	0	41
16744	0	0	39	0	0	39
16745	0	0	0	38	0	38
16746	39	0	0	0	0	39
16747	40	0	0	0	0	40
16748	44	0	0	0	0	44
16749	0	47	0	0	0	47
16750	0	46	0	0	0	46
16751	0	0	0	44	0	44
16752	47	0	0	0	0	47
16753	0	0	50	0	0	50
16754	51	0	0	0	0	51
16755	0	52	0	0	0	52
16756	0	46	0	0	0	46
16757	47	0	0	0	0	47
16758	0	46	0	0	0	46
16759	0	44	0	0	0	44
16760	43	0	0	0	0	43
16761	0	48	0	0	0	48
16762	0	0	0	41	0	41
16763	0	0	0	44	0	44
16764	40	0	0	0	0	40
16765	44	0	0	0	0	44
16766	0	45	0	0	0	45
16767	0	38	0	0	0	38
16768	0	0	38	0	0	38
16769	43	0	0	0	0	43
16770	36	0	0	0	0	36
16771	41	0	0	0	0	41
16772	0	0	0	40	0	40
16773	0	0	0	38	0	38
16774	38	0	0	0	0	38
16775	0	0	0	40	0	40
16776	0	0	42	0	0	42
16777	0	0	0	42	0	42
16778	0	42	0	0	0	42
16779	0	1	0	42	0	43
16780	0	0	0	42	0	42
16781	0	0	0	43	0	43
16782	43	0	0	0	0	43
16783	0	46	0	0	0	46
16784	0	0	0	42	0	42
16785	0	0	44	0	0	44
16786	0	0	49	0	0	49
16787	0	0	0	42	0	42
16788	0	0	0	48	0	48
16789	48	0	0	0	0	48
16790	0	0	0	46	0	46
16791	0	47	0	0	0	47
16792	0	0	45	0	0	45
16793	0	1	0	48	0	49
16794	0	0	46	0	0	46
16795	1	0	0	43	0	44
16796	42	0	0	0	0	42
16797	43	0	0	0	0	43
16798	0	50	0	0	0	50
16799	0	0	0	51	0	51
16800	47	0	1	0	0	48
16801	46	0	0	0	0	46
16802	41	0	0	0	0	41
16803	48	0	0	0	0	48
16804	46	0	0	0	0	46
16805	0	51	0	0	0	51
16806	51	0	0	0	0	51
16807	0	0	52	0	0	52
16808	0	1	0	50	0	51
16809	54	0	0	0	0	54
16810	49	0	0	0	0	49
16811	53	0	0	0	0	53
16812	0	0	56	0	0	56
16813	0	0	0	58	0	58
16814	57	0	0	0	0	57
16815	0	60	0	0	0	60
16816	64	0	0	0	0	64
16817	57	0	0	0	0	57
16818	59	0	2	0	0	61
16819	0	0	0	66	0	66
16820	65	0	0	0	0	65
16821	0	0	66	0	0	66
16822	1	0	65	0	0	66
16823	64	0	0	0	0	64
16824	1	0	63	0	0	64
16825	65	0	0	1	0	66
16826	0	0	70	0	0	70
16827	0	1	0	68	0	69
16828	70	0	0	0	0	70
16829	0	70	0	0	0	70
16830	72	1	2	0	0	75
16831	0	78	0	0	0	78
16832	0	78	0	0	0	78
16833	0	0	0	78	0	78
16834	0	0	0	77	0	77
16835	0	1	0	78	0	79
16836	0	0	82	0	0	82
16837	80	0	1	0	0	81
16838	83	0	0	0	0	83
16839	80	0	0	0	0	80
16840	71	0	0	0	0	71
16841	83	0	0	0	0	83
16842	0	0	83	0	0	83
16843	0	0	84	0	0	84
16844	0	0	0	84	0	84
16845	0	0	84	0	0	84
16846	89	0	2	1	0	92
16847	0	100	0	0	0	100
16848	0	0	0	102	0	102
16849	99	0	0	0	0	99
16850	0	0	0	101	0	101
16851	0	0	99	0	0	99
16852	0	0	106	0	0	106
16853	0	0	0	103	0	103
16854	0	0	101	0	0	101
16855	108	0	1	0	0	109
16856	0	0	0	110	0	110
16857	1	0	107	0	0	108
16858	0	107	0	0	0	107
16859	0	0	0	115	0	115
16860	0	0	120	0	0	120
16861	0	0	0	112	0	112
16862	0	2	0	119	0	121
16863	0	0	123	0	0	123
16864	0	3	0	116	0	119
16865	0	0	0	108	0	108
16866	0	0	0	125	0	125
16867	116	0	0	0	0	116
16868	0	122	0	0	0	122
16869	0	113	0	0	0	113
16870	0	0	116	0	0	116
16871	118	0	1	0	0	119
16872	0	0	114	0	0	114
16873	0	0	133	0	0	133
16874	0	0	0	129	0	129
16875	130	0	0	0	0	130
16876	0	134	0	0	0	134
16877	127	0	0	0	0	127
16878	130	0	1	0	0	131
16879	0	135	0	0	0	135
16880	133	0	0	0	0	133
16881	124	0	0	0	0	124
16882	0	134	0	0	0	134
16883	0	1	0	126	0	127
16884	0	0	0	134	0	134
16885	130	0	0	0	0	130
16886	0	136	0	0	0	136
16887	131	0	0	0	0	131
16888	119	0	0	0	0	119
16889	123	0	0	0	0	123
16890	0	1	0	124	0	125
16891	0	0	0	132	0	132
16892	125	0	1	0	0	126
16893	116	0	0	0	0	116
16894	118	0	0	0	0	118
16895	0	0	0	127	0	127
16896	0	0	135	0	0	135
16897	0	1	0	123	0	124
16898	0	0	0	125	0	125
16899	0	0	123	0	0	123
16900	0	0	131	0	0	131
16901	1	0	0	129	0	130
16902	0	0	128	0	0	128
16903	131	0	0	1	0	132
16904	0	1	0	110	0	111
16905	0	0	0	125	0	125
16906	134	0	0	0	0	134
16907	0	0	0	127	0	127
16908	2	2	0	133	0	137
16909	0	0	0	126	0	126
16910	0	0	0	130	0	130
16911	0	0	139	0	0	139
16912	0	0	0	140	0	140
16913	0	0	140	0	0	140
16914	0	135	0	0	0	135
16915	2	0	0	134	0	136
16916	2	0	149	0	0	151
16917	146	0	0	0	0	146
16918	0	154	0	8	0	162
16919	177	0	0	0	0	177
16920	1	0	0	178	0	179
16921	0	195	0	0	0	195
16922	208	0	1	1	0	210
16923	0	227	0	1	0	228
16924	229	0	0	1	0	230
16925	3	0	0	222	0	225
16926	219	0	2	1	0	222
16927	0	242	0	5	0	247
16928	234	0	0	0	0	234
16929	0	0	249	0	0	249
16930	0	2	0	242	0	244
16931	243	0	5	0	0	248
16932	231	0	2	0	0	233
16933	0	0	0	252	0	252
16934	0	0	256	0	0	256
16935	0	261	0	1	0	262
16936	0	253	0	0	0	253
16937	259	0	0	0	0	259
16938	0	1	0	234	0	235
16939	0	0	0	248	0	248
16940	250	0	0	0	0	250
16941	258	0	0	0	0	258
16942	0	0	275	0	0	275
16943	0	1	0	276	0	277
16944	0	0	275	0	0	275
16945	0	285	0	0	0	285
16946	281	0	0	0	0	281
16947	0	291	0	0	0	291
16948	1	285	0	0	0	286
16949	0	2	0	292	0	294
16950	291	0	0	0	0	291
16951	0	297	0	2	0	299
16952	287	1	2	2	0	292
16953	0	289	0	1	0	290
16954	0	0	0	300	0	300
16955	293	0	1	0	0	294
16956	0	0	305	0	0	305
16957	0	2	0	306	0	308
16958	0	0	303	0	0	303
16959	0	303	0	0	0	303
16960	0	298	0	0	0	298
16961	299	0	2	0	0	301
16962	0	308	0	0	0	308
16963	292	0	1	0	0	293
16964	291	0	0	0	0	291
16965	1	0	298	0	0	299
16966	279	0	1	0	0	280
16967	0	0	293	0	0	293
16968	0	291	0	0	0	291
16969	296	0	0	0	0	296
16970	0	305	0	0	0	305
16971	0	1	0	291	0	292
16972	321	0	0	1	0	322
16973	0	1	0	310	0	311
16974	0	0	336	0	0	336
16975	0	1	0	312	0	313
16976	0	1	0	318	0	319
16977	316	0	0	0	0	316
16978	0	0	328	0	0	328
16979	323	0	0	0	0	323
16980	303	0	4	0	0	307
16981	1	0	0	278	0	279
16982	0	0	0	301	0	301
16983	298	0	0	0	0	298
16984	0	304	0	0	0	304
16985	0	0	1	297	0	298
16986	0	0	305	0	0	305
16987	0	0	311	0	0	311
16988	0	317	0	0	0	317
16989	0	3	0	291	0	294
16990	0	2	0	298	0	300
16991	320	1	2	0	0	323
16992	0	0	0	322	0	322
16993	334	0	1	0	0	335
16994	0	344	0	4	0	348
16995	0	320	0	0	0	320
16996	0	337	0	0	0	337
16997	331	0	2	0	0	333
16998	324	0	1	0	0	325
16999	0	353	0	0	0	353
17000	340	0	1	0	0	341
17001	0	363	0	0	0	363
17002	0	0	0	347	0	347
17003	0	365	0	0	0	365
17004	345	2	0	1	0	348
17005	351	0	2	0	0	353
17006	0	2	0	384	0	386
17007	379	1	0	1	0	381
17008	0	0	0	419	0	419
17009	1	404	0	2	0	407
17010	1	0	0	404	0	405
17011	0	409	1	2	0	412
17012	372	0	6	1	0	379
17013	0	0	386	3	0	389
17014	388	1	5	0	0	394
17015	1	4	0	382	0	387
17016	0	0	400	0	0	400
17017	388	0	1	0	0	389
17018	0	0	407	0	0	407
17019	0	1	0	370	0	371
17020	0	0	0	359	0	359
17021	0	1	0	382	0	383
17022	2	1	0	408	0	411
17023	0	397	0	1	0	398
17024	0	0	0	418	0	418
17025	413	0	0	0	0	413
17026	4	0	404	0	0	408
17027	0	405	0	0	0	405
17028	389	1	1	1	0	392
17029	357	0	2	1	0	360
17030	0	0	1	401	0	402
17031	1	0	443	0	0	444
17032	0	3	0	422	0	425
17033	0	8	0	419	0	427
17034	0	0	441	0	0	441
17035	0	470	0	0	0	470
17036	460	0	5	1	0	466
17037	424	0	5	0	0	429
17038	437	0	2	0	0	439
17039	3	0	0	440	0	443
17040	1	2	1	770	0	774
17041	907	0	1	0	0	908
17042	1	2	0	1009	0	1012
17043	0	1059	1	0	0	1060
17044	1036	4	30	3	0	1073
17045	1101	0	2	8	0	1111
17046	1073	7	12	3	0	1095
17047	1107	15	2	8	0	1132
17048	2	1	1206	1	0	1210
17049	1	0	1233	0	0	1234
17050	2	5	0	1159	0	1166
17051	0	0	0	1199	0	1199
17052	1	0	1229	0	0	1230
17053	1	0	1281	0	0	1282
17054	5	3	0	1247	0	1255
17055	1307	0	2	0	0	1309
17056	0	6	0	1343	0	1349
17057	1	0	1394	0	0	1395
17058	0	1422	0	1	0	1423
17059	1403	0	6	0	0	1409
17060	1387	0	8	0	0	1395
17061	1354	0	7	0	0	1361
17062	1420	0	6	1	0	1427
17063	0	0	1568	0	0	1568
17064	0	3	0	1537	0	1540
17065	1577	0	0	0	0	1577
17066	0	5	0	1506	0	1511
17067	0	9	0	1628	0	1637
17068	0	1655	0	1	0	1656
17069	0	1	0	1674	0	1675
17070	1673	0	2	0	0	1675
17071	0	1734	1	2	0	1737
17072	1688	3	1	1	0	1693
17073	0	1882	0	0	0	1882
17074	0	0	0	1859	0	1859
17075	0	1848	0	1	0	1849
17076	0	1936	0	0	0	1936
17077	1889	0	5	1	0	1895
17078	0	0	1930	0	0	1930
17079	0	0	1905	0	0	1905
17080	2	0	1946	0	0	1948
17081	1954	0	1	0	0	1955
17082	0	1993	0	0	0	1993
17083	0	1975	0	3	0	1978
17084	2082	0	2	1	0	2085
17085	0	2143	0	0	0	2143
17086	0	2096	0	0	0	2096
17087	0	6	2	2078	0	2086
17088	0	0	2113	0	0	2113
17089	1	0	2229	0	0	2230
17090	0	1	0	2201	0	2202
17091	2243	0	4	3	0	2250
17092	0	2285	0	1	0	2286
17093	4	3	1	2199	0	2207
17094	0	0	2268	0	0	2268
17095	1	0	2283	0	0	2284
17096	0	1	0	2164	0	2165
17097	2207	0	5	0	0	2212
17098	2108	0	7	2	0	2117
17099	0	0	2241	0	0	2241
17100	2214	0	0	0	0	2214
17101	0	0	2280	0	0	2280
17102	0	6	0	2238	0	2244
17103	0	2290	0	0	0	2290
17104	2239	0	4	2	0	2245
17105	0	6	0	2107	0	2113
17106	0	2	0	2153	0	2155
17107	0	2	0	2272	0	2274
17108	2	5	0	2286	0	2293
17109	3	0	2319	0	0	2322
17110	0	2359	0	0	0	2359
17111	0	4	2	2310	0	2316
17112	2279	0	4	0	0	2283
17113	2	22	0	2139	0	2163
17114	0	4	0	2307	0	2311
17115	4	0	2292	0	0	2296
17116	3	0	2332	0	0	2335
17117	0	2334	1	2	0	2337
17118	0	2321	0	2	0	2323
17119	0	7	0	2308	0	2315
17120	2336	0	3	0	0	2339
17121	4	0	2360	0	0	2364
17122	0	2362	0	4	0	2366
17123	0	0	0	2312	0	2312
17124	5	2342	0	1	0	2348
17125	2	1	0	2354	0	2357
17126	0	2394	0	2	0	2396
17127	0	0	0	2398	0	2398
17128	2359	0	5	0	0	2364
17129	0	2488	0	2	0	2490
17130	0	3	2	2445	0	2450
17131	2352	0	1	4	0	2357
17132	0	2456	0	18	0	2474
17133	0	2378	0	0	0	2378
17134	0	2439	0	2	0	2441
17135	0	2	0	2325	0	2327
17136	5	6	0	2400	0	2411
17137	0	2375	0	8	0	2383
17138	0	15	0	2452	0	2467
17139	2	0	2483	1	0	2486
17140	0	2468	2	4	0	2474
17141	0	14	0	2449	0	2463
17142	0	2435	0	3	0	2438
17143	45	0	2357	2	0	2404
17144	0	2400	0	0	0	2400
17145	2422	0	8	0	0	2430
17146	1	2	1	2429	0	2433
17147	2532	0	0	0	0	2532
17148	1	0	2742	0	0	2743
17149	5	11	0	2696	0	2712
17150	4	0	2818	0	0	2822
17151	10	2	0	2611	0	2623
17152	2585	0	6	0	0	2591
17153	0	12	0	2582	0	2594
17154	2525	0	8	3	0	2536
17155	0	2615	1	1	0	2617
17156	2410	0	5	1	0	2416
17157	0	0	2454	0	0	2454
17158	0	2321	0	4	0	2325
17159	0	6	0	2206	0	2212
17160	5	8	0	2236	0	2249
17161	8	0	2281	0	0	2289
17162	0	2296	0	4	0	2300
17163	2	8	0	2227	0	2237
17164	0	2261	0	2	0	2263
17165	0	10	0	2227	0	2237
17166	0	2235	0	2	0	2237
17167	2146	0	7	0	0	2153
17168	0	2	1	2203	0	2206
17169	3	0	2186	0	0	2189
17170	0	2195	0	4	0	2199
17171	0	2124	0	6	0	2130
17172	3	3	2161	0	0	2167
17173	0	2226	0	0	0	2226
17174	0	8	0	2161	0	2169
17175	1	0	2238	0	0	2239
17176	12	7	1	2084	0	2104
17177	1	17	2	2053	0	2073
17178	4	0	2177	0	0	2181
17179	2166	0	5	2	0	2173
17180	0	12	0	2152	0	2164
17181	4	0	2146	0	0	2150
17182	2	2142	0	0	0	2144
17183	2073	0	8	0	0	2081
17184	0	2149	0	2	0	2151
17185	1	4	2	1885	0	1892
17186	1903	0	2	0	0	1905
17187	1	14	0	1895	0	1910
17188	3	0	1946	0	0	1949
17189	1	4	1	1872	0	1878
17190	1	1	1848	1	0	1851
17191	1758	0	10	0	0	1768
17192	0	0	1595	0	0	1595
17193	1390	2	10	2	0	1404
17194	1350	0	8	2	0	1360
17195	0	1	1085	0	0	1086
17196	1	2	1014	0	0	1017
17197	0	1054	0	0	0	1054
17198	1025	0	9	0	0	1034
17199	0	2	0	953	0	955
17200	0	1	0	970	0	971
17201	947	0	4	1	0	952
17202	964	0	6	0	0	970
17203	954	0	6	6	0	966
17204	958	1	1	1	0	961
17205	0	2	0	868	0	870
17206	810	2	3	0	0	815
17207	0	6	0	780	0	786
17208	1	5	0	717	0	723
17209	0	1	0	779	0	780
17210	0	1	733	0	0	734
17211	0	771	0	0	0	771
17212	0	739	0	1	0	740
17213	0	2	0	725	0	727
17214	734	0	3	0	0	737
17215	0	3	0	734	0	737
17216	752	0	4	0	0	756
17217	2	0	778	0	0	780
17218	740	1	2	0	0	743
17219	0	3	0	689	0	692
17220	699	0	2	2	0	703
17221	652	0	5	1	0	658
17222	694	0	3	0	0	697
17223	0	7	0	728	0	735
17224	1	0	744	0	0	745
17225	0	5	1	725	0	731
17226	679	0	0	0	0	679
17227	0	0	706	0	0	706
17228	0	0	0	680	0	680
17229	670	0	4	1	0	675
17230	0	0	701	0	0	701
17231	688	0	4	0	0	692
17232	643	0	5	0	0	648
17233	0	3	0	618	0	621
17234	0	2	0	654	0	656
17235	646	0	2	1	0	649
17236	0	1	0	675	0	676
17237	633	0	5	1	0	639
17238	0	688	0	1	0	689
17239	0	613	0	0	0	613
17240	0	3	0	602	0	605
17241	1	0	615	0	0	616
17242	0	629	0	0	0	629
17243	601	0	3	0	0	604
17244	0	614	0	3	0	617
17245	0	0	613	0	0	613
17246	0	0	1	607	0	608
17247	1	1	611	0	0	613
17248	0	626	0	0	0	626
17249	0	2	0	587	0	589
17250	1	608	0	4	0	613
17251	0	2	607	0	0	609
17252	1	2	0	605	0	608
17253	0	0	647	0	0	647
17254	0	1	0	605	0	606
17255	611	0	5	1	0	617
17256	0	1	602	0	0	603
17257	580	0	1	2	0	583
17258	1	0	599	0	0	600
17259	0	0	0	551	0	551
17260	2	0	577	0	0	579
17261	0	2	1	543	0	546
17262	0	1	0	507	0	508
17263	0	1	0	530	0	531
17264	0	3	0	552	0	555
17265	2	0	569	0	0	571
17266	560	0	0	0	0	560
17267	0	0	0	548	0	548
17268	520	0	3	0	0	523
17269	496	0	2	0	0	498
17270	517	0	2	0	0	519
17271	0	4	0	511	0	515
17272	0	1	0	533	0	534
17273	0	526	0	0	0	526
17274	524	1	0	0	0	525
17275	471	0	2	0	0	473
17276	497	0	2	1	0	500
17277	0	0	518	0	0	518
17278	0	0	0	514	0	514
17279	0	0	496	0	0	496
17280	515	0	2	0	0	517
17281	472	1	2	0	0	475
17282	1	1	0	489	0	491
17283	1	0	0	525	0	526
17284	0	511	0	2	0	513
17285	535	0	6	0	0	541
17286	526	0	1	1	0	528
17287	0	590	0	1	0	591
17288	571	0	3	1	0	575
17289	0	1	0	532	0	533
17290	1	0	0	578	0	579
17291	556	0	1	1	0	558
17292	2	0	584	0	0	586
17293	553	1	4	2	0	560
17294	530	1	4	0	0	535
17295	0	608	0	2	0	610
17296	569	0	0	3	0	572
17297	1	0	603	0	0	604
17298	5	1	0	543	0	549
17299	551	0	0	0	0	551
17300	1	1	1	559	0	562
17301	1	1	585	0	0	587
17302	1	1	0	565	0	567
17303	0	601	0	0	0	601
17304	1	0	0	564	0	565
17305	0	2	0	544	0	546
17306	0	1	0	554	0	555
17307	0	2	0	589	0	591
17308	0	0	613	2	0	615
17309	0	1	0	584	0	585
17310	591	0	0	0	0	591
17311	0	624	0	1	0	625
17312	3	1	0	586	0	590
17313	0	0	668	0	0	668
17314	2	2	0	617	0	621
17315	660	0	3	1	0	664
17316	613	0	7	0	0	620
17317	629	0	2	0	0	631
17318	11	8	0	666	0	685
17319	0	0	693	0	0	693
17320	0	678	0	6	0	684
17321	676	0	0	0	0	676
17322	2	3	0	624	0	629
17323	3	5	0	660	0	668
17324	1	1	681	0	0	683
17325	1	731	0	0	0	732
17326	0	730	0	1	0	731
17327	1	4	45	627	0	677
17328	0	0	712	0	0	712
17329	686	0	2	0	0	688
17330	0	0	720	0	0	720
17331	632	0	2	0	0	634
17332	0	659	0	2	0	661
17333	1	46	641	1	0	689
17334	633	0	2	40	0	675
17335	0	819	0	3	0	822
17336	625	0	2	152	0	779
17337	3	1	962	0	0	966
17338	0	1001	0	0	0	1001
17339	968	1	0	0	0	969
17340	0	0	1077	0	0	1077
17341	1168	0	7	0	0	1175
17342	0	1	0	1276	0	1277
17343	1407	10	1	0	0	1418
17344	0	4	1	1520	0	1525
17345	822	719	4	11	0	1556
17346	25	28	1659	38	0	1750
17347	36	21	7	2020	0	2084
17348	23	35	19	2272	0	2349
17349	62	7	2413	49	0	2531
17350	5	23	4	2560	0	2592
17351	0	2692	0	21	0	2713
17352	1	2	0	2608	0	2611
17353	2	4	0	2550	0	2556
17354	1	6	0	2676	0	2683
17355	1	0	2694	2	0	2697
17356	2705	3	6	1	0	2715
17357	1	7	0	2682	0	2690
17358	0	1	2726	1	0	2728
17359	2671	0	21	5	0	2697
17360	2662	0	28	3	0	2693
17361	2679	0	27	1	0	2707
17362	1	13	2	2777	0	2793
17363	31	34	0	2836	0	2901
17364	3	20	0	3005	0	3028
17365	0	2976	0	9	0	2985
17366	2883	1	8	3	0	2895
17367	2995	0	7	0	0	3002
17368	1	15	0	3278	0	3294
17369	2	0	3403	0	0	3405
17370	6	0	3490	0	0	3496
17371	0	3547	4	4	0	3555
17372	0	3544	0	6	0	3550
17373	3542	8	5	10	0	3565
17374	0	3796	0	7	0	3803
17375	3690	1	10	3	0	3704
17376	3638	2	14	4	0	3658
17377	3749	2	5	1	0	3757
17378	7	5	1	3845	0	3858
17379	1	4	0	4021	0	4026
17380	3935	0	5	1	0	3941
17381	0	17	1	4120	0	4138
17382	4	0	4201	0	0	4205
17383	4212	0	6	6	0	4224
17384	0	10	2	4060	0	4072
17385	3	13	0	4125	0	4141
17386	8	7	0	4373	0	4388
17387	7	0	4417	0	0	4424
17388	4417	0	8	6	0	4431
17389	3	0	4541	0	0	4544
17390	0	10	2	4521	0	4533
17391	5	0	4630	0	0	4635
17392	7	9	0	4639	0	4655
17393	4	18	0	4663	0	4685
17394	8	0	4806	0	0	4814
17395	10	20	0	4840	0	4870
17396	1	4885	5	8	0	4899
17397	4787	0	32	4	0	4823
17398	4764	0	12	1	0	4777
17399	1	13	0	5050	0	5064
17400	6	0	4984	0	0	4990
17401	0	5037	0	13	0	5050
17402	0	4970	0	10	0	4980
17403	4938	0	14	9	0	4961
17404	2	0	5096	0	0	5098
17405	5133	2	8	2	0	5145
17406	1	8	0	4966	0	4975
17407	2	5	0	5136	0	5143
17408	4784	0	10	2	0	4796
17409	1	5106	0	5	0	5112
17410	2	0	5204	0	0	5206
17411	5	13	2	5229	0	5249
17412	5	1	5320	0	0	5326
17413	1	5364	0	4	0	5369
17414	1	3	0	5333	0	5337
17415	5222	0	18	3	0	5243
17416	5157	2	10	3	0	5172
17417	4	1	5504	0	0	5509
17418	0	5542	0	5	0	5547
17419	5522	2	15	0	0	5539
17420	0	5776	1	5	0	5782
17421	9	11	0	5318	0	5338
17422	5833	0	6	5	0	5844
17423	1	35	0	5826	0	5862
17424	11	0	6122	0	0	6133
17425	0	18	0	6022	0	6040
17426	7	0	6131	2	0	6140
17427	0	4	0	6067	0	6071
17428	6100	2	13	5	0	6120
17429	0	6159	2	16	0	6177
17430	5970	0	25	0	0	5995
17431	3	12	0	5747	0	5762
17432	10	15	0	5932	0	5957
17433	9	0	5638	1	0	5648
17434	3	0	5850	0	0	5853
17435	0	5639	1	8	0	5648
17436	5	0	5753	0	0	5758
17437	5921	4	15	5	0	5945
17438	0	5992	0	1	0	5993
17439	0	5642	0	1	0	5643
17440	0	5813	0	1	0	5814
17441	1	19	2	5718	0	5740
17442	7	0	5898	0	0	5905
17443	0	5998	2	9	0	6009
17444	7	5	0	5848	0	5860
17445	0	6050	0	0	0	6050
17446	5870	3	22	2	0	5897
17447	5666	0	15	2	0	5683
17448	6	17	0	5484	0	5507
17449	0	20	0	6129	0	6149
17450	5772	0	7	7	0	5786
17451	0	6206	0	7	0	6213
17452	0	6090	0	2	0	6092
17453	6	13	1	6070	0	6090
17454	5	1	6090	0	0	6096
17455	0	6185	4	8	0	6197
17456	5975	0	25	1	0	6001
17457	0	6153	3	8	0	6164
17458	0	5770	0	6	0	5776
17459	5625	5	19	3	0	5652
17460	0	5945	0	2	0	5947
17461	32	0	5793	0	0	5825
17462	15	5969	2	8	0	5994
17463	5797	1	16	1	0	5815
17464	0	6011	0	8	0	6019
17465	5795	0	13	1	0	5809
17466	0	23	2	5472	0	5497
17467	3	18	0	5982	0	6003
17468	4	1	5723	1	0	5729
17469	0	6050	0	23	0	6073
17470	0	11	0	5704	0	5715
17471	5787	0	21	3	0	5811
17472	5660	1	17	4	0	5682
17473	0	6047	0	4	0	6051
17474	4	5	0	5764	0	5773
17475	5391	5	13	1	0	5410
17476	5265	0	22	3	0	5290
17477	0	1	5502	0	0	5503
17478	11	0	5360	0	0	5371
17479	6	3	5470	0	0	5479
17480	0	5477	0	3	0	5480
17481	5373	1	14	5	0	5393
17482	0	5538	1	8	0	5547
17483	5349	7	20	1	0	5377
17484	0	5425	0	1	0	5426
17485	7	13	0	5225	0	5245
17486	5018	1	12	7	0	5038
17487	22	0	5021	0	0	5043
17488	4942	0	20	5	0	4967
17489	4780	3	21	2	0	4806
17490	0	4927	0	24	0	4951
17491	0	4344	4	14	0	4362
17492	4052	1	31	12	0	4096
17493	20	1	3731	1	0	3753
17494	3654	0	22	7	0	3683
17495	3169	2	27	3	0	3201
17496	5	2	1	3281	0	3289
17497	3271	0	3	0	0	3274
17498	0	18	0	3225	0	3243
17499	1	18	0	3380	0	3399
17500	2	13	1	3455	0	3471
17501	0	3447	0	1	0	3448
17502	3396	0	9	1	0	3406
17503	3230	0	12	1	0	3243
17504	1	10	0	3151	0	3162
17505	7	9	1	3418	0	3435
17506	0	3468	0	1	0	3469
17507	3375	1	12	1	0	3389
17508	2	0	3529	0	0	3531
17509	7	10	0	3405	0	3422
17510	2	0	3648	0	0	3650
17511	4	15	0	3454	0	3473
17512	5	0	3595	1	0	3601
17513	1	12	0	3517	0	3530
17514	3495	0	22	2	0	3519
17515	1	1	3517	0	0	3519
17516	3480	1	9	1	0	3491
17517	0	3533	1	2	0	3536
17518	2	10	1	3179	0	3192
17519	3	8	0	2832	0	2843
17520	2804	0	9	4	0	2817
17521	1	10	0	2940	0	2951
17522	11	0	2974	1	0	2986
17523	2936	0	10	8	0	2954
17524	2761	0	10	2	0	2773
17525	2650	0	17	3	0	2670
17526	2699	14	10	2	0	2725
17527	0	2984	0	6	0	2990
17528	0	4	0	2853	0	2857
17529	2746	1	4	2	0	2753
17530	1	5	0	2768	0	2774
17531	2769	0	18	1	0	2788
17532	1	1	2843	0	0	2845
17533	0	0	2953	1	0	2954
17534	1	10	0	2850	0	2861
17535	0	2799	0	3	0	2802
17536	0	2726	15	7	0	2748
17537	2582	0	13	4	0	2599
17538	8	0	2767	1	0	2776
17539	2593	15	27	4	0	2639
17540	0	2812	0	3	0	2815
17541	2659	2	20	2	0	2683
17542	2	30	2	2592	0	2626
17543	9	0	2563	2	0	2574
17544	5	12	0	2468	0	2485
17545	0	15	0	2502	0	2517
17546	2	2452	0	13	0	2467
17547	11	2466	0	5	0	2482
17548	3	14	0	2392	0	2409
17549	2	2464	0	9	0	2475
17550	14	1	2340	0	0	2355
17551	7	1	2317	0	0	2325
17552	2483	0	6	2	0	2491
17553	2487	0	6	0	0	2493
17554	0	2627	1	0	0	2628
17555	2	4	0	2463	0	2469
17556	1	19	1	2342	0	2363
17557	4	0	2575	0	0	2579
17558	2	6	0	2498	0	2506
17559	1	2512	0	7	0	2520
17560	4	0	2291	0	0	2295
17561	2	1	2455	0	0	2458
17562	0	2418	0	8	0	2426
17563	2	0	2535	0	0	2537
17564	4	6	1	2368	0	2379
17565	5	12	0	2431	0	2448
17566	0	0	2621	0	0	2621
17567	3	11	1	2515	0	2530
17568	0	2568	10	3	0	2581
17569	0	2528	0	2	0	2530
17570	2	12	0	2447	0	2461
17571	4	1	2601	1	0	2607
17572	0	2533	0	0	0	2533
17573	0	10	1	2457	0	2468
17574	4	0	2519	0	0	2523
17575	2488	2	6	3	0	2499
17576	2366	0	14	0	0	2380
17577	2328	0	12	1	0	2341
17578	2	5	0	2296	0	2303
17579	0	6	0	2509	0	2515
17580	2	0	2618	0	0	2620
17581	0	7	0	2426	0	2433
17582	1	17	0	2450	0	2468
17583	3	0	2522	0	0	2525
17584	2502	0	13	1	0	2516
17585	1	2608	0	7	0	2616
17586	2504	0	6	4	0	2514
17587	0	2623	0	0	0	2623
17588	2	6	0	2462	0	2470
17589	2	0	2628	1	0	2631
17590	5	7	0	2513	0	2525
17591	5	0	2516	0	0	2521
17592	2500	0	4	2	0	2506
17593	1	0	2635	0	0	2636
17594	1	5	0	2493	0	2499
17595	10	0	2576	0	0	2586
17596	0	2530	0	3	0	2533
17597	1	7	0	2322	0	2330
17598	3	9	1	2195	0	2208
17599	0	2	2	2403	0	2407
17600	0	0	2432	0	0	2432
17601	2	0	2550	0	0	2552
17602	2	9	0	2320	0	2331
17603	5	14	0	2210	0	2229
17604	6	7	1	2191	0	2205
17605	2329	0	6	1	0	2336
17606	1	8	0	2392	0	2401
17607	8	0	2451	0	0	2459
17608	2471	1	5	4	0	2481
17609	3	6	0	2275	0	2284
17610	2287	1	7	1	0	2296
17611	2143	1	15	2	0	2161
17612	0	5	1	2300	0	2306
17613	2255	0	5	2	0	2262
17614	2288	0	9	1	0	2298
17615	0	0	2469	0	0	2469
17616	0	2381	1	1	0	2383
17617	0	21	0	2226	0	2247
17618	7	9	0	2146	0	2162
17619	2212	0	4	0	0	2216
17620	2057	0	7	6	0	2070
17621	2126	1	8	0	0	2135
17622	2	1	2295	0	0	2298
17623	0	2263	0	1	0	2264
17624	2283	0	6	2	0	2291
17625	0	2339	0	1	0	2340
17626	2311	0	8	2	0	2321
17627	0	8	0	2197	0	2205
17628	2153	0	8	4	0	2165
17629	2176	0	17	0	0	2193
17630	2203	0	13	1	0	2217
17631	2	0	2322	0	0	2324
17632	2226	0	9	1	0	2236
17633	0	2248	2	0	0	2250
17634	2170	0	7	0	0	2177
17635	2057	0	8	0	0	2065
17636	2034	0	9	1	0	2044
17637	1	7	0	2205	0	2213
17638	0	2234	0	3	0	2237
17639	2141	0	3	2	0	2146
17640	3	0	2234	0	0	2237
17641	0	2224	0	1	0	2225
17642	3	10	0	2132	0	2145
17643	0	2112	0	3	0	2115
17644	2107	0	13	1	0	2121
17645	1914	0	9	0	0	1923
17646	0	4	0	2146	0	2150
17647	0	0	2170	0	0	2170
17648	0	2178	0	0	0	2178
17649	3	8	0	2044	0	2055
17650	0	4	0	1980	0	1984
17651	5	5	0	2009	0	2019
17652	2096	0	4	1	0	2101
17653	2048	0	6	1	0	2055
17654	2009	0	4	1	0	2014
17655	1914	0	9	1	0	1924
17656	0	6	1	2037	0	2044
17657	2	2	2126	0	0	2130
17658	2	3	7	1978	0	1990
17659	2	7	0	1864	0	1873
17660	3	7	0	1882	0	1892
17661	2	4	0	1968	0	1974
17662	1987	0	8	0	0	1995
17663	4	3	0	1909	0	1916
17664	1906	0	9	0	0	1915
17665	1870	2	3	1	0	1876
17666	4	0	1966	0	0	1970
17667	3	0	1853	0	0	1856
17668	1	0	2013	0	0	2014
17669	3	2	2	1922	0	1929
17670	3	0	1972	0	0	1975
17671	13	5	0	1764	0	1782
17672	2	9	0	1823	0	1834
17673	1807	0	4	0	0	1811
17674	4	8	1	1879	0	1892
17675	0	1830	0	7	0	1837
17676	1817	2	1	1	0	1821
17677	3	1780	4	2	0	1789
17678	6	0	1732	1	0	1739
17679	0	1783	0	4	0	1787
17680	1810	0	10	1	0	1821
17681	1	5	0	1757	0	1763
17682	1	1	1789	0	0	1791
17683	1786	0	11	4	0	1801
17684	0	6	0	1790	0	1796
17685	3	0	1844	0	0	1847
17686	3	16	0	1829	0	1848
17687	18	16	0	1811	0	1845
17688	4	5	0	1990	0	1999
17689	0	2040	0	4	0	2044
17690	2018	1	15	3	0	2037
17691	0	8	0	2073	0	2081
17692	1	2126	0	0	0	2127
17693	0	25	0	1965	0	1990
17694	6	0	2140	2	0	2148
17695	0	2130	0	2	0	2132
17696	2163	0	20	1	0	2184
17697	2083	0	4	0	0	2087
17698	0	8	0	2050	0	2058
17699	1	8	0	2096	0	2105
17700	2073	0	6	6	0	2085
17701	2053	1	10	0	0	2064
17702	0	2236	0	1	0	2237
17703	2040	1	7	1	0	2049
17704	4	0	2083	0	0	2087
17705	1	0	2151	0	0	2152
17706	0	2131	0	5	0	2136
17707	1	2153	0	3	0	2157
17708	2168	0	5	2	0	2175
17709	0	2227	0	0	0	2227
17710	2207	2	4	1	0	2214
17711	2103	0	6	0	0	2109
17712	2020	0	5	2	0	2027
17713	0	7	0	2131	0	2138
17714	2158	0	9	0	0	2167
17715	1	1	2176	1	0	2179
17716	4	0	2147	0	0	2151
17717	1	2022	1	5	0	2029
17718	1	0	2083	0	0	2084
17719	5	3	0	2083	0	2091
17720	2	0	1975	0	0	1977
17721	2	0	2139	0	0	2141
17722	2	4	0	2017	0	2023
17723	2119	0	4	0	0	2123
17724	2023	1	6	3	0	2033
17725	0	0	2095	1	0	2096
17726	2073	0	3	0	0	2076
17727	1	0	2046	0	0	2047
17728	2042	0	13	2	0	2057
17729	1876	0	4	1	0	1881
17730	1	11	0	1786	0	1798
17731	0	7	0	1972	0	1979
17732	0	1952	0	6	0	1958
17733	0	1974	0	0	0	1974
17734	3	11	0	1838	0	1852
17735	0	7	2	1957	0	1966
17736	1920	0	1	1	0	1922
17737	0	1979	0	2	0	1981
17738	1930	1	4	2	0	1937
17739	0	1881	0	2	0	1883
17740	3	0	1923	0	0	1926
17741	1	4	0	1871	0	1876
17742	1827	1	4	4	0	1836
17743	1805	2	3	0	0	1810
17744	0	1873	0	0	0	1873
17745	2	1766	0	3	0	1771
17746	0	1787	0	4	0	1791
17747	1	3	0	1701	0	1705
17748	4	0	1762	0	0	1766
17749	0	1706	0	0	0	1706
17750	0	7	0	1599	0	1606
17751	1	7	0	1611	0	1619
17752	0	0	1556	1	0	1557
17753	0	0	1642	0	0	1642
17754	1614	0	6	0	0	1620
17755	1	0	1621	2	0	1624
17756	1615	0	6	0	0	1621
17757	1465	0	7	1	0	1473
17758	1309	2	9	0	0	1320
17759	1374	1	14	1	0	1390
17760	1	0	1538	0	0	1539
17761	0	1418	0	3	0	1421
17762	1	14	1	1307	0	1323
17763	2	2	1431	0	0	1435
17764	2	6	0	1343	0	1351
17765	0	1405	0	0	0	1405
17766	1	5	0	1314	0	1320
17767	0	5	0	1260	0	1265
17768	0	2	0	1393	0	1395
17769	1389	0	1	5	0	1395
17770	1	6	0	1308	0	1315
17771	3	12	0	1293	0	1308
17772	3	3	0	1385	0	1391
17773	1	1382	0	1	0	1384
17774	1367	0	10	0	0	1377
17775	0	1389	0	0	0	1389
17776	0	1367	0	4	0	1371
17777	1	4	0	1291	0	1296
17778	3	3	0	1257	0	1263
17779	1342	0	0	0	0	1342
17780	0	2	0	1368	0	1370
17781	1370	0	1	1	0	1372
17782	1276	0	5	2	0	1283
17783	0	7	1	1280	0	1288
17784	0	5	1	1355	0	1361
17785	0	1354	0	2	0	1356
17786	1319	3	4	0	0	1326
17787	0	1393	0	0	0	1393
17788	1312	0	3	1	0	1316
17789	1	0	1345	0	0	1346
17790	1329	0	1	1	0	1331
17791	1180	1	4	0	0	1185
17792	0	5	0	1336	0	1341
17793	2	0	1367	0	0	1369
17794	0	1352	0	0	0	1352
17795	0	2	0	1306	0	1308
17796	0	0	1366	0	0	1366
17797	2	1	0	1322	0	1325
17798	1302	1	3	0	0	1306
17799	0	0	1329	0	0	1329
17800	0	1243	1	1	0	1245
17801	0	1259	0	0	0	1259
17802	4	5	0	1201	0	1210
17803	0	1222	0	5	0	1227
17804	1231	0	1	0	0	1232
17805	1136	1	2	1	0	1140
17806	1195	0	5	1	0	1201
17807	0	0	1271	0	0	1271
17808	1244	0	5	0	0	1249
17809	1	0	0	1185	0	1186
17810	3	4	1	1150	0	1158
17811	0	7	0	1140	0	1147
17812	1	5	14	1149	0	1169
17813	3	0	1191	1	0	1195
17814	2	0	1104	1	0	1107
17815	0	0	1214	0	0	1214
17816	1176	0	3	0	0	1179
17817	0	1180	0	2	0	1182
17818	1	0	0	1159	0	1160
17819	1135	0	2	1	0	1138
17820	0	1170	2	1	0	1173
17821	2	1118	0	4	0	1124
17822	1168	0	2	0	0	1170
17823	1142	0	2	1	0	1145
17824	0	1129	0	41	0	1170
17825	2	2	0	1136	0	1140
17826	0	1133	0	6	0	1139
17827	1111	2	9	3	0	1125
17828	1003	0	1	0	0	1004
17829	995	0	6	0	0	1001
17830	7	1044	3	8	0	1062
17831	18	14	20	907	0	959
17832	8	0	958	0	0	966
17833	5	4	9	833	0	851
17834	2	1	1	786	0	790
17835	0	0	792	0	0	792
17836	745	0	2	0	0	747
17837	0	3	0	663	0	666
17838	87	3	0	410	0	500
17839	0	410	0	0	0	410
17840	371	0	2	0	0	373
17841	1	0	0	397	0	398
17842	0	400	1	0	0	401
17843	382	0	2	1	0	385
17844	0	390	0	1	0	391
17845	349	0	5	0	0	354
17846	0	0	368	0	0	368
17847	1	0	347	0	0	348
17848	0	0	336	0	0	336
17849	7	295	1	0	0	303
17850	1	3	0	268	0	272
17851	0	266	1	0	0	267
17852	260	0	1	0	0	261
17853	0	0	269	0	0	269
17854	268	0	2	0	0	270
17855	252	0	4	0	0	256
17856	0	0	0	256	0	256
17857	211	0	0	0	0	211
17858	1	3	0	237	0	241
17859	0	0	245	0	0	245
17860	223	0	1	0	0	224
17861	0	239	0	1	0	240
17862	0	1	0	193	0	194
17863	177	0	0	0	0	177
17864	0	1	0	198	0	199
17865	0	0	207	0	0	207
17866	1	1	0	199	0	201
17867	0	189	0	1	0	190
17868	196	0	1	1	0	198
17869	0	1	0	182	0	183
17870	189	0	0	0	0	189
17871	0	1	0	183	0	184
17872	2	0	0	161	0	163
17873	0	172	0	0	0	172
17874	178	0	0	1	0	179
17875	0	179	0	0	0	179
17876	0	1	0	146	0	147
17877	0	172	0	0	0	172
17878	161	0	1	0	0	162
17879	157	0	0	0	0	157
17880	148	0	1	0	0	149
17881	0	169	0	1	0	170
17882	0	166	0	0	0	166
17883	156	0	1	1	0	158
17884	0	168	0	0	0	168
17885	0	0	1	147	0	148
17886	0	0	159	0	0	159
17887	146	0	0	0	0	146
17888	122	0	1	2	0	125
17889	135	0	1	0	0	136
17890	0	147	0	0	0	147
17891	131	0	0	0	0	131
17892	0	0	141	0	0	141
17893	0	147	0	0	0	147
17894	0	1	0	136	0	137
17895	0	135	0	0	0	135
17896	136	0	0	0	0	136
17897	0	149	0	0	0	149
17898	0	1	0	141	0	142
17899	0	153	0	0	0	153
17900	0	1	0	140	0	141
17901	0	0	2	136	0	138
17902	0	0	148	0	0	148
17903	0	0	0	138	0	138
17904	148	0	0	0	0	148
17905	133	0	1	0	0	134
17906	0	0	0	126	0	126
17907	0	0	128	0	0	128
17908	0	1	0	125	0	126
17909	120	0	0	0	0	120
17910	110	0	0	0	0	110
17911	106	0	1	0	0	107
17912	0	127	0	0	0	127
17913	118	0	1	0	0	119
17914	0	0	126	0	0	126
17915	121	0	0	0	0	121
17916	0	0	0	117	0	117
17917	0	1	0	114	0	115
17918	0	0	0	116	0	116
17919	120	0	0	0	0	120
17920	109	0	1	0	0	110
17921	0	0	0	126	0	126
17922	0	0	126	0	0	126
17923	0	1	0	116	0	117
17924	0	0	0	123	0	123
17925	0	0	124	0	0	124
17926	0	140	0	0	0	140
17927	0	0	0	129	0	129
17928	133	0	0	0	0	133
17929	0	1	0	127	0	128
17930	0	1	0	133	0	134
17931	125	0	2	0	0	127
17932	0	135	0	0	0	135
17933	0	128	0	0	0	128
17934	120	0	0	0	0	120
17935	0	0	124	0	0	124
17936	119	1	0	0	0	120
17937	0	1	121	0	0	122
17938	0	123	0	1	0	124
17939	121	0	0	0	0	121
17940	116	0	0	0	0	116
17941	112	0	0	0	0	112
17942	113	1	1	1	0	116
17943	0	0	123	0	0	123
17944	0	1	0	120	0	121
17945	118	0	0	0	0	118
17946	0	0	117	0	0	117
17947	0	0	122	0	0	122
17948	0	127	0	0	0	127
17949	120	0	0	0	0	120
17950	0	2	0	117	0	119
17951	122	0	1	0	0	123
17952	0	134	0	0	0	134
17953	0	0	0	127	0	127
17954	1	0	0	122	0	123
17955	0	1	0	127	0	128
17956	1	0	121	0	0	122
17957	0	130	0	0	0	130
17958	134	0	0	0	0	134
17959	0	1	0	131	0	132
17960	131	0	0	0	0	131
17961	122	0	0	0	0	122
17962	0	0	0	128	0	128
17963	0	1	140	0	0	141
17964	0	0	0	142	0	142
17965	0	141	0	0	0	141
17966	0	0	0	140	0	140
17967	2	0	142	0	0	144
17968	143	0	2	0	0	145
17969	0	0	0	136	0	136
17970	139	0	0	0	0	139
17971	0	0	137	0	0	137
17972	135	0	0	0	0	135
17973	0	0	137	0	0	137
17974	139	0	0	0	0	139
17975	0	147	0	0	0	147
17976	0	143	0	0	0	143
17977	0	0	0	124	0	124
17978	1	0	0	129	0	130
17979	0	0	0	139	0	139
17980	132	0	1	0	0	133
17981	0	0	0	138	0	138
17982	0	0	138	0	0	138
17983	125	0	0	0	0	125
17984	0	139	0	0	0	139
17985	122	0	0	0	0	122
17986	131	0	0	0	0	131
17987	0	0	134	0	0	134
17988	0	0	0	129	0	129
17989	0	0	0	132	0	132
17990	0	0	125	0	0	125
17991	0	129	0	0	0	129
17992	127	0	0	0	0	127
17993	123	0	1	0	0	124
17994	0	0	0	116	0	116
17995	2	1	0	120	0	123
17996	0	2	0	129	0	131
17997	125	0	0	0	0	125
17998	0	127	0	0	0	127
17999	119	0	0	0	0	119
18000	110	0	3	1	0	114
18001	0	0	124	0	0	124
18002	0	0	0	123	0	123
18003	0	117	0	0	0	117
18004	0	0	0	106	0	106
18005	0	4	0	107	0	111
18006	0	0	113	0	0	113
18007	106	0	4	0	0	110
18008	106	0	3	0	0	109
18009	104	0	0	0	0	104
18010	0	0	0	108	0	108
18011	0	0	0	107	0	107
18012	0	112	0	0	0	112
18013	0	105	0	1	0	106
18014	114	0	0	2	0	116
18015	0	119	0	0	0	119
18016	2	0	119	0	0	121
18017	0	0	0	120	0	120
18018	119	0	0	0	0	119
18019	0	0	118	0	0	118
18020	0	0	117	0	0	117
18021	122	0	0	0	0	122
18022	112	0	0	0	0	112
18023	0	1	0	114	0	115
18024	0	0	123	0	0	123
18025	0	1	0	114	0	115
18026	0	0	118	0	0	118
18027	0	0	115	0	0	115
18028	0	114	0	2	0	116
18029	118	0	0	0	0	118
18030	119	0	0	0	0	119
18031	0	123	0	0	0	123
18032	0	0	0	123	0	123
18033	0	0	0	117	0	117
18034	0	0	0	127	0	127
18035	129	0	0	0	0	129
18036	0	132	0	1	0	133
18037	125	0	2	0	0	127
18038	129	0	0	0	0	129
18039	0	0	127	0	0	127
18040	0	132	0	0	0	132
18041	0	0	0	118	0	118
18042	1	0	130	0	0	131
18043	134	0	0	0	0	134
18044	127	0	0	0	0	127
18045	126	0	0	0	0	126
18046	121	0	0	0	0	121
18047	0	0	0	124	0	124
18048	0	0	132	0	0	132
18049	1	0	0	124	0	125
18050	124	0	0	0	0	124
18051	112	0	0	0	0	112
18052	0	130	0	1	0	131
18053	120	0	3	0	0	123
18054	0	0	124	0	0	124
18055	0	0	123	0	0	123
18056	127	0	0	0	0	127
18057	0	128	0	0	0	128
18058	0	0	0	117	0	117
18059	0	123	0	0	0	123
18060	1	0	0	118	0	119
18061	0	1	0	112	0	113
18062	1	0	0	116	0	117
18063	115	0	0	0	0	115
18064	116	0	0	0	0	116
18065	111	0	0	0	0	111
18066	0	0	120	0	0	120
18067	120	0	0	0	0	120
18068	0	0	0	105	0	105
18069	0	1	0	110	0	111
18070	0	0	123	0	0	123
18071	0	0	0	119	0	119
18072	121	0	0	0	0	121
18073	0	0	120	0	0	120
18074	0	1	0	113	0	114
18075	115	0	0	0	0	115
18076	105	0	0	2	0	107
18077	2	0	112	0	0	114
18078	0	0	119	0	0	119
18079	0	0	0	108	0	108
18080	107	0	0	0	0	107
18081	102	0	1	0	0	103
18082	0	0	0	112	0	112
18083	0	112	0	0	0	112
18084	111	0	0	0	0	111
18085	0	111	0	0	0	111
18086	0	0	0	101	0	101
18087	0	0	105	0	0	105
18088	0	0	103	0	0	103
18089	0	0	112	0	0	112
18090	1	0	0	105	0	106
18091	1	2	0	99	0	102
18092	111	0	0	0	0	111
18093	0	114	0	0	0	114
18094	113	0	0	0	0	113
18095	0	0	0	115	0	115
18096	0	106	0	0	0	106
18097	0	113	0	2	0	115
18098	0	0	0	111	0	111
18099	116	0	0	0	0	116
18100	0	119	0	0	0	119
18101	115	0	0	0	0	115
18102	0	118	0	0	0	118
18103	104	0	0	1	0	105
18104	0	0	112	0	0	112
18105	0	0	109	0	0	109
18106	0	113	0	0	0	113
18107	110	0	0	0	0	110
18108	0	108	0	0	0	108
18109	0	111	0	0	0	111
18110	0	0	0	113	0	113
18111	109	0	0	0	0	109
18112	0	115	0	0	0	115
18113	107	0	1	0	0	108
18114	0	108	0	0	0	108
18115	95	0	0	0	0	95
18116	0	107	0	0	0	107
18117	0	108	0	0	0	108
18118	0	0	0	105	0	105
18119	0	100	0	0	0	100
18120	105	0	0	0	0	105
18121	0	0	113	0	0	113
18122	0	1	0	110	0	111
18123	0	0	116	0	0	116
18124	0	1	0	108	0	109
18125	1	0	0	96	0	97
18126	0	0	105	0	0	105
18127	107	0	0	0	0	107
18128	0	109	0	0	0	109
18129	110	0	0	0	0	110
18130	0	108	0	0	0	108
18131	0	0	0	106	0	106
18132	101	0	0	0	0	101
18133	99	0	2	0	0	101
18134	102	0	1	0	0	103
18135	0	0	0	102	0	102
18136	0	1	0	108	0	109
18137	0	106	0	0	0	106
18138	108	0	0	0	0	108
18139	107	0	1	0	0	108
18140	96	0	0	0	0	96
18141	101	0	2	0	0	103
18142	0	116	0	0	0	116
18143	0	0	0	107	0	107
18144	0	0	112	0	0	112
18145	109	0	1	0	0	110
18146	111	0	0	0	0	111
18147	0	0	108	0	0	108
18148	2	0	116	0	0	118
18149	0	0	0	105	0	105
18150	0	0	0	105	0	105
18151	0	0	0	102	0	102
18152	116	0	0	0	0	116
18153	0	0	0	117	0	117
18154	1	0	120	0	0	121
18155	0	2	0	115	0	117
18156	0	0	123	0	0	123
18157	0	1	0	114	0	115
18158	0	1	0	107	0	108
18159	0	0	122	0	0	122
18160	128	0	1	0	0	129
18161	0	130	0	0	0	130
18162	129	0	3	0	0	132
18163	0	0	0	118	0	118
18164	124	0	0	0	0	124
18165	0	131	0	0	0	131
18166	0	131	0	0	0	131
18167	0	0	0	124	0	124
18168	0	0	126	0	0	126
18169	0	0	134	0	0	134
18170	0	135	0	0	0	135
18171	137	0	1	0	0	138
18172	0	0	0	130	0	130
18173	143	0	0	0	0	143
18174	0	168	0	0	0	168
18175	0	158	0	0	0	158
18176	0	0	0	156	0	156
18177	149	0	0	0	0	149
18178	149	0	0	0	0	149
18179	0	0	164	0	0	164
18180	0	0	175	0	0	175
18181	165	0	0	0	0	165
18182	0	168	0	0	0	168
18183	155	0	1	0	0	156
18184	0	1	0	152	0	153
18185	0	0	149	0	0	149
18186	172	0	1	2	0	175
18187	0	183	0	0	0	183
18188	0	184	0	1	0	185
18189	0	1	0	182	0	183
18190	198	0	0	0	0	198
18191	0	0	0	189	0	189
18192	195	0	1	0	0	196
18193	0	0	197	0	0	197
18194	191	0	1	0	0	192
18195	188	0	0	1	0	189
18196	0	0	189	0	0	189
18197	189	0	1	0	0	190
18198	0	206	0	0	0	206
18199	0	0	0	195	0	195
18200	0	198	0	1	0	199
18201	192	0	0	0	0	192
18202	0	0	0	203	0	203
18203	0	208	0	0	0	208
18204	0	0	0	212	0	212
18205	0	229	0	1	0	230
18206	0	0	0	227	0	227
18207	219	0	0	0	0	219
18208	0	0	0	218	0	218
18209	0	0	217	0	0	217
18210	215	0	1	0	0	216
18211	0	1	0	213	0	214
18212	0	0	211	0	0	211
18213	0	0	213	0	0	213
18214	0	0	225	0	0	225
18215	3	1	0	194	0	198
18216	1	1	0	198	0	200
18217	2	1	0	193	0	196
18218	0	0	0	202	0	202
18219	198	0	0	0	0	198
18220	197	0	3	0	0	200
18221	190	0	2	0	0	192
18222	202	0	1	0	0	203
18223	0	0	0	199	0	199
18224	0	0	196	0	0	196
18225	199	0	0	0	0	199
18226	191	0	1	0	0	192
18227	0	0	0	190	0	190
18228	1	0	0	193	0	194
18229	198	0	0	1	0	199
18230	0	0	0	199	0	199
18231	0	203	0	0	0	203
18232	188	0	1	0	0	189
18233	199	0	0	2	0	201
18234	0	0	213	0	0	213
18235	0	2	1	197	0	200
18236	0	1	0	200	0	201
18237	204	0	0	0	0	204
18238	206	0	2	1	0	209
18239	0	0	0	224	0	224
18240	0	0	218	0	0	218
18241	0	0	224	0	0	224
18242	0	3	0	217	0	220
18243	1	0	0	210	0	211
18244	206	0	5	2	0	213
18245	0	242	0	0	0	242
18246	0	224	0	2	0	226
18247	0	231	0	0	0	231
18248	0	0	0	228	0	228
18249	231	0	1	0	0	232
18250	216	0	0	0	0	216
18251	0	247	0	5	0	252
18252	239	0	3	0	0	242
18253	1	0	0	240	0	241
18254	0	0	255	0	0	255
18255	1	0	0	249	0	250
18256	1	3	0	245	0	249
18257	0	0	0	278	0	278
18258	275	0	2	0	0	277
18259	0	2	0	276	0	278
18260	0	272	0	1	0	273
18261	275	0	0	0	0	275
18262	0	293	0	1	0	294
18263	1	275	1	0	0	277
18264	0	282	0	0	0	282
18265	2	0	299	0	0	301
18266	0	286	0	0	0	286
18267	1	0	283	0	0	284
18268	286	0	2	0	0	288
18269	292	0	0	0	0	292
18270	0	0	303	0	0	303
18271	301	0	0	0	0	301
18272	299	0	1	0	0	300
18273	0	0	311	0	0	311
18274	0	316	0	0	0	316
18275	0	2	0	300	0	302
18276	304	0	1	0	0	305
18277	1	1	0	297	0	299
18278	305	0	1	0	0	306
18279	312	0	0	0	0	312
18280	0	0	326	0	0	326
18281	337	0	4	0	0	341
18282	0	338	0	0	0	338
18283	343	0	2	0	0	345
18284	0	0	0	333	0	333
18285	0	0	342	0	0	342
18286	0	0	0	338	0	338
18287	347	0	0	0	0	347
18288	0	358	0	0	0	358
18289	0	0	355	0	0	355
18290	0	1	0	345	0	346
18291	0	0	352	0	0	352
18292	0	349	0	0	0	349
18293	350	0	2	0	0	352
18294	0	0	0	350	0	350
18295	0	0	354	0	0	354
18296	0	0	352	0	0	352
18297	362	0	0	0	0	362
18298	0	3	0	335	0	338
18299	0	0	0	347	0	347
18300	0	0	344	0	0	344
18301	0	0	351	0	0	351
18302	0	362	0	0	0	362
18303	0	2	0	339	0	341
18304	0	0	0	336	0	336
18305	0	337	0	0	0	337
18306	0	0	329	0	0	329
18307	350	0	0	0	0	350
18308	2	1	0	334	0	337
18309	1	0	354	0	0	355
18310	0	2	0	348	0	350
18311	0	339	0	0	0	339
18312	0	0	349	0	0	349
18313	339	0	0	0	0	339
18314	0	0	345	2	0	347
18315	2	0	339	0	0	341
18316	0	0	331	0	0	331
18317	0	0	348	8	0	356
18318	1	2	0	334	0	337
18319	0	0	361	0	0	361
18320	0	0	0	349	0	349
18321	0	359	0	0	0	359
18322	347	0	1	0	0	348
18323	0	0	0	350	0	350
18324	0	0	343	0	0	343
18325	0	344	0	0	0	344
18326	0	1	0	341	0	342
18327	336	0	1	0	0	337
18328	0	340	0	0	0	340
18329	0	0	0	331	0	331
18330	332	0	2	0	0	334
18331	0	0	332	0	0	332
18332	322	1	0	1	0	324
18333	0	0	329	0	0	329
18334	289	0	0	1	0	290
18335	282	0	4	0	0	286
18336	0	0	309	0	0	309
18337	0	271	0	0	0	271
18338	1	2	0	260	0	263
18339	0	0	276	0	0	276
18340	0	1	0	259	0	260
18341	0	4	0	266	0	270
18342	0	0	275	0	0	275
18343	0	0	281	0	0	281
18344	2	0	0	279	0	281
18345	274	0	0	0	0	274
18346	0	278	0	0	0	278
18347	0	268	0	1	0	269
18348	271	2	0	0	0	273
18349	258	0	4	0	0	262
18350	1	7	0	258	0	266
18351	0	0	0	237	0	237
18352	0	0	0	259	0	259
18353	246	0	2	1	0	249
18354	0	261	0	0	0	261
18355	0	243	0	0	0	243
18356	0	1	0	241	0	242
18357	1	0	0	221	0	222
18358	0	3	0	248	0	251
18359	240	0	1	1	0	242
18360	0	259	0	1	0	260
18361	251	0	1	2	0	254
18362	0	0	263	0	0	263
18363	0	256	0	0	0	256
18364	0	2	0	245	0	247
18365	257	0	0	0	0	257
18366	0	0	250	0	0	250
18367	0	0	260	0	0	260
18368	0	0	0	249	0	249
18369	0	1	0	242	0	243
18370	0	0	0	244	0	244
18371	0	0	0	248	0	248
18372	0	0	0	253	0	253
18373	0	253	0	0	0	253
18374	1	2	0	257	0	260
18375	252	0	0	0	0	252
18376	0	257	0	0	0	257
18377	247	0	1	0	0	248
18378	2	0	242	0	0	244
18379	0	0	259	0	0	259
18380	0	1	0	254	0	255
18381	0	0	262	0	0	262
18382	3	0	0	239	0	242
18383	0	0	0	247	0	247
18384	237	0	1	0	0	238
18385	241	0	0	0	0	241
18386	0	252	0	0	0	252
18387	0	235	0	0	0	235
18388	0	1	0	234	0	235
18389	230	0	0	0	0	230
18390	0	0	227	0	0	227
18391	0	1	0	223	0	224
18392	0	0	0	219	0	219
18393	1	0	232	0	0	233
18394	0	223	0	0	0	223
18395	0	2	0	211	0	213
18396	0	0	222	0	0	222
18397	0	0	0	216	0	216
18398	223	0	2	0	0	225
18399	0	226	0	0	0	226
18400	1	224	0	0	0	225
18401	0	0	0	218	0	218
18402	205	0	2	0	0	207
18403	0	223	0	0	0	223
18404	210	0	0	0	0	210
18405	0	0	217	0	0	217
18406	0	0	214	0	0	214
18407	0	0	0	173	0	173
18408	1	0	0	150	0	151
18409	168	0	3	1	0	172
18410	0	2	0	176	0	178
18411	0	0	183	0	0	183
18412	0	0	0	172	0	172
18413	0	0	0	153	0	153
18414	0	0	152	0	0	152
18415	149	0	0	0	0	149
18416	0	0	0	147	0	147
18417	151	0	1	0	0	152
18418	0	155	0	0	0	155
18419	144	0	0	1	0	145
18420	0	159	0	0	0	159
18421	0	154	0	0	0	154
18422	0	0	0	139	0	139
18423	146	0	0	0	0	146
18424	144	0	1	0	0	145
18425	0	0	0	147	0	147
18426	146	0	0	0	0	146
18427	127	0	0	0	0	127
18428	2	0	0	135	0	137
18429	121	0	0	1	0	122
18430	0	130	0	0	0	130
18431	105	0	0	0	0	105
18432	0	0	112	0	0	112
18433	104	0	2	0	0	106
18434	0	2	0	100	0	102
18435	1	0	0	95	0	96
18436	1	1	0	99	0	101
18437	0	0	0	106	0	106
18438	0	2	0	103	0	105
18439	0	103	0	0	0	103
18440	0	103	0	0	0	103
18441	101	0	0	0	0	101
18442	0	0	111	0	0	111
18443	107	0	0	0	0	107
18444	0	0	111	0	0	111
18445	0	0	0	105	0	105
18446	0	0	0	105	0	105
18447	102	0	1	0	0	103
18448	0	0	110	0	0	110
18449	0	1	0	109	0	110
18450	0	0	112	0	0	112
18451	0	108	0	0	0	108
18452	1	0	0	112	0	113
18453	97	0	0	0	0	97
18454	97	0	1	0	0	98
18455	100	0	0	0	0	100
18456	0	108	0	0	0	108
18457	0	98	0	0	0	98
18458	100	0	0	1	0	101
18459	0	99	0	0	0	99
18460	0	86	0	0	0	86
18461	0	0	95	0	0	95
18462	0	93	0	0	0	93
18463	0	96	0	0	0	96
18464	1	0	0	89	0	90
18465	1	0	91	0	0	92
18466	0	2	87	0	0	89
18467	99	0	0	0	0	99
18468	0	0	93	1	0	94
18469	101	0	0	0	0	101
18470	0	0	0	101	0	101
18471	0	96	0	0	0	96
18472	100	0	1	0	0	101
18473	99	0	1	0	0	100
18474	0	0	0	99	0	99
18475	0	0	0	100	0	100
18476	0	0	0	103	0	103
18477	102	0	1	0	0	103
18478	96	0	0	1	0	97
18479	100	0	0	0	0	100
18480	0	107	0	1	0	108
18481	107	0	0	0	0	107
18482	0	119	0	0	0	119
18483	0	116	0	0	0	116
18484	0	0	0	119	0	119
18485	0	125	0	0	0	125
18486	123	0	2	0	0	125
18487	0	0	0	121	0	121
18488	122	0	0	0	0	122
18489	0	130	0	0	0	130
18490	0	129	0	0	0	129
18491	120	0	0	0	0	120
18492	0	131	0	0	0	131
18493	0	0	0	114	0	114
18494	0	0	0	111	0	111
18495	120	0	0	0	0	120
18496	0	0	0	117	0	117
18497	0	0	127	0	0	127
18498	0	0	0	123	0	123
18499	121	0	2	0	0	123
18500	0	126	0	0	0	126
18501	113	0	1	0	0	114
18502	106	0	0	1	0	107
18503	113	0	0	0	0	113
18504	0	0	112	0	0	112
18505	0	0	120	0	0	120
18506	114	0	0	0	0	114
18507	0	119	0	0	0	119
18508	0	0	0	107	0	107
18509	0	1	0	107	0	108
18510	0	115	0	0	0	115
18511	0	124	0	0	0	124
18512	0	0	0	122	0	122
18513	0	0	0	118	0	118
18514	0	0	126	0	0	126
18515	0	0	128	0	0	128
18516	130	0	0	0	0	130
18517	124	0	0	0	0	124
18518	1	1	0	131	0	133
18519	0	0	137	0	0	137
18520	1	0	0	136	0	137
18521	137	0	0	0	0	137
18522	1	0	138	0	0	139
18523	0	2	0	133	0	135
18524	2	0	138	0	0	140
18525	0	143	0	0	0	143
18526	0	0	147	0	0	147
18527	0	0	0	150	0	150
18528	156	0	0	0	0	156
18529	0	1	0	148	0	149
18530	152	0	0	0	0	152
18531	132	0	0	0	0	132
18532	143	0	0	2	0	145
18533	0	0	155	0	0	155
18534	157	0	0	0	0	157
18535	0	0	1	138	0	139
18536	0	1	0	151	0	152
18537	0	0	162	0	0	162
18538	1	0	0	166	0	167
18539	163	0	0	0	0	163
18540	0	166	0	0	0	166
18541	158	0	0	0	0	158
18542	156	0	0	0	0	156
18543	154	0	2	0	0	156
18544	0	1	0	164	0	165
18545	0	0	171	0	0	171
18546	0	0	0	167	0	167
18547	1	0	0	158	0	159
18548	146	0	0	0	0	146
18549	147	0	0	1	0	148
18550	0	0	164	0	0	164
18551	0	0	1	159	0	160
18552	0	0	158	0	0	158
18553	156	0	1	1	0	158
18554	0	161	0	0	0	161
18555	153	1	0	0	0	154
18556	0	159	0	0	0	159
18557	153	0	0	1	0	154
18558	0	161	0	0	0	161
18559	0	0	0	147	0	147
18560	0	0	0	145	0	145
18561	137	0	0	0	0	137
18562	155	0	0	0	0	155
18563	155	0	0	0	0	155
18564	149	0	0	0	0	149
18565	158	0	0	0	0	158
18566	0	1	0	158	0	159
18567	0	157	1	0	0	158
18568	0	1	0	154	0	155
18569	0	147	0	0	0	147
18570	0	0	0	147	0	147
18571	0	148	0	0	0	148
18572	2	1	0	145	0	148
18573	0	0	157	0	0	157
18574	144	0	0	0	0	144
18575	0	156	0	0	0	156
18576	135	2	0	0	0	137
18577	0	0	149	0	0	149
18578	144	0	0	0	0	144
18579	0	0	150	0	0	150
18580	1	0	0	148	0	149
18581	0	156	0	1	0	157
18582	0	0	160	0	0	160
18583	0	0	0	156	0	156
18584	150	0	1	0	0	151
18585	0	1	0	148	0	149
18586	0	4	0	144	0	148
18587	0	0	0	155	0	155
18588	0	0	161	0	0	161
18589	0	1	0	160	0	161
18590	0	169	0	0	0	169
18591	0	2	0	154	0	156
18592	0	0	0	148	0	148
18593	150	0	0	0	0	150
18594	0	1	0	159	0	160
18595	0	0	159	0	0	159
18596	0	0	159	0	0	159
18597	0	0	146	0	0	146
18598	0	162	0	0	0	162
18599	149	0	7	0	0	156
18600	0	158	0	0	0	158
18601	159	0	0	0	0	159
18602	1	0	0	153	0	154
18603	0	0	145	0	0	145
18604	0	0	158	0	0	158
18605	0	163	0	0	0	163
18606	0	1	0	149	0	150
18607	0	0	0	142	0	142
18608	0	0	0	154	0	154
18609	0	0	162	0	0	162
18610	155	0	2	0	0	157
18611	0	0	162	0	0	162
18612	0	1	0	153	0	154
18613	0	2	0	148	0	150
18614	0	0	151	0	0	151
18615	156	0	0	0	0	156
18616	0	162	0	2	0	164
18617	158	0	2	0	0	160
18618	0	0	0	155	0	155
18619	0	158	0	0	0	158
18620	0	0	0	152	0	152
18621	156	0	0	0	0	156
18622	0	0	0	157	0	157
18623	0	0	158	0	0	158
18624	154	0	1	0	0	155
18625	152	0	2	0	0	154
18626	0	0	161	0	0	161
18627	0	0	0	159	0	159
18628	157	0	0	0	0	157
18629	0	1	0	151	0	152
18630	0	0	0	148	0	148
18631	0	0	0	155	0	155
18632	0	1	0	153	0	154
18633	0	0	153	0	0	153
18634	0	2	0	146	0	148
18635	0	0	145	0	0	145
18636	143	0	0	0	0	143
18637	139	0	2	0	0	141
18638	148	0	0	1	0	149
18639	144	0	0	0	0	144
18640	1	0	0	152	0	153
18641	150	0	1	0	0	151
18642	0	0	151	0	0	151
18643	0	0	154	0	0	154
18644	146	0	0	0	0	146
18645	0	151	0	0	0	151
18646	0	144	0	0	0	144
18647	0	0	0	142	0	142
18648	0	0	146	0	0	146
18649	145	0	0	0	0	145
18650	0	0	148	0	0	148
18651	0	135	3	2	0	140
18652	1	0	142	0	0	143
18653	0	141	0	0	0	141
18654	145	0	1	0	0	146
18655	0	148	0	0	0	148
18656	0	145	0	0	0	145
18657	0	0	0	144	0	144
18658	0	0	153	0	0	153
18659	0	1	0	146	0	147
18660	0	0	0	142	0	142
18661	0	0	147	0	0	147
18662	0	1	0	144	0	145
18663	0	141	0	0	0	141
18664	0	0	0	133	0	133
18665	137	0	1	1	0	139
18666	1	1	0	139	0	141
18667	0	0	150	0	0	150
18668	0	1	0	146	0	147
18669	0	0	144	0	0	144
18670	138	0	0	0	0	138
18671	0	2	0	135	0	137
18672	136	0	0	0	0	136
18673	0	0	140	0	0	140
18674	134	0	1	0	0	135
18675	0	138	0	0	0	138
18676	0	0	135	0	0	135
18677	0	2	0	126	0	128
18678	0	0	125	0	0	125
18679	0	131	0	0	0	131
18680	0	126	0	0	0	126
18681	126	0	2	0	0	128
18682	0	131	0	0	0	131
18683	122	0	1	0	0	123
18684	0	0	0	129	0	129
18685	0	0	126	0	0	126
18686	0	127	0	0	0	127
18687	0	2	0	121	0	123
18688	0	2	0	114	0	116
18689	0	0	0	113	0	113
18690	0	0	0	125	0	125
18691	0	121	0	0	0	121
18692	0	124	0	0	0	124
18693	125	0	0	0	0	125
18694	0	132	0	0	0	132
18695	0	1	0	120	0	121
18696	0	0	136	0	0	136
18697	0	133	0	1	0	134
18698	1	1	0	125	0	127
18699	0	0	0	128	0	128
18700	0	138	0	0	0	138
18701	130	0	0	0	0	130
18702	0	0	136	0	0	136
18703	133	0	0	0	0	133
18704	0	140	2	1	0	143
18705	134	0	0	1	0	135
18706	0	142	0	0	0	142
18707	0	1	0	135	0	136
18708	0	0	0	135	0	135
18709	122	0	2	0	0	124
18710	0	1	0	142	0	143
18711	1	0	138	0	0	139
18712	0	134	0	0	0	134
18713	0	137	0	0	0	137
18714	0	1	0	133	0	134
18715	0	0	137	0	0	137
18716	0	0	0	119	0	119
18717	0	0	0	132	0	132
18718	0	0	136	0	0	136
18719	0	0	134	0	0	134
18720	0	130	0	0	0	130
18721	136	0	1	0	0	137
18722	0	0	0	126	0	126
18723	0	130	0	0	0	130
18724	143	0	0	4	0	147
18725	0	1	0	130	0	131
18726	0	0	0	144	0	144
18727	0	148	0	0	0	148
18728	0	0	0	147	0	147
18729	140	0	0	0	0	140
18730	0	0	0	138	0	138
18731	0	0	0	143	0	143
18732	0	0	146	0	0	146
18733	0	0	136	0	0	136
18734	142	0	0	0	0	142
18735	0	0	0	131	0	131
18736	0	0	0	131	0	131
18737	0	1	0	132	0	133
18738	0	0	138	1	0	139
18739	140	0	0	0	0	140
18740	0	0	0	135	0	135
18741	0	0	0	136	0	136
18742	131	0	0	0	0	131
18743	0	143	0	0	0	143
18744	1	0	141	0	0	142
18745	0	0	0	157	0	157
18746	0	168	0	0	0	168
18747	1	0	0	166	0	167
18748	153	0	0	0	0	153
18749	0	0	0	157	0	157
18750	154	0	0	0	0	154
18751	152	0	4	0	0	156
18752	0	0	0	162	0	162
18753	0	154	0	0	0	154
18754	0	153	0	0	0	153
18755	0	0	172	0	0	172
18756	0	0	0	148	0	148
18757	0	0	0	151	0	151
18758	0	0	0	161	0	161
18759	165	0	0	0	0	165
18760	0	1	0	164	0	165
18761	1	0	164	0	0	165
18762	168	0	0	0	0	168
18763	0	0	0	157	0	157
18764	0	2	0	158	0	160
18765	0	0	162	0	0	162
18766	170	0	0	0	0	170
18767	0	0	0	170	0	170
18768	0	0	181	0	0	181
18769	0	1	0	164	0	165
18770	0	0	0	169	0	169
18771	0	167	0	0	0	167
18772	161	0	0	1	0	162
18773	176	0	0	1	0	177
18774	0	186	0	0	0	186
18775	178	0	0	0	0	178
18776	157	0	1	0	0	158
18777	0	1	0	176	0	177
18778	0	0	166	0	0	166
18779	0	0	173	0	0	173
18780	0	0	171	1	0	172
18781	0	0	183	0	0	183
18782	0	0	0	170	0	170
18783	4	1	0	158	0	163
18784	0	1	0	182	0	183
18785	0	4	0	182	0	186
18786	181	0	0	0	0	181
18787	0	192	0	1	0	193
18788	176	0	1	0	0	177
18789	0	0	192	0	0	192
18790	0	0	205	0	0	205
18791	0	1	0	207	0	208
18792	203	0	0	0	0	203
18793	211	0	0	0	0	211
18794	0	246	0	0	0	246
18795	0	256	0	0	0	256
18796	0	0	0	262	0	262
18797	255	0	0	0	0	255
18798	0	264	0	0	0	264
18799	249	0	2	0	0	251
18800	241	0	2	2	0	245
18801	247	2	0	2	0	251
18802	3	0	263	0	0	266
18803	0	272	0	0	0	272
18804	261	0	3	0	0	264
18805	268	1	4	0	0	273
18806	0	299	0	0	0	299
18807	0	296	0	0	0	296
18808	284	0	5	0	0	289
18809	0	0	0	293	0	293
18810	0	0	314	0	0	314
18811	319	1	1	0	0	321
18812	0	0	0	324	0	324
18813	0	333	0	0	0	333
18814	4	2	0	323	0	329
18815	0	0	365	0	0	365
18816	0	0	0	357	0	357
18817	363	0	0	0	0	363
18818	0	0	0	344	0	344
18819	0	5	0	361	0	366
18820	0	0	380	0	0	380
18821	5	1	0	374	0	380
18822	0	367	0	0	0	367
18823	349	0	0	0	0	349
18824	359	0	4	0	0	363
18825	0	0	409	0	0	409
18826	0	2	0	398	0	400
18827	0	401	0	1	0	402
18828	0	387	0	2	0	389
18829	393	0	0	2	0	395
18830	0	2	0	397	0	399
18831	0	0	408	0	0	408
18832	2	0	438	0	0	440
18833	0	0	0	423	0	423
18834	436	0	0	0	0	436
18835	411	0	2	1	0	414
18836	0	2	0	440	0	442
18837	0	0	446	0	0	446
18838	0	444	0	0	0	444
18839	441	0	3	1	0	445
18840	0	457	0	0	0	457
18841	444	0	4	4	0	452
18842	0	0	0	449	0	449
18843	0	0	467	0	0	467
18844	0	0	0	464	0	464
18845	471	0	0	0	0	471
18846	0	0	481	0	0	481
18847	0	472	0	2	0	474
18848	1	0	0	464	0	465
18849	464	0	0	0	0	464
18850	0	0	477	0	0	477
18851	0	0	0	457	0	457
18852	0	0	2	454	0	456
18853	0	0	473	0	0	473
18854	1	0	0	460	0	461
18855	0	0	466	0	0	466
18856	461	0	4	0	0	465
18857	0	2	0	462	0	464
18858	1	0	466	0	0	467
18859	0	463	0	0	0	463
18860	459	0	0	2	0	461
18861	454	0	5	0	0	459
18862	2	2	0	483	0	487
18863	0	493	0	1	0	494
18864	489	0	0	0	0	489
18865	2	1	0	488	0	491
18866	1	0	496	0	0	497
18867	498	0	0	0	0	498
18868	0	503	0	0	0	503
18869	2	2	0	485	0	489
18870	495	0	1	0	0	496
18871	0	0	479	0	0	479
18872	1	0	475	0	0	476
18873	0	5	0	490	0	495
18874	0	0	508	0	0	508
18875	2	2	0	477	0	481
18876	0	496	0	0	0	496
18877	0	2	0	488	0	490
18878	498	0	1	1	0	500
18879	0	0	501	0	0	501
18880	0	495	0	0	0	495
18881	0	0	0	478	0	478
18882	0	0	493	0	0	493
18883	2	0	0	483	0	485
18884	0	483	0	0	0	483
18885	0	469	0	0	0	469
18886	478	0	8	0	0	486
18887	0	494	0	0	0	494
18888	0	0	469	0	0	469
18889	488	0	0	0	0	488
18890	0	0	493	0	0	493
18891	0	3	0	476	0	479
18892	0	0	475	0	0	475
18893	0	468	0	0	0	468
18894	0	2	0	445	0	447
18895	0	9	0	420	0	429
18896	1	1	0	436	0	438
18897	0	0	452	0	0	452
18898	0	2	0	423	0	425
18899	0	1	0	423	0	424
18900	419	0	0	4	0	423
18901	418	0	3	0	0	421
18902	0	0	446	0	0	446
18903	0	433	0	0	0	433
18904	0	0	440	0	0	440
18905	0	1	0	426	0	427
18906	0	0	434	0	0	434
18907	1	0	0	418	0	419
18908	1	6	0	406	0	413
18909	0	0	430	0	0	430
18910	426	0	0	0	0	426
18911	0	433	0	0	0	433
18912	0	0	0	420	0	420
18913	0	0	411	0	0	411
18914	1	0	406	0	0	407
18915	397	0	0	0	0	397
18916	0	406	0	0	0	406
18917	0	1	0	388	0	389
18918	372	0	3	1	0	376
18919	0	0	0	364	0	364
18920	0	4	0	371	0	375
18921	6	0	365	0	0	371
18922	349	0	3	0	0	352
18923	332	1	5	0	0	338
18924	0	0	0	338	0	338
18925	308	0	2	0	0	310
18926	0	2	0	321	0	323
18927	0	281	0	0	0	281
18928	0	275	1	0	0	276
18929	4	2	0	266	0	272
18930	263	0	0	0	0	263
18931	0	0	0	264	0	264
18932	256	0	0	0	0	256
18933	241	0	1	0	0	242
18934	1	0	0	217	0	218
18935	0	2	0	169	0	171
18936	0	0	167	0	0	167
18937	2	0	167	0	0	169
18938	0	0	0	156	0	156
18939	0	0	152	0	0	152
18940	144	0	0	0	0	144
18941	1	1	1	145	0	148
18942	2	0	140	0	0	142
18943	144	0	0	0	0	144
18944	137	0	3	0	0	140
18945	4	141	0	1	0	146
18946	1	0	0	133	0	134
18947	0	0	130	0	0	130
18948	123	1	0	0	0	124
18949	123	0	2	0	0	125
18950	0	0	127	0	0	127
18951	124	0	0	0	0	124
18952	0	1	0	114	0	115
18953	0	0	0	103	0	103
18954	110	0	0	0	0	110
18955	100	0	1	0	0	101
18956	0	1	0	100	0	101
18957	0	0	105	0	0	105
18958	0	100	0	0	0	100
18959	0	0	95	0	0	95
18960	0	0	104	0	0	104
18961	0	104	0	0	0	104
18962	0	5	0	93	0	98
18963	0	3	0	98	0	101
18964	0	0	110	0	0	110
18965	1	0	0	106	0	107
18966	107	0	0	0	0	107
18967	0	0	102	0	0	102
18968	99	0	0	0	0	99
18969	90	0	2	0	0	92
18970	103	0	0	0	0	103
18971	0	0	98	0	0	98
18972	0	0	103	0	0	103
18973	0	1	0	93	0	94
18974	0	0	0	100	0	100
18975	0	95	0	0	0	95
18976	91	0	2	0	0	93
18977	94	0	1	0	0	95
18978	0	99	0	0	0	99
18979	98	0	1	0	0	99
18980	0	99	0	0	0	99
18981	89	0	1	0	0	90
18982	0	0	0	93	0	93
18983	0	0	92	0	0	92
18984	1	0	94	0	0	95
18985	0	1	0	88	0	89
18986	0	0	0	88	0	88
18987	0	0	96	0	0	96
18988	0	0	0	84	0	84
18989	0	0	0	83	0	83
18990	87	0	0	0	0	87
18991	88	0	0	0	0	88
18992	87	0	0	0	0	87
18993	0	0	87	0	0	87
18994	0	88	0	0	0	88
18995	0	0	0	75	0	75
18996	0	0	83	0	0	83
18997	0	86	0	0	0	86
18998	84	0	0	0	0	84
18999	0	0	0	73	0	73
19000	0	0	0	79	0	79
19001	82	0	0	1	0	83
19002	0	0	0	79	0	79
19003	0	1	0	80	0	81
19004	80	0	0	0	0	80
19005	0	0	82	0	0	82
19006	0	77	0	0	0	77
19007	73	0	0	0	0	73
19008	0	0	79	0	0	79
19009	78	0	0	0	0	78
19010	0	73	0	0	0	73
19011	76	0	0	0	0	76
19012	67	0	0	0	0	67
19013	73	0	0	0	0	73
19014	0	1	0	68	0	69
19015	0	0	0	76	0	76
19016	0	68	0	0	0	68
19017	0	66	0	0	0	66
19018	1	70	0	0	0	71
19019	68	1	0	0	0	69
19020	0	0	72	0	0	72
19021	0	0	0	69	0	69
19022	0	0	0	67	0	67
19023	0	69	0	0	0	69
19024	0	1	0	62	0	63
19025	0	1	0	62	0	63
19026	0	65	0	0	0	65
19027	69	0	0	0	0	69
19028	0	68	0	0	0	68
19029	0	0	64	0	0	64
19030	70	0	0	0	0	70
19031	0	70	0	0	0	70
19032	68	0	1	0	0	69
19033	0	0	0	68	0	68
19034	0	0	0	72	0	72
19035	0	0	66	0	0	66
19036	0	0	70	0	0	70
19037	0	2	0	64	0	66
19038	67	0	0	0	0	67
19039	62	0	0	0	0	62
19040	0	77	0	0	0	77
19041	0	67	0	0	0	67
19042	0	75	0	0	0	75
19043	1	0	0	70	0	71
19044	71	0	0	0	0	71
19045	62	0	1	0	0	63
19046	67	0	1	0	0	68
19047	0	0	78	0	0	78
19048	0	78	0	0	0	78
19049	0	0	0	72	0	72
19050	77	0	0	0	0	77
19051	0	2	0	61	0	63
19052	0	2	0	63	0	65
19053	66	0	0	0	0	66
19054	65	0	0	0	0	65
19055	0	0	75	0	0	75
19056	0	0	0	67	0	67
19057	0	0	70	0	0	70
19058	0	0	0	71	0	71
19059	0	0	70	0	0	70
19060	0	0	0	71	0	71
19061	64	0	0	0	0	64
19062	0	77	0	0	0	77
19063	0	76	0	0	0	76
19064	0	0	0	77	0	77
19065	0	75	0	0	0	75
19066	69	0	0	0	0	69
19067	66	0	0	0	0	66
19068	0	0	73	0	0	73
19069	0	75	0	0	0	75
19070	0	0	0	67	0	67
19071	0	0	74	0	0	74
19072	69	0	1	0	0	70
19073	0	1	0	71	0	72
19074	0	0	74	0	0	74
19075	0	0	0	76	0	76
19076	74	0	0	0	0	74
19077	0	0	74	0	0	74
19078	73	0	0	0	0	73
19079	65	0	0	0	0	65
19080	1	1	0	71	0	73
19081	0	0	74	0	0	74
19082	0	0	75	0	0	75
19083	70	0	0	0	0	70
19084	66	0	1	0	0	67
19085	0	0	74	0	0	74
19086	0	0	0	69	0	69
19087	0	0	0	63	0	63
19088	0	75	0	0	0	75
19089	0	0	0	71	0	71
19090	73	0	0	0	0	73
19091	0	1	0	74	0	75
19092	0	0	76	0	0	76
19093	71	0	0	0	0	71
19094	0	0	0	71	0	71
19095	0	0	71	0	0	71
19096	0	74	0	0	0	74
19097	65	0	0	0	0	65
19098	0	74	0	0	0	74
19099	69	0	0	0	0	69
19100	1	0	74	0	0	75
19101	0	71	0	0	0	71
19102	0	70	0	0	0	70
19103	0	0	0	72	0	72
19104	0	1	0	70	0	71
19105	0	0	75	0	0	75
19106	0	0	0	72	0	72
19107	78	0	0	0	0	78
19108	0	0	76	0	0	76
19109	0	1	0	65	0	66
19110	1	0	67	0	0	68
19111	64	0	2	0	0	66
19112	0	64	0	0	0	64
19113	67	0	0	0	0	67
19114	62	0	0	0	0	62
19115	63	0	0	0	0	63
19116	0	0	68	0	0	68
19117	0	70	0	0	0	70
19118	1	0	0	59	0	60
19119	0	1	0	62	0	63
19120	70	0	0	0	0	70
19121	0	0	0	65	0	65
19122	70	0	0	0	0	70
19123	67	0	0	0	0	67
19124	63	0	1	0	0	64
19125	64	0	1	0	0	65
19126	0	0	0	64	0	64
19127	65	0	0	0	0	65
19128	0	0	67	0	0	67
19129	63	0	0	0	0	63
19130	56	0	0	0	0	56
19131	1	0	63	0	0	64
19132	68	0	0	0	0	68
19133	55	0	0	0	0	55
19134	0	0	0	63	0	63
19135	0	0	0	66	0	66
19136	70	0	0	0	0	70
19137	0	1	0	63	0	64
19138	0	0	0	69	0	69
19139	0	72	0	0	0	72
19140	0	0	0	72	0	72
19141	74	0	0	0	0	74
19142	0	0	0	67	0	67
19143	0	1	0	80	0	81
19144	0	82	0	0	0	82
19145	0	0	0	72	0	72
19146	0	0	0	74	0	74
19147	79	0	0	1	0	80
19148	0	1	0	83	0	84
19149	0	0	78	0	0	78
19150	0	83	0	0	0	83
19151	0	79	0	0	0	79
19152	77	0	0	0	0	77
19153	0	85	0	0	0	85
19154	79	0	0	0	0	79
19155	0	82	0	0	0	82
19156	80	0	0	0	0	80
19157	0	0	0	70	0	70
19158	0	0	0	79	0	79
19159	0	80	0	0	0	80
19160	0	0	0	77	0	77
19161	0	0	80	0	0	80
19162	78	1	0	0	0	79
19163	0	79	0	0	0	79
19164	80	0	0	0	0	80
19165	73	0	0	0	0	73
19166	73	0	1	0	0	74
19167	1	0	0	70	0	71
19168	0	0	0	87	0	87
19169	0	84	0	0	0	84
19170	88	0	0	0	0	88
19171	0	95	0	0	0	95
19172	87	0	1	0	0	88
19173	0	0	92	0	0	92
19174	91	0	4	0	0	95
19175	0	0	0	89	0	89
19176	0	0	88	0	0	88
19177	0	0	98	0	0	98
19178	0	0	0	97	0	97
19179	0	0	98	0	0	98
19180	0	0	0	94	0	94
19181	91	0	1	0	0	92
19182	0	0	0	95	0	95
19183	0	0	97	0	0	97
19184	0	98	0	0	0	98
19185	0	95	0	0	0	95
19186	0	1	0	87	0	88
19187	85	0	0	0	0	85
19188	0	2	0	79	0	81
19189	0	0	0	86	0	86
19190	0	0	0	88	0	88
19191	0	0	0	85	0	85
19192	0	0	85	0	0	85
19193	0	0	84	0	0	84
19194	81	0	0	0	0	81
19195	74	0	0	1	0	75
19196	0	0	0	80	0	80
19197	0	2	0	81	0	83
19198	0	0	76	0	0	76
19199	0	82	0	0	0	82
19200	83	0	2	0	0	85
19201	70	0	0	0	0	70
19202	0	0	1	79	0	80
19203	0	0	79	0	0	79
19204	0	0	0	81	0	81
19205	0	78	0	1	0	79
19206	0	0	73	0	0	73
19207	76	0	0	0	0	76
19208	0	1	0	71	0	72
19209	78	0	0	0	0	78
19210	0	0	81	0	0	81
19211	80	0	1	0	0	81
19212	0	0	0	74	0	74
19213	72	0	0	0	0	72
19214	0	0	0	73	0	73
19215	0	70	0	0	0	70
19216	1	68	0	1	0	70
19217	0	0	0	66	0	66
19218	0	0	75	0	0	75
19219	0	76	0	0	0	76
19220	0	0	0	71	0	71
19221	71	0	0	0	0	71
19222	60	0	0	0	0	60
19223	0	1	0	65	0	66
19224	0	0	0	70	0	70
19225	0	72	0	0	0	72
19226	0	71	0	0	0	71
19227	71	0	0	0	0	71
19228	0	0	0	59	0	59
19229	0	1	0	70	0	71
19230	0	0	74	0	0	74
19231	0	0	0	70	0	70
19232	0	0	0	65	0	65
19233	0	0	0	72	0	72
19234	0	0	71	0	0	71
19235	0	0	0	74	0	74
19236	69	0	0	0	0	69
19237	0	0	73	0	0	73
19238	74	0	0	0	0	74
19239	0	1	0	64	0	65
19240	0	1	0	67	0	68
19241	0	1	0	70	0	71
19242	0	0	70	0	0	70
19243	61	0	1	1	0	63
19244	0	72	0	0	0	72
19245	70	1	0	0	0	71
19246	0	77	0	0	0	77
19247	0	0	0	76	0	76
19248	73	1	0	0	0	74
19249	0	1	77	0	0	78
19250	74	0	0	0	0	74
19251	0	0	77	0	0	77
19252	0	0	0	74	0	74
19253	0	0	77	0	0	77
19254	3	76	0	0	0	79
19255	0	1	0	97	0	98
19256	102	0	0	1	0	103
19257	0	1	0	105	0	106
19258	0	111	0	0	0	111
19259	0	0	0	105	0	105
19260	99	0	0	1	0	100
19261	103	0	0	1	0	104
19262	0	118	0	0	0	118
19263	0	113	0	0	0	113
19264	0	0	0	110	0	110
19265	0	0	0	109	0	109
19266	99	0	0	1	0	100
19267	108	0	0	0	0	108
19268	0	116	0	0	0	116
19269	0	0	0	116	0	116
19270	0	0	0	114	0	114
19271	0	0	109	0	0	109
19272	0	105	0	1	0	106
19273	0	109	0	1	0	110
19274	0	0	0	115	0	115
19275	0	0	113	0	0	113
19276	0	0	114	0	0	114
19277	0	0	0	113	0	113
19278	0	2	0	111	0	113
19279	0	0	119	0	0	119
19280	0	0	0	118	0	118
19281	0	0	114	0	0	114
19282	118	0	0	0	0	118
19283	0	1	0	116	0	117
19284	0	0	117	0	0	117
19285	0	0	116	0	0	116
19286	0	0	0	118	0	118
19287	0	0	112	0	0	112
19288	0	0	112	0	0	112
19289	0	116	0	0	0	116
19290	110	0	0	0	0	110
19291	0	0	114	0	0	114
19292	0	2	0	97	0	99
19293	0	0	0	100	0	100
19294	0	1	0	100	0	101
19295	0	0	107	0	0	107
19296	0	0	0	105	0	105
19297	106	0	0	0	0	106
19298	0	0	0	109	0	109
19299	1	0	109	0	0	110
19300	0	0	0	100	0	100
19301	100	0	0	1	0	101
19302	104	0	1	0	0	105
19303	96	0	0	0	0	96
19304	0	0	0	107	0	107
19305	109	0	0	0	0	109
19306	98	0	1	1	0	100
19307	109	0	0	0	0	109
19308	0	116	0	0	0	116
19309	115	0	1	0	0	116
19310	0	0	0	112	0	112
19311	0	0	116	0	0	116
19312	0	120	0	0	0	120
19313	121	0	1	0	0	122
19314	0	2	0	104	0	106
19315	0	0	0	120	0	120
19316	0	116	0	1	0	117
19317	0	120	0	0	0	120
19318	118	0	0	0	0	118
19319	0	123	0	0	0	123
19320	113	0	0	0	0	113
19321	0	122	0	0	0	122
19322	107	0	0	0	0	107
19323	0	121	0	0	0	121
19324	0	108	0	0	0	108
19325	115	0	0	0	0	115
19326	0	0	121	0	0	121
19327	0	118	0	0	0	118
19328	0	0	0	113	0	113
19329	0	1	0	107	0	108
19330	0	0	0	109	0	109
19331	1	1	0	117	0	119
19332	0	0	122	0	0	122
19333	120	0	1	0	0	121
19334	0	0	0	116	0	116
19335	119	0	0	0	0	119
19336	112	0	0	0	0	112
19337	108	0	1	1	0	110
19338	117	0	1	0	0	118
19339	2	0	127	0	0	129
19340	0	0	0	120	0	120
19341	0	0	127	0	0	127
19342	0	126	0	0	0	126
19343	0	0	0	126	0	126
19344	0	0	0	122	0	122
19345	0	0	0	124	0	124
19346	0	0	0	130	0	130
19347	0	0	131	0	0	131
19348	1	0	0	120	0	121
19349	0	0	0	123	0	123
19350	123	0	2	0	0	125
19351	127	0	0	0	0	127
19352	0	0	0	134	0	134
19353	0	0	0	126	0	126
19354	0	0	0	135	0	135
19355	133	0	0	0	0	133
19356	131	0	1	0	0	132
19357	126	0	1	0	0	127
19358	136	0	0	0	0	136
19359	0	152	0	0	0	152
19360	151	0	0	0	0	151
19361	134	0	0	0	0	134
19362	0	0	0	132	0	132
19363	0	0	0	153	0	153
19364	152	0	0	2	0	154
19365	0	164	0	0	0	164
19366	0	161	0	0	0	161
19367	164	0	0	0	0	164
19368	0	1	0	151	0	152
19369	0	0	0	166	0	166
19370	0	2	0	163	0	165
19371	0	0	0	177	0	177
19372	0	2	0	169	0	171
19373	0	199	0	0	0	199
19374	0	1	0	195	0	196
19375	193	0	0	0	0	193
19376	0	1	0	185	0	186
19377	0	2	0	207	0	209
19378	199	0	2	0	0	201
19379	0	233	1	0	0	234
19380	0	4	0	219	0	223
19381	0	237	0	0	0	237
19382	0	1	0	227	0	228
19383	0	0	239	0	0	239
19384	233	0	1	0	0	234
19385	0	249	0	0	0	249
19386	235	1	0	1	0	237
19387	2	0	276	0	0	278
19388	1	0	0	268	0	269
19389	0	283	0	3	0	286
19390	0	283	0	0	0	283
19391	298	0	0	2	0	300
19392	0	3	0	286	0	289
19393	1	0	314	0	0	315
19394	0	0	0	303	0	303
19395	0	0	312	0	0	312
19396	306	0	0	0	0	306
19397	0	0	304	0	0	304
19398	0	0	0	289	0	289
19399	0	308	0	0	0	308
19400	2	1	0	295	0	298
19401	0	304	0	0	0	304
19402	301	0	0	0	0	301
19403	0	0	0	297	0	297
19404	0	0	305	0	0	305
19405	0	0	310	0	0	310
19406	296	0	0	0	0	296
19407	297	0	0	0	0	297
19408	304	0	3	0	0	307
19409	299	2	0	1	0	302
19410	0	329	1	1	0	331
19411	310	0	1	0	0	311
19412	299	0	0	0	0	299
19413	0	0	328	0	0	328
19414	3	0	1	320	0	324
19415	332	0	2	0	0	334
19416	0	0	361	0	0	361
19417	0	2	1	354	0	357
19418	0	0	412	0	0	412
19419	2	1	2	376	0	381
19420	0	438	0	0	0	438
19421	409	0	0	0	0	409
19422	1	0	528	0	0	529
19423	558	0	1	0	0	559
19424	1	2	0	544	0	547
19425	552	0	0	0	0	552
19426	0	1	0	569	0	570
19427	546	23	2	2	0	573
19428	0	0	624	0	0	624
19429	652	0	4	0	0	656
19430	0	1	0	629	0	630
19431	2	3	0	628	0	633
19432	669	0	4	1	0	674
19433	4	7	0	679	0	690
19434	0	0	708	0	0	708
19435	1	3	0	711	0	715
19436	696	0	0	0	0	696
19437	0	766	0	0	0	766
19438	1	752	0	0	0	753
19439	788	0	2	1	0	791
19440	0	817	0	0	0	817
19441	0	1	0	797	0	798
19442	777	0	0	0	0	777
19443	757	0	6	1	0	764
19444	806	0	7	0	0	813
19445	0	0	889	0	0	889
19446	0	1	0	878	0	879
19447	0	809	1	0	0	810
19448	2	8	2	870	0	882
19449	2	0	899	0	0	901
19450	6	880	0	1	0	887
19451	0	2	0	905	0	907
19452	918	0	4	0	0	922
19453	0	916	0	4	0	920
19454	2	0	956	0	0	958
19455	0	3	0	954	0	957
19456	1	0	1047	0	0	1048
19457	0	0	0	995	0	995
19458	1038	0	0	0	0	1038
19459	1	8	0	997	0	1006
19460	1017	0	1	0	0	1018
19461	975	0	9	1	0	985
19462	0	1066	1	0	0	1067
19463	1038	0	2	0	0	1040
19464	0	1044	0	1	0	1045
19465	0	0	1034	0	0	1034
19466	0	6	0	981	0	987
19467	0	5	0	988	0	993
19468	3	1	994	0	0	998
19469	0	1075	0	0	0	1075
19470	1043	0	7	0	0	1050
19471	1000	0	5	0	0	1005
19472	0	0	0	1009	0	1009
19473	0	0	0	1017	0	1017
19474	0	3	0	1047	0	1050
19475	1059	0	0	1	0	1060
19476	0	0	1061	0	0	1061
19477	0	0	1065	0	0	1065
19478	0	4	0	1052	0	1056
19479	1	0	1035	0	0	1036
19480	0	0	1078	0	0	1078
19481	0	1	0	1075	0	1076
19482	0	0	1073	0	0	1073
19483	0	1086	3	0	0	1089
19484	0	2	0	1067	0	1069
19485	0	0	1116	0	0	1116
19486	0	0	0	1086	0	1086
19487	0	1142	0	1	0	1143
19488	0	3	0	1128	0	1131
19489	0	0	1165	0	0	1165
19490	0	22	0	1142	0	1164
19491	1134	0	8	0	0	1142
19492	0	0	1140	0	0	1140
19493	1123	0	4	0	0	1127
19494	2	1111	0	23	0	1136
19495	1121	0	3	0	0	1124
19496	0	0	0	1081	0	1081
19497	0	1069	0	0	0	1069
19498	1069	0	9	6	0	1084
19499	0	1	0	1089	0	1090
19500	0	0	1088	1	0	1089
19501	2	1100	3	7	0	1112
19502	3	0	0	1058	0	1061
19503	1062	0	2	6	0	1070
19504	974	0	0	1	0	975
19505	0	4	0	1086	0	1090
19506	1	0	1118	0	0	1119
19507	1060	0	2	1	0	1063
19508	0	0	1089	0	0	1089
19509	0	1	0	1079	0	1080
19510	1087	0	3	0	0	1090
19511	0	1102	1	1	0	1104
19512	1039	2	3	1	0	1045
19513	0	0	1067	0	0	1067
19514	1036	0	7	2	0	1045
19515	0	4	0	973	0	977
19516	3	5	11	996	0	1015
19517	1	0	1025	0	0	1026
19518	1	2	1	988	0	992
19519	988	0	1	1	0	990
19520	1	5	0	998	0	1004
19521	1	992	0	0	0	993
19522	1	0	0	955	0	956
19523	0	946	0	0	0	946
19524	1	1	927	0	0	929
19525	949	0	1	0	0	950
19526	0	1	0	928	0	929
19527	2	0	925	0	0	927
19528	0	932	0	0	0	932
19529	0	5	1	870	0	876
19530	0	5	0	865	0	870
19531	887	0	0	0	0	887
19532	0	3	0	884	0	887
19533	846	0	13	0	0	859
19534	859	0	1	1	0	861
19535	0	913	3	1	0	917
19536	792	0	1	0	0	793
19537	0	0	0	738	0	738
19538	0	0	741	0	0	741
19539	724	0	6	0	0	730
19540	0	2	2	717	0	721
19541	3	0	698	1	0	702
19542	722	0	0	1	0	723
19543	0	5	1	707	0	713
19544	1	719	1	1	0	722
19545	1	1	0	679	0	681
19546	0	684	0	0	0	684
19547	686	0	4	0	0	690
19548	0	0	700	0	0	700
19549	0	712	1	0	0	713
19550	0	3	1	662	0	666
19551	0	0	673	0	0	673
19552	2	0	699	0	0	701
19553	0	707	0	2	0	709
19554	0	1	2	653	0	656
19555	1	0	1	605	0	607
19556	0	2	0	662	0	664
19557	657	0	7	0	0	664
19558	0	0	700	1	0	701
19559	0	689	0	5	0	694
19560	1	10	0	604	0	615
19561	2	9	1	523	0	535
19562	2	0	600	0	0	602
19563	2	2	3	576	0	583
19564	0	0	574	0	0	574
19565	0	0	555	0	0	555
19566	0	0	577	0	0	577
19567	0	0	0	541	0	541
19568	1	3	1	518	0	523
19569	0	1	0	548	0	549
19570	563	0	1	0	0	564
19571	0	578	0	0	0	578
19572	547	0	2	1	0	550
19573	525	1	2	0	0	528
19574	529	0	0	0	0	529
19575	0	558	0	0	0	558
19576	546	0	3	0	0	549
19577	512	0	1	0	0	513
19578	0	1	0	547	0	548
19579	0	0	0	539	0	539
19580	0	0	0	547	0	547
19581	0	0	558	0	0	558
19582	530	0	0	0	0	530
19583	0	0	0	545	0	545
19584	533	0	2	0	0	535
19585	0	590	1	1	0	592
19586	2	4	0	522	0	528
19587	1	1	0	520	0	522
19588	518	0	1	0	0	519
19589	0	2	0	547	0	549
19590	484	0	2	0	0	486
19591	514	0	3	0	0	517
19592	0	551	0	0	0	551
19593	0	526	0	1	0	527
19594	1	4	0	475	0	480
19595	0	491	0	2	0	493
19596	2	4	0	474	0	480
19597	0	0	489	0	0	489
19598	0	0	466	0	0	466
19599	492	0	2	0	0	494
19600	460	0	7	0	0	467
19601	0	491	1	3	0	495
19602	460	0	2	0	0	462
19603	0	475	0	3	0	478
19604	0	6	0	439	0	445
19605	1	3	1	409	0	414
19606	0	0	0	437	0	437
19607	0	1	0	433	0	434
19608	428	0	0	0	0	428
19609	0	448	0	3	0	451
19610	419	0	3	0	0	422
19611	406	0	0	1	0	407
19612	0	0	429	0	0	429
19613	422	0	1	0	0	423
19614	0	433	0	1	0	434
19615	0	5	0	386	0	391
19616	0	0	0	400	0	400
19617	0	404	0	4	0	408
19618	396	0	2	1	0	399
19619	0	0	418	0	0	418
19620	397	0	1	1	0	399
19621	0	0	432	0	0	432
19622	0	0	0	387	0	387
19623	0	4	0	365	0	369
19624	0	0	0	398	0	398
19625	397	0	1	0	0	398
19626	0	0	403	0	0	403
19627	395	0	2	1	0	398
19628	386	0	5	0	0	391
19629	368	1	5	0	0	374
19630	350	0	2	0	0	352
19631	0	4	0	386	0	390
19632	0	0	396	0	0	396
19633	0	1	0	389	0	390
19634	1	0	385	0	0	386
19635	1	0	381	0	0	382
19636	0	371	0	4	0	375
19637	1	3	0	338	0	342
19638	1	1	0	322	0	324
19639	0	1	0	355	0	356
19640	0	2	0	339	0	341
19641	369	0	1	0	0	370
19642	319	0	1	1	0	321
19643	0	1	0	367	0	368
19644	1	0	389	0	0	390
19645	0	2	0	364	0	366
19646	0	2	0	359	0	361
19647	0	0	388	0	0	388
19648	1	2	0	360	0	363
19649	380	0	2	0	0	382
19650	361	0	3	2	0	366
19651	352	0	1	0	0	353
19652	0	1	0	381	0	382
19653	376	0	1	0	0	377
19654	357	0	0	0	0	357
19655	0	0	374	0	0	374
19656	1	0	360	0	0	361
19657	0	0	380	0	0	380
19658	365	1	3	0	0	369
19659	0	389	0	0	0	389
19660	380	0	2	0	0	382
19661	0	388	0	0	0	388
19662	0	0	0	379	0	379
19663	1	1	0	385	0	387
19664	0	1	0	388	0	389
19665	0	0	406	0	0	406
19666	411	0	3	0	0	414
19667	0	2	0	404	0	406
19668	0	0	407	0	0	407
19669	1	0	419	0	0	420
19670	407	0	1	0	0	408
19671	0	443	0	0	0	443
19672	439	0	0	0	0	439
19673	436	0	0	0	0	436
19674	0	450	0	0	0	450
19675	437	0	0	0	0	437
19676	0	0	438	0	0	438
19677	3	0	420	0	0	423
19678	0	0	464	0	0	464
19679	1	2	1	436	0	440
19680	0	0	431	0	0	431
19681	448	0	1	0	0	449
19682	417	0	2	0	0	419
19683	0	0	455	0	0	455
19684	0	1	0	440	0	441
19685	443	0	2	0	0	445
19686	0	432	0	0	0	432
19687	0	422	0	0	0	422
19688	425	0	0	0	0	425
19689	0	0	443	0	0	443
19690	1	2	0	411	0	414
19691	0	1	0	419	0	420
19692	0	3	0	415	0	418
19693	0	416	0	1	0	417
19694	2	1	0	418	0	421
19695	403	0	0	0	0	403
19696	0	0	0	423	0	423
19697	0	433	0	0	0	433
19698	415	0	0	1	0	416
19699	0	3	0	389	0	392
19700	2	1	0	399	0	402
19701	413	0	0	2	0	415
19702	391	0	2	0	0	393
19703	0	0	0	420	0	420
19704	393	0	1	2	0	396
19705	391	1	3	0	0	395
19706	0	420	0	1	0	421
19707	392	0	0	0	0	392
19708	0	417	0	0	0	417
19709	3	3	0	374	0	380
19710	0	0	398	0	0	398
19711	0	2	0	362	0	364
19712	2	2	0	347	0	351
19713	1	1	0	382	0	384
19714	385	0	2	1	0	388
19715	0	393	0	1	0	394
19716	390	0	0	0	0	390
19717	0	404	0	0	0	404
19718	380	0	0	2	0	382
19719	369	0	1	1	0	371
19720	359	0	4	2	0	365
19721	379	0	3	0	0	382
19722	1	2	403	0	0	406
19723	0	2	0	369	0	371
19724	0	0	1	371	0	372
19725	0	0	378	0	0	378
19726	388	0	0	0	0	388
19727	0	1	1	379	0	381
19728	2	0	358	0	0	360
19729	1	0	389	0	0	390
19730	1	6	0	382	0	389
19731	0	0	405	0	0	405
19732	0	1	0	364	0	365
19733	3	0	0	360	0	363
19734	0	0	372	0	0	372
19735	394	0	2	0	0	396
19736	0	0	0	378	0	378
19737	0	0	406	0	0	406
19738	1	0	0	369	0	370
19739	380	0	2	0	0	382
19740	0	0	376	0	0	376
19741	371	0	0	2	0	373
19742	363	0	3	0	0	366
19743	0	1	0	341	0	342
19744	0	0	0	380	0	380
19745	0	0	384	0	0	384
19746	0	1	0	369	0	370
19747	0	1	0	349	0	350
19748	0	3	0	360	0	363
19749	1	0	382	0	0	383
19750	373	0	1	0	0	374
19751	362	0	1	0	0	363
19752	346	0	2	0	0	348
19753	356	0	0	0	0	356
19754	1	0	1	366	0	368
19755	377	0	0	0	0	377
19756	346	0	0	0	0	346
19757	338	0	2	0	0	340
19758	353	0	1	0	0	354
19759	1	393	0	0	0	394
19760	397	1	1	0	0	399
19761	395	0	4	0	0	399
19762	0	440	0	0	0	440
19763	421	0	3	0	0	424
19764	0	1	0	388	0	389
19765	3	1	0	428	0	432
19766	415	0	1	1	0	417
19767	0	449	0	0	0	449
19768	0	437	0	0	0	437
19769	1	1	1	433	0	436
19770	0	0	465	0	0	465
19771	0	1	0	433	0	434
19772	4	1	0	399	0	404
19773	458	0	1	0	0	459
19774	421	0	1	0	0	422
19775	0	3	0	463	0	466
19776	2	2	470	0	0	474
19777	0	3	0	465	0	468
19778	460	0	2	0	0	462
19779	0	0	472	0	0	472
19780	0	475	0	0	0	475
19781	471	0	1	0	0	472
19782	1	0	0	428	0	429
19783	0	1	0	433	0	434
19784	0	3	0	469	0	472
19785	0	0	481	0	0	481
19786	464	0	0	0	0	464
19787	1	0	480	0	0	481
19788	0	467	0	0	0	467
19789	0	3	0	462	0	465
19790	0	3	0	445	0	448
19791	3	3	0	454	0	460
19792	1	0	435	0	0	436
19793	0	0	461	1	0	462
19794	0	0	482	0	0	482
19795	0	487	0	1	0	488
19796	0	0	0	443	0	443
19797	478	0	2	1	0	481
19798	462	0	1	0	0	463
19799	1	0	483	0	0	484
19800	0	461	1	0	0	462
19801	1	0	449	0	0	450
19802	0	378	0	0	0	378
19803	477	0	2	0	0	479
19804	468	0	3	0	0	471
19805	0	503	0	0	0	503
19806	482	0	3	1	0	486
19807	0	1	0	453	0	454
19808	0	3	0	470	0	473
19809	460	0	2	2	0	464
19810	445	0	4	1	0	450
19811	457	0	0	0	0	457
19812	0	481	1	2	0	484
19813	0	457	0	1	0	458
19814	419	1	0	0	0	420
19815	0	0	450	0	0	450
19816	0	0	0	450	0	450
19817	422	0	2	2	0	426
19818	0	437	0	0	0	437
19819	0	431	1	0	0	432
19820	422	0	3	0	0	425
19821	0	0	428	0	0	428
19822	400	0	1	0	0	401
19823	0	0	405	0	0	405
19824	0	0	415	0	0	415
19825	1	0	0	386	0	387
19826	2	0	357	0	0	359
19827	391	0	0	0	0	391
19828	346	0	13	0	0	359
19829	354	0	6	0	0	360
19830	330	0	10	0	0	340
19831	0	0	0	366	0	366
19832	363	0	0	0	0	363
19833	0	384	0	0	0	384
19834	2	0	0	369	0	371
19835	0	365	0	0	0	365
19836	374	0	2	0	0	376
19837	381	0	1	0	0	382
19838	0	1	0	388	0	389
19839	409	0	0	0	0	409
19840	373	0	2	0	0	375
19841	0	1	0	392	0	393
19842	0	4	0	372	0	376
19843	0	0	0	403	0	403
19844	0	0	406	1	0	407
19845	0	0	400	0	0	400
19846	3	1	429	0	0	433
19847	0	3	0	401	0	404
19848	0	0	430	0	0	430
19849	0	2	1	408	0	411
19850	1	0	399	0	0	400
19851	0	0	415	0	0	415
19852	400	0	3	0	0	403
19853	0	415	0	1	0	416
19854	404	0	1	0	0	405
19855	0	1	0	374	0	375
19856	0	1	0	400	0	401
19857	1	0	404	0	0	405
19858	0	416	0	2	0	418
19859	1	1	0	400	0	402
19860	1	0	430	0	0	431
19861	0	424	0	0	0	424
19862	0	1	0	384	0	385
19863	426	0	1	1	0	428
19864	383	0	2	0	0	385
19865	0	1	1	424	0	426
19866	401	0	0	4	0	405
19867	0	443	0	0	0	443
19868	1	0	0	399	0	400
19869	1	0	422	0	0	423
19870	0	5	0	391	0	396
19871	0	0	392	3	0	395
19872	402	0	2	0	0	404
19873	0	0	0	431	0	431
19874	0	432	0	1	0	433
19875	0	1	0	422	0	423
19876	0	0	430	0	0	430
19877	1	0	406	0	0	407
19878	0	0	416	0	0	416
19879	409	0	1	0	0	410
19880	0	423	0	2	0	425
19881	1	1	0	399	0	401
19882	402	0	0	0	0	402
19883	1	422	0	0	0	423
19884	407	0	0	0	0	407
19885	396	0	0	0	0	396
19886	373	0	1	0	0	374
19887	386	0	3	1	0	390
19888	7	0	399	0	0	406
19889	386	0	1	0	0	387
19890	2	0	378	0	0	380
19891	350	0	2	0	0	352
19892	0	0	0	361	0	361
19893	6	0	336	0	0	342
19894	1	352	0	0	0	353
19895	0	0	0	328	0	328
19896	1	338	0	0	0	339
19897	0	349	0	0	0	349
19898	325	0	8	2	0	335
19899	1	0	363	0	0	364
19900	0	374	0	0	0	374
19901	356	0	3	0	0	359
19902	0	373	6	0	0	379
19903	358	0	1	0	0	359
19904	0	1	9	362	0	372
19905	415	0	1	0	0	416
19906	0	0	0	462	0	462
19907	448	29	2	1	0	480
19908	0	0	0	502	0	502
19909	0	522	0	0	0	522
19910	6	2	0	525	0	533
19911	482	7	11	11	0	511
19912	0	572	3	0	0	575
19913	4	7	0	534	0	545
19914	536	6	2	5	0	549
19915	1	6	0	495	0	502
19916	0	2	0	550	0	552
19917	3	0	520	0	0	523
19918	0	1	575	0	0	576
19919	1	5	1	551	0	558
19920	3	0	575	0	0	578
19921	0	2	1	524	0	527
19922	0	2	0	513	0	515
19923	0	3	0	548	0	551
19924	0	0	577	0	0	577
19925	0	6	0	565	0	571
19926	0	2	1	568	0	571
19927	0	600	0	0	0	600
19928	4	3	1	577	0	585
19929	560	0	4	2	0	566
19930	0	3	0	592	0	595
19931	0	0	614	1	0	615
19932	593	0	0	1	0	594
19933	0	644	0	0	0	644
19934	0	6	0	603	0	609
19935	0	1	637	0	0	638
19936	632	0	5	1	0	638
19937	0	663	0	2	0	665
19938	638	0	1	0	0	639
19939	1	3	0	608	0	612
19940	533	0	0	10	0	543
19941	0	0	658	0	0	658
19942	0	660	0	1	0	661
19943	0	642	0	3	0	645
19944	608	0	3	2	0	613
19945	599	0	4	1	0	604
19946	5	0	626	0	0	631
19947	588	36	3	0	0	627
19948	584	0	0	0	0	584
19949	591	1	3	0	0	595
19950	0	650	0	0	0	650
19951	1	602	0	0	0	603
19952	617	0	1	0	0	618
19953	607	0	1	0	0	608
19954	0	660	0	0	0	660
19955	0	3	0	635	0	638
19956	0	0	653	0	0	653
19957	616	0	5	0	0	621
19958	571	0	2	0	0	573
19959	600	0	3	0	0	603
19960	0	668	0	1	0	669
19961	0	0	630	0	0	630
19962	675	0	1	0	0	676
19963	0	5	0	644	0	649
19964	1	3	0	667	0	671
19965	1	1	0	703	0	705
19966	3	1	727	0	0	731
19967	0	6	1	711	0	718
19968	1	0	720	1	0	722
19969	0	726	0	7	0	733
19970	724	1	3	0	0	728
19971	0	775	0	1	0	776
19972	0	712	0	0	0	712
19973	757	0	1	1	0	759
19974	0	804	0	4	0	808
19975	0	3	0	759	0	762
19976	0	766	0	0	0	766
19977	777	0	0	0	0	777
19978	0	817	0	1	0	818
19979	1	8	0	779	0	788
19980	0	0	819	0	0	819
19981	2	5	0	746	0	753
19982	0	809	0	2	0	811
19983	1	4	0	748	0	753
19984	1	4	0	648	0	653
19985	0	7	0	712	0	719
19986	0	1	0	740	0	741
19987	0	1	1	738	0	740
19988	1	4	0	749	0	754
19989	1	0	759	0	0	760
19990	734	0	4	1	0	739
19991	0	0	1	724	0	725
19992	0	0	737	0	0	737
19993	0	0	762	0	0	762
19994	0	1	0	729	0	730
19995	751	0	2	2	0	755
19996	1	0	762	0	0	763
19997	730	0	5	0	0	735
19998	0	0	783	0	0	783
19999	1	9	0	708	0	718
20000	1	2	1	722	0	726
20001	0	0	729	0	0	729
20002	780	1	3	0	0	784
20003	0	4	0	778	0	782
20004	1	0	749	0	0	750
20005	0	0	783	0	0	783
20006	0	3	0	780	0	783
20007	1	784	0	0	0	785
20008	756	0	2	3	0	761
20009	763	1	3	0	0	767
20010	0	0	813	0	0	813
20011	0	0	0	801	0	801
20012	799	1	4	1	0	805
20013	1	0	789	0	0	790
20014	792	0	6	2	0	800
20015	0	824	0	1	0	825
20016	1	2	0	746	0	749
20017	1	0	0	746	0	747
20018	791	0	1	1	0	793
20019	0	6	0	749	0	755
20020	1	8	0	777	0	786
20021	0	5	0	791	0	796
20022	783	0	0	0	0	783
20023	1	0	785	0	0	786
20024	798	0	3	0	0	801
20025	743	0	7	0	0	750
20026	727	0	2	0	0	729
20027	3	0	0	789	0	792
20028	1	0	787	0	0	788
20029	0	796	0	1	0	797
20030	0	773	0	3	0	776
20031	0	742	0	2	0	744
20032	4	0	792	0	0	796
20033	8	6	1	785	0	800
20034	855	0	1	0	0	856
20035	745	0	5	0	0	750
20036	4	3	0	871	0	878
20037	1	0	856	0	0	857
20038	3	2	890	0	0	895
20039	0	5	0	886	0	891
20040	1	0	941	0	0	942
20041	1	6	1	850	0	858
20042	2	4	0	932	0	938
20043	0	1004	0	3	0	1007
20044	2	7	0	944	0	953
20045	4	4	0	970	0	978
20046	1012	0	5	3	0	1020
20047	2	5	0	962	0	969
20048	0	2	0	1062	0	1064
20049	1059	1	0	2	0	1062
20050	0	1102	0	0	0	1102
20051	1053	2	3	0	0	1058
20052	0	1	1059	0	0	1060
20053	1044	0	1	2	0	1047
20054	1042	2	9	0	0	1053
20055	0	0	1072	0	0	1072
20056	0	0	1115	0	0	1115
20057	5	2	1	1047	0	1055
20058	1099	0	2	1	0	1102
20059	0	0	1133	0	0	1133
20060	3	9	0	1110	0	1122
20061	0	0	1169	0	0	1169
20062	0	1	0	1126	0	1127
20063	2	1	0	1028	0	1031
20064	1050	1	2	0	0	1053
20065	1092	0	3	1	0	1096
20066	1132	0	10	1	0	1143
20067	1	0	1175	0	0	1176
20068	0	0	1231	0	0	1231
20069	0	4	1	1164	0	1169
20070	0	6	0	1105	0	1111
20071	1	1	0	1176	0	1178
20072	1218	0	4	0	0	1222
20073	0	1242	0	0	0	1242
20074	1195	0	3	6	0	1204
20075	1188	0	3	1	0	1192
20076	0	1224	1	1	0	1226
20077	0	1163	0	1	0	1164
20078	1222	0	3	0	0	1225
20079	0	2	0	1187	0	1189
20080	0	1200	0	2	0	1202
20081	4	8	0	1135	0	1147
20082	2	0	1226	0	0	1228
20083	0	2	0	1196	0	1198
20084	1215	1	1	1	0	1218
20085	1	0	1162	1	0	1164
20086	0	0	1184	0	0	1184
20087	1	3	0	1168	0	1172
20088	0	1140	0	1	0	1141
20089	0	1123	0	1	0	1124
20090	0	1163	0	0	0	1163
20091	1173	0	2	0	0	1175
20092	1085	0	0	0	0	1085
20093	1083	1	0	0	0	1084
20094	0	1202	0	3	0	1205
20095	1161	0	5	0	0	1166
20096	1131	0	1	2	0	1134
20097	2	0	1200	0	0	1202
20098	0	1207	0	0	0	1207
20099	0	0	0	1199	0	1199
20100	1195	0	2	0	0	1197
20101	4	0	1222	0	0	1226
20102	0	2	0	1188	0	1190
20103	0	1218	0	0	0	1218
20104	1	13	0	1125	0	1139
20105	5	2	0	1047	0	1054
20106	1169	0	0	0	0	1169
20107	1106	0	3	1	0	1110
20108	2	2	0	1161	0	1165
20109	3	0	1141	0	0	1144
20110	0	0	1086	0	0	1086
20111	1025	0	0	1	0	1026
20112	0	0	1053	0	0	1053
20113	1	4	2	1004	0	1011
20114	0	980	0	0	0	980
20115	975	0	8	0	0	983
20116	0	968	0	0	0	968
20117	960	0	9	0	0	969
20118	2	3	2	908	0	915
20119	5	1	0	870	0	876
20120	907	0	4	0	0	911
20121	900	0	4	0	0	904
20122	0	2	0	850	0	852
20123	0	3	3	831	0	837
20124	0	0	838	0	0	838
20125	1	0	807	0	0	808
20126	792	0	8	0	0	800
20127	9	0	814	0	0	823
20128	737	0	4	0	0	741
20129	711	0	4	2	0	717
20130	0	0	770	0	0	770
20131	0	742	0	0	0	742
20132	0	674	0	1	0	675
20133	3	0	772	0	0	775
20134	0	1	0	746	0	747
20135	769	0	0	0	0	769
20136	740	1	2	1	0	744
20137	702	0	6	0	0	708
20138	673	0	4	1	0	678
20139	689	1	2	0	0	692
20140	0	779	0	0	0	779
20141	752	0	5	1	0	758
20142	0	787	0	1	0	788
20143	726	0	8	2	0	736
20144	1	0	776	0	0	777
20145	0	2	0	694	0	696
20146	1	0	0	732	0	733
20147	0	736	0	0	0	736
20148	757	0	5	0	0	762
20149	728	0	1	1	0	730
20150	0	3	0	665	0	668
20151	0	0	0	726	0	726
20152	744	0	1	1	0	746
20153	1	2	0	640	0	643
20154	1	1	1	686	0	689
20155	690	0	0	0	0	690
20156	0	3	0	703	0	706
20157	694	0	0	0	0	694
20158	685	0	2	0	0	687
20159	0	0	724	0	0	724
20160	713	0	2	0	0	715
20161	641	0	0	0	0	641
20162	692	0	3	0	0	695
20163	0	0	727	0	0	727
20164	0	2	0	663	0	665
20165	0	3	0	675	0	678
20166	0	0	689	0	0	689
20167	684	0	3	0	0	687
20168	0	2	1	699	0	702
20169	0	2	633	0	0	635
20170	0	0	715	0	0	715
20171	3	2	0	685	0	690
20172	0	0	708	0	0	708
20173	0	5	0	640	0	645
20174	0	2	0	645	0	647
20175	2	0	692	0	0	694
20176	1	4	0	661	0	666
20177	0	672	0	1	0	673
20178	0	640	1	2	0	643
20179	632	0	4	1	0	637
20180	624	0	5	0	0	629
20181	0	670	0	1	0	671
20182	670	0	4	2	0	676
20183	643	0	7	1	0	651
20184	0	3	0	519	0	522
20185	1	1	0	563	0	565
20186	558	0	1	0	0	559
20187	0	570	0	0	0	570
20188	0	563	0	1	0	564
20189	2	2	0	500	0	504
20190	0	0	541	0	0	541
20191	523	0	2	0	0	525
20192	466	0	6	0	0	472
20193	496	0	2	0	0	498
20194	0	541	0	0	0	541
20195	3	3	0	476	0	482
20196	0	0	0	492	0	492
20197	511	0	1	0	0	512
20198	0	518	1	0	0	519
20199	0	3	3	482	0	488
20200	0	2	0	454	0	456
20201	0	3	0	488	0	491
20202	491	0	0	0	0	491
20203	0	493	0	0	0	493
20204	2	3	0	461	0	466
20205	0	470	0	0	0	470
20206	426	0	2	1	0	429
20207	6	0	434	0	0	440
20208	421	0	4	1	0	426
20209	5	0	446	0	0	451
20210	2	1	0	422	0	425
20211	405	0	3	2	0	410
20212	0	0	397	0	0	397
20213	407	0	0	0	0	407
20214	352	0	4	23	0	379
20215	370	0	1	0	0	371
20216	0	2	0	298	0	300
20217	0	1	0	287	0	288
20218	0	0	0	301	0	301
20219	296	0	1	0	0	297
20220	0	298	0	1	0	299
20221	278	0	7	0	0	285
20222	292	0	0	1	0	293
20223	0	0	288	0	0	288
20224	298	0	4	0	0	302
20225	281	0	1	0	0	282
20226	0	2	0	285	0	287
20227	0	1	0	290	0	291
20228	0	0	0	296	0	296
20229	298	0	2	1	0	301
20230	286	0	2	0	0	288
20231	272	0	2	0	0	274
20232	0	299	0	1	0	300
20233	0	280	0	0	0	280
20234	0	283	0	0	0	283
20235	274	0	0	0	0	274
20236	0	1	272	0	0	273
20237	0	0	261	0	0	261
20238	251	0	0	0	0	251
20239	1	0	191	2	0	194
20240	2	1	0	164	0	167
20241	0	162	1	0	0	163
20242	161	0	3	0	0	164
20243	160	0	0	0	0	160
20244	161	0	0	0	0	161
20245	0	0	0	170	0	170
20246	1	0	169	0	0	170
20247	0	0	168	0	0	168
20248	172	0	0	0	0	172
20249	166	0	1	0	0	167
20250	167	0	0	0	0	167
20251	0	1	0	155	0	156
20252	0	0	0	164	0	164
20253	1	0	164	0	0	165
20254	161	0	2	0	0	163
20255	0	2	1	156	0	159
20256	0	0	0	154	0	154
20257	0	1	0	164	0	165
20258	0	162	0	0	0	162
20259	0	0	0	163	0	163
20260	0	0	0	166	0	166
20261	161	0	1	0	0	162
20262	0	0	163	0	0	163
20263	166	0	0	0	0	166
20264	151	0	2	0	0	153
20265	0	0	0	152	0	152
20266	0	1	0	158	0	159
20267	170	0	1	0	0	171
20268	0	0	176	0	0	176
20269	0	177	0	0	0	177
20270	1	1	0	164	0	166
20271	172	0	0	0	0	172
20272	0	1	0	178	0	179
20273	0	0	179	0	0	179
20274	1	0	181	0	0	182
20275	181	1	0	0	0	182
20276	1	0	0	179	0	180
20277	1	0	174	0	0	175
20278	190	0	0	0	0	190
20279	176	0	2	0	0	178
20280	0	1	0	183	0	184
20281	0	1	0	198	0	199
20282	0	195	0	0	0	195
20283	197	0	1	0	0	198
20284	1	0	0	182	0	183
20285	0	0	0	197	0	197
20286	0	0	208	0	0	208
20287	204	0	0	0	0	204
20288	206	0	0	0	0	206
20289	0	206	0	0	0	206
20290	0	0	197	0	0	197
20291	3	0	252	0	0	255
20292	0	0	0	244	0	244
20293	254	0	0	0	0	254
20294	0	0	0	245	0	245
20295	259	0	1	0	0	260
20296	269	0	0	0	0	269
20297	270	0	0	0	0	270
20298	0	0	0	264	0	264
20299	1	0	0	280	0	281
20300	265	0	0	0	0	265
20301	0	0	267	0	0	267
20302	237	0	1	0	0	238
20303	259	0	0	0	0	259
20304	0	0	272	0	0	272
20305	0	0	271	0	0	271
20306	0	276	0	2	0	278
20307	0	0	0	262	0	262
20308	263	0	1	1	0	265
20309	0	0	0	274	0	274
20310	0	0	274	0	0	274
20311	0	279	0	0	0	279
20312	0	274	0	0	0	274
20313	0	0	0	266	0	266
20314	0	2	0	263	0	265
20315	0	280	0	0	0	280
20316	0	0	265	0	0	265
20317	270	0	1	0	0	271
20318	282	0	0	0	0	282
20319	0	288	0	1	0	289
20320	287	0	3	0	0	290
20321	0	2	0	275	0	277
20322	280	0	1	0	0	281
20323	0	0	0	285	0	285
20324	0	288	0	0	0	288
20325	0	0	286	2	0	288
20326	0	2	0	277	0	279
20327	0	0	0	264	0	264
20328	2	1	0	260	0	263
20329	281	0	1	0	0	282
20330	0	0	0	289	0	289
20331	1	0	286	0	0	287
20332	0	0	289	0	0	289
20333	279	0	2	0	0	281
20334	0	1	283	0	0	284
20335	283	0	1	0	0	284
20336	0	0	0	272	0	272
20337	0	0	0	274	0	274
20338	0	1	0	276	0	277
20339	0	0	1	286	0	287
20340	287	0	0	0	0	287
20341	0	0	291	0	0	291
20342	0	0	0	283	0	283
20343	0	286	0	0	0	286
20344	273	0	3	1	0	277
20345	1	1	0	259	0	261
20346	266	0	0	0	0	266
20347	0	0	270	0	0	270
20348	0	0	0	257	0	257
20349	0	261	0	0	0	261
20350	250	0	0	0	0	250
20351	0	0	258	0	0	258
20352	0	2	0	242	0	244
20353	0	0	0	241	0	241
20354	250	0	0	0	0	250
20355	0	0	255	0	0	255
20356	0	0	258	0	0	258
20357	1	0	1	248	0	250
20358	0	0	244	0	0	244
20359	0	0	248	0	0	248
20360	0	0	0	229	0	229
20361	0	2	0	227	0	229
20362	0	1	0	227	0	228
20363	234	0	0	0	0	234
20364	0	239	0	0	0	239
20365	232	0	4	0	0	236
20366	0	0	0	234	0	234
20367	0	224	0	0	0	224
20368	0	0	0	222	0	222
20369	222	0	0	0	0	222
20370	0	229	0	0	0	229
20371	0	1	0	208	0	209
20372	0	0	219	0	0	219
20373	206	0	0	0	0	206
20374	0	0	0	194	0	194
20375	0	2	0	195	0	197
20376	0	0	187	0	0	187
20377	0	0	187	0	0	187
20378	181	0	2	3	0	186
20379	0	188	0	0	0	188
20380	0	1	0	184	0	185
20381	173	0	1	0	0	174
20382	0	0	175	0	0	175
20383	0	176	0	0	0	176
20384	0	0	0	174	0	174
20385	170	0	0	0	0	170
20386	152	0	0	0	0	152
20387	162	0	0	0	0	162
20388	0	161	0	0	0	161
20389	0	0	167	0	0	167
20390	0	0	0	149	0	149
20391	0	1	0	143	0	144
20392	0	0	0	145	0	145
20393	1	1	0	141	0	143
20394	145	0	0	0	0	145
20395	148	0	0	0	0	148
20396	0	0	148	0	0	148
20397	0	0	141	0	0	141
20398	121	0	0	0	0	121
20399	110	0	0	0	0	110
20400	0	2	0	120	0	122
20401	0	122	0	0	0	122
20402	120	0	0	0	0	120
20403	0	125	0	1	0	126
20404	0	128	0	0	0	128
20405	0	1	0	121	0	122
20406	0	0	0	119	0	119
20407	0	1	0	117	0	118
20408	0	1	0	118	0	119
20409	0	0	126	0	0	126
20410	120	0	0	0	0	120
20411	116	0	0	0	0	116
20412	0	0	0	114	0	114
20413	0	0	0	119	0	119
20414	122	0	0	0	0	122
20415	0	0	117	0	0	117
20416	115	0	0	0	0	115
20417	111	0	0	0	0	111
20418	0	0	118	0	0	118
20419	106	0	0	0	0	106
20420	0	0	0	106	0	106
20421	0	0	0	90	0	90
20422	0	1	0	87	0	88
20423	0	0	0	96	0	96
20424	93	0	0	0	0	93
20425	0	0	0	86	0	86
20426	0	1	0	90	0	91
20427	0	97	0	0	0	97
20428	0	93	0	0	0	93
20429	1	1	0	85	0	87
20430	86	0	0	0	0	86
20431	0	0	0	93	0	93
20432	0	0	93	0	0	93
20433	0	0	93	0	0	93
20434	83	0	0	0	0	83
20435	0	90	1	1	0	92
20436	79	0	1	1	0	81
20437	0	0	86	0	0	86
20438	0	0	0	72	0	72
20439	71	0	1	0	0	72
20440	0	72	0	0	0	72
20441	66	0	0	0	0	66
20442	0	0	68	0	0	68
20443	1	0	0	63	0	64
20444	0	0	0	62	0	62
20445	66	0	0	0	0	66
20446	58	0	0	0	0	58
20447	54	0	1	0	0	55
20448	58	0	0	0	0	58
20449	62	0	0	0	0	62
20450	0	64	0	0	0	64
20451	0	2	0	57	0	59
20452	61	0	0	0	0	61
20453	0	0	0	55	0	55
20454	0	0	0	57	0	57
20455	2	0	0	58	0	60
20456	0	64	0	0	0	64
20457	61	0	0	0	0	61
20458	0	0	0	54	0	54
20459	54	0	0	1	0	55
20460	61	0	0	0	0	61
20461	0	60	0	0	0	60
20462	58	0	0	0	0	58
20463	0	0	59	0	0	59
20464	56	0	0	0	0	56
20465	0	0	0	58	0	58
20466	0	0	54	0	0	54
20467	0	55	0	0	0	55
20468	1	0	47	0	0	48
20469	0	55	0	0	0	55
20470	51	0	0	0	0	51
20471	49	0	0	0	0	49
20472	51	0	0	0	0	51
20473	0	56	0	0	0	56
20474	53	0	0	0	0	53
20475	1	0	56	0	0	57
20476	0	0	56	0	0	56
20477	0	1	0	53	0	54
20478	1	0	0	53	0	54
20479	0	58	0	1	0	59
20480	67	0	0	2	0	69
20481	0	0	0	68	0	68
20482	0	72	0	0	0	72
20483	1	0	0	70	0	71
20484	69	0	2	0	0	71
20485	70	0	0	1	0	71
20486	0	0	78	0	0	78
20487	0	0	0	76	0	76
20488	0	0	78	0	0	78
20489	0	0	0	64	0	64
20490	0	0	72	0	0	72
20491	0	2	0	65	0	67
20492	0	0	74	0	0	74
20493	0	0	0	68	0	68
20494	0	0	74	0	0	74
20495	0	0	0	67	0	67
20496	0	0	0	68	0	68
20497	0	71	0	0	0	71
20498	0	0	0	66	0	66
20499	0	0	74	0	0	74
20500	0	1	0	61	0	62
20501	0	1	0	66	0	67
20502	69	0	0	0	0	69
20503	0	0	0	61	0	61
20504	1	0	0	64	0	65
20505	0	0	63	0	0	63
20506	66	0	0	0	0	66
20507	0	1	0	59	0	60
20508	0	0	0	65	0	65
20509	0	0	0	63	0	63
20510	57	0	1	0	0	58
20511	0	0	0	59	0	59
20512	0	0	0	65	0	65
20513	64	0	0	0	0	64
20514	0	64	0	0	0	64
20515	0	0	0	65	0	65
20516	0	0	0	60	0	60
20517	0	0	61	0	0	61
20518	62	0	0	0	0	62
20519	0	0	0	61	0	61
20520	0	0	66	0	0	66
20521	67	0	0	0	0	67
20522	0	0	0	63	0	63
20523	0	0	0	64	0	64
20524	0	0	0	65	0	65
20525	0	0	0	69	0	69
20526	0	0	70	0	0	70
20527	0	1	0	67	0	68
20528	0	1	0	65	0	66
20529	0	0	65	0	0	65
20530	62	0	0	0	0	62
20531	63	0	1	0	0	64
20532	67	0	0	0	0	67
20533	0	0	0	68	0	68
20534	66	0	0	0	0	66
20535	63	0	0	0	0	63
20536	0	0	0	72	0	72
20537	69	0	0	0	0	69
20538	64	0	0	0	0	64
20539	64	0	1	0	0	65
20540	70	0	1	0	0	71
20541	0	0	0	77	0	77
20542	0	78	0	0	0	78
20543	0	73	0	0	0	73
20544	0	75	0	0	0	75
20545	79	0	0	0	0	79
20546	76	0	1	0	0	77
20547	0	0	79	0	0	79
20548	83	0	0	0	0	83
20549	0	0	0	75	0	75
20550	0	0	0	81	0	81
20551	1	0	0	81	0	82
20552	78	0	0	0	0	78
20553	0	1	0	83	0	84
20554	0	79	0	0	0	79
20555	0	0	0	77	0	77
20556	0	0	85	0	0	85
20557	0	0	0	84	0	84
20558	82	0	0	0	0	82
20559	0	0	86	0	0	86
20560	0	0	0	86	0	86
20561	0	0	0	90	0	90
20562	0	0	0	99	0	99
20563	0	103	0	0	0	103
20564	0	0	0	100	0	100
20565	96	0	0	0	0	96
20566	93	0	1	0	0	94
20567	0	0	103	0	0	103
20568	0	0	101	0	0	101
20569	0	0	0	106	0	106
20570	0	2	0	101	0	103
20571	0	0	104	0	0	104
20572	0	1	0	105	0	106
20573	0	105	0	0	0	105
20574	97	0	3	0	0	100
20575	100	0	0	0	0	100
20576	96	0	0	0	0	96
20577	0	1	103	0	0	104
20578	0	0	0	103	0	103
20579	0	0	103	0	0	103
20580	101	0	0	0	0	101
20581	0	106	0	0	0	106
20582	0	0	0	104	0	104
20583	106	0	0	0	0	106
20584	0	0	0	105	0	105
20585	0	0	0	107	0	107
20586	0	0	96	0	0	96
20587	96	0	1	2	0	99
20588	0	103	0	0	0	103
20589	1	1	0	96	0	98
20590	93	0	0	0	0	93
20591	1	0	0	96	0	97
20592	95	0	0	0	0	95
20593	0	100	0	0	0	100
20594	94	0	0	0	0	94
20595	0	0	95	0	0	95
20596	95	0	0	0	0	95
20597	95	0	0	0	0	95
20598	88	0	0	0	0	88
20599	0	0	0	94	0	94
20600	0	0	0	96	0	96
20601	0	0	0	99	0	99
20602	0	99	0	0	0	99
20603	97	0	0	0	0	97
20604	0	0	0	91	0	91
20605	0	0	0	96	0	96
20606	0	0	0	99	0	99
20607	98	0	0	1	0	99
20608	0	1	0	101	0	102
20609	0	0	99	0	0	99
20610	0	100	0	0	0	100
20611	0	0	0	96	0	96
20612	0	0	0	97	0	97
20613	0	0	0	106	0	106
20614	0	0	106	0	0	106
20615	0	0	116	0	0	116
20616	0	0	0	109	0	109
20617	0	0	120	0	0	120
20618	0	3	0	115	0	118
20619	122	0	1	0	0	123
20620	115	0	0	0	0	115
20621	116	0	0	0	0	116
20622	0	0	123	0	0	123
20623	119	0	1	0	0	120
20624	0	0	0	118	0	118
20625	1	0	120	0	0	121
20626	0	0	117	0	0	117
20627	0	118	0	0	0	118
20628	0	111	0	0	0	111
20629	113	0	0	0	0	113
20630	0	1	0	114	0	115
20631	0	0	115	0	0	115
20632	1	0	0	114	0	115
20633	113	0	0	0	0	113
20634	0	0	113	0	0	113
20635	107	0	1	1	0	109
20636	104	0	0	0	0	104
20637	105	0	0	0	0	105
20638	0	116	0	0	0	116
20639	112	0	0	0	0	112
20640	0	0	0	111	0	111
20641	0	0	0	110	0	110
20642	0	0	0	105	0	105
20643	0	0	0	115	0	115
20644	109	0	0	0	0	109
20645	0	111	0	1	0	112
20646	0	98	0	0	0	98
20647	0	111	0	0	0	111
20648	104	0	0	1	0	105
20649	106	0	0	0	0	106
20650	106	0	0	0	0	106
20651	103	0	0	0	0	103
20652	0	3	0	99	0	102
20653	0	0	0	119	0	119
20654	118	0	1	0	0	119
20655	0	126	0	0	0	126
20656	124	0	0	0	0	124
20657	116	0	0	0	0	116
20658	0	0	0	129	0	129
20659	0	133	0	0	0	133
20660	0	0	0	137	0	137
20661	139	0	1	1	0	141
20662	0	0	143	0	0	143
20663	0	0	0	135	0	135
20664	0	143	0	0	0	143
20665	133	0	1	0	0	134
20666	137	0	1	0	0	138
20667	0	0	146	0	0	146
20668	0	131	0	0	0	131
20669	1	0	146	0	0	147
20670	0	0	0	147	0	147
20671	1	0	144	0	0	145
20672	0	0	142	0	0	142
20673	0	147	0	0	0	147
20674	148	0	0	0	0	148
20675	132	0	1	0	0	133
20676	0	147	0	0	0	147
20677	0	142	0	1	0	143
20678	0	0	131	0	0	131
20679	0	0	135	0	0	135
20680	0	0	144	0	0	144
20681	0	0	0	146	0	146
20682	0	0	150	0	0	150
20683	0	0	0	142	0	142
20684	0	0	0	143	0	143
20685	1	0	149	0	0	150
20686	0	151	0	0	0	151
20687	0	0	0	151	0	151
20688	152	0	1	0	0	153
20689	0	0	0	153	0	153
20690	0	0	152	0	0	152
20691	0	150	0	0	0	150
20692	0	151	0	0	0	151
20693	1	2	0	149	0	152
20694	150	0	0	0	0	150
20695	148	0	0	0	0	148
20696	1	0	0	159	0	160
20697	0	153	1	0	0	154
20698	0	0	0	149	0	149
20699	0	0	0	137	0	137
20700	0	1	0	148	0	149
20701	156	0	0	1	0	157
20702	0	162	0	0	0	162
20703	162	0	1	0	0	163
20704	155	0	3	0	0	158
20705	147	2	0	0	0	149
20706	149	0	4	0	0	153
20707	0	0	0	176	0	176
20708	0	0	177	0	0	177
20709	0	177	0	1	0	178
20710	181	0	0	0	0	181
20711	164	0	0	0	0	164
20712	160	0	1	0	0	161
20713	0	0	174	0	0	174
20714	186	0	0	0	0	186
20715	162	0	0	2	0	164
20716	1	0	0	188	0	189
20717	0	0	191	0	0	191
20718	0	190	0	0	0	190
20719	0	0	0	184	0	184
20720	203	0	0	0	0	203
20721	0	0	0	189	0	189
20722	0	0	0	205	0	205
20723	213	0	0	0	0	213
20724	0	0	216	0	0	216
20725	212	0	0	0	0	212
20726	204	0	0	0	0	204
20727	183	0	4	0	0	187
20728	206	0	0	0	0	206
20729	0	0	218	0	0	218
20730	0	0	0	210	0	210
20731	0	0	217	0	0	217
20732	0	0	0	208	0	208
20733	0	0	211	0	0	211
20734	207	0	0	0	0	207
20735	0	215	0	0	0	215
20736	0	214	0	0	0	214
20737	1	0	0	208	0	209
20738	0	0	0	209	0	209
20739	0	216	0	0	0	216
20740	224	0	0	0	0	224
20741	230	0	1	0	0	231
20742	228	0	1	0	0	229
20743	223	0	2	2	0	227
20744	0	0	0	219	0	219
20745	0	1	0	229	0	230
20746	232	0	0	0	0	232
20747	0	0	0	234	0	234
20748	0	0	237	0	0	237
20749	1	0	241	0	0	242
20750	0	0	0	232	0	232
20751	1	0	239	0	0	240
20752	236	0	3	0	0	239
20753	1	0	0	232	0	233
20754	239	0	1	0	0	240
20755	0	0	245	0	0	245
20756	0	0	0	246	0	246
20757	0	0	242	0	0	242
20758	0	236	0	0	0	236
20759	235	0	0	0	0	235
20760	242	0	1	2	0	245
20761	0	250	0	0	0	250
20762	249	0	2	0	0	251
20763	0	0	0	224	0	224
20764	0	0	0	228	0	228
20765	234	0	0	1	0	235
20766	0	246	0	0	0	246
20767	0	240	0	0	0	240
20768	0	1	0	230	0	231
20769	223	0	0	0	0	223
20770	206	0	0	0	0	206
20771	222	0	0	1	0	223
20772	0	0	230	0	0	230
20773	0	0	234	0	0	234
20774	0	229	0	0	0	229
20775	226	2	1	2	0	231
20776	0	0	0	220	0	220
20777	226	0	1	0	0	227
20778	224	0	0	1	0	225
20779	0	0	0	235	0	235
20780	0	0	234	0	0	234
20781	227	0	0	0	0	227
20782	0	0	0	221	0	221
20783	0	0	225	0	0	225
20784	221	0	2	0	0	223
20785	218	0	1	0	0	219
20786	0	1	0	218	0	219
20787	1	0	219	0	0	220
20788	0	2	0	216	0	218
20789	0	211	0	0	0	211
20790	1	0	214	0	0	215
20791	0	211	1	1	0	213
20792	217	0	1	0	0	218
20793	209	0	2	0	0	211
20794	214	0	2	0	0	216
20795	211	0	0	0	0	211
20796	0	0	0	216	0	216
20797	220	0	0	0	0	220
20798	0	0	0	228	0	228
20799	217	0	0	1	0	218
20800	0	220	0	2	0	222
20801	0	1	0	223	0	224
20802	0	221	0	0	0	221
20803	208	0	0	0	0	208
20804	205	0	0	1	0	206
20805	0	211	0	0	0	211
20806	0	0	0	192	0	192
20807	0	0	205	0	0	205
20808	0	0	0	191	0	191
20809	0	0	193	0	0	193
20810	5	1	0	175	0	181
20811	0	181	0	0	0	181
20812	180	0	0	0	0	180
20813	165	0	0	0	0	165
20814	0	0	0	186	0	186
20815	184	0	1	0	0	185
20816	0	0	0	169	0	169
20817	0	3	0	164	0	167
20818	1	0	0	165	0	166
20819	162	0	2	0	0	164
20820	159	0	0	0	0	159
20821	167	0	0	0	0	167
20822	0	173	0	0	0	173
20823	160	0	0	0	0	160
20824	0	163	0	0	0	163
20825	159	0	1	0	0	160
20826	1	2	0	145	0	148
20827	0	1	0	145	0	146
20828	152	0	0	1	0	153
20829	154	0	0	0	0	154
20830	0	170	0	0	0	170
20831	164	0	1	0	0	165
20832	0	2	0	150	0	152
20833	1	0	0	159	0	160
20834	144	0	0	1	0	145
20835	0	0	161	0	0	161
20836	0	166	0	0	0	166
20837	0	2	0	157	0	159
20838	0	0	169	0	0	169
20839	1	0	0	156	0	157
20840	157	0	1	0	0	158
20841	0	174	0	0	0	174
20842	0	157	0	0	0	157
20843	0	171	0	0	0	171
20844	0	0	0	165	0	165
20845	167	0	0	0	0	167
20846	0	0	0	160	0	160
20847	159	0	1	0	0	160
20848	155	0	0	0	0	155
20849	3	0	0	160	0	163
20850	154	0	0	0	0	154
20851	0	0	0	161	0	161
20852	0	0	157	0	0	157
20853	149	0	0	0	0	149
20854	0	0	157	0	0	157
20855	157	0	0	0	0	157
20856	0	0	156	0	0	156
20857	4	0	0	133	0	137
20858	0	2	0	137	0	139
20859	133	0	0	1	0	134
20860	0	1	0	134	0	135
20861	133	0	0	0	0	133
20862	0	146	0	0	0	146
20863	137	0	1	0	0	138
20864	0	0	0	125	0	125
20865	0	0	0	129	0	129
20866	0	0	0	127	0	127
20867	0	0	0	131	0	131
20868	0	0	133	0	0	133
20869	0	0	136	0	0	136
20870	0	0	0	130	0	130
20871	0	0	136	0	0	136
20872	0	132	0	0	0	132
20873	0	0	0	130	0	130
20874	0	0	132	0	0	132
20875	0	0	130	0	0	130
20876	0	2	0	122	0	124
20877	1	0	0	113	0	114
20878	0	127	0	0	0	127
20879	0	2	0	111	0	113
20880	0	0	138	0	0	138
20881	136	0	0	0	0	136
20882	0	0	0	125	0	125
20883	132	0	0	0	0	132
20884	115	0	2	0	0	117
20885	123	0	2	0	0	125
20886	0	0	130	0	0	130
20887	2	0	131	0	0	133
20888	125	0	2	0	0	127
20889	0	0	128	0	0	128
20890	0	0	0	120	0	120
20891	0	4	0	119	0	123
20892	0	0	113	0	0	113
20893	0	111	0	0	0	111
20894	121	0	1	0	0	122
20895	0	123	0	0	0	123
20896	0	117	0	1	0	118
20897	120	0	0	0	0	120
20898	0	0	107	0	0	107
20899	0	0	118	0	0	118
20900	0	0	0	122	0	122
20901	118	0	0	0	0	118
20902	0	119	0	1	0	120
20903	118	0	0	0	0	118
20904	0	0	121	0	0	121
20905	0	119	0	0	0	119
20906	0	0	0	111	0	111
20907	0	0	118	0	0	118
20908	0	1	0	111	0	112
20909	0	1	0	108	0	109
20910	0	0	0	109	0	109
20911	0	0	0	112	0	112
20912	108	0	0	0	0	108
20913	112	0	0	0	0	112
20914	0	0	118	0	0	118
20915	114	0	0	0	0	114
20916	0	118	0	0	0	118
20917	110	0	0	0	0	110
20918	0	0	112	0	0	112
20919	0	0	0	115	0	115
20920	0	0	110	0	0	110
20921	0	0	117	0	0	117
20922	0	0	0	113	0	113
20923	0	1	0	110	0	111
20924	0	0	116	0	0	116
20925	0	112	0	0	0	112
20926	0	112	0	0	0	112
20927	0	0	0	113	0	113
20928	111	0	0	0	0	111
20929	0	110	0	0	0	110
20930	0	0	110	0	0	110
20931	0	0	107	2	0	109
20932	1	0	112	0	0	113
20933	0	0	0	110	0	110
20934	110	0	0	0	0	110
20935	0	108	0	0	0	108
20936	0	0	109	0	0	109
20937	0	110	0	0	0	110
20938	0	0	0	109	0	109
20939	0	0	106	0	0	106
20940	0	105	0	0	0	105
20941	0	0	1	101	0	102
20942	0	1	0	104	0	105
20943	3	0	107	0	0	110
20944	0	0	0	108	0	108
20945	0	109	0	0	0	109
20946	0	0	108	0	0	108
20947	106	0	0	1	0	107
20948	0	0	0	99	0	99
20949	0	0	0	101	0	101
20950	0	104	0	0	0	104
20951	98	2	2	0	0	102
20952	0	0	105	2	0	107
20953	104	0	3	2	0	109
20954	0	1	0	111	0	112
20955	0	123	0	0	0	123
20956	0	0	0	114	0	114
20957	0	0	0	113	0	113
20958	115	0	1	0	0	116
20959	103	0	1	0	0	104
20960	1	0	0	120	0	121
20961	0	0	118	0	0	118
20962	113	0	1	0	0	114
20963	0	119	0	0	0	119
20964	0	1	0	108	0	109
20965	0	0	0	100	0	100
20966	0	1	0	109	0	110
20967	0	0	115	0	0	115
20968	0	0	0	111	0	111
20969	0	116	0	0	0	116
20970	0	0	0	110	0	110
20971	0	115	0	0	0	115
20972	0	1	0	112	0	113
20973	0	0	119	0	0	119
20974	114	16	0	0	0	130
20975	0	0	0	129	0	129
20976	0	0	140	0	0	140
20977	0	139	0	1	0	140
20978	148	0	0	0	0	148
20979	4	0	154	0	0	158
20980	163	0	0	0	0	163
20981	0	0	0	160	0	160
20982	3	0	0	210	0	213
20983	0	219	0	0	0	219
20984	227	3	2	0	0	232
20985	284	2	2	11	0	299
20986	1	350	1	2	0	354
20987	26	8	6	301	0	341
20988	2	5	1	304	0	312
20989	0	10	0	336	0	346
20990	0	0	360	0	0	360
20991	356	0	1	0	0	357
20992	0	0	0	326	0	326
20993	0	1	0	354	0	355
20994	1	0	362	0	0	363
20995	0	0	374	0	0	374
20996	1	1	1	364	0	367
20997	1	0	376	0	0	377
20998	377	0	1	0	0	378
20999	0	3	0	368	0	371
21000	0	0	0	384	0	384
21001	0	0	398	0	0	398
21002	0	1	1	384	0	386
21003	3	0	389	0	0	392
21004	0	394	0	0	0	394
21005	384	0	1	1	0	386
21006	407	0	2	0	0	409
21007	0	434	0	0	0	434
21008	0	2	0	445	0	447
21009	1	0	459	0	0	460
21010	0	3	1	450	0	454
21011	456	0	0	0	0	456
21012	0	480	0	0	0	480
21013	447	0	3	2	0	452
21014	1	2	0	440	0	443
21015	419	0	2	0	0	421
21016	0	465	0	0	0	465
21017	417	0	1	4	0	422
21018	1	0	455	0	0	456
21019	0	446	0	1	0	447
21020	0	2	0	427	0	429
21021	430	0	1	0	0	431
21022	400	0	6	0	0	406
21023	0	0	0	439	0	439
21024	435	0	0	0	0	435
21025	394	0	2	0	0	396
21026	398	0	3	0	0	401
21027	0	6	0	383	0	389
21028	1	0	392	0	0	393
21029	0	0	369	0	0	369
21030	0	0	374	0	0	374
21031	354	0	2	0	0	356
21032	2	1	0	356	0	359
21033	0	389	0	1	0	390
21034	2	2	0	361	0	365
21035	0	415	0	1	0	416
21036	422	1	0	0	0	423
21037	0	1	0	386	0	387
21038	1	3	0	414	0	418
21039	408	0	0	0	0	408
21040	0	2	0	404	0	406
21041	0	1	0	425	0	426
21042	401	0	1	0	0	402
21043	0	1	441	0	0	442
21044	0	2	0	413	0	415
21045	0	0	448	0	0	448
21046	437	0	1	0	0	438
21047	0	2	0	404	0	406
21048	464	0	0	0	0	464
21049	0	1	0	467	0	468
21050	0	1	492	0	0	493
21051	0	1	0	476	0	477
21052	488	0	3	0	0	491
21053	0	498	0	1	0	499
21054	1	1	470	0	0	472
21055	486	0	0	0	0	486
21056	0	544	0	0	0	544
21057	0	498	0	1	0	499
21058	0	525	0	1	0	526
21059	1	2	0	494	0	497
21060	483	0	3	0	0	486
21061	465	1	1	2	0	469
21062	0	1	522	0	0	523
21063	515	0	2	1	0	518
21064	0	560	0	0	0	560
21065	0	1	0	522	0	523
21066	500	0	3	1	0	504
21067	485	0	5	0	0	490
21068	486	0	2	0	0	488
21069	483	0	3	0	0	486
21070	475	0	1	0	0	476
21071	0	1	0	515	0	516
21072	0	0	519	0	0	519
21073	0	3	0	489	0	492
21074	0	3	0	490	0	493
21075	488	0	2	1	0	491
21076	0	526	0	0	0	526
21077	497	0	0	1	0	498
21078	450	0	1	0	0	451
21079	477	0	1	1	0	479
21080	482	0	1	1	0	484
21081	0	0	505	0	0	505
21082	488	0	0	0	0	488
21083	496	0	2	0	0	498
21084	468	0	2	0	0	470
21085	464	0	8	0	0	472
21086	1	2	0	496	0	499
21087	0	0	518	0	0	518
21088	530	0	2	0	0	532
21089	0	581	0	0	0	581
21090	1	4	0	542	0	547
21091	0	574	0	1	0	575
21092	0	1	0	552	0	553
21093	538	0	4	0	0	542
21094	510	0	1	1	0	512
21095	514	0	4	1	0	519
21096	1	0	567	0	0	568
21097	552	0	0	0	0	552
21098	0	0	570	0	0	570
21099	1	0	562	0	0	563
21100	0	0	558	0	0	558
21101	0	0	1	502	0	503
21102	1	1	0	470	0	472
21103	0	0	0	511	0	511
21104	0	0	0	522	0	522
21105	0	5	0	500	0	505
21106	0	1	1	546	0	548
21107	0	549	0	2	0	551
21108	548	0	2	1	0	551
21109	0	583	0	0	0	583
21110	5	2	1	539	0	547
21111	0	1	0	553	0	554
21112	534	0	2	1	0	537
21113	0	638	0	0	0	638
21114	618	0	1	0	0	619
21115	0	4	0	570	0	574
21116	0	4	0	608	0	612
21117	0	7	0	641	0	648
21118	0	0	655	0	0	655
21119	1	3	1	633	0	638
21120	1	0	641	0	0	642
21121	0	0	705	0	0	705
21122	1	0	735	0	0	736
21123	0	7	1	696	0	704
21124	2	3	0	653	0	658
21125	1	1	0	710	0	712
21126	740	0	2	1	0	743
21127	1	5	0	725	0	731
21128	752	0	0	0	0	752
21129	0	797	0	1	0	798
21130	753	0	5	2	0	760
21131	769	10	3	1	0	783
21132	0	812	0	4	0	816
21133	788	0	3	0	0	791
21134	749	0	8	1	0	758
21135	757	0	0	3	0	760
21136	775	0	4	0	0	779
21137	0	0	810	0	0	810
21138	1	841	0	2	0	844
21139	0	4	0	808	0	812
21140	813	0	8	0	0	821
21141	2	0	836	0	0	838
21142	0	902	0	0	0	902
21143	1	5	0	854	0	860
21144	0	918	0	0	0	918
21145	1	3	0	844	0	848
21146	4	5	0	854	0	863
21147	0	0	902	0	0	902
21148	0	0	903	0	0	903
21149	869	0	3	0	0	872
21150	0	0	891	0	0	891
21151	0	0	918	0	0	918
21152	0	3	0	880	0	883
21153	0	0	0	909	0	909
21154	0	898	0	2	0	900
21155	0	849	0	1	0	850
21156	2	1	872	1	0	876
21157	1	2	1	894	0	898
21158	1	0	873	0	0	874
21159	4	0	900	0	0	904
21160	2	907	2	0	0	911
21161	0	4	0	902	0	906
21162	908	0	2	0	0	910
21163	0	4	0	872	0	876
21164	854	0	3	3	0	860
21165	845	0	2	0	0	847
21166	909	0	4	6	0	919
21167	1	0	966	0	0	967
21168	997	0	6	0	0	1003
21169	1	3	0	981	0	985
21170	976	0	12	4	0	992
21171	1012	0	5	0	0	1017
21172	0	1116	0	0	0	1116
21173	1070	1	2	1	0	1074
21174	0	0	1102	0	0	1102
21175	1106	1	4	2	0	1113
21176	1095	0	8	0	0	1103
21177	0	1257	0	0	0	1257
21178	1253	1	7	0	0	1261
21179	0	10	0	1211	0	1221
21180	0	2	0	1345	0	1347
21181	0	1365	0	0	0	1365
21182	0	10	0	1319	0	1329
21183	5	9	0	1350	0	1364
21184	1	0	1397	0	0	1398
21185	0	0	1355	0	0	1355
21186	1364	0	3	1	0	1368
21187	1292	0	5	0	0	1297
21188	0	4	0	1402	0	1406
21189	0	0	1420	0	0	1420
21190	0	1413	0	0	0	1413
21191	2	3	0	1414	0	1419
21192	3	0	1390	0	0	1393
21193	1413	1	1	0	0	1415
21194	0	3	0	1431	0	1434
21195	0	1466	0	0	0	1466
21196	0	13	0	1425	0	1438
21197	0	6	0	1467	0	1473
21198	1	3	0	1507	0	1511
21199	1530	0	3	1	0	1534
21200	0	9	0	1540	0	1549
21201	1494	0	2	2	0	1498
21202	1535	2	3	0	0	1540
21203	0	0	1594	0	0	1594
21204	0	1625	0	1	0	1626
21205	1	5	0	1552	0	1558
21206	5	1599	0	0	0	1604
21207	1595	0	8	0	0	1603
21208	2	5	0	1593	0	1600
21209	4	0	1616	0	0	1620
21210	0	0	1555	0	0	1555
21211	0	0	1624	0	0	1624
21212	1649	0	2	2	0	1653
21213	0	1687	0	1	0	1688
21214	1687	1	0	0	0	1688
21215	0	1715	0	0	0	1715
21216	1	0	0	1628	0	1629
21217	2	4	0	1668	0	1674
21218	0	1551	0	1	0	1552
21219	2	0	1673	0	0	1675
21220	0	1656	0	1	0	1657
21221	1691	0	1	0	0	1692
21222	0	1	0	1670	0	1671
21223	3	0	1648	0	0	1651
21224	1	0	1736	0	0	1737
21225	1	5	0	1736	0	1742
21226	2	0	1612	0	0	1614
21227	0	0	1713	0	0	1713
21228	1714	0	3	1	0	1718
21229	0	1747	0	0	0	1747
21230	1679	1	4	2	0	1686
21231	2	0	1724	0	0	1726
21232	0	1703	0	1	0	1704
21233	0	1666	0	4	0	1670
21234	2	8	0	1603	0	1613
21235	0	3	1	1509	0	1513
21236	0	7	0	1658	0	1665
21237	1	0	1742	0	0	1743
21238	0	5	0	1641	0	1646
21239	0	1	0	1652	0	1653
21240	1647	2	3	1	0	1653
21241	0	1644	0	0	0	1644
21242	2	2	0	1552	0	1556
21243	1571	0	1	1	0	1573
21244	1441	0	3	2	0	1446
21245	0	2	0	1590	0	1592
21246	4	0	1624	0	0	1628
21247	0	2	4	1572	0	1578
21248	3	0	1502	0	0	1505
21249	1508	0	4	2	0	1514
21250	1396	1	15	0	0	1412
21251	1	0	1	1535	0	1537
21252	1	0	1508	0	0	1509
21253	0	1439	0	0	0	1439
21254	0	0	1478	0	0	1478
21255	2	3	0	1454	0	1459
21256	0	1490	0	11	0	1501
21257	1436	0	4	1	0	1441
21258	0	10	0	1417	0	1427
21259	1	1461	0	0	0	1462
21260	1446	0	3	1	0	1450
21261	1	9	0	1444	0	1454
21262	0	1416	0	0	0	1416
21263	0	3	1	1352	0	1356
21264	0	0	1414	0	0	1414
21265	1342	0	2	2	0	1346
21266	1272	0	1	0	0	1273
21267	1	0	1376	0	0	1377
21268	0	1363	0	1	0	1364
21269	1347	0	4	0	0	1351
21270	1	3	0	1207	0	1211
21271	3	3	0	1234	0	1240
21272	0	3	0	1223	0	1226
21273	0	1	0	1245	0	1246
21274	0	0	0	1162	0	1162
21275	1227	0	3	0	0	1230
21276	1162	0	8	0	0	1170
21277	1	1	4	1159	0	1165
21278	9	9	0	1161	0	1179
21279	0	0	1121	0	0	1121
21280	0	0	1053	0	0	1053
21281	1107	0	8	0	0	1115
21282	0	5	0	1112	0	1117
21283	0	0	1183	0	0	1183
21284	1	5	1	1107	0	1114
21285	1156	0	0	2	0	1158
21286	1099	0	5	2	0	1106
21287	2	2	0	1030	0	1034
21288	0	1	0	1123	0	1124
21289	1086	0	0	2	0	1088
21290	0	1	0	1150	0	1151
21291	0	1135	1	0	0	1136
21292	2	2	0	1050	0	1054
21293	3	3	0	1056	0	1062
21294	3	0	1040	0	0	1043
21295	1	0	1082	0	0	1083
21296	0	1094	0	2	0	1096
21297	1068	1	10	0	0	1079
21298	997	0	0	0	0	997
21299	1039	1	6	0	0	1046
21300	0	1113	0	1	0	1114
21301	0	1076	0	0	0	1076
21302	1086	0	4	0	0	1090
21303	0	1059	0	0	0	1059
21304	2	0	1059	0	0	1061
21305	0	1032	0	6	0	1038
21306	1	0	1041	0	0	1042
21307	1083	0	4	1	0	1088
21308	1038	0	7	0	0	1045
21309	0	1116	0	0	0	1116
21310	1097	0	5	0	0	1102
21311	1028	0	3	1	0	1032
21312	1010	1	8	0	0	1019
21313	2	4	0	1059	0	1065
21314	1081	0	3	0	0	1084
21315	0	0	1083	1	0	1084
21316	983	0	9	0	0	992
21317	1	3	0	1027	0	1031
21318	4	0	938	0	0	942
21319	0	0	1010	0	0	1010
21320	0	5	0	907	0	912
21321	4	4	2	849	0	859
21322	907	0	7	0	0	914
21323	0	6	0	939	0	945
21324	3	0	964	0	0	967
21325	3	6	1	910	0	920
21326	0	836	0	1	0	837
21327	809	0	4	2	0	815
21328	0	4	0	750	0	754
21329	1	0	759	0	0	760
21330	1	749	0	0	0	750
21331	723	0	5	0	0	728
21332	1	5	0	707	0	713
21333	1	0	707	0	0	708
21334	1	699	0	2	0	702
21335	707	0	3	0	0	710
21336	686	0	5	1	0	692
21337	684	0	0	0	0	684
21338	0	2	0	652	0	654
21339	0	1	0	704	0	705
21340	704	0	2	0	0	706
21341	0	723	0	0	0	723
21342	709	0	4	0	0	713
21343	4	4	0	676	0	684
21344	657	0	3	0	0	660
21345	0	2	0	635	0	637
21346	0	1	0	656	0	657
21347	5	2	0	608	0	615
21348	1	0	1	634	0	636
21349	3	0	615	1	0	619
21350	0	0	632	0	0	632
21351	607	0	3	0	0	610
21352	1	0	619	0	0	620
21353	0	0	584	0	0	584
21354	589	0	1	1	0	591
21355	540	1	3	4	0	548
21356	0	0	0	588	0	588
21357	591	0	1	1	0	593
21358	0	601	0	2	0	603
21359	581	0	2	0	0	583
21360	551	0	3	0	0	554
21361	549	1	4	0	0	554
21362	0	1	0	570	0	571
21363	0	571	0	1	0	572
21364	0	553	0	1	0	554
21365	556	0	3	2	0	561
21366	524	1	2	0	0	527
21367	0	2	0	516	0	518
21368	2	1	0	552	0	555
21369	0	562	0	0	0	562
21370	539	0	0	3	0	542
21371	0	0	554	0	0	554
21372	0	2	0	516	0	518
21373	0	1	0	517	0	518
21374	0	0	546	0	0	546
21375	0	1	0	514	0	515
21376	0	547	0	0	0	547
21377	0	1	0	496	0	497
21378	1	2	0	528	0	531
21379	0	537	0	2	0	539
21380	0	554	0	0	0	554
21381	0	2	0	543	0	545
21382	540	0	0	0	0	540
21383	0	4	1	488	0	493
21384	0	3	0	546	0	549
21385	0	546	0	0	0	546
21386	0	3	0	505	0	508
21387	0	3	0	505	0	508
21388	0	1	0	542	0	543
21389	533	0	3	0	0	536
21390	0	3	0	527	0	530
21391	0	3	0	494	0	497
21392	2	2	0	522	0	526
21393	0	0	526	0	0	526
21394	536	0	0	1	0	537
21395	0	535	0	3	0	538
21396	531	0	0	0	0	531
21397	1	0	0	533	0	534
21398	1	0	551	0	0	552
21399	545	0	3	1	0	549
21400	0	0	589	0	0	589
21401	0	0	0	574	0	574
21402	576	0	1	0	0	577
21403	557	0	5	0	0	562
21404	550	0	0	0	0	550
21405	0	1	0	549	0	550
21406	0	6	0	543	0	549
21407	2	2	0	552	0	556
21408	0	486	0	1	0	487
21409	0	534	0	0	0	534
21410	0	548	0	0	0	548
21411	0	548	0	0	0	548
21412	0	1	1	525	0	527
21413	0	1	0	523	0	524
21414	527	0	2	1	0	530
21415	527	0	0	0	0	527
21416	536	0	0	0	0	536
21417	0	0	0	520	0	520
21418	1	0	0	521	0	522
21419	541	0	2	1	0	544
21420	533	0	0	1	0	534
21421	0	0	550	0	0	550
21422	1	0	546	0	0	547
21423	1	0	533	0	0	534
21424	1	0	562	0	0	563
21425	0	1	0	551	0	552
21426	553	0	2	0	0	555
21427	0	561	0	0	0	561
21428	0	3	0	527	0	530
21429	1	0	563	0	0	564
21430	0	551	0	0	0	551
21431	1	2	0	521	0	524
21432	3	0	548	0	0	551
21433	0	1	0	490	0	491
21434	2	1	0	462	0	465
21435	492	0	1	0	0	493
21436	0	1	0	489	0	490
21437	0	0	500	0	0	500
21438	3	4	0	444	0	451
21439	0	458	0	1	0	459
21440	4	0	0	420	0	424
21441	0	1	2	403	0	406
21442	3	2	0	409	0	414
21443	424	0	0	1	0	425
21444	407	0	4	0	0	411
21445	406	0	1	0	0	407
21446	408	0	3	0	0	411
21447	1	0	423	0	0	424
21448	385	0	1	0	0	386
21449	386	0	0	0	0	386
21450	1	0	377	0	0	378
21451	0	0	410	0	0	410
21452	1	2	0	419	0	422
21453	0	396	1	0	0	397
21454	402	0	2	0	0	404
21455	387	0	4	0	0	391
21456	390	0	2	0	0	392
21457	0	2	0	412	0	414
21458	0	417	0	0	0	417
21459	396	0	1	0	0	397
21460	371	0	0	0	0	371
21461	0	3	0	381	0	384
21462	0	0	384	0	0	384
21463	394	0	1	1	0	396
21464	1	1	1	372	0	375
21465	384	0	2	0	0	386
21466	2	1	0	386	0	389
21467	1	0	389	0	0	390
21468	385	0	2	0	0	387
21469	0	3	0	348	0	351
21470	0	1	1	348	0	350
21471	0	0	0	347	0	347
21472	1	0	0	338	0	339
21473	353	0	3	1	0	357
21474	3	2	0	359	0	364
21475	0	360	0	0	0	360
21476	2	1	0	346	0	349
21477	0	359	0	0	0	359
21478	3	2	0	316	0	321
21479	1	3	0	339	0	343
21480	0	351	0	0	0	351
21481	0	1	0	335	0	336
21482	1	0	0	347	0	348
21483	358	0	5	1	0	364
21484	0	0	369	0	0	369
21485	1	0	0	357	0	358
21486	334	1	1	0	0	336
21487	321	0	4	0	0	325
21488	326	0	2	0	0	328
21489	0	0	317	0	0	317
21490	0	0	347	0	0	347
21491	0	0	0	337	0	337
21492	319	0	1	1	0	321
21493	0	0	334	1	0	335
21494	343	0	3	1	0	347
21495	0	365	0	0	0	365
21496	1	2	1	329	0	333
21497	0	4	2	337	0	343
21498	336	0	1	0	0	337
21499	1	3	0	350	0	354
21500	358	0	0	1	0	359
21501	357	0	2	0	0	359
21502	2	1	0	335	0	338
21503	1	2	0	356	0	359
21504	337	0	1	0	0	338
21505	0	0	352	0	0	352
21506	315	0	1	0	0	316
21507	0	0	344	0	0	344
21508	325	0	1	0	0	326
21509	308	0	6	0	0	314
21510	292	0	1	0	0	293
21511	315	0	0	1	0	316
21512	0	355	0	0	0	355
21513	336	0	1	0	0	337
21514	303	0	1	0	0	304
21515	0	356	0	0	0	356
21516	329	0	3	0	0	332
21517	0	0	350	0	0	350
21518	310	0	0	1	0	311
21519	0	0	352	0	0	352
21520	0	0	0	321	0	321
21521	0	0	0	329	0	329
21522	0	0	351	0	0	351
21523	1	1	0	324	0	326
21524	0	1	0	335	0	336
21525	312	0	1	0	0	313
21526	0	2	0	325	0	327
21527	0	1	0	324	0	325
21528	0	2	0	328	0	330
21529	0	320	0	0	0	320
21530	0	0	0	310	0	310
21531	318	0	1	0	0	319
21532	0	0	324	0	0	324
21533	0	1	0	307	0	308
21534	0	0	296	0	0	296
21535	292	0	2	0	0	294
21536	0	0	0	297	0	297
21537	0	0	302	0	0	302
21538	0	2	0	265	0	267
21539	0	3	0	274	0	277
21540	0	284	0	0	0	284
21541	0	0	0	263	0	263
21542	0	1	0	278	0	279
21543	0	0	296	0	0	296
21544	0	2	0	275	0	277
21545	1	3	0	267	0	271
21546	254	0	1	0	0	255
21547	263	0	1	0	0	264
21548	0	274	0	0	0	274
21549	248	0	5	1	0	254
21550	238	0	1	2	0	241
21551	0	257	0	0	0	257
21552	0	0	0	244	0	244
21553	241	0	0	0	0	241
21554	221	0	2	0	0	223
21555	234	0	0	0	0	234
21556	0	235	0	0	0	235
21557	1	0	233	0	0	234
21558	225	0	1	1	0	227
21559	217	0	0	0	0	217
21560	0	233	0	0	0	233
21561	229	0	0	1	0	230
21562	198	0	0	0	0	198
21563	0	2	0	233	0	235
21564	1	0	238	0	0	239
21565	0	1	0	218	0	219
21566	1	1	0	198	0	200
21567	0	0	0	210	0	210
21568	0	0	229	0	0	229
21569	0	0	0	207	0	207
21570	0	1	0	193	0	194
21571	2	0	0	204	0	206
21572	2	3	0	202	0	207
21573	0	6	0	205	0	211
21574	1	211	0	0	0	212
21575	0	3	0	189	0	192
21576	0	0	0	214	0	214
21577	0	0	245	0	0	245
21578	0	1	0	234	0	235
21579	0	0	0	229	0	229
21580	0	0	0	224	0	224
21581	0	3	0	239	0	242
21582	245	0	0	0	0	245
21583	0	5	0	228	0	233
21584	4	0	0	255	0	259
21585	0	0	265	0	0	265
21586	0	261	0	1	0	262
21587	0	266	0	0	0	266
21588	264	0	1	2	0	267
21589	0	284	0	1	0	285
21590	0	1	0	283	0	284
21591	304	0	1	0	0	305
21592	1	0	317	0	0	318
21593	1	1	0	414	0	416
21594	0	410	0	0	0	410
21595	1	2	0	402	0	405
21596	0	418	0	5	0	423
21597	0	0	0	427	0	427
21598	423	0	6	1	0	430
21599	0	0	438	0	0	438
21600	1	4	0	416	0	421
21601	0	426	0	0	0	426
21602	396	0	2	0	0	398
21603	0	0	418	0	0	418
21604	1	1	0	394	0	396
21605	0	0	419	0	0	419
21606	0	1	0	406	0	407
21607	0	0	417	0	0	417
21608	0	4	0	398	0	402
21609	0	1	0	388	0	389
21610	390	0	0	2	0	392
21611	399	0	2	0	0	401
21612	0	0	0	412	0	412
21613	0	409	0	0	0	409
21614	0	3	0	372	0	375
21615	0	3	0	386	0	389
21616	393	0	0	2	0	395
21617	0	406	0	2	0	408
21618	392	0	0	0	0	392
21619	387	0	2	0	0	389
21620	0	409	0	0	0	409
21621	2	398	0	0	0	400
21622	401	0	3	0	0	404
21623	0	0	391	0	0	391
21624	385	0	0	0	0	385
21625	371	0	2	2	0	375
21626	0	394	0	0	0	394
21627	0	2	0	377	0	379
21628	0	380	0	2	0	382
21629	377	0	1	0	0	378
21630	376	0	3	0	0	379
21631	1	3	0	343	0	347
21632	0	0	0	380	0	380
21633	356	0	1	0	0	357
21634	0	377	0	6	0	383
21635	0	380	0	0	0	380
21636	0	370	0	0	0	370
21637	0	360	0	0	0	360
21638	0	346	0	0	0	346
21639	0	0	0	304	0	304
21640	0	0	302	0	0	302
21641	0	231	2	0	0	233
21642	240	0	0	0	0	240
21643	0	0	1	234	0	235
21644	238	0	0	2	0	240
21645	0	227	0	0	0	227
21646	225	0	2	0	0	227
21647	0	244	0	0	0	244
21648	0	0	1	224	0	225
21649	218	0	1	0	0	219
21650	208	0	0	0	0	208
21651	0	0	0	205	0	205
21652	0	0	0	225	0	225
21653	0	235	0	0	0	235
21654	0	0	0	226	0	226
21655	1	1	0	219	0	221
21656	0	0	0	234	0	234
21657	0	225	0	4	0	229
21658	221	0	6	0	0	227
21659	0	240	0	2	0	242
21660	228	0	0	0	0	228
21661	0	236	0	1	0	237
21662	1	0	235	0	0	236
21663	0	0	0	216	0	216
21664	0	0	215	0	0	215
21665	0	0	209	0	0	209
21666	0	0	0	188	0	188
21667	0	0	211	0	0	211
21668	0	0	0	176	0	176
21669	0	0	0	186	0	186
21670	0	1	0	201	0	202
21671	202	0	0	0	0	202
21672	0	0	0	190	0	190
21673	0	0	0	203	0	203
21674	183	0	0	1	0	184
21675	0	202	0	0	0	202
21676	0	192	0	0	0	192
21677	0	196	0	1	0	197
21678	0	0	0	190	0	190
21679	0	0	189	0	0	189
21680	185	0	1	0	0	186
21681	0	196	0	1	0	197
21682	180	0	2	0	0	182
21683	166	0	0	1	0	167
21684	176	2	1	1	0	180
21685	0	0	184	0	0	184
21686	4	1	1	162	0	168
21687	1	1	0	165	0	167
21688	0	0	0	167	0	167
21689	0	0	0	175	0	175
21690	0	169	0	1	0	170
21691	164	0	0	0	0	164
21692	0	0	173	0	0	173
21693	166	0	0	1	0	167
21694	0	0	0	161	0	161
21695	0	158	0	0	0	158
21696	0	162	0	0	0	162
21697	0	1	0	158	0	159
21698	0	167	0	0	0	167
21699	145	0	2	1	0	148
21700	0	0	168	0	0	168
21701	0	6	0	141	0	147
21702	0	2	0	149	0	151
21703	1	1	0	151	0	153
21704	0	0	0	165	0	165
21705	159	0	0	1	0	160
21706	0	174	0	0	0	174
21707	162	0	1	0	0	163
21708	0	1	0	158	0	159
21709	0	1	0	169	0	170
21710	0	155	0	0	0	155
21711	167	0	1	0	0	168
21712	176	0	0	0	0	176
21713	0	188	0	0	0	188
21714	0	0	1	181	0	182
21715	0	189	0	0	0	189
21716	173	0	0	0	0	173
21717	0	0	176	0	0	176
21718	0	0	179	0	0	179
21719	181	0	0	0	0	181
21720	0	188	0	0	0	188
21721	0	0	0	166	0	166
21722	0	0	0	171	0	171
21723	0	0	181	0	0	181
21724	0	1	0	157	0	158
21725	0	0	0	172	0	172
21726	0	178	0	1	0	179
21727	0	0	0	168	0	168
21728	0	0	0	172	0	172
21729	170	0	0	0	0	170
21730	0	180	0	0	0	180
21731	0	170	0	1	0	171
21732	0	0	0	172	0	172
21733	0	1	0	153	0	154
21734	0	0	0	171	0	171
21735	0	175	0	0	0	175
21736	0	1	1	166	0	168
21737	0	0	0	159	0	159
21738	0	3	0	168	0	171
21739	0	0	0	172	0	172
21740	0	173	0	0	0	173
21741	0	172	0	0	0	172
21742	164	2	1	1	0	168
21743	165	0	0	0	0	165
21744	0	3	0	187	0	190
21745	0	0	202	0	0	202
21746	0	0	1	189	0	190
21747	0	2	0	192	0	194
21748	210	0	0	1	0	211
21749	0	219	0	0	0	219
21750	0	3	0	204	0	207
21751	0	0	0	209	0	209
21752	0	0	218	0	0	218
21753	0	0	237	0	0	237
21754	0	1	0	224	0	225
21755	0	0	0	242	0	242
21756	0	236	0	0	0	236
21757	0	229	0	0	0	229
21758	255	0	0	1	0	256
21759	0	2	0	267	0	269
21760	0	0	266	0	0	266
21761	0	287	0	2	0	289
21762	0	1	0	282	0	283
21763	286	0	0	1	0	287
21764	0	0	0	293	0	293
21765	296	0	0	1	0	297
21766	0	312	0	1	0	313
21767	300	0	0	0	0	300
21768	0	2	0	309	0	311
21769	0	0	300	0	0	300
21770	2	0	0	309	0	311
21771	0	318	0	0	0	318
21772	1	4	0	316	0	321
21773	0	322	0	2	0	324
21774	1	4	0	309	0	314
21775	2	0	315	0	0	317
21776	0	0	304	0	0	304
21777	0	0	321	0	0	321
21778	332	0	0	0	0	332
21779	0	338	0	0	0	338
21780	0	329	0	0	0	329
21781	333	0	1	0	0	334
21782	320	0	0	0	0	320
21783	0	2	0	329	0	331
21784	0	0	339	0	0	339
21785	0	0	349	0	0	349
21786	0	1	0	347	0	348
21787	363	0	2	0	0	365
21788	0	363	0	4	0	367
21789	0	1	0	354	0	355
21790	357	0	0	0	0	357
21791	333	0	2	0	0	335
21792	0	0	348	0	0	348
21793	330	0	1	0	0	331
21794	0	0	334	0	0	334
21795	0	0	334	0	0	334
21796	0	0	2	306	0	308
21797	0	2	0	289	0	291
21798	0	0	0	326	0	326
21799	4	0	339	0	0	343
21800	329	0	1	0	0	330
21801	0	2	0	319	0	321
21802	310	1	0	0	0	311
21803	321	0	0	0	0	321
21804	0	330	0	1	0	331
21805	0	310	0	0	0	310
21806	1	321	0	2	0	324
21807	0	1	0	303	0	304
21808	1	0	327	0	0	328
21809	0	0	0	325	0	325
21810	0	324	0	0	0	324
21811	0	318	0	2	0	320
21812	6	1	0	312	0	319
21813	309	0	2	0	0	311
21814	0	332	0	0	0	332
21815	0	303	3	0	0	306
21816	311	0	1	0	0	312
21817	0	1	0	274	0	275
21818	0	1	0	267	0	268
21819	0	0	0	268	0	268
21820	259	0	0	0	0	259
21821	252	0	0	0	0	252
21822	0	0	0	258	0	258
21823	0	0	267	0	0	267
21824	257	0	1	0	0	258
21825	0	3	0	230	0	233
21826	0	0	225	0	0	225
21827	0	0	241	0	0	241
21828	0	0	0	226	0	226
21829	0	0	231	0	0	231
21830	0	0	1	212	0	213
21831	0	2	0	198	0	200
21832	0	0	0	220	0	220
21833	211	0	0	0	0	211
21834	0	2	0	206	0	208
21835	0	1	0	204	0	205
21836	0	2	0	200	0	202
21837	0	1	0	210	0	211
21838	0	0	214	0	0	214
21839	0	217	0	0	0	217
21840	0	0	0	205	0	205
21841	0	1	0	207	0	208
21842	0	216	0	0	0	216
21843	0	206	0	5	0	211
21844	212	0	2	0	0	214
21845	0	227	0	0	0	227
21846	0	0	0	214	0	214
21847	1	0	227	0	0	228
21848	218	0	2	0	0	220
21849	0	0	205	0	0	205
21850	207	0	3	1	0	211
21851	202	0	0	0	0	202
21852	0	0	240	0	0	240
21853	0	0	0	228	0	228
21854	0	231	0	0	0	231
21855	0	1	0	209	0	210
21856	236	0	1	0	0	237
21857	222	0	3	0	0	225
21858	0	240	0	0	0	240
21859	233	0	0	0	0	233
21860	0	0	0	238	0	238
21861	219	0	0	0	0	219
21862	219	0	0	0	0	219
21863	0	2	0	222	0	224
21864	219	0	0	0	0	219
21865	214	0	0	0	0	214
21866	0	0	236	0	0	236
21867	221	0	0	0	0	221
21868	0	0	226	0	0	226
21869	2	0	229	0	0	231
21870	0	231	0	0	0	231
21871	0	0	0	222	0	222
21872	0	0	215	0	0	215
21873	0	0	225	0	0	225
21874	229	0	0	0	0	229
21875	0	0	0	220	0	220
21876	1	0	0	214	0	215
21877	0	2	0	225	0	227
21878	0	0	0	224	0	224
21879	0	1	1	231	0	233
21880	0	0	235	1	0	236
21881	1	0	238	0	0	239
21882	0	0	0	236	0	236
21883	232	0	1	0	0	233
21884	0	241	0	0	0	241
21885	0	0	0	241	0	241
21886	250	0	0	0	0	250
21887	0	250	0	0	0	250
21888	0	1	0	239	0	240
21889	0	1	0	241	0	242
21890	0	1	0	248	0	249
21891	246	0	0	0	0	246
21892	0	0	246	0	0	246
21893	249	0	0	0	0	249
21894	0	0	0	256	0	256
21895	0	0	0	248	0	248
21896	0	243	0	0	0	243
21897	0	0	243	0	0	243
21898	235	0	1	0	0	236
21899	227	0	3	0	0	230
21900	0	0	248	0	0	248
21901	249	0	0	0	0	249
21902	0	259	0	1	0	260
21903	0	241	0	0	0	241
21904	0	249	0	0	0	249
21905	240	0	0	0	0	240
21906	0	0	263	0	0	263
21907	0	0	0	251	0	251
21908	0	253	0	0	0	253
21909	0	244	0	0	0	244
21910	0	237	0	2	0	239
21911	0	0	0	252	0	252
21912	255	0	0	0	0	255
21913	0	259	0	0	0	259
21914	0	1	0	253	0	254
21915	0	0	0	236	0	236
21916	232	0	1	0	0	233
21917	0	3	0	217	0	220
21918	0	0	0	242	0	242
21919	0	0	244	0	0	244
21920	0	0	0	239	0	239
21921	0	0	0	224	0	224
21922	233	0	0	0	0	233
21923	219	0	0	0	0	219
21924	0	0	0	242	0	242
21925	233	0	0	0	0	233
21926	231	0	1	0	0	232
21927	0	230	0	0	0	230
21928	2	0	223	0	0	225
21929	0	241	0	1	0	242
21930	0	0	0	238	0	238
21931	245	0	0	0	0	245
21932	0	248	0	0	0	248
21933	0	1	0	237	0	238
21934	238	0	1	0	0	239
21935	218	0	0	0	0	218
21936	0	0	0	229	0	229
21937	0	0	233	0	0	233
21938	0	0	0	208	0	208
21939	0	2	0	220	0	222
21940	0	0	231	0	0	231
21941	0	0	0	215	0	215
21942	0	0	0	219	0	219
21943	224	0	0	0	0	224
21944	0	0	0	215	0	215
21945	0	1	0	221	0	222
21946	211	0	2	0	0	213
21947	216	0	0	0	0	216
21948	210	0	2	0	0	212
21949	0	0	224	0	0	224
21950	0	0	0	207	0	207
21951	0	201	0	1	0	202
21952	0	0	0	186	0	186
21953	1	0	200	0	0	201
21954	0	0	0	200	0	200
21955	0	0	191	0	0	191
21956	197	0	1	0	0	198
21957	174	0	0	0	0	174
21958	3	0	0	176	0	179
21959	0	2	0	176	0	178
21960	0	0	0	187	0	187
21961	0	189	0	0	0	189
21962	185	0	0	0	0	185
21963	179	0	0	0	0	179
21964	0	2	0	162	0	164
21965	0	0	0	173	0	173
21966	0	0	0	161	0	161
21967	0	1	0	173	0	174
21968	0	0	176	0	0	176
21969	1	0	0	178	0	179
21970	171	0	0	0	0	171
21971	158	0	0	0	0	158
21972	0	0	0	174	0	174
21973	0	0	174	0	0	174
21974	170	0	0	0	0	170
21975	0	1	0	174	0	175
21976	0	163	0	0	0	163
21977	0	169	0	0	0	169
21978	167	0	0	1	0	168
21979	0	0	0	159	0	159
21980	0	0	0	154	0	154
21981	0	0	0	164	0	164
21982	1	0	0	169	0	170
21983	0	0	0	173	0	173
21984	1	0	166	0	0	167
21985	0	0	169	0	0	169
21986	0	0	175	0	0	175
21987	0	0	0	166	0	166
21988	0	0	172	0	0	172
21989	0	1	0	162	0	163
21990	0	1	0	156	0	157
21991	0	0	0	164	0	164
21992	164	0	0	0	0	164
21993	0	2	0	149	0	151
21994	1	0	0	163	0	164
21995	158	0	0	0	0	158
21996	0	166	0	0	0	166
21997	0	158	0	0	0	158
21998	163	0	1	0	0	164
21999	0	165	0	0	0	165
22000	160	0	0	0	0	160
22001	156	0	0	0	0	156
22002	159	0	0	0	0	159
22003	154	0	1	0	0	155
22004	157	0	0	0	0	157
22005	0	172	0	0	0	172
22006	165	0	0	0	0	165
22007	156	0	1	0	0	157
22008	0	168	0	1	0	169
22009	165	0	1	0	0	166
22010	159	0	0	0	0	159
22011	144	0	0	0	0	144
22012	156	0	0	0	0	156
22013	0	0	165	0	0	165
22014	0	0	0	156	0	156
22015	0	0	0	150	0	150
22016	0	0	145	0	0	145
22017	0	0	147	0	0	147
22018	154	0	0	0	0	154
22019	1	0	0	153	0	154
22020	0	0	153	0	0	153
22021	0	0	154	0	0	154
22022	155	0	0	0	0	155
22023	143	0	1	0	0	144
22024	151	0	3	0	0	154
22025	1	0	158	0	0	159
22026	0	1	0	149	0	150
22027	3	0	154	0	0	157
22028	151	0	0	1	0	152
22029	2	0	154	0	0	156
22030	0	0	0	141	0	141
22031	0	1	0	154	0	155
22032	0	152	0	0	0	152
22033	152	0	0	0	0	152
22034	0	0	154	0	0	154
22035	149	0	1	0	0	150
22036	0	0	160	0	0	160
22037	0	0	0	151	0	151
22038	0	1	0	156	0	157
22039	0	3	0	149	0	152
22040	150	0	1	0	0	151
22041	0	0	0	147	0	147
22042	0	0	0	160	0	160
22043	0	148	0	0	0	148
22044	0	1	0	142	0	143
22045	141	0	0	0	0	141
22046	1	0	140	0	0	141
22047	1	0	0	139	0	140
22048	0	0	141	0	0	141
22049	0	135	0	0	0	135
22050	0	0	131	0	0	131
22051	140	0	0	0	0	140
22052	128	0	0	0	0	128
22053	0	0	0	129	0	129
22054	135	0	0	0	0	135
22055	117	0	2	0	0	119
22056	0	0	0	129	0	129
22057	0	2	0	130	0	132
22058	0	0	131	0	0	131
22059	0	132	0	0	0	132
22060	128	0	0	2	0	130
22061	0	120	0	0	0	120
22062	0	0	0	119	0	119
22063	0	0	0	115	0	115
22064	0	0	0	123	0	123
22065	0	0	0	122	0	122
22066	0	0	121	0	0	121
22067	122	0	0	0	0	122
22068	110	0	2	0	0	112
22069	0	0	0	115	0	115
22070	107	0	0	0	0	107
22071	0	2	0	107	0	109
22072	0	0	110	0	0	110
22073	0	0	0	107	0	107
22074	0	106	0	0	0	106
22075	0	1	0	103	0	104
22076	0	104	0	0	0	104
22077	0	0	0	96	0	96
22078	0	105	0	0	0	105
22079	102	0	0	0	0	102
22080	0	0	101	0	0	101
22081	0	97	0	0	0	97
22082	0	94	0	0	0	94
22083	1	0	0	88	0	89
22084	3	0	0	91	0	94
22085	1	1	0	86	0	88
22086	0	1	0	108	0	109
22087	0	120	0	0	0	120
22088	0	2	0	102	0	104
22089	0	0	0	105	0	105
22090	101	0	0	0	0	101
22091	0	1	0	102	0	103
22092	0	0	107	0	0	107
22093	0	0	111	0	0	111
22094	103	0	0	0	0	103
22095	0	109	0	0	0	109
22096	0	103	0	0	0	103
22097	0	1	0	97	0	98
22098	0	0	0	99	0	99
22099	0	0	102	0	0	102
22100	105	0	0	0	0	105
22101	102	0	0	0	0	102
22102	0	0	105	0	0	105
22103	0	0	110	0	0	110
22104	106	0	2	0	0	108
22105	110	0	0	0	0	110
22106	105	1	0	0	0	106
22107	104	0	1	0	0	105
22108	0	117	0	0	0	117
22109	108	0	0	0	0	108
22110	0	0	109	0	0	109
22111	0	0	105	0	0	105
22112	1	0	112	0	0	113
22113	0	0	0	102	0	102
22114	111	0	1	0	0	112
22115	101	0	0	0	0	101
22116	1	1	0	99	0	101
22117	1	0	0	100	0	101
22118	0	1	0	110	0	111
22119	0	105	0	1	0	106
22120	108	0	0	0	0	108
22121	94	0	0	0	0	94
22122	103	0	0	0	0	103
22123	107	0	0	0	0	107
22124	110	0	0	0	0	110
22125	0	0	0	120	0	120
22126	0	129	0	0	0	129
22127	0	0	0	120	0	120
22128	0	1	1	121	0	123
22129	124	0	1	0	0	125
22130	0	0	131	1	0	132
22131	0	0	132	0	0	132
22132	1	0	136	0	0	137
22133	141	0	0	0	0	141
22134	124	0	2	0	0	126
22135	0	0	0	132	0	132
22136	0	1	0	125	0	126
22137	0	1	0	138	0	139
22138	0	0	151	0	0	151
22139	0	0	0	144	0	144
22140	0	0	155	0	0	155
22141	0	2	0	145	0	147
22142	0	3	0	136	0	139
22143	0	0	0	142	0	142
22144	151	0	1	1	0	153
22145	151	0	0	0	0	151
22146	0	0	159	0	0	159
22147	157	0	2	0	0	159
22148	148	0	1	0	0	149
22149	0	0	0	156	0	156
22150	158	0	1	0	0	159
22151	0	0	0	159	0	159
22152	0	0	0	157	0	157
22153	0	0	159	0	0	159
22154	159	0	0	0	0	159
22155	0	0	1	148	0	149
22156	0	0	155	0	0	155
22157	0	0	154	0	0	154
22158	0	1	0	142	0	143
22159	0	0	0	146	0	146
22160	146	0	0	0	0	146
22161	0	2	0	147	0	149
22162	0	1	0	149	0	150
22163	0	2	0	150	0	152
22164	0	0	0	146	0	146
22165	147	0	1	1	0	149
22166	146	0	0	0	0	146
22167	167	0	1	0	0	168
22168	180	0	2	0	0	182
22169	0	2	0	177	0	179
22170	186	0	0	0	0	186
22171	0	0	0	191	0	191
22172	218	0	1	1	0	220
22173	0	0	0	227	0	227
22174	0	2	0	241	0	243
22175	0	245	0	0	0	245
22176	0	3	0	237	0	240
22177	230	0	1	0	0	231
22178	227	0	1	0	0	228
22179	0	0	262	0	0	262
22180	0	265	0	0	0	265
22181	250	0	0	0	0	250
22182	0	270	0	1	0	271
22183	263	0	2	1	0	266
22184	0	278	0	0	0	278
22185	0	0	271	0	0	271
22186	0	325	0	0	0	325
22187	0	330	0	0	0	330
22188	0	0	0	354	0	354
22189	379	0	1	0	0	380
22190	1	0	0	354	0	355
22191	0	0	0	393	0	393
22192	394	0	6	0	0	400
22193	380	0	2	2	0	384
22194	0	1	0	389	0	390
22195	0	0	0	384	0	384
22196	0	2	0	410	0	412
22197	398	0	1	0	0	399
22198	0	0	416	0	0	416
22199	0	1	0	408	0	409
22200	0	0	411	0	0	411
22201	0	411	0	0	0	411
22202	0	0	404	0	0	404
22203	0	0	0	418	0	418
22204	1	0	399	0	0	400
22205	425	0	2	0	0	427
22206	0	0	0	415	0	415
22207	2	416	0	0	0	418
22208	0	1	0	425	0	426
22209	0	401	0	0	0	401
22210	0	427	0	0	0	427
22211	0	434	3	0	0	437
22212	0	1	0	429	0	430
22213	0	441	0	0	0	441
22214	410	0	2	0	0	412
22215	0	0	417	2	0	419
22216	0	0	424	0	0	424
22217	4	0	437	0	0	441
22218	0	0	0	422	0	422
22219	0	3	0	393	0	396
22220	1	3	0	402	0	406
22221	0	0	0	417	0	417
22222	2	0	0	431	0	433
22223	0	431	0	0	0	431
22224	0	0	394	0	0	394
22225	0	0	435	0	0	435
22226	0	443	0	2	0	445
22227	0	3	0	429	0	432
22228	0	0	0	415	0	415
22229	0	0	0	433	0	433
22230	425	0	2	0	0	427
22231	0	0	447	0	0	447
22232	437	0	0	0	0	437
22233	433	0	0	1	0	434
22234	0	457	0	0	0	457
22235	0	444	0	0	0	444
22236	446	0	0	2	0	448
22237	0	2	0	410	0	412
22238	2	2	0	432	0	436
22239	0	0	439	0	0	439
22240	1	0	439	0	0	440
22241	0	0	0	436	0	436
22242	435	0	2	0	0	437
22243	0	0	439	0	0	439
22244	434	0	4	0	0	438
22245	0	1	0	415	0	416
22246	0	0	0	406	0	406
22247	0	3	0	425	0	428
22248	1	0	413	0	0	414
22249	0	429	0	0	0	429
22250	0	431	0	0	0	431
22251	423	0	2	0	0	425
22252	412	0	0	0	0	412
22253	0	0	0	412	0	412
22254	425	0	0	0	0	425
22255	0	0	416	0	0	416
22256	2	0	422	0	0	424
22257	0	0	0	423	0	423
22258	416	0	0	0	0	416
22259	0	0	0	395	0	395
22260	2	0	0	397	0	399
22261	380	0	0	0	0	380
22262	404	0	1	0	0	405
22263	0	415	1	0	0	416
22264	371	0	0	0	0	371
22265	0	4	0	318	0	322
22266	0	311	0	4	0	315
22267	324	0	2	0	0	326
22268	0	330	0	0	0	330
22269	0	0	0	321	0	321
22270	310	0	1	0	0	311
22271	0	1	316	0	0	317
22272	2	0	305	0	0	307
22273	1	1	0	283	0	285
22274	0	0	0	254	0	254
22275	0	1	0	270	0	271
22276	0	273	0	0	0	273
22277	255	0	5	1	0	261
22278	246	0	1	0	0	247
22279	252	2	1	0	0	255
22280	0	262	0	0	0	262
22281	0	1	0	236	0	237
22282	0	1	0	224	0	225
22283	0	0	0	242	0	242
22284	235	0	0	0	0	235
22285	0	247	0	0	0	247
22286	0	5	0	212	0	217
22287	1	3	0	216	0	220
22288	0	0	214	4	0	218
22289	0	221	0	0	0	221
22290	2	6	0	182	0	190
22291	1	8	0	176	0	185
22292	0	0	0	192	0	192
22293	205	0	0	1	0	206
22294	0	219	0	0	0	219
22295	201	0	5	1	0	207
22296	0	1	0	203	0	204
22297	196	0	0	0	0	196
22298	0	0	204	0	0	204
22299	200	0	2	0	0	202
22300	202	2	0	0	0	204
22301	0	0	216	0	0	216
22302	0	0	1	198	0	199
22303	0	2	0	194	0	196
22304	206	0	0	0	0	206
22305	0	2	0	200	0	202
22306	0	1	0	197	0	198
22307	0	0	0	209	0	209
22308	0	0	209	0	0	209
22309	204	0	1	1	0	206
22310	0	222	0	0	0	222
22311	0	0	0	210	0	210
22312	0	214	0	0	0	214
22313	0	209	0	0	0	209
22314	0	1	0	202	0	203
22315	1	0	213	0	0	214
22316	0	0	211	0	0	211
22317	1	0	0	213	0	214
22318	0	0	219	0	0	219
22319	205	0	0	0	0	205
22320	0	0	0	180	0	180
22321	0	1	0	200	0	201
22322	0	194	0	0	0	194
22323	0	1	0	179	0	180
22324	0	2	0	185	0	187
22325	0	200	0	0	0	200
22326	0	0	0	165	0	165
22327	0	0	0	192	0	192
22328	0	190	0	0	0	190
22329	177	0	1	0	0	178
22330	1	0	186	0	0	187
22331	0	0	188	0	0	188
22332	0	0	0	177	0	177
22333	1	1	0	175	0	177
22334	2	0	170	0	0	172
22335	0	0	175	0	0	175
22336	169	0	0	0	0	169
22337	0	176	0	1	0	177
22338	162	0	1	0	0	163
22339	2	0	160	0	0	162
22340	0	155	0	0	0	155
22341	1	0	0	144	0	145
22342	0	0	147	0	0	147
22343	0	0	154	0	0	154
22344	0	0	0	148	0	148
22345	0	0	154	0	0	154
22346	0	149	0	0	0	149
22347	0	0	0	132	0	132
22348	0	0	149	0	0	149
22349	0	144	0	0	0	144
22350	145	0	0	0	0	145
22351	0	0	153	0	0	153
22352	0	150	0	0	0	150
22353	1	0	0	140	0	141
22354	1	1	0	131	0	133
22355	154	0	2	0	0	156
22356	0	0	0	126	0	126
22357	1	0	0	152	0	153
22358	139	0	0	0	0	139
22359	0	0	0	140	0	140
22360	0	0	149	0	0	149
22361	0	0	0	138	0	138
22362	0	0	131	1	0	132
22363	0	0	127	0	0	127
22364	0	0	137	0	0	137
22365	2	1	0	111	0	114
22366	0	0	0	127	0	127
22367	128	0	1	1	0	130
22368	0	0	0	138	0	138
22369	0	144	0	0	0	144
22370	0	0	0	136	0	136
22371	0	1	0	139	0	140
22372	0	138	0	0	0	138
22373	132	0	0	0	0	132
22374	126	0	1	1	0	128
22375	0	146	0	0	0	146
22376	0	136	0	0	0	136
22377	1	0	0	135	0	136
22378	133	0	2	0	0	135
22379	1	0	129	0	0	130
22380	0	0	145	0	0	145
22381	135	0	1	0	0	136
22382	0	137	1	1	0	139
22383	0	2	0	116	0	118
22384	0	0	0	109	0	109
22385	0	0	0	110	0	110
22386	0	1	0	120	0	121
22387	0	116	0	0	0	116
22388	0	0	0	125	0	125
22389	119	0	1	0	0	120
22390	0	1	0	108	0	109
22391	0	0	0	112	0	112
22392	119	0	0	0	0	119
22393	122	0	0	0	0	122
22394	121	0	0	0	0	121
22395	114	0	0	0	0	114
22396	0	0	0	112	0	112
22397	125	0	0	0	0	125
22398	0	0	0	120	0	120
22399	111	0	0	0	0	111
22400	106	0	0	0	0	106
22401	0	0	0	117	0	117
22402	0	0	123	0	0	123
22403	115	0	0	0	0	115
22404	119	0	1	0	0	120
22405	111	0	0	0	0	111
22406	108	0	0	0	0	108
22407	1	0	0	117	0	118
22408	0	0	120	0	0	120
22409	0	0	116	0	0	116
22410	116	0	0	0	0	116
22411	107	0	3	0	0	110
22412	0	131	0	0	0	131
22413	0	127	0	0	0	127
22414	129	0	0	0	0	129
22415	1	0	0	118	0	119
22416	0	1	0	131	0	132
22417	133	0	0	0	0	133
22418	0	137	0	0	0	137
22419	128	0	1	1	0	130
22420	0	0	138	0	0	138
22421	124	0	0	0	0	124
22422	0	2	0	135	0	137
22423	0	1	178	0	0	179
22424	0	191	0	0	0	191
22425	0	0	0	169	0	169
22426	0	0	194	0	0	194
22427	0	0	1	176	0	177
22428	200	0	0	1	0	201
22429	0	0	199	0	0	199
22430	189	0	0	0	0	189
22431	0	198	1	1	0	200
22432	0	1	0	167	0	168
22433	0	0	187	0	0	187
22434	0	0	0	171	0	171
22435	0	0	178	0	0	178
22436	0	189	0	0	0	189
22437	181	0	0	0	0	181
22438	0	192	0	0	0	192
22439	0	0	0	179	0	179
22440	0	1	0	181	0	182
22441	0	0	162	0	0	162
22442	182	0	2	0	0	184
22443	0	185	0	0	0	185
22444	0	164	0	3	0	167
22445	0	175	0	0	0	175
22446	0	1	0	175	0	176
22447	0	183	0	0	0	183
22448	0	1	0	180	0	181
22449	0	195	0	1	0	196
22450	0	4	0	184	0	188
22451	0	205	0	0	0	205
22452	194	0	1	0	0	195
22453	0	0	209	0	0	209
22454	200	0	0	1	0	201
22455	181	0	1	0	0	182
22456	198	0	1	1	0	200
22457	0	217	0	0	0	217
22458	201	0	0	0	0	201
22459	190	0	0	0	0	190
22460	190	0	0	0	0	190
22461	0	0	218	0	0	218
22462	0	1	0	207	0	208
22463	0	0	213	0	0	213
22464	0	0	0	210	0	210
22465	215	0	0	0	0	215
22466	0	214	0	0	0	214
22467	0	0	210	0	0	210
22468	0	1	0	207	0	208
22469	0	0	0	205	0	205
22470	0	0	200	0	0	200
22471	200	0	2	2	0	204
22472	189	0	2	1	0	192
22473	209	0	2	0	0	211
22474	0	1	0	220	0	221
22475	0	217	0	0	0	217
22476	0	217	0	0	0	217
22477	0	1	2	194	0	197
22478	0	0	0	205	0	205
22479	0	197	0	0	0	197
22480	216	0	0	0	0	216
22481	0	226	0	0	0	226
22482	0	0	0	214	0	214
22483	0	0	230	0	0	230
22484	0	0	0	229	0	229
22485	232	0	0	0	0	232
22486	0	0	230	0	0	230
22487	218	0	1	0	0	219
22488	224	0	1	1	0	226
22489	214	1	0	0	0	215
22490	190	0	0	0	0	190
22491	212	0	0	0	0	212
22492	0	0	212	0	0	212
22493	0	0	208	0	0	208
22494	203	0	0	0	0	203
22495	186	0	0	0	0	186
22496	0	1	0	204	0	205
22497	0	211	0	0	0	211
22498	0	1	0	206	0	207
22499	205	0	0	0	0	205
22500	1	1	0	186	0	188
22501	0	208	0	0	0	208
22502	195	0	0	1	0	196
22503	198	0	0	0	0	198
22504	196	0	1	1	0	198
22505	0	216	0	0	0	216
22506	0	0	0	195	0	195
22507	0	0	0	192	0	192
22508	0	201	0	0	0	201
22509	0	0	0	201	0	201
22510	175	0	1	0	0	176
22511	191	0	3	1	0	195
22512	0	204	0	0	0	204
22513	0	2	0	188	0	190
22514	1	3	0	169	0	173
22515	0	0	0	194	0	194
22516	190	0	1	0	0	191
22517	0	0	194	0	0	194
22518	190	0	0	0	0	190
22519	0	0	203	0	0	203
22520	0	1	0	196	0	197
22521	0	195	0	0	0	195
22522	0	181	0	0	0	181
22523	193	0	0	0	0	193
22524	189	0	2	0	0	191
22525	0	198	0	0	0	198
22526	0	194	0	0	0	194
22527	185	0	0	0	0	185
22528	175	0	1	0	0	176
22529	0	206	0	0	0	206
22530	182	0	1	0	0	183
22531	0	1	197	0	0	198
22532	183	0	0	0	0	183
22533	176	0	2	0	0	178
22534	0	0	0	196	0	196
22535	0	202	0	0	0	202
22536	1	1	0	195	0	197
22537	187	0	0	0	0	187
22538	0	0	0	179	0	179
22539	0	1	0	194	0	195
22540	0	0	203	0	0	203
22541	0	0	0	173	0	173
22542	0	0	0	183	0	183
22543	185	0	0	0	0	185
22544	0	0	192	0	0	192
22545	195	0	0	0	0	195
22546	0	1	0	184	0	185
22547	0	0	0	187	0	187
22548	0	0	0	216	0	216
22549	0	186	0	0	0	186
22550	0	212	0	0	0	212
22551	1	1	0	195	0	197
22552	200	0	1	1	0	202
22553	199	0	0	0	0	199
22554	0	0	0	220	0	220
22555	229	0	0	3	0	232
22556	1	1	0	230	0	232
22557	0	0	0	249	0	249
22558	234	0	1	0	0	235
22559	0	255	1	0	0	256
22560	252	0	2	1	0	255
22561	234	0	0	2	0	236
22562	233	0	3	0	0	236
22563	0	267	0	0	0	267
22564	0	0	0	248	0	248
22565	0	0	0	262	0	262
22566	2	0	275	0	0	277
22567	0	1	0	264	0	265
22568	0	0	268	0	0	268
22569	0	262	0	2	0	264
22570	0	256	0	0	0	256
22571	0	266	0	0	0	266
22572	0	0	0	249	0	249
22573	0	0	0	245	0	245
22574	0	0	0	240	0	240
22575	0	0	0	252	0	252
22576	0	0	248	0	0	248
22577	0	0	258	0	0	258
22578	0	0	1	251	0	252
22579	0	0	236	0	0	236
22580	247	0	0	0	0	247
22581	235	0	0	0	0	235
22582	0	0	265	0	0	265
22583	0	1	0	251	0	252
22584	0	0	0	243	0	243
22585	0	0	0	248	0	248
22586	0	0	0	251	0	251
22587	1	3	0	233	0	237
22588	247	0	0	0	0	247
22589	243	0	1	0	0	244
22590	0	260	0	0	0	260
22591	0	0	266	0	0	266
22592	0	263	0	0	0	263
22593	0	265	0	0	0	265
22594	262	0	0	0	0	262
22595	0	268	0	0	0	268
22596	0	268	0	0	0	268
22597	260	0	0	0	0	260
22598	1	1	240	0	0	242
22599	269	0	3	0	0	272
22600	0	0	0	261	0	261
22601	1	5	0	238	0	244
22602	0	2	0	253	0	255
22603	1	0	261	0	0	262
22604	0	250	0	0	0	250
22605	245	0	0	0	0	245
22606	0	0	0	251	0	251
22607	0	250	0	0	0	250
22608	0	3	0	245	0	248
22609	0	0	262	0	0	262
22610	0	0	0	239	0	239
22611	0	2	0	238	0	240
22612	1	3	0	235	0	239
22613	236	0	0	0	0	236
22614	0	2	0	252	0	254
22615	0	0	258	0	0	258
22616	0	252	0	0	0	252
22617	0	1	0	231	0	232
22618	2	0	0	225	0	227
22619	0	0	234	0	0	234
22620	0	0	219	0	0	219
22621	223	0	0	0	0	223
22622	206	0	2	1	0	209
22623	0	240	0	0	0	240
22624	218	0	0	0	0	218
22625	0	0	219	0	0	219
22626	2	0	196	0	0	198
22627	215	0	0	0	0	215
22628	194	0	3	0	0	197
22629	0	0	221	0	0	221
22630	195	0	0	1	0	196
22631	0	0	215	0	0	215
22632	194	0	2	1	0	197
22633	183	0	2	0	0	185
22634	1	0	0	201	0	202
22635	0	205	0	0	0	205
22636	189	0	1	1	0	191
22637	0	1	208	1	0	210
22638	0	208	0	1	0	209
22639	191	0	0	2	0	193
22640	174	0	0	0	0	174
22641	0	209	0	0	0	209
22642	1	1	0	200	0	202
22643	0	0	218	0	0	218
22644	3	0	0	201	0	204
22645	0	1	218	0	0	219
22646	0	2	0	188	0	190
22647	0	1	0	197	0	198
22648	1	0	213	0	0	214
22649	0	212	0	1	0	213
22650	1	0	0	198	0	199
22651	0	0	201	0	0	201
22652	211	0	0	0	0	211
22653	0	0	0	199	0	199
22654	0	1	0	205	0	206
22655	207	0	1	0	0	208
22656	1	0	0	206	0	207
22657	0	1	0	194	0	195
22658	0	208	0	0	0	208
22659	0	0	0	202	0	202
22660	0	0	232	0	0	232
22661	0	0	0	216	0	216
22662	0	224	0	2	0	226
22663	0	228	0	1	0	229
22664	0	2	0	218	0	220
22665	225	1	2	0	0	228
22666	0	3	0	227	0	230
22667	224	0	2	0	0	226
22668	0	0	0	227	0	227
22669	186	1	0	0	0	187
22670	176	0	1	0	0	177
22671	0	0	0	182	0	182
22672	0	0	0	193	0	193
22673	0	182	0	1	0	183
22674	0	165	0	0	0	165
22675	0	0	181	0	0	181
22676	0	177	0	1	0	178
22677	183	0	1	0	0	184
22678	0	0	0	189	0	189
22679	0	187	0	0	0	187
22680	196	0	0	0	0	196
22681	0	0	0	174	0	174
22682	3	0	0	170	0	173
22683	0	0	0	187	0	187
22684	0	0	0	186	0	186
22685	0	180	0	0	0	180
22686	0	179	0	0	0	179
22687	183	0	2	0	0	185
22688	0	192	0	1	0	193
22689	0	0	0	183	0	183
22690	2	2	0	170	0	174
22691	0	1	0	170	0	171
22692	0	1	0	172	0	173
22693	182	0	0	0	0	182
22694	173	0	0	0	0	173
22695	0	0	196	0	0	196
22696	1	0	0	193	0	194
22697	1	0	192	0	0	193
22698	0	2	0	185	0	187
22699	0	2	0	171	0	173
22700	171	0	0	0	0	171
22701	1	0	0	178	0	179
22702	0	0	183	0	0	183
22703	0	0	176	0	0	176
22704	167	0	1	1	0	169
22705	0	0	182	1	0	183
22706	0	0	0	156	0	156
22707	0	0	164	0	0	164
22708	1	0	0	155	0	156
22709	0	164	0	0	0	164
22710	0	0	0	151	0	151
22711	0	156	0	0	0	156
22712	0	155	0	0	0	155
22713	0	0	0	151	0	151
22714	148	0	0	0	0	148
22715	0	151	0	1	0	152
22716	0	1	0	136	0	137
22717	131	0	0	0	0	131
22718	124	0	0	0	0	124
22719	123	0	0	0	0	123
22720	2	2	3	121	0	128
22721	5	0	0	117	0	122
22722	115	0	1	0	0	116
22723	111	0	0	0	0	111
22724	106	0	0	0	0	106
22725	2	3	0	112	0	117
22726	0	0	112	0	0	112
22727	111	0	2	0	0	113
22728	0	1	0	109	0	110
22729	13	92	0	0	0	105
22730	0	0	0	103	0	103
22731	0	126	0	0	0	126
22732	0	0	0	118	0	118
22733	0	0	132	0	0	132
22734	0	135	0	0	0	135
22735	0	5	0	114	0	119
22736	0	1	0	113	0	114
22737	0	0	0	128	0	128
22738	133	0	0	0	0	133
22739	0	144	0	0	0	144
22740	0	1	0	138	0	139
22741	129	0	3	0	0	132
22742	130	0	0	0	0	130
22743	0	0	0	145	0	145
22744	0	0	152	0	0	152
22745	0	0	0	159	0	159
22746	0	158	0	0	0	158
22747	0	2	0	158	0	160
22748	157	0	1	0	0	158
22749	0	0	0	157	0	157
22750	1	0	167	0	0	168
22751	0	161	0	0	0	161
22752	153	0	0	0	0	153
22753	0	0	159	0	0	159
22754	160	0	0	1	0	161
22755	0	0	0	148	0	148
22756	0	0	0	162	0	162
22757	0	167	0	0	0	167
22758	161	0	0	0	0	161
22759	0	0	0	149	0	149
22760	0	0	0	147	0	147
22761	0	0	0	162	0	162
22762	0	0	167	0	0	167
22763	0	0	0	154	0	154
22764	174	0	0	0	0	174
22765	157	0	1	0	0	158
22766	0	0	0	159	0	159
22767	1	0	0	171	0	172
22768	161	0	0	0	0	161
22769	0	0	169	0	0	169
22770	168	0	0	0	0	168
22771	0	0	162	0	0	162
22772	0	0	167	0	0	167
22773	0	0	0	158	0	158
22774	1	0	158	0	0	159
22775	161	0	1	0	0	162
22776	0	0	0	161	0	161
22777	0	0	164	0	0	164
22778	161	0	2	0	0	163
22779	165	0	0	0	0	165
22780	0	0	171	0	0	171
22781	0	1	0	167	0	168
22782	0	168	0	0	0	168
22783	165	0	2	0	0	167
22784	0	0	166	0	0	166
22785	163	0	2	0	0	165
22786	0	168	0	0	0	168
22787	164	0	0	0	0	164
22788	161	0	0	0	0	161
22789	161	0	0	0	0	161
22790	0	0	0	167	0	167
22791	0	161	0	0	0	161
22792	0	0	164	0	0	164
22793	0	173	0	0	0	173
22794	0	0	0	163	0	163
22795	2	166	0	0	0	168
22796	0	169	0	1	0	170
22797	161	0	0	0	0	161
22798	0	0	171	0	0	171
22799	0	0	163	0	0	163
22800	0	0	175	0	0	175
22801	0	173	0	0	0	173
22802	151	0	0	2	0	153
22803	143	0	2	0	0	145
22804	146	0	0	0	0	146
22805	0	146	0	0	0	146
22806	0	1	0	142	0	143
22807	0	0	144	0	0	144
22808	1	0	139	0	0	140
22809	150	0	0	0	0	150
22810	145	0	0	0	0	145
22811	126	0	0	0	0	126
22812	0	0	133	0	0	133
22813	133	0	2	0	0	135
22814	0	0	0	116	0	116
22815	0	0	0	116	0	116
22816	1	0	115	0	0	116
22817	0	114	0	0	0	114
22818	0	1	0	108	0	109
22819	0	0	113	0	0	113
22820	112	0	0	0	0	112
22821	0	2	0	95	0	97
22822	0	0	0	102	0	102
22823	102	0	0	0	0	102
22824	1	0	0	103	0	104
22825	106	0	0	0	0	106
22826	102	0	0	0	0	102
22827	0	0	0	96	0	96
22828	0	2	0	75	0	77
22829	77	0	0	0	0	77
22830	0	0	0	70	0	70
22831	75	0	0	0	0	75
22832	72	0	0	1	0	73
22833	71	0	0	0	0	71
22834	0	1	0	67	0	68
22835	0	1	0	76	0	77
22836	77	0	0	0	0	77
22837	0	74	0	0	0	74
22838	0	72	0	0	0	72
22839	74	0	0	0	0	74
22840	0	0	73	0	0	73
22841	69	0	0	0	0	69
22842	0	0	0	77	0	77
22843	0	0	77	0	0	77
22844	74	0	2	0	0	76
22845	1	0	0	71	0	72
22846	1	0	0	59	0	60
22847	0	1	0	59	0	60
22848	0	0	0	63	0	63
22849	64	0	0	0	0	64
22850	0	67	0	0	0	67
22851	63	0	0	0	0	63
22852	0	0	66	0	0	66
22853	0	0	63	0	0	63
22854	0	63	0	0	0	63
22855	0	0	0	63	0	63
22856	0	0	66	0	0	66
22857	0	70	0	0	0	70
22858	0	0	66	0	0	66
22859	0	0	0	60	0	60
22860	0	1	0	62	0	63
22861	63	0	0	1	0	64
22862	0	0	0	64	0	64
22863	64	0	0	0	0	64
22864	0	0	62	0	0	62
22865	0	67	0	0	0	67
22866	0	0	0	63	0	63
22867	0	0	0	60	0	60
22868	0	0	64	0	0	64
22869	0	0	59	0	0	59
22870	63	0	0	0	0	63
22871	60	0	0	0	0	60
22872	0	0	0	65	0	65
22873	0	0	0	63	0	63
22874	0	59	0	1	0	60
22875	0	0	0	60	0	60
22876	61	0	1	0	0	62
22877	62	0	0	0	0	62
22878	0	65	0	0	0	65
22879	61	0	0	0	0	61
22880	53	0	2	0	0	55
22881	0	0	0	66	0	66
22882	0	63	0	0	0	63
22883	1	0	0	58	0	59
22884	0	0	0	63	0	63
22885	0	0	66	0	0	66
22886	64	0	0	0	0	64
22887	0	0	0	60	0	60
22888	0	0	0	64	0	64
22889	0	64	0	0	0	64
22890	0	0	0	61	0	61
22891	63	0	0	0	0	63
22892	57	0	0	0	0	57
22893	0	0	64	0	0	64
22894	0	0	68	0	0	68
22895	0	0	0	52	0	52
22896	0	0	0	54	0	54
22897	0	0	53	0	0	53
22898	0	0	61	0	0	61
22899	0	0	0	59	0	59
22900	0	0	55	0	0	55
22901	0	0	61	0	0	61
22902	0	0	0	52	0	52
22903	55	0	1	0	0	56
22904	55	0	0	0	0	55
22905	0	0	0	55	0	55
22906	0	0	0	59	0	59
22907	57	0	0	0	0	57
22908	0	0	0	52	0	52
22909	58	0	1	0	0	59
22910	51	0	1	0	0	52
22911	0	0	0	53	0	53
22912	0	0	0	60	0	60
22913	60	0	0	0	0	60
22914	0	54	0	0	0	54
22915	0	52	0	0	0	52
22916	0	0	0	51	0	51
22917	0	0	58	0	0	58
22918	0	0	0	57	0	57
22919	51	0	0	0	0	51
22920	0	0	0	57	0	57
22921	53	0	1	0	0	54
22922	0	0	54	0	0	54
22923	50	0	0	0	0	50
22924	0	1	0	41	0	42
22925	0	0	0	46	0	46
22926	0	0	49	0	0	49
22927	0	1	0	44	0	45
22928	0	0	0	40	0	40
22929	0	0	0	41	0	41
22930	47	0	0	0	0	47
22931	0	0	47	0	0	47
22932	0	0	45	0	0	45
22933	41	0	0	2	0	43
22934	39	0	0	0	0	39
22935	0	0	47	0	0	47
22936	0	0	0	42	0	42
22937	0	45	0	0	0	45
22938	0	0	0	47	0	47
22939	43	0	0	0	0	43
22940	46	0	0	0	0	46
22941	0	0	0	52	0	52
22942	0	48	0	0	0	48
22943	0	0	0	48	0	48
22944	0	46	0	0	0	46
22945	44	0	0	0	0	44
22946	37	0	0	0	0	37
22947	41	1	1	0	0	43
22948	0	50	0	0	0	50
22949	0	48	0	0	0	48
22950	0	1	0	44	0	45
22951	0	0	0	42	0	42
22952	0	2	0	47	0	49
22953	0	0	0	52	0	52
22954	0	0	49	0	0	49
22955	49	0	0	0	0	49
22956	0	0	50	0	0	50
22957	48	0	0	0	0	48
22958	0	0	49	0	0	49
22959	47	0	0	0	0	47
22960	0	0	50	0	0	50
22961	47	0	0	0	0	47
22962	0	0	0	51	0	51
22963	45	0	0	0	0	45
22964	0	0	0	46	0	46
22965	0	0	0	42	0	42
22966	0	0	0	50	0	50
22967	0	49	0	0	0	49
22968	50	0	0	0	0	50
22969	47	0	1	0	0	48
22970	0	53	0	0	0	53
22971	0	0	0	49	0	49
22972	0	0	51	0	0	51
22973	50	0	0	0	0	50
22974	42	0	0	0	0	42
22975	45	0	0	0	0	45
22976	0	0	0	51	0	51
22977	0	52	0	0	0	52
22978	0	0	0	50	0	50
22979	47	0	0	0	0	47
22980	0	0	0	48	0	48
22981	0	53	0	0	0	53
22982	47	0	0	0	0	47
22983	0	0	47	0	0	47
22984	0	0	49	0	0	49
22985	0	49	0	0	0	49
22986	0	46	0	0	0	46
22987	0	0	44	0	0	44
22988	0	0	52	0	0	52
22989	0	0	0	46	0	46
22990	53	0	0	0	0	53
22991	0	0	54	0	0	54
22992	0	52	0	0	0	52
22993	49	0	1	0	0	50
22994	0	53	0	0	0	53
22995	51	0	0	0	0	51
22996	0	55	0	0	0	55
22997	0	50	0	0	0	50
22998	0	0	0	53	0	53
22999	0	1	0	55	0	56
23000	0	0	59	0	0	59
23001	1	0	0	54	0	55
23002	56	0	0	0	0	56
23003	58	0	0	0	0	58
23004	0	0	0	57	0	57
23005	0	0	52	0	0	52
23006	0	0	59	0	0	59
23007	0	0	0	54	0	54
23008	0	0	58	0	0	58
23009	0	1	0	48	0	49
23010	0	0	0	51	0	51
23011	0	0	54	0	0	54
23012	56	0	0	0	0	56
23013	52	0	0	0	0	52
23014	0	0	53	0	0	53
23015	0	0	58	0	0	58
23016	0	0	0	53	0	53
23017	0	0	0	50	0	50
23018	0	1	0	51	0	52
23019	0	0	0	53	0	53
23020	55	0	0	0	0	55
23021	54	0	0	0	0	54
23022	0	0	0	54	0	54
23023	0	0	0	55	0	55
23024	0	0	60	0	0	60
23025	0	0	1	54	0	55
23026	0	0	0	53	0	53
23027	57	0	0	0	0	57
23028	0	60	0	0	0	60
23029	0	0	0	55	0	55
23030	0	0	1	52	0	53
23031	0	0	0	59	0	59
23032	0	58	0	0	0	58
23033	0	64	0	0	0	64
23034	0	1	0	57	0	58
23035	0	0	0	56	0	56
23036	0	0	0	65	0	65
23037	65	0	0	0	0	65
23038	0	69	0	0	0	69
23039	67	0	2	0	0	69
23040	73	0	1	0	0	74
23041	0	1	0	80	0	81
23042	0	82	0	0	0	82
23043	80	0	2	0	0	82
23044	0	0	0	82	0	82
23045	75	0	0	0	0	75
23046	2	0	0	82	0	84
23047	0	0	86	0	0	86
23048	0	0	96	0	0	96
23049	0	0	0	87	0	87
23050	0	0	0	91	0	91
23051	0	1	0	93	0	94
23052	0	95	0	0	0	95
23053	0	98	0	0	0	98
23054	97	0	0	0	0	97
23055	95	0	0	0	0	95
23056	0	96	0	0	0	96
23057	0	89	0	0	0	89
23058	0	102	0	0	0	102
23059	101	0	0	0	0	101
23060	0	108	0	0	0	108
23061	0	0	0	105	0	105
23062	103	0	0	0	0	103
23063	91	0	0	0	0	91
23064	0	1	0	102	0	103
23065	0	0	105	0	0	105
23066	1	0	105	0	0	106
23067	1	0	0	106	0	107
23068	0	0	102	0	0	102
23069	0	0	0	100	0	100
23070	0	0	0	103	0	103
23071	0	0	101	0	0	101
23072	0	0	102	0	0	102
23073	0	0	0	94	0	94
23074	0	0	0	95	0	95
23075	104	0	0	0	0	104
23076	0	103	0	0	0	103
23077	0	99	0	0	0	99
23078	101	0	0	0	0	101
23079	109	0	0	0	0	109
23080	0	118	0	0	0	118
23081	0	118	0	0	0	118
23082	120	0	0	0	0	120
23083	0	0	0	120	0	120
23084	117	0	0	0	0	117
23085	0	120	0	0	0	120
23086	111	0	1	0	0	112
23087	1	0	117	0	0	118
23088	105	0	0	0	0	105
23089	0	0	118	0	0	118
23090	2	0	0	114	0	116
23091	103	0	5	0	0	108
23092	0	0	113	0	0	113
23093	0	0	0	108	0	108
23094	105	0	0	0	0	105
23095	0	0	113	0	0	113
23096	0	0	0	95	0	95
23097	99	0	0	0	0	99
23098	0	98	0	0	0	98
23099	0	0	0	81	0	81
23100	0	0	0	76	0	76
23101	0	0	0	90	0	90
23102	0	93	0	0	0	93
23103	0	0	0	83	0	83
23104	0	0	0	78	0	78
23105	0	0	0	85	0	85
23106	0	4	0	84	0	88
23107	0	0	91	0	0	91
23108	88	0	0	0	0	88
23109	85	0	0	0	0	85
23110	0	93	0	0	0	93
23111	0	0	0	86	0	86
23112	0	0	0	88	0	88
23113	0	93	0	1	0	94
23114	0	0	0	95	0	95
23115	95	0	0	0	0	95
23116	0	92	0	0	0	92
23117	95	0	0	0	0	95
23118	0	0	0	92	0	92
23119	0	0	81	0	0	81
23120	0	93	0	0	0	93
23121	90	0	1	0	0	91
23122	0	92	0	0	0	92
23123	0	89	0	0	0	89
23124	90	0	0	0	0	90
23125	0	0	91	0	0	91
23126	0	95	0	0	0	95
23127	98	0	0	1	0	99
23128	96	0	0	0	0	96
23129	0	98	0	0	0	98
23130	0	3	0	97	0	100
23131	0	0	102	0	0	102
23132	0	0	0	93	0	93
23133	0	0	0	88	0	88
23134	0	0	0	97	0	97
23135	0	0	101	0	0	101
23136	0	0	0	103	0	103
23137	0	0	97	0	0	97
23138	1	0	97	0	0	98
23139	100	0	1	0	0	101
23140	0	109	0	0	0	109
23141	0	104	0	0	0	104
23142	0	2	0	105	0	107
23143	105	0	0	0	0	105
23144	103	0	0	0	0	103
23145	94	0	0	0	0	94
23146	92	0	0	1	0	93
23147	94	0	0	0	0	94
23148	0	0	106	0	0	106
23149	0	0	0	104	0	104
23150	0	109	0	0	0	109
23151	0	1	0	108	0	109
23152	111	1	1	0	0	113
23153	0	113	0	0	0	113
23154	0	0	0	113	0	113
23155	108	1	2	0	0	111
23156	103	0	0	0	0	103
23157	0	0	0	107	0	107
23158	0	0	0	107	0	107
23159	0	0	0	109	0	109
23160	0	0	112	0	0	112
23161	0	0	109	0	0	109
23162	0	0	0	106	0	106
23163	1	0	0	102	0	103
23164	107	0	0	0	0	107
23165	104	0	1	1	0	106
23166	102	0	0	0	0	102
23167	104	0	0	0	0	104
23168	106	0	1	0	0	107
23169	0	117	0	0	0	117
23170	113	0	0	0	0	113
23171	102	0	0	1	0	103
23172	97	0	0	0	0	97
23173	0	0	0	109	0	109
23174	0	0	116	0	0	116
23175	0	0	0	113	0	113
23176	1	0	115	0	0	116
23177	0	1	0	114	0	115
23178	0	116	0	0	0	116
23179	111	0	0	0	0	111
23180	108	0	0	0	0	108
23181	0	0	0	102	0	102
23182	0	0	0	106	0	106
23183	0	1	0	114	0	115
23184	0	114	0	0	0	114
23185	117	0	0	0	0	117
23186	112	0	2	0	0	114
23187	0	125	0	0	0	125
23188	0	0	0	114	0	114
23189	0	1	0	126	0	127
23190	0	124	0	0	0	124
23191	126	0	0	0	0	126
23192	109	0	2	0	0	111
23193	0	0	0	129	0	129
23194	0	0	131	0	0	131
23195	0	0	133	0	0	133
23196	0	1	0	131	0	132
23197	0	0	0	129	0	129
23198	0	0	0	127	0	127
23199	131	0	1	0	0	132
23200	125	0	0	0	0	125
23201	0	141	0	0	0	141
23202	130	0	0	1	0	131
23203	0	0	130	0	0	130
23204	0	0	136	0	0	136
23205	0	140	0	0	0	140
23206	136	0	0	0	0	136
23207	0	146	0	0	0	146
23208	140	1	1	0	0	142
23209	1	0	137	0	0	138
23210	0	0	148	0	0	148
23211	0	0	0	141	0	141
23212	0	0	146	0	0	146
23213	0	1	0	143	0	144
23214	0	2	0	138	0	140
23215	0	147	0	1	0	148
23216	1	0	0	132	0	133
23217	0	1	0	133	0	134
23218	140	0	0	0	0	140
23219	0	148	0	0	0	148
23220	0	0	0	135	0	135
23221	0	0	142	0	0	142
23222	139	0	1	0	0	140
23223	0	0	145	0	0	145
23224	0	0	0	136	0	136
23225	0	138	0	0	0	138
23226	0	0	0	142	0	142
23227	142	0	0	0	0	142
23228	123	0	0	0	0	123
23229	0	138	0	0	0	138
23230	134	0	0	1	0	135
23231	131	0	0	0	0	131
23232	124	0	1	0	0	125
23233	108	0	0	0	0	108
23234	123	0	3	0	0	126
23235	1	0	124	0	0	125
23236	0	0	0	121	0	121
23237	0	0	0	121	0	121
23238	0	0	0	120	0	120
23239	0	116	0	0	0	116
23240	0	0	0	117	0	117
23241	0	0	120	0	0	120
23242	0	116	0	0	0	116
23243	0	108	0	0	0	108
23244	1	2	0	108	0	111
23245	0	0	2	107	0	109
23246	0	0	0	121	0	121
23247	0	122	0	0	0	122
23248	0	114	3	0	0	117
23249	118	0	0	0	0	118
23250	119	0	1	0	0	120
23251	0	130	0	0	0	130
23252	125	0	2	0	0	127
23253	111	0	1	0	0	112
23254	0	0	0	125	0	125
23255	0	0	0	125	0	125
23256	0	0	0	126	0	126
23257	0	0	129	0	0	129
23258	0	0	134	0	0	134
23259	0	127	0	0	0	127
23260	129	0	0	0	0	129
23261	0	0	127	0	0	127
23262	134	0	0	0	0	134
23263	0	0	122	1	0	123
23264	137	0	0	0	0	137
23265	0	132	0	0	0	132
23266	138	0	0	0	0	138
23267	0	0	0	129	0	129
23268	0	0	0	129	0	129
23269	0	0	131	0	0	131
23270	0	143	0	0	0	143
23271	0	0	0	135	0	135
23272	0	0	142	0	0	142
23273	130	0	1	0	0	131
23274	0	148	0	0	0	148
23275	145	0	1	0	0	146
23276	0	154	0	0	0	154
23277	0	0	0	148	0	148
23278	145	0	0	0	0	145
23279	0	151	0	1	0	152
23280	0	0	0	151	0	151
23281	0	0	151	0	0	151
23282	136	0	0	0	0	136
23283	1	0	0	150	0	151
23284	0	0	144	0	0	144
23285	0	144	0	1	0	145
23286	0	1	0	144	0	145
23287	0	0	149	0	0	149
23288	0	1	0	145	0	146
23289	0	143	0	0	0	143
23290	0	120	0	0	0	120
23291	0	0	137	0	0	137
23292	0	0	0	137	0	137
23293	0	0	140	0	0	140
23294	139	0	1	0	0	140
23295	0	0	0	139	0	139
23296	0	134	0	1	0	135
23297	0	131	0	2	0	133
23298	131	0	2	0	0	133
23299	0	135	0	0	0	135
23300	131	0	0	0	0	131
23301	0	0	134	0	0	134
23302	122	0	6	0	0	128
23303	0	136	0	0	0	136
23304	132	0	1	0	0	133
23305	0	135	0	0	0	135
23306	0	1	0	127	0	128
23307	10	0	0	112	0	122
23308	0	0	130	0	0	130
23309	129	0	0	0	0	129
23310	0	0	133	0	0	133
23311	129	0	2	0	0	131
23312	0	0	0	112	0	112
23313	0	0	0	125	0	125
23314	0	123	0	0	0	123
23315	0	0	0	120	0	120
23316	0	1	0	121	0	122
23317	0	0	126	0	0	126
23318	134	0	1	0	0	135
23319	0	132	1	0	0	133
23320	132	0	0	0	0	132
23321	0	2	0	125	0	127
23322	0	0	0	130	0	130
23323	128	0	0	1	0	129
23324	0	139	0	0	0	139
23325	131	0	0	0	0	131
23326	0	134	0	0	0	134
23327	0	128	0	0	0	128
23328	129	0	1	0	0	130
23329	0	0	0	133	0	133
23330	0	0	138	0	0	138
23331	0	0	0	114	0	114
23332	0	0	0	129	0	129
23333	0	136	0	0	0	136
23334	0	0	0	129	0	129
23335	2	0	0	121	0	123
23336	0	0	0	127	0	127
23337	0	0	0	133	0	133
23338	0	0	126	0	0	126
23339	0	0	139	0	0	139
23340	1	0	0	133	0	134
23341	0	0	131	0	0	131
23342	1	0	135	0	0	136
23343	0	0	0	130	0	130
23344	0	0	138	0	0	138
23345	0	0	0	126	0	126
23346	0	130	0	0	0	130
23347	120	0	0	0	0	120
23348	0	0	136	0	0	136
23349	0	0	0	123	0	123
23350	0	0	140	0	0	140
23351	0	0	0	127	0	127
23352	1	0	0	128	0	129
23353	124	0	0	0	0	124
23354	0	0	0	134	0	134
23355	122	0	0	0	0	122
23356	126	0	0	0	0	126
23357	0	132	0	0	0	132
23358	121	0	0	0	0	121
23359	0	127	0	0	0	127
23360	0	118	0	0	0	118
23361	115	0	0	0	0	115
23362	1	0	117	0	0	118
23363	1	0	113	0	0	114
23364	117	0	0	0	0	117
23365	112	0	1	0	0	113
23366	0	117	0	1	0	118
23367	111	0	2	0	0	113
23368	109	0	0	0	0	109
23369	105	0	0	0	0	105
23370	0	0	0	116	0	116
23371	112	0	0	0	0	112
23372	0	115	0	0	0	115
23373	0	0	0	105	0	105
23374	0	0	0	105	0	105
23375	0	110	0	0	0	110
23376	0	0	0	112	0	112
23377	101	0	1	0	0	102
23378	105	0	0	0	0	105
23379	0	109	0	0	0	109
23380	0	104	0	0	0	104
23381	89	0	0	0	0	89
23382	0	0	100	0	0	100
23383	0	0	99	0	0	99
23384	0	1	0	90	0	91
23385	0	0	0	91	0	91
23386	0	0	99	0	0	99
23387	0	100	0	0	0	100
23388	0	0	0	97	0	97
23389	0	0	103	0	0	103
23390	0	0	0	95	0	95
23391	1	0	0	95	0	96
23392	0	104	0	2	0	106
23393	0	2	0	90	0	92
23394	0	0	0	90	0	90
23395	0	3	0	102	0	105
23396	104	0	0	0	0	104
23397	0	1	0	116	0	117
23398	0	117	0	0	0	117
23399	109	0	0	0	0	109
23400	0	0	121	0	0	121
23401	0	0	118	0	0	118
23402	119	0	1	0	0	120
23403	0	1	0	117	0	118
23404	1	0	122	0	0	123
23405	0	1	0	116	0	117
23406	1	0	0	120	0	121
23407	101	0	2	0	0	103
23408	116	0	2	0	0	118
23409	0	129	0	0	0	129
23410	1	0	0	119	0	120
23411	0	0	128	0	0	128
23412	0	131	0	0	0	131
23413	127	0	0	0	0	127
23414	0	136	0	0	0	136
23415	127	0	0	0	0	127
23416	0	0	135	0	0	135
23417	121	0	0	0	0	121
23418	117	0	1	0	0	118
23419	0	0	132	0	0	132
23420	0	0	0	127	0	127
23421	0	125	0	0	0	125
23422	0	119	0	0	0	119
23423	0	129	0	0	0	129
23424	0	1	0	134	0	135
23425	0	0	145	0	0	145
23426	0	1	0	134	0	135
23427	0	0	0	143	0	143
23428	0	0	138	0	0	138
23429	0	148	0	0	0	148
23430	0	0	0	145	0	145
23431	135	0	0	0	0	135
23432	0	0	0	125	0	125
23433	2	0	0	144	0	146
23434	0	149	0	0	0	149
23435	141	0	1	0	0	142
23436	0	2	0	148	0	150
23437	0	0	172	0	0	172
23438	0	178	0	0	0	178
23439	169	0	0	0	0	169
23440	1	0	180	24	0	205
23441	227	0	1	0	0	228
23442	1	0	0	244	0	245
23443	0	237	0	0	0	237
23444	303	1	0	0	0	304
23445	249	4	1	84	0	338
23446	0	429	0	1	0	430
23447	11	4	0	395	0	410
23448	0	0	0	444	0	444
23449	446	1	3	4	0	454
23450	9	547	0	0	0	556
23451	2	0	0	564	0	566
23452	3	561	0	12	0	576
23453	0	584	0	0	0	584
23454	0	2	0	614	0	616
23455	605	0	2	0	0	607
23456	1	637	0	1	0	639
23457	0	2	0	597	0	599
23458	1	2	0	606	0	609
23459	1	0	605	0	0	606
23460	0	0	630	1	0	631
23461	0	634	0	3	0	637
23462	0	0	616	0	0	616
23463	0	1	0	639	0	640
23464	0	0	692	0	0	692
23465	0	2	0	626	0	628
23466	1	2	0	658	0	661
23467	0	1	0	705	0	706
23468	732	0	0	0	0	732
23469	0	3	0	721	0	724
23470	0	7	0	772	0	779
23471	11	805	0	2	0	818
23472	0	9	0	801	0	810
23473	790	0	7	0	0	797
23474	0	825	0	2	0	827
23475	777	0	9	0	0	786
23476	1	1	855	0	0	857
23477	0	0	983	0	0	983
23478	0	5	0	960	0	965
23479	7	7	0	1011	0	1025
23480	0	1070	0	0	0	1070
23481	0	4	1	1049	0	1054
23482	1054	0	2	1	0	1057
23483	1014	1	2	1	0	1018
23484	0	2	0	1085	0	1087
23485	0	0	1097	0	0	1097
23486	0	1	0	1041	0	1042
23487	1	4	0	1016	0	1021
23488	1	7	0	1051	0	1059
23489	0	3	0	1094	0	1097
23490	0	7	0	1129	0	1136
23491	0	1142	0	0	0	1142
23492	1071	0	6	4	0	1081
23493	1095	0	6	0	0	1101
23494	1120	1	3	1	0	1125
23495	0	1191	0	1	0	1192
23496	1168	0	4	0	0	1172
23497	0	1238	1	0	0	1239
23498	1	0	1237	0	0	1238
23499	0	4	0	1299	0	1303
23500	0	0	1348	0	0	1348
23501	0	1364	0	4	0	1368
23502	1319	0	4	1	0	1324
23503	0	0	1359	0	0	1359
23504	0	0	1395	0	0	1395
23505	0	1510	0	0	0	1510
23506	1	10	0	1491	0	1502
23507	6	0	1777	0	0	1783
23508	0	6	3	1665	0	1674
23509	0	15	0	1659	0	1674
23510	1	3	0	1743	0	1747
23511	1823	0	4	0	0	1827
23512	1679	0	6	1	0	1686
23513	1	1	0	1809	0	1811
23514	1845	0	2	0	0	1847
23515	0	0	1844	0	0	1844
23516	2	0	1818	0	0	1820
23517	2	0	1823	0	0	1825
23518	1	0	1889	0	0	1890
23519	0	1936	0	4	0	1940
23520	1	12	0	1924	0	1937
23521	5	0	1902	0	0	1907
23522	1886	0	10	2	0	1898
23523	1889	0	9	2	0	1900
23524	0	1958	0	0	0	1958
23525	1924	0	7	0	0	1931
23526	0	5	0	2002	0	2007
23527	5	0	1958	0	0	1963
23528	2	7	1	2013	0	2023
23529	1	2007	0	1	0	2009
23530	1938	0	2	0	0	1940
23531	1972	0	4	0	0	1976
23532	0	2044	0	4	0	2048
23533	1928	0	11	2	0	1941
23534	2023	0	9	1	0	2033
23535	0	2132	0	2	0	2134
23536	1	6	0	2058	0	2065
23537	0	2152	0	1	0	2153
23538	2116	2	3	0	0	2121
23539	0	9	0	2054	0	2063
23540	2055	0	5	2	0	2062
23541	0	2	0	2167	0	2169
23542	3	0	2210	0	0	2213
23543	2151	0	6	4	0	2161
23544	0	0	2227	0	0	2227
23545	0	3	0	2232	0	2235
23546	3	0	2270	0	0	2273
23547	2	13	2	2173	0	2190
23548	0	0	2243	0	0	2243
23549	2264	0	7	4	0	2275
23550	0	2319	0	0	0	2319
23551	2269	4	6	3	0	2282
23552	0	5	0	2288	0	2293
23553	2225	0	6	3	0	2234
23554	0	2329	0	0	0	2329
23555	3	2225	0	6	0	2234
23556	0	2317	0	5	0	2322
23557	2287	0	5	0	0	2292
23558	0	7	0	2100	0	2107
23559	2	3	0	2260	0	2265
23560	0	2	2268	0	0	2270
23561	6	0	2345	0	0	2351
23562	0	7	0	2300	0	2307
23563	1	0	2347	0	0	2348
23564	0	2366	0	4	0	2370
23565	2275	0	7	0	0	2282
23566	0	0	2324	0	0	2324
23567	10	0	2382	1	0	2393
23568	1	3	0	2313	0	2317
23569	2354	2	6	0	0	2362
23570	0	5	0	2257	0	2262
23571	2258	0	7	0	0	2265
23572	0	9	0	2327	0	2336
23573	5	0	2311	0	0	2316
23574	0	2254	2	1	0	2257
23575	3	2	2231	0	0	2236
23576	0	2333	0	2	0	2335
23577	0	7	0	2258	0	2265
23578	2316	2	18	0	0	2336
23579	4	0	2350	0	0	2354
23580	7	3	0	2218	0	2228
23581	4	1	2	2223	0	2230
23582	2225	0	5	1	0	2231
23583	0	3	4	2301	0	2308
23584	0	2300	0	4	0	2304
23585	2241	0	6	0	0	2247
23586	2	0	2301	0	0	2303
23587	2248	0	4	0	0	2252
23588	0	2266	0	0	0	2266
23589	0	4	0	2161	0	2165
23590	0	2230	0	1	0	2231
23591	2159	2	5	2	0	2168
23592	0	0	2188	0	0	2188
23593	2146	0	4	0	0	2150
23594	0	2103	0	1	0	2104
23595	0	2	0	2006	0	2008
23596	2038	0	2	0	0	2040
23597	1886	0	5	0	0	1891
23598	0	3	2	1878	0	1883
23599	2	3	0	1965	0	1970
23600	1	1870	0	3	0	1874
23601	12	9	2	1895	0	1918
23602	0	1903	0	0	0	1903
23603	0	1867	0	3	0	1870
23604	2	1	0	1883	0	1886
23605	0	1886	0	0	0	1886
23606	4	0	1820	0	0	1824
23607	2	0	1925	0	0	1927
23608	2	1840	0	11	0	1853
23609	10	0	1819	0	0	1829
23610	0	0	1883	0	0	1883
23611	1	2	1928	0	0	1931
23612	0	1889	0	0	0	1889
23613	1880	0	21	0	0	1901
23614	0	1892	0	3	0	1895
23615	4	0	1870	0	0	1874
23616	0	12	2	1849	0	1863
23617	1867	0	12	0	0	1879
23618	0	0	1878	0	0	1878
23619	0	2	2	1811	0	1815
23620	3	0	1832	0	0	1835
23621	1	3	1	1804	0	1809
23622	1791	0	3	0	0	1794
23623	0	0	1784	0	0	1784
23624	0	1732	7	2	0	1741
23625	1	4	0	1692	0	1697
23626	1646	0	7	0	0	1653
23627	0	0	1599	0	0	1599
23628	0	1	0	1517	0	1518
23629	1	1506	0	1	0	1508
23630	1448	1	1	1	0	1451
23631	1387	0	1	0	0	1388
23632	0	5	0	1450	0	1455
23633	0	1448	0	0	0	1448
23634	0	1434	0	2	0	1436
23635	1422	0	4	0	0	1426
23636	0	11	0	1402	0	1413
23637	0	1429	0	2	0	1431
23638	1420	0	1	0	0	1421
23639	1	2	0	1316	0	1319
23640	1	1	0	1363	0	1365
23641	17	0	1347	0	0	1364
23642	0	1360	0	4	0	1364
23643	0	1371	0	1	0	1372
23644	0	9	0	1364	0	1373
23645	1322	0	3	2	0	1327
23646	0	1355	0	1	0	1356
23647	1312	1	1	0	0	1314
23648	0	1324	2	2	0	1328
23649	5	3	0	1073	0	1081
23650	980	0	2	1	0	983
23651	2	2	0	986	0	990
23652	1	0	1014	0	0	1015
23653	0	8	0	966	0	974
23654	0	894	0	0	0	894
23655	847	0	3	1	0	851
23656	0	781	1	0	0	782
23657	3	3	0	647	0	653
23658	0	3	1	672	0	676
23659	0	0	622	1	0	623
23660	0	0	670	0	0	670
23661	0	2	0	640	0	642
23662	1	0	650	0	0	651
23663	0	643	0	0	0	643
23664	626	0	1	2	0	629
23665	2	0	627	0	0	629
23666	640	0	1	2	0	643
23667	613	0	3	7	0	623
23668	603	0	1	0	0	604
23669	554	0	5	0	0	559
23670	0	3	0	561	0	564
23671	0	3	0	590	0	593
23672	0	601	0	0	0	601
23673	585	0	0	1	0	586
23674	0	0	612	0	0	612
23675	0	1	0	556	0	557
23676	0	2	0	571	0	573
23677	0	0	580	0	0	580
23678	0	582	1	2	0	585
23679	1	3	0	558	0	562
23680	0	0	0	584	0	584
23681	578	0	2	0	0	580
23682	0	595	0	1	0	596
23683	0	3	0	568	0	571
23684	0	583	0	0	0	583
23685	2	1	0	546	0	549
23686	550	0	2	1	0	553
23687	515	0	3	0	0	518
23688	0	2	0	547	0	549
23689	523	0	0	0	0	523
23690	526	0	2	0	0	528
23691	0	530	0	0	0	530
23692	1	0	0	500	0	501
23693	0	497	0	0	0	497
23694	0	1	0	455	0	456
23695	435	0	0	0	0	435
23696	0	3	0	387	0	390
23697	0	2	0	444	0	446
23698	0	0	448	0	0	448
23699	0	440	0	0	0	440
23700	0	409	0	0	0	409
23701	393	0	0	0	0	393
23702	0	1	0	376	0	377
23703	367	0	0	2	0	369
23704	0	387	0	1	0	388
23705	0	365	0	0	0	365
23706	0	377	0	0	0	377
23707	352	0	0	0	0	352
23708	0	358	0	1	0	359
23709	314	0	4	1	0	319
23710	304	0	4	0	0	308
23711	299	0	1	0	0	300
23712	0	1	0	300	0	301
23713	0	1	0	293	0	294
23714	0	5	0	281	0	286
23715	0	0	0	301	0	301
23716	305	0	1	0	0	306
23717	0	311	0	0	0	311
23718	0	0	0	307	0	307
23719	287	0	3	0	0	290
23720	0	1	0	268	0	269
23721	0	1	0	267	0	268
23722	295	0	0	0	0	295
23723	0	0	310	0	0	310
23724	0	1	1	298	0	300
23725	0	0	308	0	0	308
23726	0	0	0	277	0	277
23727	0	0	0	284	0	284
23728	267	0	0	2	0	269
23729	0	285	0	1	0	286
23730	0	278	0	0	0	278
23731	279	0	1	0	0	280
23732	0	282	0	1	0	283
23733	269	0	0	0	0	269
23734	0	0	270	0	0	270
23735	275	0	2	0	0	277
23736	260	0	0	1	0	261
23737	255	0	2	0	0	257
23738	0	1	0	243	0	244
23739	1	2	0	259	0	262
23740	0	266	0	0	0	266
23741	0	1	0	267	0	268
23742	255	0	0	2	0	257
23743	0	268	0	0	0	268
23744	0	266	0	0	0	266
23745	262	0	1	0	0	263
23746	0	0	277	0	0	277
23747	1	0	0	261	0	262
23748	1	0	270	0	0	271
23749	0	1	1	255	0	257
23750	0	260	0	0	0	260
23751	0	1	0	246	0	247
23752	245	0	5	0	0	250
23753	0	4	0	261	0	265
23754	0	0	277	0	0	277
23755	265	0	1	0	0	266
23756	3	266	1	0	0	270
23757	0	232	0	0	0	232
23758	239	0	0	0	0	239
23759	230	0	1	0	0	231
23760	0	0	237	0	0	237
23761	226	0	4	0	0	230
23762	0	238	0	0	0	238
23763	233	0	0	0	0	233
23764	0	0	0	233	0	233
23765	0	229	0	0	0	229
23766	240	0	0	0	0	240
23767	0	0	243	0	0	243
23768	1	0	0	225	0	226
23769	234	0	2	0	0	236
23770	0	0	232	0	0	232
23771	222	0	0	0	0	222
23772	0	2	0	211	0	213
23773	1	0	0	210	0	211
23774	0	0	223	0	0	223
23775	0	0	0	213	0	213
23776	212	0	0	0	0	212
23777	0	211	0	0	0	211
23778	198	0	0	0	0	198
23779	189	0	1	0	0	190
23780	0	0	0	196	0	196
23781	0	0	210	0	0	210
23782	0	1	0	197	0	198
23783	193	0	0	0	0	193
23784	0	196	0	0	0	196
23785	193	0	0	0	0	193
23786	0	0	0	174	0	174
23787	0	2	0	182	0	184
23788	1	0	0	167	0	168
23789	0	0	178	0	0	178
23790	3	1	0	164	0	168
23791	2	0	168	0	0	170
23792	0	0	166	0	0	166
23793	0	0	0	159	0	159
23794	0	0	162	0	0	162
23795	160	0	1	0	0	161
23796	0	0	0	150	0	150
23797	0	0	0	161	0	161
23798	0	165	0	0	0	165
23799	149	0	0	0	0	149
23800	154	0	2	0	0	156
23801	0	165	0	0	0	165
23802	1	0	0	158	0	159
23803	0	0	165	0	0	165
23804	156	0	0	0	0	156
23805	154	1	1	0	0	156
23806	0	1	0	163	0	164
23807	0	0	166	0	0	166
23808	0	167	0	0	0	167
23809	157	0	0	0	0	157
23810	0	0	167	0	0	167
23811	6	155	0	0	0	161
23812	152	0	0	11	0	163
23813	163	0	2	0	0	165
23814	0	0	0	184	0	184
23815	0	203	0	0	0	203
23816	1	0	0	188	0	189
23817	3	2	0	178	0	183
23818	0	0	2	178	0	180
23819	0	3	0	192	0	195
23820	2	0	198	1	0	201
23821	0	2	0	178	0	180
23822	0	3	1	191	0	195
23823	0	0	201	0	0	201
23824	0	182	0	0	0	182
23825	194	0	0	0	0	194
23826	196	0	0	0	0	196
23827	0	1	0	197	0	198
23828	202	0	0	0	0	202
23829	0	1	0	195	0	196
23830	1	0	189	0	0	190
23831	0	0	192	0	0	192
23832	0	198	0	2	0	200
23833	190	0	0	0	0	190
23834	0	0	198	0	0	198
23835	0	1	1	172	0	174
23836	0	1	0	174	0	175
23837	0	1	0	189	0	190
23838	0	0	0	191	0	191
23839	0	0	0	188	0	188
23840	0	0	199	0	0	199
23841	0	0	0	201	0	201
23842	192	0	1	0	0	193
23843	0	194	0	3	0	197
23844	183	0	0	2	0	185
23845	0	198	0	0	0	198
23846	186	0	2	0	0	188
23847	185	0	0	0	0	185
23848	1	1	0	184	0	186
23849	0	0	0	208	0	208
23850	170	0	0	3	0	173
23851	188	0	0	0	0	188
23852	197	0	1	0	0	198
23853	0	210	0	0	0	210
23854	1	168	0	0	0	169
23855	0	0	189	0	0	189
23856	0	1	0	192	0	193
23857	0	0	194	0	0	194
23858	0	202	0	0	0	202
23859	0	1	0	182	0	183
23860	0	0	0	165	0	165
23861	0	0	0	188	0	188
23862	175	0	0	0	0	175
23863	187	0	0	0	0	187
23864	0	201	0	1	0	202
23865	0	0	0	189	0	189
23866	1	0	182	0	0	183
23867	0	0	182	0	0	182
23868	183	0	0	0	0	183
23869	166	0	0	0	0	166
23870	0	0	0	184	0	184
23871	176	0	1	0	0	177
23872	0	0	179	0	0	179
23873	0	185	0	0	0	185
23874	0	1	0	176	0	177
23875	0	0	181	0	0	181
23876	1	0	0	164	0	165
23877	0	1	0	171	0	172
23878	1	0	177	0	0	178
23879	175	0	2	0	0	177
23880	170	0	0	0	0	170
23881	0	174	0	2	0	176
23882	152	0	0	0	0	152
23883	165	0	0	0	0	165
23884	0	0	164	0	0	164
23885	163	0	0	1	0	164
23886	0	172	0	0	0	172
23887	154	0	3	3	0	160
23888	149	0	0	0	0	149
23889	153	0	1	0	0	154
23890	147	0	0	0	0	147
23891	148	0	0	0	0	148
23892	0	160	0	0	0	160
23893	156	1	0	0	0	157
23894	0	154	0	0	0	154
23895	0	130	0	0	0	130
23896	0	150	0	0	0	150
23897	143	0	0	0	0	143
23898	132	0	0	0	0	132
23899	2	0	132	0	0	134
23900	129	0	0	1	0	130
23901	128	0	0	0	0	128
23902	0	0	132	0	0	132
23903	0	1	0	133	0	134
23904	1	2	0	124	0	127
23905	0	2	0	122	0	124
23906	0	0	0	129	0	129
23907	0	0	0	133	0	133
23908	0	0	133	0	0	133
23909	0	135	0	0	0	135
23910	133	0	0	0	0	133
23911	0	138	0	0	0	138
23912	126	0	1	0	0	127
23913	130	0	0	1	0	131
23914	0	0	136	0	0	136
23915	0	0	0	132	0	132
23916	0	137	0	0	0	137
23917	125	0	4	0	0	129
23918	121	0	1	0	0	122
23919	127	0	0	0	0	127
23920	0	132	0	0	0	132
23921	123	0	0	0	0	123
23922	119	0	0	0	0	119
23923	122	0	2	0	0	124
23924	0	0	0	129	0	129
23925	0	0	0	132	0	132
23926	0	0	0	139	0	139
23927	141	0	0	0	0	141
23928	0	142	0	0	0	142
23929	123	0	1	0	0	124
23930	120	0	0	0	0	120
23931	113	0	2	1	0	116
23932	121	0	1	0	0	122
23933	0	126	0	0	0	126
23934	123	0	0	0	0	123
23935	0	128	0	0	0	128
23936	0	111	0	0	0	111
23937	122	0	0	0	0	122
23938	0	140	0	0	0	140
23939	0	148	0	0	0	148
23940	148	1	0	0	0	149
23941	138	0	0	0	0	138
23942	0	0	0	137	0	137
23943	0	0	0	146	0	146
23944	150	0	0	0	0	150
23945	139	0	3	0	0	142
23946	150	0	0	0	0	150
23947	0	0	157	0	0	157
23948	149	0	2	0	0	151
23949	0	0	0	147	0	147
23950	0	0	0	147	0	147
23951	0	1	0	151	0	152
23952	0	0	0	159	0	159
23953	0	0	150	0	0	150
23954	0	0	158	0	0	158
23955	0	0	0	156	0	156
23956	0	0	150	0	0	150
23957	0	0	158	0	0	158
23958	0	0	0	139	0	139
23959	0	0	0	144	0	144
23960	0	0	0	144	0	144
23961	0	0	0	142	0	142
23962	146	0	1	0	0	147
23963	146	0	1	1	0	148
23964	0	1	0	136	0	137
23965	0	2	0	130	0	132
23966	0	2	0	129	0	131
23967	0	1	0	130	0	131
23968	1	1	0	130	0	132
23969	0	132	0	0	0	132
23970	134	0	0	0	0	134
23971	0	134	0	0	0	134
23972	138	0	0	0	0	138
23973	145	0	0	0	0	145
23974	141	0	0	0	0	141
23975	0	0	0	143	0	143
23976	143	0	0	0	0	143
23977	0	0	0	128	0	128
23978	0	0	0	147	0	147
23979	141	0	0	2	0	143
23980	0	143	0	0	0	143
23981	0	143	0	0	0	143
23982	132	0	1	0	0	133
23983	0	0	140	0	0	140
23984	141	0	0	0	0	141
23985	0	0	0	136	0	136
23986	0	139	0	0	0	139
23987	0	141	0	2	0	143
23988	144	0	0	0	0	144
23989	0	0	0	142	0	142
23990	0	144	0	0	0	144
23991	144	0	0	1	0	145
23992	132	0	0	1	0	133
23993	125	0	0	0	0	125
23994	130	2	0	0	0	132
23995	0	142	1	1	0	144
23996	0	142	0	0	0	142
23997	138	0	1	0	0	139
23998	142	0	0	0	0	142
23999	0	0	151	1	0	152
24000	0	147	0	0	0	147
24001	146	0	0	0	0	146
24002	138	0	1	0	0	139
24003	1	0	146	0	0	147
24004	144	0	0	0	0	144
24005	0	0	141	0	0	141
24006	2	0	152	0	0	154
24007	1	1	1	138	0	141
24008	0	145	0	0	0	145
24009	146	0	1	0	0	147
24010	0	1	0	132	0	133
24011	0	0	0	129	0	129
24012	0	0	0	140	0	140
24013	144	0	1	0	0	145
24014	0	1	0	138	0	139
24015	0	1	0	137	0	138
24016	2	0	151	0	0	153
24017	142	0	0	2	0	144
24018	135	0	0	0	0	135
24019	0	0	148	0	0	148
24020	139	0	0	2	0	141
24021	0	2	0	140	0	142
24022	2	154	0	0	0	156
24023	0	0	0	157	0	157
24024	163	0	0	0	0	163
24025	0	175	0	2	0	177
24026	2	0	0	162	0	164
24027	0	2	0	163	0	165
24028	0	0	0	172	0	172
24029	0	0	1	178	0	179
24030	0	186	0	2	0	188
24031	181	0	0	0	0	181
24032	181	0	0	0	0	181
24033	0	189	0	0	0	189
24034	189	2	0	0	0	191
24035	172	0	0	0	0	172
24036	186	0	1	0	0	187
24037	0	0	196	0	0	196
24038	0	0	0	186	0	186
24039	2	0	201	0	0	203
24040	199	0	2	0	0	201
24041	0	211	0	1	0	212
24042	202	2	0	0	0	204
24043	0	217	0	0	0	217
24044	0	2	0	192	0	194
24045	0	0	0	211	0	211
24046	1	0	217	0	0	218
24047	0	213	0	2	0	215
24048	225	0	2	0	0	227
24049	0	0	218	0	0	218
24050	209	0	2	0	0	211
24051	0	0	0	214	0	214
24052	0	0	221	0	0	221
24053	0	221	0	0	0	221
24054	0	0	0	209	0	209
24055	0	0	217	0	0	217
24056	1	0	216	0	0	217
24057	0	218	0	0	0	218
24058	0	1	0	201	0	202
24059	0	0	0	200	0	200
24060	0	213	0	0	0	213
24061	213	0	2	0	0	215
24062	2	0	0	212	0	214
24063	0	214	1	1	0	216
24064	214	0	0	0	0	214
24065	198	0	3	0	0	201
24066	210	0	0	0	0	210
24067	0	222	0	0	0	222
24068	217	0	1	0	0	218
24069	200	0	0	0	0	200
24070	0	1	0	207	0	208
24071	200	0	1	0	0	201
24072	0	1	0	210	0	211
24073	0	0	208	0	0	208
24074	0	0	212	0	0	212
24075	0	4	0	187	0	191
24076	0	0	194	0	0	194
24077	189	0	0	0	0	189
24078	0	2	0	164	0	166
24079	0	0	0	181	0	181
24080	0	0	188	0	0	188
24081	0	183	0	0	0	183
24082	0	179	0	0	0	179
24083	7	11	5	157	0	180
24084	4	16	7	140	0	167
24085	4	0	165	1	0	170
24086	2	0	176	0	0	178
24087	3	1	6	152	0	162
24088	0	0	160	0	0	160
24089	127	0	0	0	0	127
24090	0	0	4	93	0	97
24091	87	0	2	0	0	89
24092	0	0	0	78	0	78
24093	0	7	0	63	0	70
24094	0	0	61	0	0	61
24095	0	64	0	0	0	64
24096	0	0	0	66	0	66
24097	1	0	68	0	0	69
24098	0	65	0	0	0	65
24099	0	1	0	69	0	70
24100	63	0	1	0	0	64
24101	0	0	64	0	0	64
24102	71	0	1	0	0	72
24103	0	0	68	0	0	68
24104	68	0	0	0	0	68
24105	0	70	0	1	0	71
24106	0	70	0	0	0	70
24107	0	0	0	71	0	71
24108	0	73	0	0	0	73
24109	75	0	0	0	0	75
24110	0	0	0	72	0	72
24111	0	0	0	70	0	70
24112	0	0	0	76	0	76
24113	0	0	80	0	0	80
24114	2	1	0	70	0	73
24115	0	0	75	0	0	75
24116	0	78	0	0	0	78
24117	74	0	1	0	0	75
24118	0	76	0	0	0	76
24119	75	0	0	0	0	75
24120	77	0	0	0	0	77
24121	72	0	0	0	0	72
24122	74	0	0	0	0	74
24123	1	0	75	0	0	76
24124	0	0	0	70	0	70
24125	0	0	0	68	0	68
24126	0	0	0	75	0	75
24127	68	0	0	0	0	68
24128	65	0	0	0	0	65
24129	0	72	0	0	0	72
24130	1	0	68	0	0	69
24131	0	0	74	0	0	74
24132	0	77	0	0	0	77
24133	0	75	0	0	0	75
24134	1	0	0	65	0	66
24135	0	0	0	69	0	69
24136	72	0	0	0	0	72
24137	0	73	1	0	0	74
24138	0	0	0	74	0	74
24139	0	0	73	0	0	73
24140	0	0	0	65	0	65
24141	0	0	0	58	0	58
24142	0	0	0	65	0	65
24143	0	2	0	67	0	69
24144	0	0	69	0	0	69
24145	0	68	0	0	0	68
24146	0	68	0	0	0	68
24147	66	0	0	0	0	66
24148	0	66	0	0	0	66
24149	0	63	0	0	0	63
24150	0	0	0	63	0	63
24151	0	0	0	53	0	53
24152	0	0	0	62	0	62
24153	0	0	60	0	0	60
24154	0	62	0	0	0	62
24155	0	0	0	61	0	61
24156	0	62	0	0	0	62
24157	54	0	2	0	0	56
24158	0	63	0	0	0	63
24159	55	0	1	0	0	56
24160	0	0	58	0	0	58
24161	57	0	1	0	0	58
24162	0	2	0	57	0	59
24163	0	0	51	0	0	51
24164	54	0	0	0	0	54
24165	44	0	3	0	0	47
24166	43	0	0	0	0	43
24167	0	0	0	51	0	51
24168	0	0	47	0	0	47
24169	48	0	0	0	0	48
24170	0	1	0	44	0	45
24171	0	0	0	50	0	50
24172	0	0	48	0	0	48
24173	0	49	0	0	0	49
24174	0	2	0	46	0	48
24175	0	47	0	0	0	47
24176	45	0	1	1	0	47
24177	55	0	2	1	0	58
24178	0	0	0	60	0	60
24179	59	0	0	0	0	59
24180	0	62	0	0	0	62
24181	56	0	0	0	0	56
24182	0	68	0	0	0	68
24183	0	0	0	65	0	65
24184	1	0	0	65	0	66
24185	0	65	0	0	0	65
24186	0	0	0	66	0	66
24187	0	0	66	0	0	66
24188	0	69	0	0	0	69
24189	62	0	1	0	0	63
24190	0	73	0	0	0	73
24191	0	0	0	66	0	66
24192	0	0	82	0	0	82
24193	0	0	0	75	0	75
24194	0	1	0	80	0	81
24195	74	0	0	0	0	74
24196	0	0	83	0	0	83
24197	0	83	0	0	0	83
24198	0	0	79	0	0	79
24199	0	0	76	0	0	76
24200	0	0	86	0	0	86
24201	0	0	0	85	0	85
24202	87	0	1	0	0	88
24203	0	89	0	0	0	89
24204	80	0	0	0	0	80
24205	87	0	0	0	0	87
24206	0	0	0	87	0	87
24207	0	86	0	0	0	86
24208	87	0	3	0	0	90
24209	0	94	0	0	0	94
24210	0	0	0	83	0	83
24211	0	1	0	90	0	91
24212	0	93	0	0	0	93
24213	0	1	0	89	0	90
24214	0	0	92	0	0	92
24215	1	0	88	0	0	89
24216	0	1	0	90	0	91
24217	0	0	0	86	0	86
24218	0	0	90	0	0	90
24219	0	0	88	0	0	88
24220	87	0	0	0	0	87
24221	0	91	0	1	0	92
24222	0	89	0	0	0	89
24223	0	0	0	86	0	86
24224	0	0	0	83	0	83
24225	0	0	0	91	0	91
24226	1	0	88	0	0	89
24227	1	0	88	0	0	89
24228	0	0	0	94	0	94
24229	0	0	94	0	0	94
24230	0	91	0	0	0	91
24231	82	0	0	0	0	82
24232	0	0	83	0	0	83
24233	0	0	84	0	0	84
24234	0	0	0	89	0	89
24235	0	0	87	0	0	87
24236	0	90	0	0	0	90
24237	0	0	0	86	0	86
24238	0	0	87	0	0	87
24239	0	93	0	0	0	93
24240	91	0	0	0	0	91
24241	0	0	0	81	0	81
24242	0	0	0	85	0	85
24243	86	0	1	0	0	87
24244	0	88	0	0	0	88
24245	82	0	0	0	0	82
24246	81	0	0	0	0	81
24247	63	0	0	0	0	63
24248	0	0	0	65	0	65
24249	66	0	0	0	0	66
24250	0	66	0	0	0	66
24251	0	51	0	0	0	51
24252	52	0	0	0	0	52
24253	0	1	0	53	0	54
24254	2	2	0	48	0	52
24255	0	0	0	55	0	55
24256	0	0	52	0	0	52
24257	0	50	0	0	0	50
24258	0	0	0	45	0	45
24259	43	0	0	0	0	43
24260	0	0	0	45	0	45
24261	1	0	42	0	0	43
24262	0	45	0	0	0	45
24263	37	0	2	0	0	39
24264	40	0	0	0	0	40
24265	37	0	0	0	0	37
24266	0	0	0	41	0	41
24267	0	0	37	0	0	37
24268	0	0	43	0	0	43
24269	0	43	0	0	0	43
24270	0	0	0	43	0	43
24271	0	0	0	33	0	33
24272	44	0	0	0	0	44
24273	0	0	0	42	0	42
24274	43	0	0	0	0	43
24275	0	0	45	0	0	45
24276	0	0	40	0	0	40
24277	0	0	0	33	0	33
24278	0	0	0	33	0	33
24279	0	0	0	28	0	28
24280	38	0	0	0	0	38
24281	32	0	0	0	0	32
24282	0	0	0	37	0	37
24283	0	0	36	0	0	36
24284	0	0	34	0	0	34
24285	0	1	0	35	0	36
24286	34	0	0	0	0	34
24287	0	0	0	32	0	32
24288	0	0	0	34	0	34
24289	0	0	34	0	0	34
24290	0	0	37	0	0	37
24291	32	0	0	0	0	32
24292	0	0	37	0	0	37
24293	0	0	0	34	0	34
24294	0	0	0	32	0	32
24295	34	0	1	0	0	35
24296	0	36	0	0	0	36
24297	36	0	0	0	0	36
24298	0	38	0	0	0	38
24299	34	0	0	0	0	34
24300	0	0	39	0	0	39
24301	36	0	0	0	0	36
24302	35	0	0	0	0	35
24303	0	0	0	39	0	39
24304	0	0	40	0	0	40
24305	0	0	0	38	0	38
24306	0	0	0	36	0	36
24307	0	36	0	0	0	36
24308	0	0	0	38	0	38
24309	0	40	0	0	0	40
24310	0	0	0	38	0	38
24311	41	0	0	0	0	41
24312	0	0	0	36	0	36
24313	0	0	38	0	0	38
24314	38	0	1	0	0	39
24315	0	0	36	0	0	36
24316	34	0	0	0	0	34
24317	34	0	0	0	0	34
24318	0	40	0	0	0	40
24319	0	39	0	0	0	39
24320	36	0	0	0	0	36
24321	35	0	0	0	0	35
24322	38	0	0	0	0	38
24323	34	0	0	0	0	34
24324	36	0	0	0	0	36
24325	0	1	0	33	0	34
24326	0	0	0	37	0	37
24327	0	0	34	0	0	34
24328	35	0	1	0	0	36
24329	0	0	0	31	0	31
24330	0	0	0	33	0	33
24331	0	0	36	0	0	36
24332	0	32	0	0	0	32
24333	0	30	0	0	0	30
24334	31	0	0	0	0	31
24335	31	0	0	0	0	31
24336	0	34	0	0	0	34
24337	1	34	0	0	0	35
24338	35	0	0	0	0	35
24339	36	0	0	0	0	36
24340	0	0	0	39	0	39
24341	1	0	0	37	0	38
24342	0	0	0	40	0	40
24343	39	0	0	0	0	39
24344	38	0	0	0	0	38
24345	0	0	0	41	0	41
24346	38	0	0	0	0	38
24347	0	0	41	0	0	41
24348	0	1	0	37	0	38
24349	0	0	39	0	0	39
24350	0	40	0	0	0	40
24351	0	0	0	38	0	38
24352	35	0	0	0	0	35
24353	0	0	0	37	0	37
24354	0	0	0	37	0	37
24355	0	0	38	0	0	38
24356	0	0	35	0	0	35
24357	0	38	0	0	0	38
24358	36	0	0	0	0	36
24359	35	0	0	0	0	35
24360	39	0	0	0	0	39
24361	38	0	0	0	0	38
24362	0	0	0	42	0	42
24363	0	0	0	42	0	42
24364	0	38	0	0	0	38
24365	41	0	0	0	0	41
24366	39	0	1	0	0	40
24367	0	0	43	0	0	43
24368	41	0	0	0	0	41
24369	0	44	0	0	0	44
24370	0	0	0	41	0	41
24371	0	42	0	0	0	42
24372	40	0	0	0	0	40
24373	0	40	0	0	0	40
24374	0	0	0	37	0	37
24375	0	0	0	35	0	35
24376	0	0	0	43	0	43
24377	0	42	0	0	0	42
24378	0	1	0	42	0	43
24379	0	0	0	46	0	46
24380	0	42	0	0	0	42
24381	0	44	0	0	0	44
24382	44	0	0	0	0	44
24383	0	45	0	0	0	45
24384	43	0	0	0	0	43
24385	0	0	44	0	0	44
24386	0	42	0	0	0	42
24387	43	0	0	0	0	43
24388	42	0	0	0	0	42
24389	0	0	46	0	0	46
24390	1	0	0	48	0	49
24391	0	0	46	0	0	46
24392	0	49	0	0	0	49
24393	50	0	0	0	0	50
24394	0	47	0	0	0	47
24395	0	0	0	51	0	51
24396	0	0	0	48	0	48
24397	0	0	48	0	0	48
24398	0	0	48	0	0	48
24399	54	0	1	0	0	55
24400	52	0	0	0	0	52
24401	53	0	0	0	0	53
24402	54	0	0	0	0	54
24403	0	58	0	0	0	58
24404	0	0	0	52	0	52
24405	0	0	0	52	0	52
24406	0	56	0	0	0	56
24407	50	0	0	0	0	50
24408	52	0	0	0	0	52
24409	0	0	54	0	0	54
24410	56	0	0	0	0	56
24411	0	0	0	56	0	56
24412	0	0	56	0	0	56
24413	0	0	0	55	0	55
24414	0	0	51	0	0	51
24415	0	0	58	0	0	58
24416	0	1	0	54	0	55
24417	0	53	0	2	0	55
24418	51	0	2	0	0	53
24419	57	0	0	0	0	57
24420	0	61	0	0	0	61
24421	0	61	0	0	0	61
24422	60	0	1	0	0	61
24423	58	0	1	0	0	59
24424	60	0	0	0	0	60
24425	59	0	0	0	0	59
24426	0	0	0	60	0	60
24427	0	0	60	0	0	60
24428	0	59	0	0	0	59
24429	64	0	0	0	0	64
24430	0	64	0	0	0	64
24431	61	0	0	0	0	61
24432	63	0	0	0	0	63
24433	0	0	67	0	0	67
24434	0	65	0	0	0	65
24435	0	0	0	62	0	62
24436	0	0	0	60	0	60
24437	0	0	0	64	0	64
24438	63	0	0	0	0	63
24439	61	0	0	0	0	61
24440	63	0	0	0	0	63
24441	0	66	0	0	0	66
24442	59	0	2	0	0	61
24443	0	65	0	0	0	65
24444	0	0	62	0	0	62
24445	0	65	0	0	0	65
24446	0	0	0	66	0	66
24447	0	0	0	64	0	64
24448	0	0	70	0	0	70
24449	0	0	0	65	0	65
24450	0	0	0	68	0	68
24451	69	0	1	0	0	70
24452	62	0	0	0	0	62
24453	64	0	0	0	0	64
24454	0	70	0	0	0	70
24455	68	0	0	0	0	68
24456	65	0	0	0	0	65
24457	0	69	0	0	0	69
24458	0	0	0	63	0	63
24459	0	0	0	62	0	62
24460	62	0	0	1	0	63
24461	0	0	66	0	0	66
24462	0	65	0	0	0	65
24463	0	0	0	67	0	67
24464	0	61	0	0	0	61
24465	0	66	0	0	0	66
24466	62	0	0	0	0	62
24467	60	0	0	0	0	60
24468	0	3	0	59	0	62
24469	0	0	0	62	0	62
24470	0	0	0	62	0	62
24471	0	0	0	64	0	64
24472	0	0	62	0	0	62
24473	0	0	62	0	0	62
24474	0	0	0	64	0	64
24475	0	0	62	0	0	62
24476	0	60	1	0	0	61
24477	65	0	0	0	0	65
24478	58	0	0	0	0	58
24479	0	0	0	57	0	57
24480	1	0	0	61	0	62
24481	0	0	0	72	0	72
24482	0	69	0	0	0	69
24483	70	0	0	0	0	70
24484	63	0	0	0	0	63
24485	0	0	70	0	0	70
24486	0	0	0	66	0	66
24487	0	0	68	0	0	68
24488	0	0	0	53	0	53
24489	1	0	0	56	0	57
24490	0	0	0	55	0	55
24491	0	0	0	63	0	63
24492	61	0	0	0	0	61
24493	60	1	0	0	0	61
24494	57	0	0	0	0	57
24495	1	0	0	64	0	65
24496	0	0	93	0	0	93
24497	94	0	0	0	0	94
24498	0	0	0	104	0	104
24499	103	0	1	0	0	104
24500	0	1	0	128	0	129
24501	0	135	0	3	0	138
24502	7	134	1	9	0	151
24503	2	0	0	153	0	155
24504	3	3	0	146	0	152
24505	1	5	0	159	0	165
24506	0	152	2	5	0	159
24507	145	4	9	0	0	158
24508	0	174	0	0	0	174
24509	0	0	175	0	0	175
24510	0	0	0	161	0	161
24511	0	176	0	0	0	176
24512	0	2	0	169	0	171
24513	0	0	0	172	0	172
24514	0	0	181	0	0	181
24515	183	0	1	0	0	184
24516	0	191	0	2	0	193
24517	179	0	0	0	0	179
24518	160	0	5	2	0	167
24519	200	0	0	1	0	201
24520	0	0	211	0	0	211
24521	0	0	0	198	0	198
24522	0	4	0	196	0	200
24523	2	0	202	0	0	204
24524	210	0	0	0	0	210
24525	0	0	219	0	0	219
24526	0	0	219	0	0	219
24527	0	236	0	0	0	236
24528	1	4	0	221	0	226
24529	2	0	222	0	0	224
24530	220	0	0	0	0	220
24531	216	0	4	1	0	221
24532	0	0	247	0	0	247
24533	0	0	0	243	0	243
24534	0	0	247	0	0	247
24535	0	259	0	2	0	261
24536	245	0	1	0	0	246
24537	232	0	2	0	0	234
24538	237	0	1	0	0	238
24539	0	0	0	287	0	287
24540	1	1	0	304	0	306
24541	0	0	305	0	0	305
24542	300	0	4	0	0	304
24543	0	1	0	290	0	291
24544	294	0	3	1	0	298
24545	0	0	309	0	0	309
24546	0	0	324	0	0	324
24547	1	0	0	299	0	300
24548	0	0	0	305	0	305
24549	0	0	315	0	0	315
24550	334	1	2	0	0	337
24551	4	5	0	323	0	332
24552	0	344	0	0	0	344
24553	335	0	0	0	0	335
24554	0	353	0	0	0	353
24555	320	0	0	0	0	320
24556	0	0	340	0	0	340
24557	0	0	333	0	0	333
24558	0	341	0	2	0	343
24559	330	0	0	0	0	330
24560	0	0	347	0	0	347
24561	348	0	0	1	0	349
24562	0	375	0	0	0	375
24563	0	1	0	346	0	347
24564	0	5	0	345	0	350
24565	0	356	0	1	0	357
24566	357	0	1	1	0	359
24567	329	0	0	1	0	330
24568	345	0	1	0	0	346
24569	0	0	372	0	0	372
24570	0	2	0	349	0	351
24571	0	1	0	330	0	331
24572	0	1	0	352	0	353
24573	0	0	354	0	0	354
24574	0	360	0	0	0	360
24575	346	0	2	0	0	348
24576	0	0	362	0	0	362
24577	372	0	0	1	0	373
24578	0	381	0	1	0	382
24579	374	0	2	0	0	376
24580	0	2	1	366	0	369
24581	353	1	1	0	0	355
24582	0	0	0	383	0	383
24583	0	0	384	0	0	384
24584	0	2	0	373	0	375
24585	0	0	380	0	0	380
24586	366	0	0	0	0	366
24587	0	380	0	0	0	380
24588	1	1	0	334	0	336
24589	0	363	0	0	0	363
24590	343	0	1	2	0	346
24591	340	1	2	0	0	343
24592	0	379	0	1	0	380
24593	354	0	2	0	0	356
24594	325	0	2	0	0	327
24595	0	0	0	350	0	350
24596	0	3	0	354	0	357
24597	351	0	4	0	0	355
24598	340	0	2	0	0	342
24599	1	0	0	344	0	345
24600	1	4	0	354	0	359
24601	338	0	3	0	0	341
24602	1	0	348	0	0	349
24603	331	0	4	0	0	335
24604	0	0	347	0	0	347
24605	0	338	0	0	0	338
24606	0	0	0	325	0	325
24607	1	0	337	0	0	338
24608	0	340	6	0	0	346
24609	323	1	0	0	0	324
24610	0	0	333	0	0	333
24611	314	0	0	2	0	316
24612	306	0	5	2	0	313
24613	300	0	3	1	0	304
24614	0	2	0	324	0	326
24615	0	331	0	0	0	331
24616	307	0	0	0	0	307
24617	1	0	323	0	0	324
24618	322	0	1	1	0	324
24619	0	0	335	0	0	335
24620	0	334	0	0	0	334
24621	0	1	0	278	0	279
24622	0	3	0	308	0	311
24623	0	344	0	0	0	344
24624	1	3	3	319	0	326
24625	2	0	344	0	0	346
24626	0	345	0	1	0	346
24627	1	5	0	339	0	345
24628	332	0	0	5	0	337
24629	328	0	0	0	0	328
24630	0	1	0	374	0	375
24631	0	394	0	0	0	394
24632	2	3	0	356	0	361
24633	3	0	1	376	0	380
24634	8	0	364	1	0	373
24635	0	401	4	3	0	408
24636	0	2	0	388	0	390
24637	7	0	395	7	0	409
24638	0	407	0	0	0	407
24639	0	3	0	390	0	393
24640	413	0	0	0	0	413
24641	0	425	0	0	0	425
24642	0	0	0	411	0	411
24643	397	0	1	0	0	398
24644	382	0	5	0	0	387
24645	389	0	3	1	0	393
24646	397	0	2	0	0	399
24647	0	2	0	433	0	435
24648	6	0	435	0	0	441
24649	0	0	0	411	0	411
24650	0	418	0	1	0	419
24651	402	0	2	1	0	405
24652	0	0	422	0	0	422
24653	407	0	1	0	0	408
24654	0	0	437	0	0	437
24655	0	0	1	417	0	418
24656	2	0	442	0	0	444
24657	0	1	0	431	0	432
24658	0	0	451	0	0	451
24659	0	0	0	461	0	461
24660	462	0	0	0	0	462
24661	0	475	0	0	0	475
24662	1	0	0	447	0	448
24663	0	4	0	447	0	451
24664	0	0	433	0	0	433
24665	0	0	453	1	0	454
24666	445	1	3	0	0	449
24667	0	471	0	0	0	471
24668	435	0	3	0	0	438
24669	425	0	1	2	0	428
24670	0	2	0	456	0	458
24671	0	464	0	1	0	465
24672	429	0	1	0	0	430
24673	412	0	1	0	0	413
24674	405	0	2	0	0	407
24675	391	0	1	0	0	392
24676	403	0	1	0	0	404
24677	0	0	444	0	0	444
24678	424	0	0	1	0	425
24679	1	0	442	0	0	443
24680	2	0	0	395	0	397
24681	0	2	0	414	0	416
24682	0	0	429	0	0	429
24683	435	0	2	0	0	437
24684	0	2	0	353	0	355
24685	1	2	0	375	0	378
24686	0	3	0	404	0	407
24687	0	1	0	414	0	415
24688	1	0	0	426	0	427
24689	0	0	423	0	0	423
24690	1	1	0	414	0	416
24691	0	0	418	0	0	418
24692	0	0	413	0	0	413
24693	402	0	2	3	0	407
24694	375	0	4	0	0	379
24695	390	0	1	0	0	391
24696	0	0	422	0	0	422
24697	0	0	411	0	0	411
24698	0	0	429	0	0	429
24699	0	432	0	0	0	432
24700	0	2	0	429	0	431
24701	423	0	3	0	0	426
24702	0	0	0	425	0	425
24703	0	440	0	2	0	442
24704	442	1	0	0	0	443
24705	0	2	1	485	0	488
24706	0	538	0	3	0	541
24707	0	2	0	512	0	514
24708	0	3	0	520	0	523
24709	528	0	0	2	0	530
24710	0	3	1	550	0	554
24711	2	0	576	1	0	579
24712	0	1	0	558	0	559
24713	0	555	0	0	0	555
24714	0	552	0	1	0	553
24715	0	2	0	524	0	526
24716	0	0	0	544	0	544
24717	0	539	0	0	0	539
24718	0	568	0	0	0	568
24719	0	563	0	0	0	563
24720	1	3	0	586	0	590
24721	0	607	0	1	0	608
24722	572	0	2	0	0	574
24723	1	1	629	0	0	631
24724	0	2	0	619	0	621
24725	0	635	0	1	0	636
24726	576	0	3	1	0	580
24727	1	0	641	0	0	642
24728	0	656	0	0	0	656
24729	623	0	2	0	0	625
24730	0	676	0	7	0	683
24731	2	659	0	1	0	662
24732	2	7	0	673	0	682
24733	0	705	0	3	0	708
24734	672	0	6	1	0	679
24735	0	4	0	699	0	703
24736	0	0	702	0	0	702
24737	1	1	767	1	0	770
24738	1	2	0	738	0	741
24739	0	0	766	1	0	767
24740	4	5	0	752	0	761
24741	764	0	1	0	0	765
24742	1	0	783	0	0	784
24743	0	1	0	776	0	777
24744	0	750	0	7	0	757
24745	0	6	0	726	0	732
24746	0	3	0	736	0	739
24747	0	684	0	0	0	684
24748	0	1	0	732	0	733
24749	0	1	0	742	0	743
24750	1	0	710	0	0	711
24751	0	723	0	1	0	724
24752	700	0	1	0	0	701
24753	0	4	0	738	0	742
24754	3	0	745	0	0	748
24755	1	4	0	733	0	738
24756	0	0	716	0	0	716
24757	730	0	0	1	0	731
24758	0	768	0	0	0	768
24759	2	4	0	720	0	726
24760	2	1	0	687	0	690
24761	684	0	0	0	0	684
24762	0	4	0	755	0	759
24763	0	0	749	0	0	749
24764	1	2	0	729	0	732
24765	0	722	0	1	0	723
24766	1	676	0	1	0	678
24767	0	723	0	2	0	725
24768	1	4	0	704	0	709
24769	0	0	725	0	0	725
24770	0	749	0	0	0	749
24771	723	0	1	2	0	726
24772	0	739	1	1	0	741
24773	659	0	2	2	0	663
24774	652	0	2	0	0	654
24775	0	0	677	0	0	677
24776	690	0	1	1	0	692
24777	648	1	3	0	0	652
24778	620	0	3	0	0	623
24779	641	0	5	2	0	648
24780	1	0	687	0	0	688
24781	660	0	2	0	0	662
24782	626	0	2	1	0	629
24783	0	710	0	0	0	710
24784	0	4	0	627	0	631
24785	2	2	0	648	0	652
24786	0	651	0	1	0	652
24787	665	0	4	0	0	669
24788	0	703	1	0	0	704
24789	626	0	5	0	0	631
24790	637	0	3	0	0	640
24791	1	693	0	0	0	694
24792	0	1	0	673	0	674
24793	0	0	676	0	0	676
24794	0	673	0	1	0	674
24795	0	3	0	661	0	664
24796	0	615	0	0	0	615
24797	0	596	1	1	0	598
24798	0	3	0	649	0	652
24799	0	0	650	0	0	650
24800	0	647	0	0	0	647
24801	0	638	0	1	0	639
24802	636	0	1	1	0	638
24803	0	1	0	585	0	586
24804	0	0	1	607	0	608
24805	0	1	0	630	0	631
24806	0	0	659	1	0	660
24807	0	2	0	604	0	606
24808	0	624	0	2	0	626
24809	598	1	0	2	0	601
24810	1	2	0	608	0	611
24811	1	0	598	0	0	599
24812	601	0	4	2	0	607
24813	0	0	0	633	0	633
24814	2	0	609	0	0	611
24815	1	1	632	0	0	634
24816	646	0	1	0	0	647
24817	620	0	2	0	0	622
24818	584	0	0	3	0	587
24819	630	0	4	0	0	634
24820	2	1	672	0	0	675
24821	1	693	0	0	0	694
24822	690	0	1	0	0	691
24823	0	709	0	2	0	711
24824	686	1	3	1	0	691
24825	0	726	0	0	0	726
24826	1	7	2	650	0	660
24827	0	4	0	648	0	652
24828	0	1	0	733	0	734
24829	0	734	0	1	0	735
24830	0	752	0	0	0	752
24831	0	2	0	751	0	753
24832	0	770	1	0	0	771
24833	4	0	785	0	0	789
24834	0	1	0	772	0	773
24835	0	0	749	0	0	749
24836	759	0	0	0	0	759
24837	736	0	2	0	0	738
24838	1	0	771	1	0	773
24839	0	0	814	0	0	814
24840	1	3	0	781	0	785
24841	0	0	825	0	0	825
24842	0	3	0	769	0	772
24843	0	791	0	0	0	791
24844	2	1	0	764	0	767
24845	2	3	0	730	0	735
24846	0	6	0	748	0	754
24847	0	0	813	0	0	813
24848	0	7	0	734	0	741
24849	0	6	0	738	0	744
24850	0	1	0	772	0	773
24851	0	785	0	0	0	785
24852	765	0	3	1	0	769
24853	754	0	3	0	0	757
24854	727	0	1	0	0	728
24855	5	2	0	766	0	773
24856	0	0	732	0	0	732
24857	0	0	746	0	0	746
24858	0	745	0	2	0	747
24859	769	0	1	1	0	771
24860	0	766	0	0	0	766
24861	740	1	7	0	0	748
24862	0	766	0	0	0	766
24863	740	0	2	0	0	742
24864	0	759	0	2	0	761
24865	3	3	0	712	0	718
24866	1	0	718	0	0	719
24867	0	0	735	0	0	735
24868	0	2	0	684	0	686
24869	2	8	0	685	0	695
24870	0	2	0	702	0	704
24871	2	0	729	0	0	731
24872	2	1	0	676	0	679
24873	687	0	1	2	0	690
24874	664	0	9	2	0	675
24875	0	682	0	0	0	682
24876	649	0	3	1	0	653
24877	0	656	0	0	0	656
24878	626	1	1	0	0	628
24879	586	0	2	2	0	590
24880	599	2	4	0	0	605
24881	1	0	577	0	0	578
24882	1	0	574	0	0	575
24883	586	0	1	0	0	587
24884	534	0	0	0	0	534
24885	0	2	0	509	0	511
24886	1	3	0	528	0	532
24887	2	3	0	529	0	534
24888	0	1	0	522	0	523
24889	0	2	0	525	0	527
24890	527	0	2	1	0	530
24891	3	1	0	548	0	552
24892	1	0	566	0	0	567
24893	528	0	1	0	0	529
24894	534	0	1	0	0	535
24895	0	588	0	2	0	590
24896	0	581	0	0	0	581
24897	585	0	1	0	0	586
24898	0	586	0	3	0	589
24899	593	0	3	0	0	596
24900	576	0	4	0	0	580
24901	540	0	2	0	0	542
24902	0	0	0	626	0	626
24903	0	635	0	0	0	635
24904	622	0	3	0	0	625
24905	0	7	0	579	0	586
24906	1	1	0	645	0	647
24907	665	0	4	1	0	670
24908	0	688	0	0	0	688
24909	0	0	1	678	0	679
24910	657	0	2	0	0	659
24911	0	686	0	0	0	686
24912	638	0	4	0	0	642
24913	0	0	696	0	0	696
24914	635	0	2	0	0	637
24915	0	673	0	3	0	676
24916	612	0	2	1	0	615
24917	633	0	1	0	0	634
24918	0	689	0	1	0	690
24919	680	0	0	0	0	680
24920	0	693	0	1	0	694
24921	671	0	3	0	0	674
24922	0	5	0	632	0	637
24923	3	1	0	643	0	647
24924	0	1	0	644	0	645
24925	1	0	682	0	0	683
24926	0	3	0	652	0	655
24927	2	0	670	4	0	676
24928	0	3	0	647	0	650
24929	0	658	0	1	0	659
24930	3	1	0	606	0	610
24931	0	0	664	0	0	664
24932	0	0	671	0	0	671
24933	1	1	0	601	0	603
24934	681	0	0	0	0	681
24935	682	0	2	0	0	684
24936	0	687	0	0	0	687
24937	2	3	0	648	0	653
24938	2	0	701	0	0	703
24939	0	5	0	665	0	670
24940	1	0	643	0	0	644
24941	685	0	1	0	0	686
24942	2	7	0	679	0	688
24943	1	0	714	0	0	715
24944	4	7	0	640	0	651
24945	0	1	0	683	0	684
24946	0	0	707	0	0	707
24947	0	0	0	670	0	670
24948	689	0	3	0	0	692
24949	624	0	0	0	0	624
24950	0	3	0	670	0	673
24951	673	0	0	0	0	673
24952	1	0	663	0	0	664
24953	2	0	608	0	0	610
24954	656	0	2	0	0	658
24955	599	0	3	0	0	602
24956	0	4	0	589	0	593
24957	0	1	0	609	0	610
24958	1	0	628	0	0	629
24959	0	2	0	623	0	625
24960	0	617	0	1	0	618
24961	581	0	6	1	0	588
24962	587	0	3	0	0	590
24963	0	627	0	3	0	630
24964	600	0	0	2	0	602
24965	567	0	5	0	0	572
24966	0	622	0	0	0	622
24967	575	0	3	0	0	578
24968	2	590	0	0	0	592
24969	558	0	1	5	0	564
24970	0	1	535	0	0	536
24971	0	2	0	527	0	529
24972	1	2	0	510	0	513
24973	2	1	0	476	0	479
24974	536	0	2	0	0	538
24975	1	1	0	513	0	515
24976	0	0	537	0	0	537
24977	508	0	2	1	0	511
24978	0	0	0	484	0	484
24979	0	425	1	1	0	427
24980	0	411	0	0	0	411
24981	0	1	0	372	0	373
24982	0	3	0	357	0	360
24983	1	4	0	379	0	384
24984	2	0	402	0	0	404
24985	0	404	0	0	0	404
24986	381	0	1	0	0	382
24987	362	2	1	0	0	365
24988	0	390	0	0	0	390
24989	0	374	0	0	0	374
24990	2	4	1	364	0	371
24991	0	0	363	0	0	363
24992	389	0	1	0	0	390
24993	339	0	2	1	0	342
24994	0	1	0	341	0	342
24995	0	2	0	373	0	375
24996	383	0	0	0	0	383
24997	1	0	386	0	0	387
24998	360	0	1	1	0	362
24999	0	385	0	5	0	390
25000	0	1	0	346	0	347
25001	0	360	0	0	0	360
25002	353	0	0	0	0	353
25003	0	0	0	320	0	320
25004	0	0	0	344	0	344
25005	0	350	0	2	0	352
25006	350	0	0	0	0	350
25007	333	0	1	0	0	334
25008	0	0	348	0	0	348
25009	0	0	343	0	0	343
25010	331	0	1	0	0	332
25011	0	0	334	0	0	334
25012	0	0	315	0	0	315
25013	324	0	1	0	0	325
25014	0	0	303	1	0	304
25015	7	3	0	254	0	264
25016	1	0	0	256	0	257
25017	258	0	1	0	0	259
25018	0	0	261	0	0	261
25019	262	0	5	0	0	267
25020	1	1	0	243	0	245
25021	245	0	2	1	0	248
25022	236	0	2	0	0	238
25023	238	0	0	0	0	238
25024	0	0	0	243	0	243
25025	239	0	0	0	0	239
25026	1	1	0	240	0	242
25027	0	0	0	234	0	234
25028	0	0	0	225	0	225
25029	0	1	0	227	0	228
25030	233	0	0	0	0	233
25031	239	0	1	0	0	240
25032	0	0	249	0	0	249
25033	251	0	1	0	0	252
25034	235	0	0	0	0	235
25035	0	0	0	263	0	263
25036	0	270	0	0	0	270
25037	269	0	0	0	0	269
25038	0	1	0	271	0	272
25039	265	0	0	0	0	265
25040	0	282	0	0	0	282
25041	257	0	4	0	0	261
25042	0	1	0	260	0	261
25043	0	254	0	1	0	255
25044	278	1	0	1	0	280
25045	0	292	0	0	0	292
25046	0	282	0	0	0	282
25047	276	0	4	0	0	280
25048	0	0	277	0	0	277
25049	266	0	1	0	0	267
25050	1	0	0	278	0	279
25051	2	0	271	0	0	273
25052	0	2	1	252	0	255
25053	0	0	0	243	0	243
25054	1	0	263	0	0	264
25055	266	0	0	0	0	266
25056	0	2	0	239	0	241
25057	0	0	0	248	0	248
25058	0	0	0	254	0	254
25059	259	0	0	0	0	259
25060	0	0	259	0	0	259
25061	0	0	268	0	0	268
25062	0	0	1	261	0	262
25063	2	0	259	0	0	261
25064	255	0	1	0	0	256
25065	0	263	0	6	0	269
25066	261	0	0	0	0	261
25067	0	4	0	264	0	268
25068	0	253	0	0	0	253
25069	3	0	0	262	0	265
25070	2	265	0	2	0	269
25071	3	0	0	268	0	271
25072	0	0	277	0	0	277
25073	0	0	276	0	0	276
25074	0	277	0	0	0	277
25075	281	0	1	0	0	282
25076	0	0	0	249	0	249
25077	0	1	0	254	0	255
25078	251	0	2	1	0	254
25079	244	0	0	0	0	244
25080	0	4	0	257	0	261
25081	0	0	266	0	0	266
25082	0	266	1	0	0	267
25083	0	0	0	242	0	242
25084	1	1	0	247	0	249
25085	0	258	0	0	0	258
25086	250	0	3	0	0	253
25087	0	0	262	0	0	262
25088	1	1	1	255	0	258
25089	0	1	0	251	0	252
25090	0	0	259	0	0	259
25091	0	2	0	238	0	240
25092	234	0	0	0	0	234
25093	216	0	0	0	0	216
25094	216	1	4	0	0	221
25095	0	245	0	0	0	245
25096	228	0	0	0	0	228
25097	0	3	1	223	0	227
25098	0	8	0	231	0	239
25099	0	241	0	0	0	241
25100	235	0	1	0	0	236
25101	234	0	0	0	0	234
25102	229	0	1	0	0	230
25103	224	0	0	0	0	224
25104	237	0	2	0	0	239
25105	0	0	260	0	0	260
25106	255	0	2	0	0	257
25107	241	0	2	1	0	244
25108	237	0	0	0	0	237
25109	0	0	0	237	0	237
25110	0	1	0	257	0	258
25111	0	0	262	0	0	262
25112	257	0	0	1	0	258
25113	0	264	0	0	0	264
25114	0	232	0	1	0	233
25115	0	0	256	0	0	256
25116	0	276	0	0	0	276
25117	0	279	0	0	0	279
25118	0	1	0	278	0	279
25119	0	300	0	0	0	300
25120	296	0	0	0	0	296
25121	277	0	2	0	0	279
25122	0	0	0	297	0	297
25123	1	0	302	2	0	305
25124	289	0	3	0	0	292
25125	0	0	290	0	0	290
25126	0	0	294	0	0	294
25127	0	1	0	280	0	281
25128	0	2	0	285	0	287
25129	0	0	298	0	0	298
25130	0	291	0	0	0	291
25131	1	281	0	0	0	282
25132	285	0	0	0	0	285
25133	284	0	0	0	0	284
25134	0	0	296	0	0	296
25135	294	0	2	0	0	296
25136	283	0	3	0	0	286
25137	0	0	0	284	0	284
25138	0	0	0	300	0	300
25139	1	1	0	290	0	292
25140	304	0	1	0	0	305
25141	292	0	0	0	0	292
25142	290	0	0	0	0	290
25143	0	0	2	301	0	303
25144	0	0	309	0	0	309
25145	305	0	0	1	0	306
25146	276	0	1	0	0	277
25147	0	0	0	303	0	303
25148	0	302	0	0	0	302
25149	0	2	0	300	0	302
25150	0	306	0	0	0	306
25151	0	1	0	294	0	295
25152	0	303	0	0	0	303
25153	294	0	2	0	0	296
25154	0	3	0	296	0	299
25155	0	299	0	0	0	299
25156	0	0	294	0	0	294
25157	302	0	0	0	0	302
25158	0	0	0	306	0	306
25159	0	305	0	0	0	305
25160	1	3	0	308	0	312
25161	0	310	1	0	0	311
25162	0	313	0	0	0	313
25163	310	0	1	1	0	312
25164	305	0	0	0	0	305
25165	1	0	318	0	0	319
25166	308	0	6	0	0	314
25167	301	0	0	0	0	301
25168	0	320	0	0	0	320
25169	0	1	0	295	0	296
25170	0	3	0	303	0	306
25171	0	0	313	0	0	313
25172	0	0	308	0	0	308
25173	322	0	0	0	0	322
25174	312	0	1	2	0	315
25175	306	0	1	2	0	309
25176	0	0	328	0	0	328
25177	2	0	0	306	0	308
25178	311	0	0	0	0	311
25179	1	0	0	311	0	312
25180	0	0	313	0	0	313
25181	305	0	0	0	0	305
25182	0	0	312	0	0	312
25183	0	313	0	0	0	313
25184	300	0	2	0	0	302
25185	0	0	345	0	0	345
25186	0	0	0	317	0	317
25187	351	0	1	0	0	352
25188	2	0	0	336	0	338
25189	336	0	2	0	0	338
25190	0	0	0	345	0	345
25191	339	1	0	0	0	340
25192	326	0	4	1	0	331
25193	325	0	2	0	0	327
25194	263	0	0	0	0	263
25195	0	0	0	247	0	247
25196	0	0	237	0	0	237
25197	3	0	241	0	0	244
25198	0	250	0	0	0	250
25199	0	239	0	1	0	240
25200	241	0	1	0	0	242
25201	0	0	0	232	0	232
25202	0	0	242	0	0	242
25203	1	0	243	0	0	244
25204	1	1	0	236	0	238
25205	241	1	0	0	0	242
25206	0	246	0	0	0	246
25207	235	0	1	0	0	236
25208	0	0	0	221	0	221
25209	1	2	0	217	0	220
25210	0	0	0	228	0	228
25211	0	0	225	0	0	225
25212	0	0	228	0	0	228
25213	0	230	0	0	0	230
25214	0	0	0	221	0	221
25215	230	0	0	0	0	230
25216	1	0	226	0	0	227
25217	0	0	238	1	0	239
25218	0	2	0	220	0	222
25219	0	0	0	208	0	208
25220	2	0	0	215	0	217
25221	0	0	0	225	0	225
25222	214	0	1	3	0	218
25223	0	0	0	225	0	225
25224	233	0	0	0	0	233
25225	0	0	227	0	0	227
25226	0	230	0	0	0	230
25227	0	0	0	224	0	224
25228	0	0	230	0	0	230
25229	0	0	227	0	0	227
25230	0	233	0	2	0	235
25231	0	0	0	223	0	223
25232	0	1	0	222	0	223
25233	1	0	234	0	0	235
25234	228	0	1	1	0	230
25235	0	5	0	214	0	219
25236	1	0	0	229	0	230
25237	0	0	231	0	0	231
25238	0	235	0	0	0	235
25239	0	230	0	0	0	230
25240	237	0	1	0	0	238
25241	0	0	0	241	0	241
25242	251	0	0	1	0	252
25243	0	0	265	0	0	265
25244	0	3	0	256	0	259
25245	265	0	0	1	0	266
25246	228	0	1	0	0	229
25247	0	0	0	246	0	246
25248	0	0	251	0	0	251
25249	0	0	255	0	0	255
25250	0	1	0	238	0	239
25251	0	0	241	0	0	241
25252	233	0	1	1	0	235
25253	0	249	0	1	0	250
25254	247	0	1	0	0	248
25255	211	0	1	0	0	212
25256	0	1	0	245	0	246
25257	0	1	0	246	0	247
25258	229	1	0	0	0	230
25259	0	0	0	254	0	254
25260	2	0	252	0	0	254
25261	0	257	0	0	0	257
25262	0	0	0	229	0	229
25263	0	1	0	234	0	235
25264	1	0	0	239	0	240
25265	0	0	251	0	0	251
25266	0	257	0	0	0	257
25267	0	1	0	243	0	244
25268	0	0	262	0	0	262
25269	0	2	0	240	0	242
25270	254	0	0	0	0	254
25271	1	0	0	250	0	251
25272	0	0	259	0	0	259
25273	249	0	1	0	0	250
25274	0	259	0	0	0	259
25275	0	241	0	1	0	242
25276	248	0	1	0	0	249
25277	0	0	251	0	0	251
25278	0	1	0	231	0	232
25279	0	0	0	234	0	234
25280	2	0	235	1	0	238
25281	0	248	0	1	0	249
25282	0	0	0	241	0	241
25283	0	0	249	0	0	249
25284	0	0	0	240	0	240
25285	242	0	0	0	0	242
25286	0	0	247	0	0	247
25287	0	1	0	229	0	230
25288	0	0	0	215	0	215
25289	0	0	219	0	0	219
25290	0	2	0	230	0	232
25291	0	237	0	0	0	237
25292	0	0	1	225	0	226
25293	0	230	0	2	0	232
25294	217	0	0	0	0	217
25295	211	0	0	0	0	211
25296	0	0	228	0	0	228
25297	0	0	222	0	0	222
25298	2	0	222	0	0	224
25299	0	223	0	0	0	223
25300	0	0	0	205	0	205
25301	0	0	225	0	0	225
25302	0	1	0	204	0	205
25303	0	1	0	204	0	205
25304	0	0	218	0	0	218
25305	2	0	0	206	0	208
25306	0	2	0	208	0	210
25307	0	220	0	0	0	220
25308	0	1	1	208	0	210
25309	1	5	1	189	0	196
25310	0	0	215	0	0	215
25311	2	1	0	197	0	200
25312	1	0	210	0	0	211
25313	0	0	210	0	0	210
25314	204	0	0	0	0	204
25315	0	1	0	206	0	207
25316	0	211	0	0	0	211
25317	0	205	0	0	0	205
25318	2	0	0	184	0	186
25319	0	0	207	0	0	207
25320	0	214	0	0	0	214
25321	3	4	0	187	0	194
25322	0	0	220	0	0	220
25323	0	186	0	0	0	186
25324	218	0	0	0	0	218
25325	208	0	0	0	0	208
25326	194	0	0	2	0	196
25327	0	0	0	223	0	223
25328	0	0	0	228	0	228
25329	3	0	1	188	0	192
25330	0	0	218	0	0	218
25331	228	0	0	0	0	228
25332	3	0	0	196	0	199
25333	1	0	238	0	0	239
25334	258	0	2	0	0	260
25335	231	0	5	0	0	236
25336	0	2	207	0	0	209
25337	267	0	0	0	0	267
25338	0	267	0	0	0	267
25339	0	0	272	0	0	272
25340	275	0	0	0	0	275
25341	0	284	0	0	0	284
25342	2	0	0	273	0	275
25343	0	264	0	0	0	264
25344	1	0	0	270	0	271
25345	0	0	289	0	0	289
25346	270	0	1	0	0	271
25347	0	0	284	0	0	284
25348	0	281	0	0	0	281
25349	0	277	0	2	0	279
25350	270	0	2	0	0	272
25351	1	0	283	0	0	284
25352	0	1	0	275	0	276
25353	2	0	286	0	0	288
25354	0	284	0	0	0	284
25355	0	0	0	284	0	284
25356	0	278	0	0	0	278
25357	283	0	0	0	0	283
25358	281	0	0	0	0	281
25359	262	0	2	0	0	264
25360	0	0	276	0	0	276
25361	0	0	273	0	0	273
25362	262	0	0	0	0	262
25363	0	0	270	0	0	270
25364	0	0	0	263	0	263
25365	0	265	0	0	0	265
25366	258	0	2	0	0	260
25367	258	0	3	0	0	261
25368	252	0	0	0	0	252
25369	1	2	0	243	0	246
25370	1	0	0	250	0	251
25371	242	0	0	0	0	242
25372	0	247	0	0	0	247
25373	236	0	1	0	0	237
25374	2	2	0	216	0	220
25375	0	1	0	223	0	224
25376	218	0	0	0	0	218
25377	0	240	0	0	0	240
25378	214	0	1	0	0	215
25379	0	228	0	0	0	228
25380	197	0	0	0	0	197
25381	0	1	0	208	0	209
25382	197	0	0	0	0	197
25383	195	0	0	0	0	195
25384	188	0	2	2	0	192
25385	0	202	0	0	0	202
25386	1	0	188	0	0	189
25387	188	0	1	0	0	189
25388	177	0	0	0	0	177
25389	0	192	0	0	0	192
25390	0	1	0	164	0	165
25391	0	0	0	171	0	171
25392	170	0	1	0	0	171
25393	0	0	0	176	0	176
25394	0	0	174	0	0	174
25395	0	0	176	0	0	176
25396	171	0	1	0	0	172
25397	0	0	0	157	0	157
25398	0	0	0	146	0	146
25399	0	0	0	149	0	149
25400	0	0	167	0	0	167
25401	0	0	0	149	0	149
25402	0	0	0	146	0	146
25403	0	1	0	147	0	148
25404	155	0	0	0	0	155
25405	1	0	0	149	0	150
25406	0	0	157	0	0	157
25407	154	0	0	0	0	154
25408	0	0	145	0	0	145
25409	130	0	0	0	0	130
25410	126	0	1	0	0	127
25411	0	0	0	139	0	139
25412	0	139	0	0	0	139
25413	1	1	0	124	0	126
25414	0	1	0	130	0	131
25415	0	135	0	0	0	135
25416	134	0	1	0	0	135
25417	0	138	0	0	0	138
25418	132	0	0	0	0	132
25419	120	0	0	0	0	120
25420	0	0	0	122	0	122
25421	0	0	0	131	0	131
25422	1	0	131	0	0	132
25423	0	0	121	0	0	121
25424	124	0	0	0	0	124
25425	120	0	0	0	0	120
25426	0	132	0	0	0	132
25427	0	0	0	123	0	123
25428	0	0	128	0	0	128
25429	0	1	0	116	0	117
25430	114	0	0	0	0	114
25431	121	0	0	0	0	121
25432	0	120	0	0	0	120
25433	0	0	0	112	0	112
25434	0	0	0	106	0	106
25435	0	1	0	119	0	120
25436	0	0	106	0	0	106
25437	112	0	0	0	0	112
25438	105	0	0	0	0	105
25439	0	0	121	0	0	121
25440	0	113	1	0	0	114
25441	112	0	1	0	0	113
25442	108	2	0	0	0	110
25443	0	0	114	0	0	114
25444	1	0	119	0	0	120
25445	0	1	0	117	0	118
25446	0	0	116	0	0	116
25447	119	0	0	0	0	119
25448	110	0	1	2	0	113
25449	112	0	0	0	0	112
25450	0	0	0	121	0	121
25451	0	123	0	0	0	123
25452	114	0	1	0	0	115
25453	111	0	2	0	0	113
25454	0	0	113	0	0	113
25455	0	0	117	0	0	117
25456	118	0	0	0	0	118
25457	0	0	0	126	0	126
25458	0	0	123	0	0	123
25459	0	124	0	0	0	124
25460	0	0	0	123	0	123
25461	124	0	0	0	0	124
25462	0	125	0	0	0	125
25463	0	2	0	124	0	126
25464	0	127	0	0	0	127
25465	0	126	0	0	0	126
25466	0	0	0	120	0	120
25467	0	1	0	127	0	128
25468	0	126	0	1	0	127
25469	120	0	0	0	0	120
25470	0	0	127	0	0	127
25471	117	0	3	0	0	120
25472	2	0	0	142	0	144
25473	0	0	0	147	0	147
25474	0	0	0	144	0	144
25475	0	2	0	144	0	146
25476	0	0	152	0	0	152
25477	0	0	0	148	0	148
25478	0	0	0	145	0	145
25479	0	146	0	0	0	146
25480	0	0	145	0	0	145
25481	0	140	0	0	0	140
25482	1	0	141	0	0	142
25483	0	148	0	0	0	148
25484	0	0	0	144	0	144
25485	147	0	1	1	0	149
25486	0	152	0	0	0	152
25487	0	0	0	148	0	148
25488	0	0	148	0	0	148
25489	0	146	0	0	0	146
25490	153	0	0	0	0	153
25491	149	0	1	0	0	150
25492	0	145	0	0	0	145
25493	0	0	143	0	0	143
25494	139	0	2	0	0	141
25495	0	0	0	135	0	135
25496	139	0	0	1	0	140
25497	0	143	0	0	0	143
25498	0	130	0	0	0	130
25499	0	0	138	0	0	138
25500	138	0	0	0	0	138
25501	0	0	0	141	0	141
25502	132	0	7	0	0	139
25503	0	135	0	0	0	135
25504	120	0	2	0	0	122
25505	125	0	0	0	0	125
25506	0	0	130	0	0	130
25507	0	131	0	0	0	131
25508	0	130	0	0	0	130
25509	0	1	0	130	0	131
25510	0	133	0	0	0	133
25511	127	0	1	0	0	128
25512	0	134	0	0	0	134
25513	0	1	0	132	0	133
25514	0	126	0	0	0	126
25515	0	128	0	0	0	128
25516	0	130	0	0	0	130
25517	0	2	0	127	0	129
25518	0	0	0	120	0	120
25519	0	0	0	133	0	133
25520	0	135	3	1	0	139
25521	0	0	125	0	0	125
25522	0	0	128	0	0	128
25523	133	0	2	0	0	135
25524	0	0	0	136	0	136
25525	0	0	130	0	0	130
25526	0	0	130	0	0	130
25527	0	130	0	0	0	130
25528	0	0	0	115	0	115
25529	0	1	0	114	0	115
25530	124	0	0	0	0	124
25531	0	0	0	120	0	120
25532	0	0	0	123	0	123
25533	0	0	125	0	0	125
25534	0	0	0	113	0	113
25535	0	0	0	109	0	109
25536	0	0	110	0	0	110
25537	0	0	110	0	0	110
25538	0	104	0	0	0	104
25539	0	0	105	0	0	105
25540	0	0	0	108	0	108
25541	0	0	0	110	0	110
25542	0	0	105	0	0	105
25543	0	108	0	2	0	110
25544	109	0	1	0	0	110
25545	0	109	0	0	0	109
25546	0	0	0	97	0	97
25547	0	0	0	91	0	91
25548	0	98	0	0	0	98
25549	0	0	0	100	0	100
25550	0	0	0	93	0	93
25551	0	0	89	0	0	89
25552	0	90	0	0	0	90
25553	0	0	0	87	0	87
25554	0	0	92	0	0	92
25555	0	1	0	84	0	85
25556	0	0	0	81	0	81
25557	0	0	0	76	0	76
25558	0	0	0	84	0	84
25559	0	0	0	89	0	89
25560	0	88	0	0	0	88
25561	88	0	0	0	0	88
25562	0	0	92	0	0	92
25563	87	0	0	0	0	87
25564	0	0	90	0	0	90
25565	0	81	0	0	0	81
25566	0	0	83	0	0	83
25567	0	87	0	2	0	89
25568	0	0	0	80	0	80
25569	0	0	0	84	0	84
25570	0	88	0	0	0	88
25571	0	92	0	0	0	92
25572	92	0	0	0	0	92
25573	85	0	0	3	0	88
25574	84	0	0	0	0	84
25575	79	0	1	0	0	80
25576	0	0	0	85	0	85
25577	0	87	0	0	0	87
25578	87	0	0	0	0	87
25579	0	0	0	84	0	84
25580	82	0	0	0	0	82
25581	78	0	0	1	0	79
25582	0	88	0	0	0	88
25583	0	89	0	0	0	89
25584	0	91	0	0	0	91
25585	0	0	0	85	0	85
25586	0	89	0	0	0	89
25587	85	0	1	0	0	86
25588	86	0	2	0	0	88
25589	89	0	0	0	0	89
25590	80	0	0	0	0	80
25591	81	0	1	0	0	82
25592	0	0	90	0	0	90
25593	78	0	1	0	0	79
25594	0	0	81	0	0	81
25595	77	0	0	0	0	77
25596	0	0	0	81	0	81
25597	0	0	80	0	0	80
25598	0	0	82	0	0	82
25599	0	79	0	0	0	79
25600	82	0	0	0	0	82
25601	77	0	0	0	0	77
25602	0	87	0	0	0	87
25603	0	0	0	87	0	87
25604	84	0	0	0	0	84
25605	0	0	87	0	0	87
25606	0	80	0	0	0	80
25607	80	0	0	0	0	80
25608	0	84	0	0	0	84
25609	0	1	0	75	0	76
25610	0	74	1	0	0	75
25611	0	0	0	72	0	72
25612	0	79	0	0	0	79
25613	0	77	0	0	0	77
25614	65	0	1	0	0	66
25615	66	0	0	0	0	66
25616	0	0	74	0	0	74
25617	0	0	69	0	0	69
25618	0	0	77	0	0	77
25619	0	1	0	50	0	51
25620	0	0	48	0	0	48
25621	0	0	0	47	0	47
25622	0	0	0	49	0	49
25623	0	47	0	0	0	47
25624	47	0	0	0	0	47
25625	0	48	0	0	0	48
25626	1	0	1	48	0	50
25627	0	1	0	40	0	41
25628	0	0	0	50	0	50
25629	0	0	51	0	0	51
25630	0	1	0	47	0	48
25631	0	3	0	43	0	46
25632	0	1	0	45	0	46
25633	0	0	48	0	0	48
25634	0	49	0	0	0	49
25635	45	0	1	0	0	46
25636	48	0	0	0	0	48
25637	0	49	0	0	0	49
25638	0	0	0	42	0	42
25639	0	0	0	46	0	46
25640	0	0	49	0	0	49
25641	0	48	0	0	0	48
25642	0	0	0	48	0	48
25643	0	0	48	0	0	48
25644	0	0	0	45	0	45
25645	1	1	0	45	0	47
25646	0	0	48	0	0	48
25647	0	0	0	40	0	40
25648	0	0	0	46	0	46
25649	0	0	46	0	0	46
25650	0	0	0	43	0	43
25651	0	0	0	45	0	45
25652	0	0	0	44	0	44
25653	0	0	46	0	0	46
25654	0	0	0	40	0	40
25655	42	0	0	0	0	42
25656	46	0	0	0	0	46
25657	0	45	0	0	0	45
25658	43	0	0	0	0	43
25659	0	0	46	0	0	46
25660	0	1	0	40	0	41
25661	0	0	0	40	0	40
25662	0	0	0	42	0	42
25663	43	0	0	0	0	43
25664	0	44	0	0	0	44
25665	0	1	0	42	0	43
25666	0	42	0	0	0	42
25667	33	0	1	0	0	34
25668	0	39	0	0	0	39
25669	37	0	0	0	0	37
25670	0	38	0	0	0	38
25671	0	34	0	0	0	34
25672	0	0	0	33	0	33
25673	0	0	0	33	0	33
25674	0	0	0	28	0	28
25675	0	0	0	32	0	32
25676	0	0	35	0	0	35
25677	0	33	0	0	0	33
25678	0	0	0	34	0	34
25679	0	28	0	0	0	28
25680	0	0	29	0	0	29
25681	0	0	0	29	0	29
25682	0	0	0	31	0	31
25683	0	0	29	0	0	29
25684	0	30	0	0	0	30
25685	0	0	0	30	0	30
25686	0	0	30	0	0	30
25687	0	30	0	0	0	30
25688	3	0	0	24	0	27
25689	0	0	28	0	0	28
25690	0	0	28	0	0	28
25691	0	29	0	0	0	29
25692	0	27	0	0	0	27
25693	0	0	0	27	0	27
25694	0	0	0	27	0	27
25695	0	0	28	0	0	28
25696	26	0	0	0	0	26
25697	26	0	0	0	0	26
25698	0	0	28	0	0	28
25699	0	29	0	0	0	29
25700	0	27	0	0	0	27
25701	0	27	0	0	0	27
25702	0	29	0	0	0	29
25703	0	0	0	26	0	26
25704	0	0	0	21	0	21
25705	0	0	0	26	0	26
25706	0	0	0	24	0	24
25707	0	26	0	0	0	26
25708	0	1	0	26	0	27
25709	2	29	0	0	0	31
25710	0	0	0	44	0	44
25711	49	0	0	0	0	49
25712	0	0	0	79	0	79
25713	0	84	0	0	0	84
25714	0	0	0	80	0	80
25715	2	0	0	75	0	77
25716	1	2	1	80	0	84
25717	79	1	1	3	0	84
25718	0	5	0	89	0	94
25719	0	0	93	0	0	93
25720	0	103	0	0	0	103
25721	0	0	0	88	0	88
25722	0	0	1	98	0	99
25723	0	1	0	104	0	105
25724	104	0	0	0	0	104
25725	0	0	111	0	0	111
25726	0	0	0	109	0	109
25727	0	111	0	0	0	111
25728	0	0	0	110	0	110
25729	115	0	2	0	0	117
25730	0	122	0	0	0	122
25731	0	1	0	124	0	125
25732	1	0	0	129	0	130
25733	0	118	0	0	0	118
25734	0	0	0	119	0	119
25735	0	1	0	120	0	121
25736	0	0	127	0	0	127
25737	0	128	0	0	0	128
25738	119	0	0	0	0	119
25739	0	0	129	0	0	129
25740	127	0	0	0	0	127
25741	0	0	162	0	0	162
25742	0	0	0	159	0	159
25743	166	0	0	0	0	166
25744	0	0	0	164	0	164
25745	161	0	0	0	0	161
25746	154	0	0	0	0	154
25747	166	0	3	0	0	169
25748	0	171	0	0	0	171
25749	0	1	0	158	0	159
25750	0	0	0	146	0	146
25751	0	0	0	154	0	154
25752	0	0	157	0	0	157
25753	0	0	0	148	0	148
25754	153	0	0	0	0	153
25755	146	0	0	0	0	146
25756	0	0	177	0	0	177
25757	172	0	0	0	0	172
25758	165	0	0	0	0	165
25759	0	0	0	181	0	181
25760	182	0	1	0	0	183
25761	175	0	0	0	0	175
25762	0	2	0	211	0	213
25763	209	0	0	0	0	209
25764	195	0	0	0	0	195
25765	0	1	0	214	0	215
25766	0	0	215	0	0	215
25767	202	0	0	0	0	202
25768	2	0	242	2	0	246
25769	0	0	254	0	0	254
25770	0	265	0	0	0	265
25771	0	5	1	251	0	257
25772	0	6	0	251	0	257
25773	0	1	0	265	0	266
25774	0	0	261	0	0	261
25775	0	0	269	0	0	269
25776	0	276	0	0	0	276
25777	0	1	0	263	0	264
25778	0	3	0	255	0	258
25779	0	2	0	278	0	280
25780	0	0	291	0	0	291
25781	0	297	0	0	0	297
25782	0	0	0	299	0	299
25783	0	0	294	0	0	294
25784	3	0	290	0	0	293
25785	291	0	1	0	0	292
25786	289	0	0	0	0	289
25787	268	0	1	0	0	269
25788	0	1	0	305	0	306
25789	0	0	301	0	0	301
25790	0	302	0	1	0	303
25791	0	282	0	0	0	282
25792	0	0	291	0	0	291
25793	0	3	0	291	0	294
25794	0	1	0	307	0	308
25795	0	324	0	0	0	324
25796	2	314	0	0	0	316
25797	307	0	2	0	0	309
25798	317	0	0	0	0	317
25799	323	0	0	0	0	323
25800	315	0	0	0	0	315
25801	330	0	0	1	0	331
25802	0	357	0	0	0	357
25803	0	345	0	0	0	345
25804	2	355	0	0	0	357
25805	358	0	2	0	0	360
25806	0	0	0	323	0	323
25807	0	0	0	365	0	365
25808	382	0	3	1	0	386
25809	0	404	0	1	0	405
25810	0	2	0	393	0	395
25811	0	2	0	396	0	398
25812	0	0	0	401	0	401
25813	390	0	1	0	0	391
25814	0	0	0	416	0	416
25815	0	0	415	0	0	415
25816	406	0	0	1	0	407
25817	0	2	0	419	0	421
25818	0	0	402	0	0	402
25819	1	412	0	0	0	413
25820	0	409	0	6	0	415
25821	420	0	0	1	0	421
25822	424	1	0	0	0	425
25823	0	448	0	1	0	449
25824	0	2	0	433	0	435
25825	425	0	0	0	0	425
25826	0	2	0	399	0	401
25827	0	4	0	415	0	419
25828	0	2	0	426	0	428
25829	0	0	0	448	0	448
25830	0	445	0	1	0	446
25831	2	3	0	429	0	434
25832	0	0	0	423	0	423
25833	0	3	0	447	0	450
25834	0	0	454	0	0	454
25835	0	459	0	0	0	459
25836	0	0	0	461	0	461
25837	1	0	455	0	0	456
25838	0	0	465	0	0	465
25839	0	469	0	3	0	472
25840	484	0	0	0	0	484
25841	3	0	0	474	0	477
25842	495	0	0	0	0	495
25843	0	502	0	1	0	503
25844	0	2	0	495	0	497
25845	492	0	0	2	0	494
25846	495	0	0	0	0	495
25847	0	0	0	472	0	472
25848	0	2	0	508	0	510
25849	0	0	522	0	0	522
25850	0	0	0	511	0	511
25851	0	0	0	512	0	512
25852	496	0	6	0	0	502
25853	0	513	0	0	0	513
25854	1	0	518	0	0	519
25855	505	2	4	0	0	511
25856	0	533	0	2	0	535
25857	0	0	0	520	0	520
25858	542	0	0	1	0	543
25859	0	1	2	506	0	509
25860	0	2	0	545	0	547
25861	0	0	551	0	0	551
25862	2	2	0	538	0	542
25863	525	0	8	0	0	533
25864	2	0	0	525	0	527
25865	534	0	0	0	0	534
25866	0	569	0	0	0	569
25867	0	533	0	0	0	533
25868	0	2	0	523	0	525
25869	0	0	0	551	0	551
25870	518	0	0	1	0	519
25871	0	559	0	0	0	559
25872	540	0	0	0	0	540
25873	521	0	0	0	0	521
25874	0	0	0	541	0	541
25875	511	0	0	0	0	511
25876	1	0	518	0	0	519
25877	0	3	0	492	0	495
25878	0	0	504	0	0	504
25879	0	0	0	483	0	483
25880	487	0	5	0	0	492
25881	477	0	4	1	0	482
25882	0	502	0	0	0	502
25883	0	1	0	472	0	473
25884	0	0	0	455	0	455
25885	0	489	0	0	0	489
25886	0	4	0	465	0	469
25887	0	1	0	474	0	475
25888	0	486	0	0	0	486
25889	476	0	1	2	0	479
25890	461	0	3	0	0	464
25891	0	1	0	434	0	435
25892	1	1	0	444	0	446
25893	0	0	460	0	0	460
25894	2	0	0	447	0	449
25895	0	453	0	0	0	453
25896	449	1	1	0	0	451
25897	2	3	0	391	0	396
25898	0	1	0	456	0	457
25899	447	0	1	0	0	448
25900	0	465	0	0	0	465
25901	0	0	0	448	0	448
25902	0	0	0	448	0	448
25903	0	440	0	1	0	441
25904	437	0	0	1	0	438
25905	2	0	446	0	0	448
25906	0	0	458	0	0	458
25907	0	0	0	421	0	421
25908	1	0	407	0	0	408
25909	409	0	2	0	0	411
25910	0	3	0	405	0	408
25911	1	0	398	0	0	399
25912	0	0	392	0	0	392
25913	0	391	0	2	0	393
25914	386	0	4	1	0	391
25915	0	395	0	2	0	397
25916	388	0	0	0	0	388
25917	387	0	3	0	0	390
25918	0	388	0	0	0	388
25919	357	0	2	0	0	359
25920	346	0	0	0	0	346
25921	0	0	370	0	0	370
25922	0	4	0	355	0	359
25923	0	363	0	2	0	365
25924	0	350	0	2	0	352
25925	0	1	0	356	0	357
25926	343	0	0	0	0	343
25927	0	1	0	326	0	327
25928	0	2	0	339	0	341
25929	2	4	0	338	0	344
25930	0	332	0	0	0	332
25931	0	3	0	309	0	312
25932	0	0	311	0	0	311
25933	298	0	4	0	0	302
25934	284	0	4	1	0	289
25935	0	311	0	0	0	311
25936	272	0	6	0	0	278
25937	0	0	0	270	0	270
25938	0	0	269	0	0	269
25939	273	0	0	0	0	273
25940	0	285	0	1	0	286
25941	2	0	0	285	0	287
25942	276	0	1	0	0	277
25943	0	285	0	0	0	285
25944	0	263	0	0	0	263
25945	270	0	0	0	0	270
25946	0	0	282	0	0	282
25947	277	0	1	0	0	278
25948	0	0	0	247	0	247
25949	0	0	0	252	0	252
25950	0	0	246	2	0	248
25951	0	0	266	0	0	266
25952	0	1	0	253	0	254
25953	0	0	249	0	0	249
25954	0	0	256	0	0	256
25955	0	1	0	231	0	232
25956	0	0	0	217	0	217
25957	242	0	2	0	0	244
25958	0	0	0	239	0	239
25959	233	0	0	0	0	233
25960	0	240	0	1	0	241
25961	0	3	0	214	0	217
25962	0	0	224	0	0	224
25963	219	0	1	0	0	220
25964	217	0	0	0	0	217
25965	219	0	2	0	0	221
25966	200	0	0	0	0	200
25967	192	0	3	0	0	195
25968	0	1	0	206	0	207
25969	0	0	208	0	0	208
25970	3	0	200	0	0	203
25971	0	0	207	0	0	207
25972	199	0	6	0	0	205
25973	188	0	1	0	0	189
25974	0	0	0	206	0	206
25975	0	209	0	1	0	210
25976	0	0	0	196	0	196
25977	0	0	206	0	0	206
25978	0	1	206	0	0	207
25979	211	0	1	0	0	212
25980	0	0	242	0	0	242
25981	0	0	0	228	0	228
25982	241	0	0	0	0	241
25983	227	0	1	0	0	228
25984	211	0	4	0	0	215
25985	224	0	2	0	0	226
25986	0	0	242	0	0	242
25987	223	0	0	2	0	225
25988	0	245	0	0	0	245
25989	0	0	0	217	0	217
25990	0	0	234	0	0	234
25991	1	0	0	226	0	227
25992	0	0	240	0	0	240
25993	0	3	0	218	0	221
25994	0	1	0	224	0	225
25995	0	0	248	0	0	248
25996	1	1	0	238	0	240
25997	241	0	0	0	0	241
25998	0	0	0	215	0	215
25999	0	0	0	226	0	226
26000	226	0	0	0	0	226
26001	0	223	0	0	0	223
26002	219	0	0	0	0	219
26003	0	234	0	0	0	234
26004	212	0	1	1	0	214
26005	0	0	222	0	0	222
26006	0	1	0	207	0	208
26007	0	0	0	201	0	201
26008	213	0	0	1	0	214
26009	0	206	0	0	0	206
26010	0	2	0	198	0	200
26011	4	1	0	200	0	205
26012	0	194	0	1	0	195
26013	204	0	0	0	0	204
26014	0	207	0	0	0	207
26015	0	0	0	192	0	192
26016	0	1	0	191	0	192
26017	0	193	0	0	0	193
26018	192	0	0	0	0	192
26019	0	0	204	0	0	204
26020	200	0	0	0	0	200
26021	0	207	0	1	0	208
26022	0	0	0	208	0	208
26023	214	0	0	0	0	214
26024	0	0	0	193	0	193
26025	0	0	0	218	0	218
26026	201	0	0	1	0	202
26027	0	216	0	1	0	217
26028	0	210	0	2	0	212
26029	206	0	1	0	0	207
26030	0	0	217	0	0	217
26031	0	200	0	0	0	200
26032	0	0	0	208	0	208
26033	0	0	218	0	0	218
26034	0	6	0	206	0	212
26035	208	0	1	0	0	209
26036	0	215	0	0	0	215
26037	0	2	0	209	0	211
26038	0	202	0	0	0	202
26039	193	0	1	1	0	195
26040	197	0	4	0	0	201
26041	0	204	0	2	0	206
26042	0	0	0	198	0	198
26043	0	196	1	0	0	197
26044	192	0	1	0	0	193
26045	179	0	2	0	0	181
26046	0	0	0	169	0	169
26047	0	0	0	191	0	191
26048	0	0	193	0	0	193
26049	177	0	0	1	0	178
26050	0	0	195	0	0	195
26051	0	0	0	190	0	190
26052	193	0	1	0	0	194
26053	0	198	0	1	0	199
26054	188	0	0	0	0	188
26055	0	0	176	0	0	176
26056	194	0	0	0	0	194
26057	0	194	0	0	0	194
26058	187	0	1	0	0	188
26059	0	191	0	0	0	191
26060	0	2	0	178	0	180
26061	0	0	187	0	0	187
26062	0	0	195	0	0	195
26063	0	0	0	179	0	179
26064	0	0	191	0	0	191
26065	0	0	0	186	0	186
26066	0	2	0	174	0	176
26067	1	0	170	0	0	171
26068	175	0	2	0	0	177
26069	170	0	1	0	0	171
26070	0	171	0	0	0	171
26071	148	0	0	1	0	149
26072	0	0	0	150	0	150
26073	0	0	160	0	0	160
26074	0	2	0	133	0	135
26075	0	0	0	148	0	148
26076	138	0	0	0	0	138
26077	0	153	0	0	0	153
26078	0	141	0	0	0	141
26079	0	1	0	140	0	141
26080	0	1	0	142	0	143
26081	0	144	0	1	0	145
26082	0	0	0	152	0	152
26083	0	2	0	148	0	150
26084	0	142	0	0	0	142
26085	149	0	0	0	0	149
26086	0	0	0	151	0	151
26087	0	150	0	0	0	150
26088	0	0	0	151	0	151
26089	145	0	1	0	0	146
26090	0	155	0	0	0	155
26091	147	0	1	0	0	148
26092	138	0	1	0	0	139
26093	0	0	0	156	0	156
26094	151	0	0	0	0	151
26095	146	0	0	0	0	146
26096	146	0	0	2	0	148
26097	144	0	0	0	0	144
26098	0	0	0	151	0	151
26099	1	1	0	155	0	157
26100	0	0	170	0	0	170
26101	0	0	0	149	0	149
26102	1	2	0	147	0	150
26103	0	0	162	0	0	162
26104	163	0	0	1	0	164
26105	0	0	0	162	0	162
26106	0	0	169	0	0	169
26107	180	0	0	0	0	180
26108	0	0	182	0	0	182
26109	0	191	0	2	0	193
26110	0	189	0	0	0	189
26111	0	3	0	180	0	183
26112	0	0	192	0	0	192
26113	175	0	0	0	0	175
26114	183	0	3	0	0	186
26115	0	0	195	0	0	195
26116	197	0	0	0	0	197
26117	172	0	2	0	0	174
26118	0	194	0	0	0	194
26119	189	0	0	0	0	189
26120	0	0	0	178	0	178
26121	1	0	201	0	0	202
26122	0	1	0	198	0	199
26123	0	204	0	1	0	205
26124	1	200	0	2	0	203
26125	204	0	0	0	0	204
26126	194	0	3	0	0	197
26127	195	0	0	0	0	195
26128	0	0	0	201	0	201
26129	1	1	0	211	0	213
26130	0	209	0	0	0	209
26131	203	1	1	0	0	205
26132	0	224	2	0	0	226
26133	226	2	2	0	0	230
26134	0	251	0	0	0	251
26135	231	0	0	0	0	231
26136	256	0	0	0	0	256
26137	0	0	0	280	0	280
26138	0	264	0	0	0	264
26139	3	0	282	0	0	285
26140	276	0	3	0	0	279
26141	0	295	0	1	0	296
26142	1	0	292	0	0	293
26143	0	0	322	0	0	322
26144	0	0	0	300	0	300
26145	0	0	0	292	0	292
26146	0	309	0	0	0	309
26147	308	0	1	0	0	309
26148	0	0	0	303	0	303
26149	0	300	0	0	0	300
26150	0	303	0	0	0	303
26151	0	0	297	0	0	297
26152	3	0	308	0	0	311
26153	324	0	1	0	0	325
26154	0	0	335	0	0	335
26155	0	0	0	323	0	323
26156	0	0	0	329	0	329
26157	2	0	355	0	0	357
26158	0	0	0	333	0	333
26159	0	1	0	331	0	332
26160	347	0	2	0	0	349
26161	353	0	0	0	0	353
26162	0	1	0	359	0	360
26163	0	350	0	1	0	351
26164	0	348	0	2	0	350
26165	356	0	2	2	0	360
26166	0	0	373	0	0	373
26167	0	2	0	362	0	364
26168	376	0	0	0	0	376
26169	329	0	1	0	0	330
26170	0	2	0	366	0	368
26171	0	0	372	0	0	372
26172	0	0	375	0	0	375
26173	382	0	0	0	0	382
26174	369	1	2	0	0	372
26175	0	384	0	0	0	384
26176	0	373	0	0	0	373
26177	386	0	2	0	0	388
26178	359	0	1	1	0	361
26179	0	1	0	368	0	369
26180	0	0	0	381	0	381
26181	0	0	0	383	0	383
26182	405	0	2	0	0	407
26183	0	0	0	403	0	403
26184	0	0	422	0	0	422
26185	414	0	1	0	0	415
26186	2	3	0	416	0	421
26187	1	0	413	0	0	414
26188	410	0	1	0	0	411
26189	380	0	1	0	0	381
26190	0	429	0	0	0	429
26191	0	406	0	0	0	406
26192	0	0	423	0	0	423
26193	410	0	0	2	0	412
26194	0	412	0	0	0	412
26195	0	0	418	0	0	418
26196	428	0	5	0	0	433
26197	0	429	0	0	0	429
26198	0	0	422	0	0	422
26199	444	0	0	0	0	444
26200	0	455	1	0	0	456
26201	0	0	0	448	0	448
26202	442	0	0	0	0	442
26203	0	452	0	1	0	453
26204	0	0	0	448	0	448
26205	434	0	0	0	0	434
26206	1	0	455	1	0	457
26207	0	427	0	0	0	427
26208	0	0	436	0	0	436
26209	0	0	0	442	0	442
26210	1	0	439	0	0	440
26211	0	439	2	0	0	441
26212	0	424	0	0	0	424
26213	0	2	0	422	0	424
26214	0	0	0	413	0	413
26215	0	1	0	430	0	431
26216	0	0	453	0	0	453
26217	0	2	0	438	0	440
26218	426	0	2	0	0	428
26219	424	0	0	2	0	426
26220	0	0	449	0	0	449
26221	0	451	0	0	0	451
26222	453	0	0	0	0	453
26223	0	458	0	0	0	458
26224	450	0	0	0	0	450
26225	450	0	1	0	0	451
26226	0	0	451	0	0	451
26227	0	446	0	0	0	446
26228	0	2	0	435	0	437
26229	0	0	425	0	0	425
26230	454	0	0	0	0	454
26231	0	2	0	446	0	448
26232	1	0	449	0	0	450
26233	442	0	0	0	0	442
26234	0	0	459	0	0	459
26235	0	0	0	455	0	455
26236	447	0	1	0	0	448
26237	0	446	0	0	0	446
26238	0	0	445	0	0	445
26239	440	0	0	0	0	440
26240	424	0	0	0	0	424
26241	0	459	0	0	0	459
26242	3	0	0	436	0	439
26243	1	2	0	400	0	403
26244	421	0	0	2	0	423
26245	0	1	0	435	0	436
26246	1	0	455	0	0	456
26247	0	0	0	438	0	438
26248	437	0	0	0	0	437
26249	0	435	0	0	0	435
26250	0	0	0	408	0	408
26251	0	424	0	0	0	424
26252	421	0	0	0	0	421
26253	0	0	0	399	0	399
26254	0	0	0	397	0	397
26255	0	408	0	0	0	408
26256	0	0	413	0	0	413
26257	0	0	1	399	0	400
26258	0	0	0	379	0	379
26259	0	2	0	381	0	383
26260	0	384	0	1	0	385
26261	0	0	375	0	0	375
26262	0	0	371	0	0	371
26263	371	0	0	1	0	372
26264	369	0	0	0	0	369
26265	0	0	386	0	0	386
26266	377	0	1	0	0	378
26267	0	0	384	0	0	384
26268	376	0	1	0	0	377
26269	0	368	0	0	0	368
26270	365	0	2	0	0	367
26271	0	0	365	0	0	365
26272	0	0	370	0	0	370
26273	2	1	0	352	0	355
26274	344	0	2	0	0	346
26275	0	352	0	0	0	352
26276	0	0	360	0	0	360
26277	1	2	0	333	0	336
26278	1	0	0	301	0	302
26279	333	0	0	0	0	333
26280	296	0	2	0	0	298
26281	0	0	0	322	0	322
26282	320	0	1	0	0	321
26283	0	0	328	0	0	328
26284	0	0	0	261	0	261
26285	0	3	0	241	0	244
26286	255	0	1	1	0	257
26287	240	0	1	0	0	241
26288	0	1	0	246	0	247
26289	242	0	0	0	0	242
26290	0	0	246	0	0	246
26291	0	198	0	0	0	198
26292	0	0	196	0	0	196
26293	1	0	0	192	0	193
26294	192	0	0	0	0	192
26295	0	195	0	0	0	195
26296	0	0	0	175	0	175
26297	0	0	0	179	0	179
26298	0	183	0	0	0	183
26299	0	1	0	165	0	166
26300	0	0	0	154	0	154
26301	0	0	2	160	0	162
26302	0	0	0	160	0	160
26303	7	0	0	164	0	171
26304	0	157	0	0	0	157
26305	0	0	0	149	0	149
26306	0	0	0	149	0	149
26307	0	0	138	0	0	138
26308	0	134	0	0	0	134
26309	0	3	1	126	0	130
26310	0	1	3	116	0	120
26311	0	0	0	136	0	136
26312	0	130	0	0	0	130
26313	1	0	135	0	0	136
26314	0	0	0	134	0	134
26315	0	0	124	0	0	124
26316	2	0	128	0	0	130
26317	0	0	0	119	0	119
26318	115	0	0	0	0	115
26319	0	2	0	105	0	107
26320	0	0	0	117	0	117
26321	0	122	0	0	0	122
26322	0	0	0	107	0	107
26323	0	0	0	125	0	125
26324	0	0	123	0	0	123
26325	0	128	0	0	0	128
26326	0	0	0	121	0	121
26327	118	0	0	0	0	118
26328	0	0	123	0	0	123
26329	0	1	0	109	0	110
26330	0	0	0	114	0	114
26331	113	0	1	0	0	114
26332	0	123	0	2	0	125
26333	118	2	0	0	0	120
26334	0	128	0	0	0	128
26335	0	2	0	124	0	126
26336	121	0	0	0	0	121
26337	0	0	125	0	0	125
26338	0	124	0	0	0	124
26339	0	123	0	2	0	125
26340	126	0	0	0	0	126
26341	0	0	0	121	0	121
26342	0	126	0	0	0	126
26343	0	120	0	0	0	120
26344	0	0	0	123	0	123
26345	0	0	0	136	0	136
26346	124	0	0	0	0	124
26347	0	134	0	0	0	134
26348	0	0	0	131	0	131
26349	0	0	133	0	0	133
26350	0	118	0	0	0	118
26351	0	0	119	0	0	119
26352	0	125	0	0	0	125
26353	1	0	0	113	0	114
26354	0	0	0	121	0	121
26355	0	122	0	0	0	122
26356	0	0	127	0	0	127
26357	122	0	0	0	0	122
26358	0	0	0	118	0	118
26359	0	0	0	122	0	122
26360	0	0	127	0	0	127
26361	0	1	1	125	0	127
26362	0	0	128	0	0	128
26363	0	0	0	124	0	124
26364	0	0	123	0	0	123
26365	0	116	0	1	0	117
26366	0	0	120	0	0	120
26367	0	0	0	120	0	120
26368	116	0	0	0	0	116
26369	0	124	0	0	0	124
26370	0	0	0	108	0	108
26371	0	0	111	0	0	111
26372	0	109	0	0	0	109
26373	0	0	0	100	0	100
26374	0	0	109	0	0	109
26375	0	104	0	0	0	104
26376	103	0	0	0	0	103
26377	94	1	1	0	0	96
26378	0	0	0	93	0	93
26379	93	0	0	0	0	93
26380	0	0	0	91	0	91
26381	0	0	0	90	0	90
26382	0	0	92	0	0	92
26383	1	2	0	79	0	82
26384	0	0	3	75	0	78
26385	77	0	2	0	0	79
26386	74	0	0	0	0	74
26387	0	78	0	0	0	78
26388	0	0	81	0	0	81
26389	0	0	0	76	0	76
26390	0	0	76	0	0	76
26391	71	0	1	0	0	72
26392	0	0	66	0	0	66
26393	0	0	0	68	0	68
26394	0	67	0	0	0	67
26395	0	2	0	58	0	60
26396	2	0	0	53	0	55
26397	2	0	59	0	0	61
26398	0	3	0	56	0	59
26399	61	0	0	0	0	61
26400	57	0	2	0	0	59
26401	49	0	0	0	0	49
26402	56	0	0	0	0	56
26403	0	61	0	0	0	61
26404	0	53	0	0	0	53
26405	1	0	0	47	0	48
26406	0	0	0	50	0	50
26407	0	50	0	0	0	50
26408	0	1	0	47	0	48
26409	0	0	0	42	0	42
26410	0	0	0	42	0	42
26411	0	0	0	45	0	45
26412	0	0	0	46	0	46
26413	48	0	0	0	0	48
26414	0	45	0	0	0	45
26415	0	0	48	0	0	48
26416	0	0	0	44	0	44
26417	0	0	0	45	0	45
26418	0	0	0	45	0	45
26419	47	0	0	0	0	47
26420	0	48	0	0	0	48
26421	0	0	0	45	0	45
26422	0	44	0	0	0	44
26423	0	0	0	43	0	43
26424	0	42	0	0	0	42
26425	0	0	43	0	0	43
26426	0	0	0	39	0	39
26427	0	0	40	0	0	40
26428	0	0	0	39	0	39
26429	0	0	0	36	0	36
26430	39	0	0	0	0	39
26431	37	0	0	0	0	37
26432	41	0	0	1	0	42
26433	42	0	0	0	0	42
26434	41	0	0	0	0	41
26435	0	1	0	41	0	42
26436	0	39	0	2	0	41
26437	0	2	0	37	0	39
26438	0	0	41	0	0	41
26439	40	0	0	0	0	40
26440	39	0	0	0	0	39
26441	0	0	0	41	0	41
26442	0	0	0	42	0	42
26443	0	40	0	0	0	40
26444	0	0	0	38	0	38
26445	0	0	0	39	0	39
26446	1	41	0	0	0	42
26447	0	0	0	43	0	43
26448	44	0	0	0	0	44
26449	0	0	44	0	0	44
26450	41	0	1	0	0	42
26451	0	0	45	0	0	45
26452	0	0	0	40	0	40
26453	0	0	0	40	0	40
26454	0	41	0	0	0	41
26455	0	42	0	0	0	42
26456	0	0	0	42	0	42
26457	0	0	41	0	0	41
26458	49	0	1	1	0	51
26459	0	0	0	51	0	51
26460	0	55	0	0	0	55
26461	0	1	0	53	0	54
26462	0	0	0	56	0	56
26463	0	58	0	0	0	58
26464	0	0	0	58	0	58
26465	0	0	58	1	0	59
26466	0	0	64	0	0	64
26467	0	0	0	63	0	63
26468	0	66	0	0	0	66
26469	0	0	0	66	0	66
26470	60	0	0	0	0	60
26471	61	0	0	0	0	61
26472	59	0	0	0	0	59
26473	0	64	0	0	0	64
26474	0	0	61	0	0	61
26475	56	0	0	0	0	56
26476	63	0	1	0	0	64
26477	0	73	0	0	0	73
26478	0	0	0	69	0	69
26479	83	0	0	0	0	83
26480	80	0	2	0	0	82
26481	100	0	0	0	0	100
26482	0	0	0	100	0	100
26483	100	0	0	0	0	100
26484	0	1	0	101	0	102
26485	0	0	0	106	0	106
26486	116	0	0	0	0	116
26487	0	0	0	118	0	118
26488	112	0	1	0	0	113
26489	0	1	0	104	0	105
26490	0	1	0	117	0	118
26491	108	0	0	0	0	108
26492	0	0	126	0	0	126
26493	0	0	0	117	0	117
26494	0	1	0	112	0	113
26495	0	0	0	113	0	113
26496	0	0	0	117	0	117
26497	0	1	0	118	0	119
26498	0	124	0	0	0	124
26499	0	1	0	121	0	122
26500	0	0	126	0	0	126
26501	0	0	0	118	0	118
26502	0	0	0	116	0	116
26503	0	1	0	124	0	125
26504	2	0	126	0	0	128
26505	0	0	131	0	0	131
26506	131	0	0	0	0	131
26507	131	0	0	0	0	131
26508	0	143	0	0	0	143
26509	0	0	0	138	0	138
26510	0	1	0	134	0	135
26511	0	0	0	135	0	135
26512	131	0	1	0	0	132
26513	139	0	0	0	0	139
26514	0	0	0	140	0	140
26515	0	0	0	146	0	146
26516	0	0	0	148	0	148
26517	0	0	0	150	0	150
26518	130	0	0	0	0	130
26519	0	0	160	0	0	160
26520	0	164	0	0	0	164
26521	0	161	0	0	0	161
26522	159	1	0	0	0	160
26523	0	0	0	154	0	154
26524	0	0	153	0	0	153
26525	0	0	156	0	0	156
26526	0	160	0	0	0	160
26527	150	0	0	2	0	152
26528	0	0	156	0	0	156
26529	159	0	0	0	0	159
26530	0	1	0	149	0	150
26531	0	0	0	154	0	154
26532	0	131	1	0	0	132
26533	1	147	0	0	0	148
26534	147	1	0	0	0	148
26535	158	0	0	0	0	158
26536	0	161	0	0	0	161
26537	0	0	155	0	0	155
26538	0	0	166	0	0	166
26539	0	0	0	168	0	168
26540	174	0	0	0	0	174
26541	0	177	0	0	0	177
26542	0	2	0	173	0	175
26543	172	0	1	0	0	173
26544	0	0	0	157	0	157
26545	0	0	0	173	0	173
26546	170	0	0	0	0	170
26547	0	184	0	1	0	185
26548	0	173	0	1	0	174
26549	0	0	181	0	0	181
26550	0	1	0	179	0	180
26551	0	0	0	180	0	180
26552	0	0	166	0	0	166
26553	175	0	0	0	0	175
26554	175	0	2	1	0	178
26555	0	0	176	0	0	176
26556	137	0	0	0	0	137
26557	0	0	178	0	0	178
26558	0	179	0	0	0	179
26559	0	1	0	169	0	170
26560	0	0	0	171	0	171
26561	175	0	1	0	0	176
26562	172	0	0	0	0	172
26563	166	0	0	0	0	166
26564	152	0	0	0	0	152
26565	162	1	0	0	0	163
26566	0	0	175	0	0	175
26567	0	176	0	0	0	176
26568	0	0	0	168	0	168
26569	0	176	0	0	0	176
26570	0	180	0	0	0	180
26571	0	0	0	178	0	178
26572	0	0	0	176	0	176
26573	0	0	179	0	0	179
26574	176	0	0	0	0	176
26575	177	0	0	0	0	177
26576	0	186	0	0	0	186
26577	180	0	0	0	0	180
26578	167	0	0	1	0	168
26579	0	0	0	183	0	183
26580	0	0	186	0	0	186
26581	0	0	182	0	0	182
26582	176	0	0	0	0	176
26583	175	0	3	0	0	178
26584	0	177	0	6	0	183
26585	0	174	0	0	0	174
26586	0	0	0	176	0	176
26587	193	0	0	0	0	193
26588	0	0	194	0	0	194
26589	0	0	0	190	0	190
26590	193	0	1	0	0	194
26591	170	0	2	0	0	172
26592	0	0	0	188	0	188
26593	189	0	0	0	0	189
26594	0	0	189	0	0	189
26595	0	0	191	0	0	191
26596	0	2	0	171	0	173
26597	0	0	0	176	0	176
26598	0	2	0	180	0	182
26599	0	180	0	0	0	180
26600	0	181	0	0	0	181
26601	0	0	0	183	0	183
26602	179	0	0	0	0	179
26603	0	0	0	170	0	170
26604	0	0	0	177	0	177
26605	0	169	0	1	0	170
26606	0	162	0	0	0	162
26607	0	0	0	167	0	167
26608	0	0	0	163	0	163
26609	165	0	0	0	0	165
26610	0	165	0	0	0	165
26611	153	0	0	0	0	153
26612	0	2	0	151	0	153
26613	0	0	159	0	0	159
26614	0	0	165	0	0	165
26615	165	0	0	0	0	165
26616	0	0	0	147	0	147
26617	0	2	0	153	0	155
26618	0	0	0	160	0	160
26619	0	0	160	0	0	160
26620	0	1	0	153	0	154
26621	0	161	0	0	0	161
26622	0	0	0	142	0	142
26623	0	0	0	148	0	148
26624	0	159	0	0	0	159
26625	0	0	0	155	0	155
26626	153	0	0	1	0	154
26627	0	156	0	0	0	156
26628	139	0	0	0	0	139
26629	142	0	0	0	0	142
26630	0	0	0	133	0	133
26631	0	1	0	131	0	132
26632	0	0	0	134	0	134
26633	0	0	128	0	0	128
26634	0	138	0	0	0	138
26635	0	129	0	0	0	129
26636	0	0	0	124	0	124
26637	120	0	1	0	0	121
26638	0	0	0	129	0	129
26639	0	0	127	0	0	127
26640	0	131	0	0	0	131
26641	0	126	0	0	0	126
26642	123	0	0	0	0	123
26643	111	0	0	0	0	111
26644	0	129	0	0	0	129
26645	117	0	0	0	0	117
26646	0	0	126	0	0	126
26647	0	0	105	0	0	105
26648	113	0	0	0	0	113
26649	99	0	1	1	0	101
26650	0	0	0	100	0	100
26651	104	0	0	0	0	104
26652	0	0	102	0	0	102
26653	1	0	101	0	0	102
26654	0	0	0	89	0	89
26655	0	0	0	77	0	77
26656	0	0	0	76	0	76
26657	0	1	0	76	0	77
26658	1	0	0	73	0	74
26659	0	0	86	0	0	86
26660	0	0	0	83	0	83
26661	87	0	0	0	0	87
26662	0	0	0	81	0	81
26663	87	0	0	0	0	87
26664	0	0	1	91	0	92
26665	93	0	0	0	0	93
26666	83	0	0	0	0	83
26667	0	0	0	91	0	91
26668	1	0	0	85	0	86
26669	80	0	0	0	0	80
26670	80	0	0	1	0	81
26671	0	0	89	0	0	89
26672	0	0	0	81	0	81
26673	0	2	0	79	0	81
26674	85	0	0	0	0	85
26675	79	0	0	0	0	79
26676	1	0	0	87	0	88
26677	0	1	0	85	0	86
26678	0	0	0	86	0	86
26679	0	1	0	88	0	89
26680	0	85	0	1	0	86
26681	0	84	0	0	0	84
26682	0	4	0	83	0	87
26683	0	87	0	0	0	87
26684	0	0	0	85	0	85
26685	0	0	88	0	0	88
26686	0	0	92	0	0	92
26687	0	90	0	0	0	90
26688	0	0	0	88	0	88
26689	0	0	99	0	0	99
26690	0	0	0	97	0	97
26691	0	0	0	92	0	92
26692	95	0	0	0	0	95
26693	0	0	0	99	0	99
26694	0	0	103	0	0	103
26695	0	0	107	0	0	107
26696	0	107	0	0	0	107
26697	0	109	0	0	0	109
26698	102	0	0	0	0	102
26699	0	0	107	0	0	107
26700	0	0	0	104	0	104
26701	107	0	1	0	0	108
26702	109	0	0	0	0	109
26703	0	118	0	0	0	118
26704	0	1	0	108	0	109
26705	0	0	0	108	0	108
26706	0	0	0	116	0	116
26707	117	0	0	1	0	118
26708	0	0	123	0	0	123
26709	0	122	0	0	0	122
26710	0	0	0	113	0	113
26711	0	0	0	117	0	117
26712	0	0	126	0	0	126
26713	0	3	0	110	0	113
26714	0	1	0	109	0	110
26715	0	2	0	119	0	121
26716	0	1	0	127	0	128
26717	0	0	130	0	0	130
26718	0	0	0	133	0	133
26719	0	0	135	0	0	135
26720	0	136	0	0	0	136
26721	0	4	0	125	0	129
26722	0	0	0	140	0	140
26723	0	0	140	0	0	140
26724	0	149	0	0	0	149
26725	0	2	0	137	0	139
26726	0	0	154	0	0	154
26727	0	159	0	0	0	159
26728	0	0	0	155	0	155
26729	0	0	169	0	0	169
26730	2	1	0	158	0	161
26731	0	0	0	166	0	166
26732	0	0	0	173	0	173
26733	175	0	0	0	0	175
26734	0	177	0	0	0	177
26735	172	0	0	0	0	172
26736	0	0	189	0	0	189
26737	195	0	0	0	0	195
26738	176	0	0	0	0	176
26739	0	0	0	191	0	191
26740	192	0	0	0	0	192
26741	184	0	0	0	0	184
26742	184	0	1	0	0	185
26743	0	0	0	188	0	188
26744	0	1	0	200	0	201
26745	0	0	194	0	0	194
26746	0	0	199	1	0	200
26747	215	0	0	0	0	215
26748	0	0	0	221	0	221
26749	0	224	0	2	0	226
26750	223	0	1	0	0	224
26751	0	250	0	0	0	250
26752	0	234	0	1	0	235
26753	0	0	232	0	0	232
26754	0	0	265	0	0	265
26755	0	0	0	265	0	265
26756	0	0	259	0	0	259
26757	4	0	266	0	0	270
26758	261	0	1	0	0	262
26759	274	0	2	0	0	276
26760	0	5	0	266	0	271
26761	0	1	0	293	0	294
26762	0	0	289	0	0	289
26763	0	296	0	0	0	296
26764	0	0	0	296	0	296
26765	284	0	1	0	0	285
26766	0	0	1	301	0	302
26767	0	307	0	0	0	307
26768	2	0	311	0	0	313
26769	0	304	0	5	0	309
26770	304	0	0	0	0	304
26771	287	0	0	0	0	287
26772	0	1	0	310	0	311
26773	1	0	320	0	0	321
26774	0	0	326	0	0	326
26775	0	330	0	0	0	330
26776	0	2	0	331	0	333
26777	0	0	0	328	0	328
26778	0	1	384	0	0	385
26779	0	0	0	371	0	371
26780	0	388	0	0	0	388
26781	0	2	0	373	0	375
26782	0	1	0	384	0	385
26783	0	0	388	0	0	388
26784	0	2	0	383	0	385
26785	379	0	6	1	0	386
26786	0	0	393	0	0	393
26787	1	0	395	0	0	396
26788	0	394	0	0	0	394
26789	0	0	0	377	0	377
26790	0	0	0	391	0	391
26791	1	0	392	0	0	393
26792	405	0	1	0	0	406
26793	0	1	0	403	0	404
26794	0	0	419	0	0	419
26795	0	0	0	414	0	414
26796	4	0	407	0	0	411
26797	0	0	413	1	0	414
26798	0	425	0	0	0	425
26799	0	2	0	416	0	418
26800	0	429	0	0	0	429
26801	426	0	0	0	0	426
26802	2	0	431	0	0	433
26803	0	435	0	0	0	435
26804	0	0	0	437	0	437
26805	432	0	0	2	0	434
26806	0	458	0	0	0	458
26807	1	4	1	430	0	436
26808	0	1	0	462	0	463
26809	0	463	0	0	0	463
26810	459	0	2	0	0	461
26811	0	3	0	422	0	425
26812	3	5	0	449	0	457
26813	0	0	461	0	0	461
26814	0	473	0	0	0	473
26815	0	0	0	461	0	461
26816	0	0	0	466	0	466
26817	0	498	0	0	0	498
26818	0	4	0	473	0	477
26819	0	1	1	469	0	471
26820	0	0	0	504	0	504
26821	0	501	0	0	0	501
26822	485	0	1	0	0	486
26823	0	0	504	0	0	504
26824	507	0	0	1	0	508
26825	0	526	0	1	0	527
26826	0	3	1	514	0	518
26827	0	0	565	0	0	565
26828	0	1	0	543	0	544
26829	0	2	0	524	0	526
26830	1	1	0	551	0	553
26831	2	0	555	0	0	557
26832	0	546	0	0	0	546
26833	0	0	539	1	0	540
26834	0	562	0	0	0	562
26835	1	0	560	0	0	561
26836	0	1	0	573	0	574
26837	569	0	3	0	0	572
26838	0	571	0	0	0	571
26839	0	0	563	0	0	563
26840	0	576	0	0	0	576
26841	0	1	573	0	0	574
26842	0	5	0	575	0	580
26843	0	0	0	615	0	615
26844	0	642	0	0	0	642
26845	0	637	0	1	0	638
26846	637	0	0	0	0	637
26847	0	6	0	623	0	629
26848	2	0	653	0	0	655
26849	2	0	0	654	0	656
26850	2	0	643	0	0	645
26851	7	0	649	0	0	656
26852	0	0	0	637	0	637
26853	1	650	0	2	0	653
26854	642	0	4	0	0	646
26855	0	0	0	609	0	609
26856	0	1	0	649	0	650
26857	0	649	0	1	0	650
26858	639	2	0	0	0	641
26859	634	0	1	0	0	635
26860	0	0	0	676	0	676
26861	0	668	0	0	0	668
26862	0	670	0	1	0	671
26863	658	0	0	0	0	658
26864	1	0	664	0	0	665
26865	657	0	1	0	0	658
26866	616	0	2	0	0	618
26867	638	0	0	0	0	638
26868	0	676	0	0	0	676
26869	0	1	0	663	0	664
26870	651	0	1	0	0	652
26871	644	0	3	1	0	648
26872	0	708	0	0	0	708
26873	688	0	1	0	0	689
26874	0	0	0	634	0	634
26875	0	3	0	692	0	695
26876	0	712	0	0	0	712
26877	0	1	0	676	0	677
26878	0	1	0	701	0	702
26879	0	709	0	0	0	709
26880	2	5	0	712	0	719
26881	0	711	0	0	0	711
26882	647	0	4	0	0	651
26883	663	0	3	0	0	666
26884	0	684	1	0	0	685
26885	3	0	719	0	0	722
26886	2	4	0	727	0	733
26887	2	0	714	0	0	716
26888	0	726	0	3	0	729
26889	0	724	0	0	0	724
26890	710	0	3	2	0	715
26891	0	753	0	0	0	753
26892	0	5	0	722	0	727
26893	1	748	0	0	0	749
26894	0	752	0	0	0	752
26895	723	0	0	2	0	725
26896	3	2	0	733	0	738
26897	0	0	749	0	0	749
26898	0	0	752	0	0	752
26899	0	744	0	3	0	747
26900	732	2	3	0	0	737
26901	0	742	0	0	0	742
26902	0	2	0	718	0	720
26903	749	0	3	0	0	752
26904	0	4	0	730	0	734
26905	0	1	0	751	0	752
26906	0	741	0	0	0	741
26907	0	1	0	725	0	726
26908	0	0	745	0	0	745
26909	720	0	5	0	0	725
26910	0	748	0	0	0	748
26911	0	709	0	0	0	709
26912	668	0	0	2	0	670
26913	0	0	699	0	0	699
26914	689	0	1	1	0	691
26915	0	698	0	3	0	701
26916	0	664	0	0	0	664
26917	7	0	666	0	0	673
26918	2	721	0	0	0	723
26919	1	1	0	699	0	701
26920	0	3	0	688	0	691
26921	0	730	0	0	0	730
26922	2	0	0	709	0	711
26923	702	0	1	0	0	703
26924	0	0	706	0	0	706
26925	694	0	1	1	0	696
26926	650	0	2	0	0	652
26927	624	0	0	0	0	624
26928	0	0	670	0	0	670
26929	0	0	0	649	0	649
26930	0	0	642	0	0	642
26931	626	0	5	0	0	631
26932	611	0	5	0	0	616
26933	0	664	0	0	0	664
26934	0	3	0	640	0	643
26935	0	649	0	0	0	649
26936	1	0	654	0	0	655
26937	0	0	1	634	0	635
26938	633	0	1	0	0	634
26939	614	0	2	0	0	616
26940	1	0	0	666	0	667
26941	0	655	0	0	0	655
26942	0	0	640	0	0	640
26943	0	0	649	0	0	649
26944	638	0	2	0	0	640
26945	1	0	661	0	0	662
26946	0	650	0	0	0	650
26947	0	4	0	628	0	632
26948	0	2	652	0	0	654
26949	0	2	1	627	0	630
26950	0	0	633	3	0	636
26951	646	0	0	0	0	646
26952	0	0	0	635	0	635
26953	0	627	0	2	0	629
26954	0	637	0	4	0	641
26955	0	0	0	638	0	638
26956	0	1	0	639	0	640
26957	0	624	0	8	0	632
26958	1	1	650	0	0	652
26959	0	3	1	649	0	653
26960	0	0	627	1	0	628
26961	3	0	655	0	0	658
26962	652	1	2	1	0	656
26963	0	672	0	9	0	681
26964	665	0	1	0	0	666
26965	0	0	0	679	0	679
26966	0	661	0	0	0	661
26967	1	1	3	645	0	650
26968	2	0	0	670	0	672
26969	0	690	0	7	0	697
26970	0	0	702	1	0	703
26971	0	3	0	677	0	680
26972	661	8	6	0	0	675
26973	1	2	0	657	0	660
26974	0	0	0	697	0	697
26975	0	0	717	0	0	717
26976	0	717	0	0	0	717
26977	0	3	1	702	0	706
26978	2	0	693	0	0	695
26979	1	0	708	0	0	709
26980	705	1	2	0	0	708
26981	0	716	0	13	0	729
26982	700	0	1	0	0	701
26983	0	738	0	0	0	738
26984	0	682	0	0	0	682
26985	825	0	2	0	0	827
26986	2	1	0	793	0	796
26987	0	824	0	0	0	824
26988	0	0	0	821	0	821
26989	801	0	2	0	0	803
26990	1	0	821	0	0	822
26991	3	0	825	0	0	828
26992	781	0	0	0	0	781
26993	0	793	0	1	0	794
26994	1	0	699	0	0	700
26995	0	728	0	0	0	728
26996	0	1	1	697	0	699
26997	0	0	721	0	0	721
26998	0	1	1	698	0	700
26999	0	0	715	0	0	715
27000	706	0	6	0	0	712
27001	0	737	0	7	0	744
27002	725	0	3	1	0	729
27003	2	3	0	732	0	737
27004	0	692	0	7	0	699
27005	658	0	2	1	0	661
27006	678	0	5	3	0	686
27007	3	0	708	0	0	711
27008	0	0	715	0	0	715
27009	689	2	2	0	0	693
27010	0	701	0	0	0	701
27011	0	669	0	0	0	669
27012	0	2	0	640	0	642
27013	0	2	709	0	0	711
27014	0	721	0	0	0	721
27015	0	710	0	0	0	710
27016	0	0	0	703	0	703
27017	686	0	2	0	0	688
27018	651	0	1	0	0	652
27019	679	0	4	0	0	683
27020	0	0	735	0	0	735
27021	707	0	7	0	0	714
27022	616	0	4	16	0	636
27023	637	0	6	0	0	643
27024	0	3	0	726	0	729
27025	0	720	0	0	0	720
27026	710	2	4	5	0	721
27027	0	786	0	5	0	791
27028	1	2	1	778	0	782
27029	4	0	806	0	0	810
27030	0	4	0	795	0	799
27031	2	9	0	810	0	821
27032	1	2	827	0	0	830
27033	0	868	0	0	0	868
27034	0	1	0	848	0	849
27035	855	4	1	2	0	862
27036	0	909	0	0	0	909
27037	886	1	5	0	0	892
27038	1	3	0	895	0	899
27039	0	842	0	3	0	845
27040	941	2	1	0	0	944
27041	0	987	0	1	0	988
27042	3	0	965	0	0	968
27043	944	0	1	0	0	945
27044	898	0	8	0	0	906
27045	0	1003	0	0	0	1003
27046	2	0	987	0	0	989
27047	0	1046	0	1	0	1047
27048	0	0	1	969	0	970
27049	0	4	0	941	0	945
27050	0	6	0	1062	0	1068
27051	0	1099	0	0	0	1099
27052	0	4	0	1030	0	1034
27053	0	4	0	1049	0	1053
27054	1079	0	0	0	0	1079
27055	0	9	0	1004	0	1013
27056	0	4	0	1096	0	1100
27057	1078	0	0	2	0	1080
27058	0	1156	0	0	0	1156
27059	1130	0	6	0	0	1136
27060	1102	0	2	0	0	1104
27061	1115	0	2	0	0	1117
27062	0	4	0	1118	0	1122
27063	1	4	0	1169	0	1174
27064	2	0	1179	0	0	1181
27065	1	0	1166	0	0	1167
27066	2	0	1167	0	0	1169
27067	1145	0	5	2	0	1152
27068	1	0	1222	0	0	1223
27069	0	1209	0	1	0	1210
27070	2	2	0	1165	0	1169
27071	0	0	0	1192	0	1192
27072	0	1181	0	0	0	1181
27073	2	0	1169	0	0	1171
27074	0	1178	0	0	0	1178
27075	1197	1	5	0	0	1203
27076	2	0	1231	0	0	1233
27077	0	1232	0	1	0	1233
27078	0	0	1289	0	0	1289
27079	1	2	0	1271	0	1274
27080	6	0	1316	0	0	1322
27081	0	1	0	1305	0	1306
27082	1314	0	5	0	0	1319
27083	0	0	1337	0	0	1337
27084	1	1372	0	4	0	1377
27085	1324	1	7	0	0	1332
27086	0	0	1334	0	0	1334
27087	7	0	1368	0	0	1375
27088	1	2	1	1382	0	1386
27089	1	0	1429	0	0	1430
27090	1453	0	5	3	0	1461
27091	0	1471	0	2	0	1473
27092	1	2	0	1445	0	1448
27093	0	1477	0	0	0	1477
27094	1439	0	13	1	0	1453
27095	0	0	1463	0	0	1463
27096	0	0	1497	0	0	1497
27097	0	10	0	1432	0	1442
27098	0	1	0	1406	0	1407
27099	0	3	0	1437	0	1440
27100	0	2	0	1516	0	1518
27101	18	0	1528	1	0	1547
27102	0	1553	0	1	0	1554
27103	5	6	0	1505	0	1516
27104	2	2	1544	0	0	1548
27105	0	1546	0	2	0	1548
27106	1534	0	6	2	0	1542
27107	0	1	0	1528	0	1529
27108	1548	0	3	0	0	1551
27109	0	1566	0	2	0	1568
27110	1505	0	11	0	0	1516
27111	0	0	1559	0	0	1559
27112	25	6	0	1522	0	1553
27113	0	1444	0	2	0	1446
27114	3	0	1514	0	0	1517
27115	0	1571	0	2	0	1573
27116	0	2	0	1534	0	1536
27117	1551	0	8	0	0	1559
27118	0	1567	0	0	0	1567
27119	1500	0	5	0	0	1505
27120	0	0	1527	0	0	1527
27121	6	0	1529	0	0	1535
27122	1548	0	2	0	0	1550
27123	5	5	1	1456	0	1467
27124	0	4	0	1493	0	1497
27125	0	0	1524	1	0	1525
27126	4	0	1510	1	0	1515
27127	0	1469	0	1	0	1470
27128	1479	0	6	0	0	1485
27129	1458	0	6	0	0	1464
27130	0	1514	0	0	0	1514
27131	0	3	2	1492	0	1497
27132	1457	0	3	0	0	1460
27133	3	0	0	1429	0	1432
27134	1437	0	1	0	0	1438
27135	1386	0	8	1	0	1395
27136	1303	0	2	0	0	1305
27137	0	11	0	1299	0	1310
27138	0	1	0	1373	0	1374
27139	1313	0	2	0	0	1315
27140	1259	0	5	0	0	1264
27141	1317	0	3	0	0	1320
27142	0	1393	0	0	0	1393
27143	1338	0	21	0	0	1359
27144	0	1391	0	1	0	1392
27145	1313	0	9	1	0	1323
27146	0	0	1371	0	0	1371
27147	1305	0	4	0	0	1309
27148	0	1352	0	0	0	1352
27149	0	1324	3	2	0	1329
27150	1303	0	3	0	0	1306
27151	0	2	0	1199	0	1201
27152	0	2	0	1319	0	1321
27153	0	1270	0	1	0	1271
27154	2	1312	0	0	0	1314
27155	1283	1	8	1	0	1293
27156	3	0	1316	0	0	1319
27157	0	2	0	1291	0	1293
27158	1285	0	0	0	0	1285
27159	2	0	1298	2	0	1302
27160	0	1227	0	2	0	1229
27161	1203	0	4	0	0	1207
27162	0	0	1217	0	0	1217
27163	5	10	4	1152	0	1171
27164	1	0	1137	0	0	1138
27165	1141	0	4	0	0	1145
27166	0	1139	0	0	0	1139
27167	1138	0	3	4	0	1145
27168	1062	0	1	0	0	1063
27169	0	6	0	1104	0	1110
27170	1079	0	4	0	0	1083
27171	1	4	0	993	0	998
27172	0	0	0	1074	0	1074
27173	1	0	1072	0	0	1073
27174	0	1078	0	1	0	1079
27175	1	2	0	991	0	994
27176	0	2	0	940	0	942
27177	1	1	0	988	0	990
27178	0	0	993	0	0	993
27179	0	974	0	0	0	974
27180	4	6	0	943	0	953
27181	0	10	0	934	0	944
27182	1	0	962	0	0	963
27183	0	0	0	949	0	949
27184	930	0	2	0	0	932
27185	0	950	0	0	0	950
27186	848	0	0	1	0	849
27187	1	0	866	0	0	867
27188	0	2	0	770	0	772
27189	778	0	0	0	0	778
27190	770	1	1	0	0	772
27191	2	0	785	0	0	787
27192	0	6	0	747	0	753
27193	6	0	754	0	0	760
27194	696	0	12	0	0	708
27195	0	724	0	1	0	725
27196	632	0	12	4	0	648
27197	637	0	2	1	0	640
27198	0	653	0	6	0	659
27199	626	0	5	0	0	631
27200	0	0	605	0	0	605
27201	597	0	6	0	0	603
27202	0	3	0	571	0	574
27203	2	0	597	0	0	599
27204	7	8	0	524	0	539
27205	1	5	0	523	0	529
27206	2	5	0	551	0	558
27207	0	539	0	2	0	541
27208	518	1	3	0	0	522
27209	0	2	0	521	0	523
27210	0	511	0	0	0	511
27211	0	2	0	506	0	508
27212	0	506	0	0	0	506
27213	0	0	511	0	0	511
27214	0	3	0	496	0	499
27215	0	1	0	481	0	482
27216	1	0	509	0	0	510
27217	518	0	1	1	0	520
27218	0	513	0	0	0	513
27219	0	3	0	490	0	493
27220	0	4	0	492	0	496
27221	1	1	0	489	0	491
27222	0	501	0	1	0	502
27223	496	0	1	0	0	497
27224	0	0	492	0	0	492
27225	1	0	502	0	0	503
27226	0	2	0	462	0	464
27227	2	1	0	437	0	440
27228	455	0	1	1	0	457
27229	1	457	0	0	0	458
27230	0	0	1	452	0	453
27231	442	0	2	0	0	444
27232	1	1	0	441	0	443
27233	394	0	2	0	0	396
27234	1	0	413	0	0	414
27235	7	388	2	1	0	398
27236	372	0	1	0	0	373
27237	2	1	380	2	0	385
27238	294	0	4	0	0	298
27239	0	0	299	0	0	299
27240	281	0	1	0	0	282
27241	0	0	0	269	0	269
27242	257	0	2	0	0	259
27243	0	2	0	218	0	220
27244	1	2	0	233	0	236
27245	232	0	1	0	0	233
27246	0	236	1	4	0	241
27247	0	0	0	216	0	216
27248	192	0	0	0	0	192
27249	181	0	4	0	0	185
27250	0	0	0	171	0	171
27251	0	0	0	178	0	178
27252	168	0	1	0	0	169
27253	0	1	0	157	0	158
27254	1	0	0	145	0	146
27255	150	0	1	0	0	151
27256	0	1	0	153	0	154
27257	0	0	150	0	0	150
27258	127	1	0	0	0	128
27259	0	0	124	0	0	124
27260	0	0	132	0	0	132
27261	117	0	0	0	0	117
27262	0	121	0	0	0	121
27263	0	0	0	99	0	99
27264	0	0	0	99	0	99
27265	0	1	0	101	0	102
27266	0	0	0	103	0	103
27267	105	0	1	1	0	107
27268	102	0	0	0	0	102
27269	103	0	0	0	0	103
27270	0	0	115	0	0	115
27271	0	1	0	80	0	81
27272	0	0	0	82	0	82
27273	0	1	0	87	0	88
27274	0	87	0	0	0	87
27275	0	87	0	0	0	87
27276	90	0	1	0	0	91
27277	0	0	0	83	0	83
27278	0	1	0	82	0	83
27279	0	0	0	85	0	85
27280	0	0	87	0	0	87
27281	0	0	86	0	0	86
27282	90	0	1	0	0	91
27283	90	0	0	0	0	90
27284	0	0	0	92	0	92
27285	0	86	0	0	0	86
27286	0	0	0	87	0	87
27287	0	0	0	81	0	81
27288	0	0	86	0	0	86
27289	89	0	1	0	0	90
27290	0	1	0	79	0	80
27291	0	0	0	82	0	82
27292	85	0	0	0	0	85
27293	0	80	0	0	0	80
27294	82	0	0	0	0	82
27295	0	0	0	83	0	83
27296	0	71	0	0	0	71
27297	76	0	0	0	0	76
27298	0	0	1	72	0	73
27299	73	0	0	0	0	73
27300	65	0	0	0	0	65
27301	63	0	1	0	0	64
27302	0	65	0	0	0	65
27303	0	55	0	0	0	55
27304	0	0	0	42	0	42
27305	0	41	0	0	0	41
27306	43	0	0	0	0	43
27307	0	0	0	41	0	41
27308	43	0	0	0	0	43
27309	42	0	0	0	0	42
27310	0	0	0	40	0	40
27311	0	0	0	36	0	36
27312	39	0	0	0	0	39
27313	33	0	2	0	0	35
27314	42	0	0	0	0	42
27315	41	0	0	0	0	41
27316	42	0	0	0	0	42
27317	0	0	0	43	0	43
27318	0	0	0	37	0	37
27319	0	0	0	43	0	43
27320	45	0	0	0	0	45
27321	0	0	0	48	0	48
27322	0	51	0	0	0	51
27323	0	0	0	43	0	43
27324	46	0	1	0	0	47
27325	47	0	0	0	0	47
27326	0	0	57	0	0	57
27327	0	0	0	54	0	54
27328	0	61	0	0	0	61
27329	63	0	0	0	0	63
27330	0	63	0	0	0	63
27331	0	1	0	61	0	62
27332	60	0	0	0	0	60
27333	60	0	0	0	0	60
27334	0	56	0	0	0	56
27335	0	0	0	57	0	57
27336	0	0	61	0	0	61
27337	58	0	0	0	0	58
27338	0	0	68	0	0	68
27339	67	0	0	0	0	67
27340	63	0	0	0	0	63
27341	0	0	0	73	0	73
27342	73	0	0	2	0	75
27343	81	0	0	0	0	81
27344	72	0	0	0	0	72
27345	0	1	0	76	0	77
27346	77	1	0	0	0	78
27347	0	0	0	66	0	66
27348	0	0	0	71	0	71
27349	0	73	0	0	0	73
27350	0	0	0	74	0	74
27351	0	77	0	0	0	77
27352	75	0	0	0	0	75
27353	71	0	0	0	0	71
27354	0	0	0	74	0	74
27355	0	0	0	74	0	74
27356	78	0	0	0	0	78
27357	0	0	78	0	0	78
27358	79	0	0	0	0	79
27359	0	0	0	73	0	73
27360	0	0	73	0	0	73
27361	74	0	0	0	0	74
27362	72	0	0	0	0	72
27363	0	0	72	0	0	72
27364	69	0	0	0	0	69
27365	0	0	71	0	0	71
27366	0	68	0	0	0	68
27367	67	0	0	0	0	67
27368	63	0	0	1	0	64
27369	0	71	0	0	0	71
27370	0	66	0	0	0	66
27371	64	0	2	0	0	66
27372	61	0	0	0	0	61
27373	0	0	2	66	0	68
27374	2	0	65	0	0	67
27375	2	0	64	0	0	66
27376	61	0	0	0	0	61
27377	0	0	67	0	0	67
27378	53	0	0	0	0	53
27379	0	0	0	43	0	43
27380	2	0	0	35	0	37
27381	0	0	38	0	0	38
27382	39	0	0	0	0	39
27383	0	0	0	37	0	37
27384	0	0	0	41	0	41
27385	44	0	0	0	0	44
27386	45	0	0	0	0	45
27387	43	0	0	0	0	43
27388	0	47	0	0	0	47
27389	0	0	44	0	0	44
27390	43	0	1	0	0	44
27391	40	0	0	0	0	40
27392	0	45	0	0	0	45
27393	43	0	0	0	0	43
27394	0	0	0	43	0	43
27395	0	0	41	0	0	41
27396	41	0	0	1	0	42
27397	30	0	0	1	0	31
27398	27	0	2	0	0	29
27399	28	0	0	1	0	29
27400	0	0	0	32	0	32
27401	0	0	0	34	0	34
27402	32	0	0	0	0	32
27403	0	0	0	33	0	33
27404	0	0	0	35	0	35
27405	0	37	0	0	0	37
27406	0	0	0	35	0	35
27407	0	0	0	36	0	36
27408	0	0	0	38	0	38
27409	0	0	0	45	0	45
27410	0	38	0	0	0	38
27411	0	1	0	40	0	41
27412	0	0	0	39	0	39
27413	0	0	43	0	0	43
27414	0	0	40	0	0	40
27415	0	43	1	0	0	44
27416	42	0	0	0	0	42
27417	0	51	0	0	0	51
27418	0	0	0	52	0	52
27419	0	0	57	0	0	57
27420	57	0	0	0	0	57
27421	0	0	0	56	0	56
27422	50	0	1	1	0	52
27423	47	0	0	0	0	47
27424	0	61	0	0	0	61
27425	57	0	0	0	0	57
27426	0	62	0	0	0	62
27427	1	0	0	56	0	57
27428	0	57	0	0	0	57
27429	0	0	54	0	0	54
27430	0	60	0	0	0	60
27431	0	0	0	59	0	59
27432	61	0	0	0	0	61
27433	0	61	0	0	0	61
27434	0	0	0	56	0	56
27435	0	0	0	58	0	58
27436	0	0	62	0	0	62
27437	0	0	0	56	0	56
27438	0	0	58	0	0	58
27439	56	0	0	0	0	56
27440	0	0	59	0	0	59
27441	0	60	0	0	0	60
27442	0	0	0	57	0	57
27443	0	1	0	47	0	48
27444	0	0	0	52	0	52
27445	50	0	0	0	0	50
27446	0	0	0	57	0	57
27447	0	56	0	0	0	56
27448	55	0	0	0	0	55
27449	0	60	0	0	0	60
27450	0	1	0	53	0	54
27451	59	0	1	0	0	60
27452	0	62	0	0	0	62
27453	0	59	0	0	0	59
27454	57	0	0	0	0	57
27455	55	0	0	0	0	55
27456	0	0	58	0	0	58
27457	57	0	0	0	0	57
27458	0	0	63	0	0	63
27459	0	0	0	57	0	57
27460	0	0	60	0	0	60
27461	1	0	0	58	0	59
27462	0	0	59	0	0	59
27463	0	0	0	52	0	52
27464	0	1	0	55	0	56
27465	54	0	0	0	0	54
27466	0	0	53	0	0	53
27467	50	0	0	0	0	50
27468	0	0	60	0	0	60
27469	0	0	60	0	0	60
27470	0	0	0	55	0	55
27471	55	0	0	0	0	55
27472	0	53	1	0	0	54
27473	50	0	0	0	0	50
27474	54	0	0	0	0	54
27475	0	57	0	0	0	57
27476	55	0	0	0	0	55
27477	0	0	54	0	0	54
27478	0	0	0	50	0	50
27479	53	0	1	0	0	54
27480	0	56	0	0	0	56
27481	0	0	0	52	0	52
27482	0	0	0	47	0	47
27483	0	0	0	53	0	53
27484	0	1	0	55	0	56
27485	52	0	0	0	0	52
27486	53	0	0	0	0	53
27487	56	0	0	0	0	56
27488	56	0	0	0	0	56
27489	0	0	59	0	0	59
27490	60	0	0	0	0	60
27491	53	0	0	0	0	53
27492	0	62	0	1	0	63
27493	0	58	0	4	0	62
27494	0	1	0	58	0	59
27495	0	0	0	62	0	62
27496	0	0	63	0	0	63
27497	0	60	0	1	0	61
27498	0	0	0	61	0	61
27499	0	74	0	0	0	74
27500	2	0	0	70	0	72
27501	0	0	0	75	0	75
27502	0	77	0	1	0	78
27503	0	0	0	80	0	80
27504	0	0	82	0	0	82
27505	0	0	79	0	0	79
27506	79	0	1	0	0	80
27507	80	0	1	1	0	82
27508	0	107	0	0	0	107
27509	101	0	0	0	0	101
27510	0	0	0	110	0	110
27511	104	0	0	0	0	104
27512	0	118	0	0	0	118
27513	0	0	116	0	0	116
27514	110	2	3	0	0	115
27515	0	0	117	0	0	117
27516	0	0	113	0	0	113
27517	0	0	115	0	0	115
27518	0	110	0	6	0	116
27519	109	0	1	0	0	110
27520	99	0	1	0	0	100
27521	0	0	0	116	0	116
27522	0	0	0	121	0	121
27523	0	106	0	0	0	106
27524	120	0	0	0	0	120
27525	0	125	0	0	0	125
27526	0	118	0	0	0	118
27527	120	0	0	0	0	120
27528	0	1	0	113	0	114
27529	0	0	0	121	0	121
27530	0	1	0	124	0	125
27531	0	130	0	0	0	130
27532	130	0	0	1	0	131
27533	0	0	0	125	0	125
27534	0	127	0	1	0	128
27535	0	133	0	0	0	133
27536	0	1	0	131	0	132
27537	0	141	0	0	0	141
27538	0	0	0	139	0	139
27539	140	2	0	0	0	142
27540	0	0	139	0	0	139
27541	0	145	0	0	0	145
27542	0	1	0	139	0	140
27543	0	0	140	0	0	140
27544	139	0	0	0	0	139
27545	0	0	0	133	0	133
27546	131	0	1	1	0	133
27547	128	0	0	4	0	132
27548	0	143	0	0	0	143
27549	132	0	0	0	0	132
27550	126	0	0	0	0	126
27551	123	0	0	0	0	123
27552	0	0	0	127	0	127
27553	0	3	0	132	0	135
27554	0	0	0	139	0	139
27555	0	0	134	0	0	134
27556	0	141	0	0	0	141
27557	138	0	1	0	0	139
27558	0	135	0	1	0	136
27559	6	0	0	124	0	130
27560	1	0	141	0	0	142
27561	144	0	0	0	0	144
27562	0	147	0	0	0	147
27563	0	1	0	138	0	139
27564	1	1	0	141	0	143
27565	0	0	146	0	0	146
27566	0	149	0	0	0	149
27567	0	1	0	135	0	136
27568	0	0	0	134	0	134
27569	0	2	0	138	0	140
27570	129	0	0	0	0	129
27571	0	0	145	0	0	145
27572	0	145	0	0	0	145
27573	145	0	4	0	0	149
27574	0	148	0	1	0	149
27575	0	0	0	138	0	138
27576	0	150	0	1	0	151
27577	145	0	2	0	0	147
27578	131	0	0	0	0	131
27579	0	0	0	149	0	149
27580	0	2	0	142	0	144
27581	0	0	0	154	0	154
27582	0	0	153	0	0	153
27583	0	153	0	0	0	153
27584	0	0	0	147	0	147
27585	0	1	0	130	0	131
27586	0	1	0	144	0	145
27587	0	2	0	160	0	162
27588	0	0	158	0	0	158
27589	0	167	0	0	0	167
27590	0	2	0	153	0	155
27591	0	2	0	159	0	161
27592	0	0	171	0	0	171
27593	0	1	0	169	0	170
27594	0	163	0	0	0	163
27595	0	158	0	0	0	158
27596	0	0	0	161	0	161
27597	1	0	167	0	0	168
27598	166	0	1	0	0	167
27599	0	168	0	0	0	168
27600	1	0	154	0	0	155
27601	0	0	165	0	0	165
27602	0	170	0	2	0	172
27603	0	0	178	0	0	178
27604	0	1	0	172	0	173
27605	177	0	1	0	0	178
27606	173	0	2	1	0	176
27607	168	0	0	0	0	168
27608	179	0	0	0	0	179
27609	0	189	0	0	0	189
27610	184	0	1	0	0	185
27611	0	185	0	0	0	185
27612	0	0	180	0	0	180
27613	0	0	0	190	0	190
27614	0	198	0	0	0	198
27615	0	1	0	198	0	199
27616	193	0	2	0	0	195
27617	0	2	0	189	0	191
27618	0	201	0	0	0	201
27619	184	0	2	0	0	186
27620	0	0	203	0	0	203
27621	0	2	0	188	0	190
27622	0	2	0	188	0	190
27623	196	0	0	0	0	196
27624	0	191	0	1	0	192
27625	1	0	190	0	0	191
27626	0	0	1	196	0	197
27627	1	0	192	0	0	193
27628	0	199	0	0	0	199
27629	0	194	0	0	0	194
27630	176	0	0	0	0	176
27631	0	1	184	0	0	185
27632	181	0	2	0	0	183
27633	0	1	0	193	0	194
27634	0	192	0	0	0	192
27635	179	1	2	1	0	183
27636	0	0	195	0	0	195
27637	0	4	0	173	0	177
27638	0	1	0	163	0	164
27639	0	1	0	188	0	189
27640	0	189	0	2	0	191
27641	188	0	0	0	0	188
27642	0	193	0	0	0	193
27643	0	182	0	0	0	182
27644	0	0	0	189	0	189
27645	171	0	3	0	0	174
27646	168	0	0	0	0	168
27647	161	0	0	0	0	161
27648	0	163	0	0	0	163
27649	0	0	0	155	0	155
27650	0	0	157	0	0	157
27651	0	2	0	132	0	134
27652	0	0	0	143	0	143
27653	0	138	0	1	0	139
27654	142	0	0	0	0	142
27655	0	1	0	136	0	137
27656	0	142	0	0	0	142
27657	131	0	0	1	0	132
27658	0	0	141	0	0	141
27659	139	0	1	0	0	140
27660	0	136	0	0	0	136
27661	132	0	0	0	0	132
27662	129	0	0	0	0	129
27663	0	0	142	0	0	142
27664	111	0	1	0	0	112
27665	0	0	137	0	0	137
27666	0	0	130	0	0	130
27667	128	0	0	0	0	128
27668	127	0	0	0	0	127
27669	0	1	137	0	0	138
27670	1	1	0	130	0	132
27671	0	1	0	130	0	131
27672	0	136	0	0	0	136
27673	130	0	0	0	0	130
27674	132	0	2	0	0	134
27675	1	0	138	0	0	139
27676	131	0	0	1	0	132
27677	134	0	0	0	0	134
27678	0	137	0	0	0	137
27679	0	0	0	125	0	125
27680	0	0	0	114	0	114
27681	0	0	0	136	0	136
27682	133	0	1	0	0	134
27683	0	135	0	0	0	135
27684	0	1	0	125	0	126
27685	0	133	0	0	0	133
27686	0	0	0	124	0	124
27687	0	128	0	1	0	129
27688	0	132	0	0	0	132
27689	129	0	0	0	0	129
27690	121	0	1	0	0	122
27691	0	3	0	126	0	129
27692	0	0	0	120	0	120
27693	0	0	0	124	0	124
27694	2	0	0	128	0	130
27695	0	0	0	135	0	135
27696	0	136	0	0	0	136
27697	0	0	0	126	0	126
27698	0	0	0	134	0	134
27699	129	0	1	0	0	130
27700	0	0	0	122	0	122
27701	0	0	0	138	0	138
27702	0	0	143	0	0	143
27703	0	0	0	133	0	133
27704	0	0	0	146	0	146
27705	0	1	142	0	0	143
27706	0	133	0	0	0	133
27707	0	0	137	0	0	137
27708	0	0	145	0	0	145
27709	0	139	0	0	0	139
27710	140	0	1	0	0	141
27711	139	0	0	0	0	139
27712	0	0	0	142	0	142
27713	150	0	0	0	0	150
27714	0	0	151	0	0	151
27715	0	0	0	149	0	149
27716	0	0	154	0	0	154
27717	0	1	0	137	0	138
27718	0	0	0	148	0	148
27719	0	0	0	142	0	142
27720	142	0	2	0	0	144
27721	0	0	0	149	0	149
27722	145	0	0	0	0	145
27723	152	0	1	0	0	153
27724	0	163	0	0	0	163
27725	161	0	0	0	0	161
27726	1	158	0	0	0	159
27727	1	2	0	146	0	149
27728	0	0	0	146	0	146
27729	0	1	0	150	0	151
27730	2	0	154	0	0	156
27731	0	156	0	0	0	156
27732	0	1	0	138	0	139
27733	1	1	0	135	0	137
27734	0	151	0	0	0	151
27735	146	0	1	0	0	147
27736	0	155	0	0	0	155
27737	143	0	0	0	0	143
27738	0	151	0	0	0	151
27739	0	1	0	144	0	145
27740	0	148	0	0	0	148
27741	144	0	0	0	0	144
27742	130	0	3	0	0	133
27743	133	0	2	0	0	135
27744	140	0	0	0	0	140
27745	0	0	150	0	0	150
27746	145	0	0	0	0	145
27747	121	0	0	0	0	121
27748	139	0	0	0	0	139
27749	0	0	149	0	0	149
27750	148	0	0	0	0	148
27751	0	151	0	0	0	151
27752	131	0	2	0	0	133
27753	0	0	140	0	0	140
27754	128	0	2	0	0	130
27755	111	0	1	0	0	112
27756	3	0	0	130	0	133
27757	1	0	131	0	0	132
27758	128	0	0	0	0	128
27759	0	0	0	116	0	116
27760	1	1	0	131	0	133
27761	0	0	134	0	0	134
27762	124	0	1	0	0	125
27763	125	0	0	1	0	126
27764	0	132	0	0	0	132
27765	0	2	0	122	0	124
27766	0	0	0	110	0	110
27767	0	1	0	126	0	127
27768	0	131	0	1	0	132
27769	127	0	0	0	0	127
27770	0	1	0	123	0	124
27771	0	1	0	127	0	128
27772	127	0	0	0	0	127
27773	124	0	0	0	0	124
27774	0	1	0	116	0	117
27775	0	1	0	128	0	129
27776	0	0	129	0	0	129
27777	119	0	0	0	0	119
27778	0	127	0	0	0	127
27779	0	0	0	117	0	117
27780	0	0	0	117	0	117
27781	0	129	0	0	0	129
27782	0	0	0	129	0	129
27783	126	0	0	0	0	126
27784	0	1	0	121	0	122
27785	0	0	0	125	0	125
27786	0	0	0	131	0	131
27787	0	0	130	0	0	130
27788	0	0	0	124	0	124
27789	0	0	129	0	0	129
27790	0	128	0	0	0	128
27791	0	0	0	116	0	116
27792	0	2	0	114	0	116
27793	0	0	0	117	0	117
27794	0	0	0	121	0	121
27795	0	1	0	127	0	128
27796	122	0	0	0	0	122
27797	0	0	129	0	0	129
27798	0	123	0	0	0	123
27799	0	127	0	0	0	127
27800	0	0	0	119	0	119
27801	0	2	0	109	0	111
27802	0	1	0	125	0	126
27803	0	129	0	0	0	129
27804	0	0	0	127	0	127
27805	1	0	133	0	0	134
27806	0	134	0	1	0	135
27807	0	0	0	133	0	133
27808	126	0	0	0	0	126
27809	0	0	0	123	0	123
27810	0	1	0	144	0	145
27811	0	141	0	1	0	142
27812	0	143	0	0	0	143
27813	0	0	0	138	0	138
27814	1	2	0	144	0	147
27815	0	0	149	0	0	149
27816	0	1	0	140	0	141
27817	0	0	0	138	0	138
27818	0	1	0	140	0	141
27819	1	1	0	141	0	143
27820	150	0	0	1	0	151
27821	142	0	0	0	0	142
27822	0	0	0	145	0	145
27823	0	0	0	162	0	162
27824	144	0	2	0	0	146
27825	0	0	0	150	0	150
27826	0	0	149	0	0	149
27827	0	161	0	0	0	161
27828	1	0	0	155	0	156
27829	0	1	0	149	0	150
27830	163	0	0	0	0	163
27831	0	1	0	144	0	145
27832	1	0	0	165	0	166
27833	158	0	1	1	0	160
27834	0	0	0	177	0	177
27835	0	176	0	0	0	176
27836	0	0	0	170	0	170
27837	0	2	0	164	0	166
27838	0	0	0	174	0	174
27839	0	1	0	178	0	179
27840	0	0	175	0	0	175
27841	0	0	178	0	0	178
27842	1	1	0	174	0	176
27843	1	0	0	173	0	174
27844	0	175	0	0	0	175
27845	1	3	0	162	0	166
27846	0	190	0	1	0	191
27847	195	0	1	1	0	197
27848	0	213	0	0	0	213
27849	0	0	0	204	0	204
27850	0	2	0	195	0	197
27851	0	0	189	0	0	189
27852	193	0	1	0	0	194
27853	192	0	4	0	0	196
27854	0	212	0	0	0	212
27855	0	1	0	201	0	202
27856	0	0	210	0	0	210
27857	0	211	0	0	0	211
27858	204	0	0	1	0	205
27859	191	0	2	0	0	193
27860	0	0	214	0	0	214
27861	227	0	1	0	0	228
27862	0	1	0	226	0	227
27863	2	230	0	1	0	233
27864	229	0	0	0	0	229
27865	0	1	0	245	0	246
27866	244	0	1	0	0	245
27867	231	0	0	0	0	231
27868	0	0	0	254	0	254
27869	0	0	240	0	0	240
27870	241	0	2	0	0	243
27871	219	0	1	0	0	220
27872	243	0	0	1	0	244
27873	0	258	0	0	0	258
27874	0	2	0	236	0	238
27875	0	0	0	242	0	242
27876	2	0	242	0	0	244
27877	0	2	0	249	0	251
27878	0	254	0	0	0	254
27879	243	0	0	0	0	243
27880	0	248	0	2	0	250
27881	1	0	223	0	0	224
27882	0	248	0	2	0	250
27883	0	248	0	0	0	248
27884	0	1	0	253	0	254
27885	232	0	0	0	0	232
27886	215	0	1	1	0	217
27887	237	0	0	0	0	237
27888	0	248	0	0	0	248
27889	1	0	233	0	0	234
27890	238	0	0	0	0	238
27891	220	0	0	0	0	220
27892	0	251	0	0	0	251
27893	240	0	0	0	0	240
27894	0	1	0	231	0	232
27895	1	0	245	0	0	246
27896	247	0	0	0	0	247
27897	219	0	3	1	0	223
27898	210	0	4	0	0	214
27899	0	0	0	217	0	217
27900	0	0	0	229	0	229
27901	1	1	0	238	0	240
27902	1	236	0	0	0	237
27903	0	0	0	229	0	229
27904	0	0	0	229	0	229
27905	0	1	246	0	0	247
27906	0	1	0	228	0	229
27907	2	0	0	208	0	210
27908	2	2	0	215	0	219
27909	0	1	0	242	0	243
27910	0	243	0	0	0	243
27911	1	1	0	231	0	233
27912	0	1	0	226	0	227
27913	224	0	0	0	0	224
27914	0	0	234	0	0	234
27915	0	0	221	0	0	221
27916	227	0	3	1	0	231
27917	213	0	1	0	0	214
27918	0	0	0	247	0	247
27919	0	252	0	0	0	252
27920	243	0	0	2	0	245
27921	0	2	0	251	0	253
27922	0	244	0	0	0	244
27923	252	0	1	0	0	253
27924	0	271	0	0	0	271
27925	248	0	1	1	0	250
27926	257	0	0	0	0	257
27927	0	279	0	1	0	280
27928	0	1	0	263	0	264
27929	0	1	272	0	0	273
27930	0	2	0	262	0	264
27931	271	1	0	0	0	272
27932	0	0	270	0	0	270
27933	0	273	0	0	0	273
27934	0	0	0	267	0	267
27935	0	0	263	0	0	263
27936	0	274	1	0	0	275
27937	266	0	1	1	0	268
27938	0	0	0	241	0	241
27939	0	0	0	240	0	240
27940	1	0	0	266	0	267
27941	0	269	0	1	0	270
27942	264	3	1	0	0	268
27943	0	284	0	3	0	287
27944	0	261	0	0	0	261
27945	259	2	2	1	0	264
27946	265	0	1	2	0	268
27947	0	0	285	0	0	285
27948	292	0	2	0	0	294
27949	270	0	5	0	0	275
27950	0	7	0	300	0	307
27951	2	0	319	0	0	321
27952	0	0	0	313	0	313
27953	323	0	0	0	0	323
27954	0	0	330	0	0	330
27955	2	3	0	306	0	311
27956	0	3	0	298	0	301
27957	0	0	0	325	0	325
27958	319	0	1	2	0	322
27959	0	331	0	0	0	331
27960	317	0	0	0	0	317
27961	0	0	346	0	0	346
27962	0	1	0	339	0	340
27963	0	334	0	0	0	334
27964	351	0	0	0	0	351
27965	0	4	1	343	0	348
27966	0	0	370	0	0	370
27967	0	0	0	378	0	378
27968	394	0	0	0	0	394
27969	0	393	0	0	0	393
27970	0	0	0	379	0	379
27971	0	372	0	1	0	373
27972	353	0	2	0	0	355
27973	395	0	0	1	0	396
27974	0	413	0	0	0	413
27975	394	0	2	0	0	396
27976	0	0	0	403	0	403
27977	0	381	0	1	0	382
27978	373	0	0	1	0	374
27979	379	1	3	0	0	383
27980	0	411	0	0	0	411
27981	0	403	0	0	0	403
27982	407	0	0	0	0	407
27983	0	0	0	377	0	377
27984	393	0	0	0	0	393
27985	0	0	0	414	0	414
27986	2	0	413	0	0	415
27987	0	1	0	407	0	408
27988	387	0	0	1	0	388
27989	4	0	401	0	0	405
27990	0	2	0	371	0	373
27991	0	2	0	357	0	359
27992	0	0	372	0	0	372
27993	365	0	2	0	0	367
27994	0	1	0	374	0	375
27995	0	0	375	0	0	375
27996	364	0	3	2	0	369
27997	0	365	0	1	0	366
27998	0	336	0	0	0	336
27999	0	332	0	1	0	333
28000	0	0	355	0	0	355
28001	1	1	0	338	0	340
28002	1	0	364	0	0	365
28003	0	4	0	333	0	337
28004	0	352	0	1	0	353
28005	0	343	0	2	0	345
28006	0	0	0	334	0	334
28007	335	0	1	0	0	336
28008	0	3	0	325	0	328
28009	2	0	0	335	0	337
28010	0	303	0	4	0	307
28011	300	0	2	0	0	302
28012	0	320	0	0	0	320
28013	2	3	0	287	0	292
28014	0	1	0	282	0	283
28015	0	281	0	0	0	281
28016	0	0	0	266	0	266
28017	258	0	1	0	0	259
28018	0	6	0	241	0	247
28019	4	3	0	266	0	273
28020	0	267	0	0	0	267
28021	1	1	0	245	0	247
28022	255	0	0	0	0	255
28023	249	0	1	0	0	250
28024	232	0	0	0	0	232
28025	0	2	0	257	0	259
28026	0	0	245	0	0	245
28027	0	0	268	0	0	268
28028	1	2	1	244	0	248
28029	269	0	1	0	0	270
28030	1	3	0	251	0	255
28031	263	0	1	0	0	264
28032	0	1	0	238	0	239
28033	0	0	0	255	0	255
28034	252	0	0	0	0	252
28035	1	0	266	0	0	267
28036	247	0	1	0	0	248
28037	0	0	266	0	0	266
28038	0	0	0	256	0	256
28039	245	0	0	1	0	246
28040	0	0	242	0	0	242
28041	1	0	246	0	0	247
28042	234	0	0	0	0	234
28043	0	0	253	0	0	253
28044	0	252	0	0	0	252
28045	0	0	0	246	0	246
28046	242	0	1	0	0	243
28047	1	0	249	0	0	250
28048	236	0	0	1	0	237
28049	240	0	0	0	0	240
28050	217	0	0	0	0	217
28051	213	0	0	0	0	213
28052	0	0	0	245	0	245
28053	0	244	0	0	0	244
28054	225	0	1	0	0	226
28055	0	0	240	0	0	240
28056	0	236	0	3	0	239
28057	234	0	0	0	0	234
28058	0	243	0	0	0	243
28059	0	227	0	1	0	228
28060	0	1	1	211	0	213
28061	0	1	0	193	0	194
28062	1	0	0	213	0	214
28063	214	0	0	0	0	214
28064	201	0	1	2	0	204
28065	0	2	0	210	0	212
28066	0	1	0	223	0	224
28067	0	0	220	0	0	220
28068	223	0	0	0	0	223
28069	207	0	2	0	0	209
28070	0	1	0	213	0	214
28071	1	0	0	218	0	219
28072	0	0	223	0	0	223
28073	0	1	0	216	0	217
28074	0	0	219	0	0	219
28075	0	205	0	0	0	205
28076	0	0	207	0	0	207
28077	0	1	0	210	0	211
28078	0	0	204	0	0	204
28079	0	0	212	0	0	212
28080	220	0	1	0	0	221
28081	0	2	0	218	0	220
28082	0	0	222	0	0	222
28083	213	0	1	0	0	214
28084	0	0	214	0	0	214
28085	0	0	233	0	0	233
28086	0	226	0	1	0	227
28087	1	0	0	223	0	224
28088	2	0	222	0	0	224
28089	2	0	231	0	0	233
28090	0	0	0	222	0	222
28091	0	2	0	223	0	225
28092	0	233	0	0	0	233
28093	0	0	0	217	0	217
28094	224	0	0	0	0	224
28095	210	0	0	0	0	210
28096	207	0	1	0	0	208
28097	0	1	0	218	0	219
28098	0	197	0	0	0	197
28099	192	0	0	0	0	192
28100	0	202	0	0	0	202
28101	0	186	1	0	0	187
28102	0	197	0	0	0	197
28103	206	0	0	0	0	206
28104	0	1	0	185	0	186
28105	0	0	0	198	0	198
28106	0	209	0	0	0	209
28107	195	0	2	0	0	197
28108	0	0	209	0	0	209
28109	2	0	1	196	0	199
28110	202	0	2	0	0	204
28111	5	203	0	3	0	211
28112	180	1	2	0	0	183
28113	6	0	0	186	0	192
28114	1	186	0	1	0	188
28115	0	0	192	0	0	192
28116	197	0	0	0	0	197
28117	0	0	0	163	0	163
28118	167	0	0	1	0	168
28119	0	0	0	170	0	170
28120	0	160	0	0	0	160
28121	0	0	146	1	0	147
28122	1	0	176	2	0	179
28123	3	0	0	165	0	168
28124	175	1	0	6	0	182
28125	177	0	1	0	0	178
28126	2	0	0	184	0	186
28127	0	0	0	197	0	197
28128	196	0	0	0	0	196
28129	0	0	0	196	0	196
28130	194	0	0	0	0	194
28131	0	207	0	0	0	207
28132	192	0	0	0	0	192
28133	0	0	201	0	0	201
28134	0	3	0	182	0	185
28135	0	1	0	179	0	180
28136	0	0	0	193	0	193
28137	1	187	0	0	0	188
28138	0	186	0	0	0	186
28139	0	2	0	185	0	187
28140	0	0	196	0	0	196
28141	0	2	0	171	0	173
28142	0	1	0	168	0	169
28143	0	0	0	188	0	188
28144	188	0	0	0	0	188
28145	0	193	0	0	0	193
28146	0	179	0	0	0	179
28147	0	0	0	188	0	188
28148	0	1	0	173	0	174
28149	0	0	1	180	0	181
28150	0	1	0	191	0	192
28151	186	0	0	0	0	186
28152	0	196	0	0	0	196
28153	181	0	2	1	0	184
28154	178	0	0	0	0	178
28155	2	0	2	172	0	176
28156	0	0	0	187	0	187
28157	175	0	0	0	0	175
28158	175	0	0	1	0	176
28159	0	0	0	174	0	174
28160	0	0	0	202	0	202
28161	0	0	188	0	0	188
28162	0	185	0	1	0	186
28163	0	189	0	2	0	191
28164	178	0	0	0	0	178
28165	0	0	192	0	0	192
28166	0	0	187	0	0	187
28167	192	0	1	0	0	193
28168	177	0	1	0	0	178
28169	0	201	0	0	0	201
28170	0	198	0	0	0	198
28171	0	0	0	202	0	202
28172	207	0	1	1	0	209
28173	196	0	1	0	0	197
28174	190	0	0	1	0	191
28175	0	0	0	202	0	202
28176	0	1	0	202	0	203
28177	1	0	214	0	0	215
28178	0	0	197	0	0	197
28179	5	0	212	0	0	217
28180	0	0	0	210	0	210
28181	205	0	0	0	0	205
28182	0	0	239	0	0	239
28183	0	1	0	223	0	224
28184	0	242	0	0	0	242
28185	1	1	0	235	0	237
28186	0	0	0	217	0	217
28187	0	0	252	0	0	252
28188	1	0	0	248	0	249
28189	246	0	1	1	0	248
28190	0	0	262	0	0	262
28191	0	0	0	244	0	244
28192	1	0	247	0	0	248
28193	0	239	0	0	0	239
28194	0	0	247	0	0	247
28195	1	0	0	241	0	242
28196	0	1	0	251	0	252
28197	0	0	260	0	0	260
28198	0	0	0	247	0	247
28199	0	1	0	258	0	259
28200	0	262	0	1	0	263
28201	1	0	273	0	0	274
28202	0	1	0	263	0	264
28203	2	1	0	266	0	269
28204	1	282	0	4	0	287
28205	0	0	0	295	0	295
28206	300	0	0	0	0	300
28207	0	0	0	301	0	301
28208	2	0	300	1	0	303
28209	300	0	0	0	0	300
28210	285	0	4	0	0	289
28211	0	0	311	0	0	311
28212	326	0	0	0	0	326
28213	0	352	0	0	0	352
28214	0	2	0	332	0	334
28215	0	0	0	344	0	344
28216	0	3	3	359	0	365
28217	0	1	0	365	0	366
28218	0	1	0	382	0	383
28219	371	0	1	0	0	372
28220	1	0	390	0	0	391
28221	382	0	1	0	0	383
28222	0	0	416	0	0	416
28223	0	1	0	405	0	406
28224	458	0	2	1	0	461
28225	0	1	0	469	0	470
28226	0	474	0	2	0	476
28227	477	0	0	0	0	477
28228	0	1	0	483	0	484
28229	0	0	456	0	0	456
28230	479	0	0	2	0	481
28231	0	486	0	0	0	486
28232	2	0	476	0	0	478
28233	0	0	0	466	0	466
28234	0	3	0	478	0	481
28235	0	466	0	1	0	467
28236	0	0	479	0	0	479
28237	0	4	0	484	0	488
28238	0	0	491	1	0	492
28239	0	8	0	482	0	490
28240	0	0	0	488	0	488
28241	0	0	512	0	0	512
28242	1	0	0	511	0	512
28243	0	0	0	509	0	509
28244	0	2	0	498	0	500
28245	1	1	0	501	0	503
28246	486	0	0	1	0	487
28247	0	0	522	0	0	522
28248	515	0	0	1	0	516
28249	0	3	0	478	0	481
28250	0	1	0	493	0	494
28251	0	2	0	502	0	504
28252	0	492	0	9	0	501
28253	518	0	0	1	0	519
28254	2	0	0	532	0	534
28255	0	543	0	1	0	544
28256	0	0	0	538	0	538
28257	521	0	1	0	0	522
28258	519	0	2	0	0	521
28259	528	0	2	0	0	530
28260	0	535	0	1	0	536
28261	0	0	508	0	0	508
28262	532	0	2	0	0	534
28263	508	0	4	0	0	512
28264	0	540	0	0	0	540
28265	537	0	0	0	0	537
28266	537	0	1	0	0	538
28267	555	0	1	0	0	556
28268	0	592	0	2	0	594
28269	1	0	0	588	0	589
28270	597	0	0	0	0	597
28271	570	0	0	0	0	570
28272	543	0	3	0	0	546
28273	523	0	4	0	0	527
28274	1	1	0	576	0	578
28275	1	0	592	0	0	593
28276	0	4	0	576	0	580
28277	0	585	0	0	0	585
28278	0	3	0	555	0	558
28279	0	0	603	0	0	603
28280	605	0	2	0	0	607
28281	0	0	0	580	0	580
28282	596	0	2	0	0	598
28283	555	0	2	2	0	559
28284	1	2	0	599	0	602
28285	0	0	597	0	0	597
28286	0	0	608	0	0	608
28287	579	0	0	2	0	581
28288	2	631	0	0	0	633
28289	0	606	0	0	0	606
28290	0	606	0	0	0	606
28291	0	602	0	0	0	602
28292	602	0	2	0	0	604
28293	600	0	1	0	0	601
28294	576	0	4	0	0	580
28295	562	0	0	0	0	562
28296	0	1	0	624	0	625
28297	0	610	0	1	0	611
28298	580	0	1	1	0	582
28299	0	0	623	0	0	623
28300	0	603	0	0	0	603
28301	0	0	619	0	0	619
28302	605	0	5	0	0	610
28303	598	0	3	0	0	601
28304	588	1	12	0	0	601
28305	1	1	0	657	0	659
28306	0	0	664	0	0	664
28307	0	665	0	3	0	668
28308	656	0	6	3	0	665
28309	0	680	0	0	0	680
28310	0	642	0	0	0	642
28311	1	660	0	0	0	661
28312	1	616	0	0	0	617
28313	11	0	653	0	0	664
28314	0	687	0	0	0	687
28315	677	0	3	0	0	680
28316	0	3	0	618	0	621
28317	0	0	0	685	0	685
28318	708	0	2	0	0	710
28319	0	712	0	4	0	716
28320	1	0	709	0	0	710
28321	0	0	0	667	0	667
28322	2	2	0	663	0	667
28323	1	0	0	688	0	689
28324	0	0	687	0	0	687
28325	0	0	709	0	0	709
28326	2	0	0	694	0	696
28327	0	0	682	0	0	682
28328	1	0	689	0	0	690
28329	687	0	3	1	0	691
28330	0	707	0	3	0	710
28331	0	683	0	2	0	685
28332	0	684	0	1	0	685
28333	0	0	0	663	0	663
28334	0	691	0	2	0	693
28335	648	0	13	0	0	661
28336	0	0	707	0	0	707
28337	691	0	0	0	0	691
28338	0	2	0	646	0	648
28339	1	5	0	668	0	674
28340	0	679	0	2	0	681
28341	658	0	4	1	0	663
28342	666	0	0	0	0	666
28343	0	699	0	0	0	699
28344	0	2	0	675	0	677
28345	2	0	676	0	0	678
28346	0	0	695	0	0	695
28347	0	697	0	0	0	697
28348	676	0	2	0	0	678
28349	0	0	697	0	0	697
28350	0	0	0	678	0	678
28351	685	1	0	1	0	687
28352	659	0	2	0	0	661
28353	0	710	0	0	0	710
28354	0	694	0	1	0	695
28355	676	0	0	1	0	677
28356	1	0	685	0	0	686
28357	693	0	0	0	0	693
28358	653	0	6	0	0	659
28359	4	1	0	671	0	676
28360	0	0	688	0	0	688
28361	1	1	686	0	0	688
28362	675	0	1	0	0	676
28363	1	0	641	7	0	649
28364	639	0	1	0	0	640
28365	586	0	3	2	0	591
28366	0	622	0	3	0	625
28367	0	1	623	0	0	624
28368	0	639	0	0	0	639
28369	619	0	5	0	0	624
28370	2	0	643	0	0	645
28371	0	2	0	627	0	629
28372	2	0	627	0	0	629
28373	1	0	606	1	0	608
28374	0	0	593	0	0	593
28375	0	0	597	0	0	597
28376	0	572	0	1	0	573
28377	2	0	582	0	0	584
28378	0	581	0	0	0	581
28379	0	0	574	0	0	574
28380	591	0	1	0	0	592
28381	0	0	0	571	0	571
28382	0	593	0	0	0	593
28383	589	0	5	0	0	594
28384	568	0	3	0	0	571
28385	550	0	4	1	0	555
28386	579	0	3	0	0	582
28387	0	607	0	0	0	607
28388	569	0	2	1	0	572
28389	551	0	0	0	0	551
28390	0	567	2	0	0	569
28391	0	0	591	0	0	591
28392	7	0	0	564	0	571
28393	0	562	0	1	0	563
28394	2	0	555	0	0	557
28395	1	0	576	0	0	577
28396	0	577	0	0	0	577
28397	0	564	0	0	0	564
28398	0	564	0	1	0	565
28399	0	575	0	0	0	575
28400	565	0	0	0	0	565
28401	568	0	6	0	0	574
28402	0	0	575	0	0	575
28403	0	0	589	0	0	589
28404	0	1	1	545	0	547
28405	0	3	0	516	0	519
28406	0	0	0	551	0	551
28407	540	3	0	1	0	544
28408	0	586	0	0	0	586
28409	0	566	0	1	0	567
28410	0	600	0	0	0	600
28411	573	0	1	0	0	574
28412	598	0	0	0	0	598
28413	0	12	0	595	0	607
28414	592	0	3	0	0	595
28415	558	0	0	0	0	558
28416	0	1	0	596	0	597
28417	556	0	0	0	0	556
28418	0	575	0	0	0	575
28419	3	0	0	510	0	513
28420	0	0	508	0	0	508
28421	0	496	0	2	0	498
28422	0	0	513	0	0	513
28423	0	4	0	503	0	507
28424	0	510	0	0	0	510
28425	1	0	0	518	0	519
28426	2	3	0	481	0	486
28427	3	0	518	1	0	522
28428	0	0	528	0	0	528
28429	2	4	0	485	0	491
28430	0	4	0	503	0	507
28431	0	501	0	0	0	501
28432	502	0	0	0	0	502
28433	0	515	0	2	0	517
28434	0	474	0	2	0	476
28435	2	0	499	0	0	501
28436	0	512	0	2	0	514
28437	0	2	0	498	0	500
28438	0	491	0	0	0	491
28439	2	8	0	484	0	494
28440	0	506	0	1	0	507
28441	499	0	0	0	0	499
28442	0	520	0	0	0	520
28443	1	0	0	501	0	502
28444	0	506	0	2	0	508
28445	484	0	2	3	0	489
28446	483	0	3	0	0	486
28447	0	514	0	0	0	514
28448	480	0	3	0	0	483
28449	1	0	0	471	0	472
28450	0	0	449	0	0	449
28451	2	1	471	0	0	474
28452	0	458	0	5	0	463
28453	447	0	0	0	0	447
28454	441	0	0	0	0	441
28455	0	0	444	0	0	444
28456	0	0	447	0	0	447
28457	446	0	0	0	0	446
28458	400	0	0	1	0	401
28459	0	0	421	0	0	421
28460	406	0	2	0	0	408
28461	0	426	0	0	0	426
28462	0	396	0	0	0	396
28463	0	4	0	399	0	403
28464	0	0	0	405	0	405
28465	407	0	0	0	0	407
28466	390	0	0	0	0	390
28467	388	0	2	0	0	390
28468	0	4	0	386	0	390
28469	0	1	0	407	0	408
28470	0	379	0	0	0	379
28471	0	383	0	0	0	383
28472	0	397	0	1	0	398
28473	0	3	0	390	0	393
28474	0	388	0	0	0	388
28475	0	0	384	0	0	384
28476	386	0	1	0	0	387
28477	0	0	390	0	0	390
28478	0	0	390	0	0	390
28479	386	0	3	0	0	389
28480	0	393	0	0	0	393
28481	361	0	2	0	0	363
28482	366	0	0	0	0	366
28483	1	0	370	0	0	371
28484	0	0	389	0	0	389
28485	11	363	0	1	0	375
28486	0	0	372	0	0	372
28487	0	4	0	338	0	342
28488	2	1	0	356	0	359
28489	0	365	0	0	0	365
28490	0	373	0	0	0	373
28491	376	0	1	0	0	377
28492	353	0	0	0	0	353
28493	0	0	0	348	0	348
28494	2	1	0	354	0	357
28495	329	0	5	0	0	334
28496	354	0	0	0	0	354
28497	0	387	0	0	0	387
28498	374	0	2	0	0	376
28499	0	393	0	0	0	393
28500	0	365	0	0	0	365
28501	382	1	0	0	0	383
28502	340	0	3	0	0	343
28503	0	1	0	370	0	371
28504	361	0	0	0	0	361
28505	0	0	381	0	0	381
28506	0	364	0	0	0	364
28507	336	0	4	0	0	340
28508	2	0	351	0	0	353
28509	0	0	0	340	0	340
28510	0	342	0	1	0	343
28511	0	335	0	0	0	335
28512	328	0	1	0	0	329
28513	0	0	326	0	0	326
28514	318	0	2	0	0	320
28515	1	2	0	322	0	325
28516	1	0	322	0	0	323
28517	305	0	0	0	0	305
28518	0	314	0	0	0	314
28519	0	307	0	0	0	307
28520	299	0	0	0	0	299
28521	295	0	4	0	0	299
28522	274	0	0	0	0	274
28523	0	0	0	291	0	291
28524	1	0	0	303	0	304
28525	0	0	305	0	0	305
28526	2	0	306	0	0	308
28527	0	311	0	2	0	313
28528	0	0	0	308	0	308
28529	305	0	3	0	0	308
28530	0	315	0	0	0	315
28531	2	0	0	302	0	304
28532	294	0	0	0	0	294
28533	0	316	0	0	0	316
28534	0	284	0	0	0	284
28535	2	0	292	0	0	294
28536	286	0	0	0	0	286
28537	280	0	1	0	0	281
28538	0	0	300	0	0	300
28539	284	0	0	0	0	284
28540	0	0	291	0	0	291
28541	0	286	0	1	0	287
28542	0	0	0	290	0	290
28543	266	0	0	0	0	266
28544	0	287	0	1	0	288
28545	0	289	0	0	0	289
28546	264	0	1	1	0	266
28547	0	0	280	0	0	280
28548	261	0	4	0	0	265
28549	0	257	0	0	0	257
28550	0	0	252	0	0	252
28551	255	0	2	0	0	257
28552	225	0	1	0	0	226
28553	1	0	0	220	0	221
28554	0	2	0	245	0	247
28555	0	250	0	0	0	250
28556	0	0	255	0	0	255
28557	0	1	0	240	0	241
28558	0	0	246	0	0	246
28559	0	0	257	0	0	257
28560	1	0	2	231	0	234
28561	0	0	238	0	0	238
28562	0	0	247	0	0	247
28563	0	1	0	224	0	225
28564	0	0	228	0	0	228
28565	238	0	2	0	0	240
28566	0	229	0	0	0	229
28567	1	0	215	2	0	218
28568	0	0	242	0	0	242
28569	0	1	0	211	0	212
28570	224	0	3	0	0	227
28571	218	1	2	0	0	221
28572	208	0	5	0	0	213
28573	215	0	1	0	0	216
28574	0	3	0	206	0	209
28575	0	0	214	0	0	214
28576	202	0	5	2	0	209
28577	183	0	1	0	0	184
28578	209	0	0	0	0	209
28579	0	0	209	0	0	209
28580	200	0	0	0	0	200
28581	0	0	0	218	0	218
28582	0	213	0	1	0	214
28583	2	1	0	203	0	206
28584	0	215	0	0	0	215
28585	210	0	1	0	0	211
28586	0	0	226	0	0	226
28587	0	2	0	210	0	212
28588	0	223	0	0	0	223
28589	0	221	0	2	0	223
28590	213	0	0	0	0	213
28591	200	0	1	2	0	203
28592	0	0	224	0	0	224
28593	226	0	0	0	0	226
28594	0	2	0	226	0	228
28595	0	0	195	0	0	195
28596	0	0	230	0	0	230
28597	0	0	0	214	0	214
28598	225	0	0	0	0	225
28599	0	0	0	209	0	209
28600	0	2	0	223	0	225
28601	0	3	0	238	0	241
28602	0	238	0	0	0	238
28603	0	1	0	235	0	236
28604	234	0	0	0	0	234
28605	0	244	0	0	0	244
28606	0	0	0	231	0	231
28607	233	0	2	0	0	235
28608	0	251	0	0	0	251
28609	0	239	0	1	0	240
28610	0	3	0	236	0	239
28611	240	0	0	0	0	240
28612	0	0	241	0	0	241
28613	0	0	225	0	0	225
28614	230	0	0	1	0	231
28615	224	0	0	0	0	224
28616	0	239	0	1	0	240
28617	0	0	0	208	0	208
28618	2	0	214	0	0	216
28619	0	0	203	0	0	203
28620	0	0	222	0	0	222
28621	0	212	1	0	0	213
28622	0	214	0	1	0	215
28623	211	0	1	0	0	212
28624	1	0	216	0	0	217
28625	212	0	0	1	0	213
28626	203	0	1	0	0	204
28627	0	0	216	0	0	216
28628	0	219	0	0	0	219
28629	0	2	0	213	0	215
28630	0	0	201	0	0	201
28631	0	0	216	0	0	216
28632	218	0	0	0	0	218
28633	0	222	0	0	0	222
28634	0	0	0	205	0	205
28635	0	0	0	225	0	225
28636	0	213	0	0	0	213
28637	0	216	0	0	0	216
28638	0	225	0	0	0	225
28639	0	0	0	218	0	218
28640	211	0	0	1	0	212
28641	1	2	0	216	0	219
28642	0	0	211	0	0	211
28643	0	0	219	0	0	219
28644	0	0	0	200	0	200
28645	0	0	206	0	0	206
28646	0	201	0	2	0	203
28647	0	1	0	187	0	188
28648	193	0	2	0	0	195
28649	189	0	1	0	0	190
28650	0	199	0	0	0	199
28651	186	0	0	0	0	186
28652	174	0	1	0	0	175
28653	186	0	0	0	0	186
28654	0	0	185	0	0	185
28655	182	0	0	0	0	182
28656	0	182	0	0	0	182
28657	0	0	171	0	0	171
28658	0	0	176	0	0	176
28659	0	171	0	0	0	171
28660	176	0	2	0	0	178
28661	0	0	0	179	0	179
28662	0	185	0	0	0	185
28663	187	0	0	0	0	187
28664	0	0	0	175	0	175
28665	174	0	1	1	0	176
28666	0	0	0	180	0	180
28667	4	0	171	0	0	175
28668	0	0	172	0	0	172
28669	0	0	175	0	0	175
28670	0	0	0	165	0	165
28671	0	0	0	147	0	147
28672	0	0	156	0	0	156
28673	0	156	0	0	0	156
28674	153	0	1	0	0	154
28675	146	0	0	0	0	146
28676	0	159	0	0	0	159
28677	0	0	0	141	0	141
28678	0	0	148	0	0	148
28679	143	0	0	0	0	143
28680	0	0	139	0	0	139
28681	0	0	139	0	0	139
28682	1	0	135	0	0	136
28683	127	0	0	1	0	128
28684	0	0	138	0	0	138
28685	0	143	0	0	0	143
28686	0	135	0	0	0	135
28687	0	4	0	129	0	133
28688	0	0	1	133	0	134
28689	1	0	138	0	0	139
28690	146	0	1	0	0	147
28691	132	0	0	0	0	132
28692	0	0	0	140	0	140
28693	106	0	0	0	0	106
28694	0	117	0	0	0	117
28695	110	0	0	0	0	110
28696	2	114	0	0	0	116
28697	0	112	0	0	0	112
28698	98	0	2	0	0	100
28699	98	0	0	2	0	100
28700	88	1	0	0	0	89
28701	97	0	0	0	0	97
28702	0	0	96	0	0	96
28703	93	0	0	0	0	93
28704	0	0	0	88	0	88
28705	2	67	0	0	0	69
28706	63	0	0	0	0	63
28707	0	74	0	0	0	74
28708	74	0	0	0	0	74
28709	0	0	0	68	0	68
28710	0	0	0	71	0	71
28711	0	0	71	0	0	71
28712	0	0	74	0	0	74
28713	0	76	0	0	0	76
28714	73	0	2	0	0	75
28715	0	76	0	0	0	76
28716	0	75	0	0	0	75
28717	0	75	0	0	0	75
28718	0	0	77	0	0	77
28719	0	81	0	0	0	81
28720	81	0	0	1	0	82
28721	80	0	0	0	0	80
28722	0	0	0	88	0	88
28723	0	89	0	0	0	89
28724	0	90	0	0	0	90
28725	0	0	0	86	0	86
28726	0	0	96	0	0	96
28727	0	98	0	0	0	98
28728	0	0	0	98	0	98
28729	98	0	0	0	0	98
28730	93	0	0	0	0	93
28731	0	102	0	0	0	102
28732	98	0	0	0	0	98
28733	90	0	1	0	0	91
28734	0	0	0	106	0	106
28735	0	0	106	0	0	106
28736	0	106	0	0	0	106
28737	0	0	0	104	0	104
28738	0	0	107	0	0	107
28739	0	108	0	0	0	108
28740	101	0	1	0	0	102
28741	97	0	0	0	0	97
28742	0	0	0	106	0	106
28743	0	104	0	0	0	104
28744	1	0	98	0	0	99
28745	0	0	0	110	0	110
28746	0	0	110	0	0	110
28747	0	113	0	0	0	113
28748	0	0	0	109	0	109
28749	108	0	0	3	0	111
28750	0	109	0	0	0	109
28751	107	0	0	0	0	107
28752	100	0	2	0	0	102
28753	0	110	0	0	0	110
28754	0	0	0	104	0	104
28755	0	1	0	107	0	108
28756	0	105	0	0	0	105
28757	0	108	0	0	0	108
28758	0	2	0	103	0	105
28759	0	102	0	0	0	102
28760	99	0	0	0	0	99
28761	105	0	0	1	0	106
28762	0	0	106	0	0	106
28763	0	0	107	0	0	107
28764	103	0	2	0	0	105
28765	103	0	0	0	0	103
28766	0	111	0	0	0	111
28767	107	0	0	0	0	107
28768	103	0	0	0	0	103
28769	0	109	0	0	0	109
28770	105	0	0	0	0	105
28771	0	0	0	97	0	97
28772	0	0	0	106	0	106
28773	0	0	85	0	0	85
28774	0	104	0	0	0	104
28775	0	104	0	0	0	104
28776	100	0	1	0	0	101
28777	95	0	0	0	0	95
28778	88	0	3	0	0	91
28779	99	0	0	0	0	99
28780	0	0	101	0	0	101
28781	0	0	97	0	0	97
28782	0	99	0	0	0	99
28783	0	0	0	94	0	94
28784	0	0	0	95	0	95
28785	0	96	0	0	0	96
28786	0	2	0	91	0	93
28787	87	0	0	0	0	87
28788	0	96	0	0	0	96
28789	0	0	95	0	0	95
28790	0	95	0	0	0	95
28791	92	0	0	0	0	92
28792	0	0	96	0	0	96
28793	91	0	0	0	0	91
28794	89	0	0	0	0	89
28795	0	0	92	0	0	92
28796	0	0	88	0	0	88
28797	0	0	82	0	0	82
28798	84	0	0	0	0	84
28799	0	0	87	0	0	87
28800	0	89	0	0	0	89
28801	84	0	0	0	0	84
28802	0	0	85	0	0	85
28803	82	0	0	0	0	82
28804	0	0	82	0	0	82
28805	0	0	82	0	0	82
28806	0	81	0	0	0	81
28807	0	0	82	0	0	82
28808	0	0	85	0	0	85
28809	0	86	0	0	0	86
28810	86	0	0	0	0	86
28811	0	0	83	0	0	83
28812	0	0	0	81	0	81
28813	0	84	0	0	0	84
28814	79	0	0	0	0	79
28815	79	0	0	0	0	79
28816	0	0	83	0	0	83
28817	0	83	0	0	0	83
28818	0	75	0	0	0	75
28819	0	0	0	71	0	71
28820	0	78	0	0	0	78
28821	0	0	0	68	0	68
28822	0	0	0	74	0	74
28823	0	78	0	1	0	79
28824	0	0	0	71	0	71
28825	0	74	0	0	0	74
28826	0	0	74	0	0	74
28827	0	0	0	63	0	63
28828	0	0	0	67	0	67
28829	0	69	0	0	0	69
28830	0	70	0	0	0	70
28831	0	0	0	63	0	63
28832	0	74	0	0	0	74
28833	73	0	0	0	0	73
28834	0	0	0	72	0	72
28835	0	67	0	0	0	67
28836	63	0	0	0	0	63
28837	0	65	0	0	0	65
28838	1	0	64	0	0	65
28839	0	0	0	57	0	57
28840	60	0	0	0	0	60
28841	0	0	61	0	0	61
28842	0	0	0	56	0	56
28843	0	58	0	0	0	58
28844	0	0	56	0	0	56
28845	0	52	0	0	0	52
28846	56	0	0	0	0	56
28847	49	0	1	0	0	50
28848	0	56	0	0	0	56
28849	46	0	0	0	0	46
28850	0	0	48	0	0	48
28851	0	0	0	42	0	42
28852	0	3	0	39	0	42
28853	0	41	0	0	0	41
28854	40	0	1	0	0	41
28855	40	0	0	0	0	40
28856	0	0	43	0	0	43
28857	40	0	0	0	0	40
28858	33	0	2	1	0	36
28859	32	0	0	0	0	32
28860	0	0	0	33	0	33
28861	0	0	0	34	0	34
28862	0	36	0	0	0	36
28863	31	0	0	0	0	31
28864	26	0	0	0	0	26
28865	0	34	0	0	0	34
28866	0	0	0	34	0	34
28867	0	33	0	0	0	33
28868	0	33	0	0	0	33
28869	33	0	0	0	0	33
28870	0	0	36	0	0	36
28871	0	0	37	0	0	37
28872	0	36	0	0	0	36
28873	35	0	0	0	0	35
28874	0	0	35	0	0	35
28875	0	36	0	0	0	36
28876	32	0	0	0	0	32
28877	0	0	37	0	0	37
28878	0	0	0	32	0	32
28879	34	0	0	0	0	34
28880	0	0	37	0	0	37
28881	0	0	31	0	0	31
28882	0	0	32	0	0	32
28883	0	0	31	0	0	31
28884	29	0	0	0	0	29
28885	22	0	0	0	0	22
28886	0	30	0	0	0	30
28887	0	0	0	25	0	25
28888	0	0	0	27	0	27
28889	0	27	0	1	0	28
28890	0	0	0	29	0	29
28891	0	26	0	0	0	26
28892	0	29	0	0	0	29
28893	0	0	0	27	0	27
28894	0	0	30	0	0	30
28895	0	30	0	0	0	30
28896	0	0	0	29	0	29
28897	30	0	0	0	0	30
28898	0	0	25	0	0	25
28899	30	0	0	0	0	30
28900	26	0	0	0	0	26
28901	0	0	0	26	0	26
28902	0	0	27	0	0	27
28903	0	0	27	0	0	27
28904	0	27	0	0	0	27
28905	0	0	0	27	0	27
28906	0	0	27	0	0	27
28907	0	0	27	0	0	27
28908	0	26	0	0	0	26
28909	25	0	0	0	0	25
28910	22	0	0	0	0	22
28911	0	0	0	24	0	24
28912	0	0	24	0	0	24
28913	0	0	25	0	0	25
28914	0	24	0	0	0	24
28915	1	0	20	0	0	21
28916	0	0	25	0	0	25
28917	0	0	0	24	0	24
28918	0	0	24	0	0	24
28919	25	0	0	0	0	25
28920	0	1	0	25	0	26
28921	0	0	25	0	0	25
28922	0	25	0	0	0	25
28923	0	0	0	25	0	25
28924	0	0	26	0	0	26
28925	0	26	0	0	0	26
28926	0	0	0	27	0	27
28927	0	27	0	0	0	27
28928	0	0	0	23	0	23
28929	0	0	0	27	0	27
28930	0	0	26	0	0	26
28931	0	27	0	0	0	27
28932	0	0	0	25	0	25
28933	0	0	0	25	0	25
28934	0	0	0	27	0	27
28935	0	0	29	0	0	29
28936	0	28	0	0	0	28
28937	0	0	0	23	0	23
28938	0	0	26	0	0	26
28939	0	30	0	0	0	30
28940	0	0	0	27	0	27
28941	0	0	29	0	0	29
28942	0	28	0	0	0	28
28943	0	0	0	27	0	27
28944	0	0	0	29	0	29
28945	0	0	30	0	0	30
28946	29	0	0	0	0	29
28947	0	31	0	0	0	31
28948	27	0	0	0	0	27
28949	0	0	30	0	0	30
28950	30	0	0	0	0	30
28951	0	0	0	29	0	29
28952	0	1	0	27	0	28
28953	0	0	31	0	0	31
28954	29	0	0	0	0	29
28955	29	0	0	0	0	29
28956	0	29	0	0	0	29
28957	0	28	0	0	0	28
28958	29	0	0	0	0	29
28959	0	0	29	0	0	29
28960	0	30	0	0	0	30
28961	0	0	0	28	0	28
28962	0	0	0	27	0	27
28963	0	0	29	0	0	29
28964	32	0	0	0	0	32
28965	0	0	32	0	0	32
28966	30	0	0	0	0	30
28967	0	0	35	0	0	35
28968	0	33	0	0	0	33
28969	36	0	0	0	0	36
28970	33	0	1	0	0	34
28971	36	0	0	0	0	36
28972	33	0	0	0	0	33
28973	0	0	0	36	0	36
28974	0	0	35	0	0	35
28975	0	0	0	36	0	36
28976	0	33	0	0	0	33
28977	0	0	0	32	0	32
28978	0	0	36	0	0	36
28979	0	0	37	0	0	37
28980	0	2	0	33	0	35
28981	38	0	0	0	0	38
28982	33	0	0	0	0	33
28983	33	0	0	0	0	33
28984	0	0	33	0	0	33
28985	0	0	36	0	0	36
28986	0	35	0	0	0	35
28987	0	31	0	0	0	31
28988	35	0	0	0	0	35
28989	36	0	0	0	0	36
28990	0	35	0	0	0	35
28991	33	0	0	0	0	33
28992	33	0	0	0	0	33
28993	0	35	0	0	0	35
28994	36	0	0	0	0	36
28995	33	0	0	0	0	33
28996	0	36	0	0	0	36
28997	34	0	0	0	0	34
28998	33	0	0	0	0	33
28999	0	0	35	0	0	35
29000	0	0	33	0	0	33
29001	0	34	0	0	0	34
29002	0	31	0	0	0	31
29003	33	0	0	0	0	33
29004	33	0	0	0	0	33
29005	33	0	0	0	0	33
29006	0	35	0	0	0	35
29007	0	0	0	32	0	32
29008	0	0	31	0	0	31
29009	0	5	0	26	0	31
29010	0	28	0	1	0	29
29011	28	0	0	1	0	29
29012	0	31	0	0	0	31
29013	0	0	0	30	0	30
29014	25	0	0	1	0	26
29015	25	0	1	0	0	26
29016	0	0	24	0	0	24
29017	26	0	0	0	0	26
29018	21	0	0	2	0	23
29019	22	0	0	0	0	22
29020	0	0	0	21	0	21
29021	0	22	0	0	0	22
29022	0	0	0	22	0	22
29023	0	0	21	0	0	21
29024	0	22	0	0	0	22
29025	0	0	0	20	0	20
29026	0	0	20	0	0	20
29027	0	20	0	0	0	20
29028	0	0	0	19	0	19
29029	0	0	21	0	0	21
29030	21	0	0	0	0	21
29031	0	0	19	0	0	19
29032	0	0	20	0	0	20
29033	0	23	0	0	0	23
29034	0	0	0	20	0	20
29035	0	0	0	21	0	21
29036	0	21	0	0	0	21
29037	0	0	0	21	0	21
29038	22	0	0	0	0	22
29039	21	0	0	0	0	21
29040	0	0	22	0	0	22
29041	20	0	2	0	0	22
29042	21	0	0	0	0	21
29043	0	0	22	0	0	22
29044	0	21	0	0	0	21
29045	0	22	0	0	0	22
29046	0	0	0	21	0	21
29047	0	22	0	0	0	22
29048	0	0	20	0	0	20
29049	0	0	22	0	0	22
29050	0	20	0	0	0	20
29051	22	0	0	0	0	22
29052	22	0	0	0	0	22
29053	22	0	0	0	0	22
29054	22	0	0	0	0	22
29055	21	0	0	0	0	21
29056	0	22	0	0	0	22
29057	0	0	22	0	0	22
29058	0	0	0	22	0	22
29059	22	0	0	0	0	22
29060	0	23	0	0	0	23
29061	0	0	0	21	0	21
29062	0	0	23	0	0	23
29063	0	22	0	0	0	22
29064	0	23	0	0	0	23
29065	21	0	0	0	0	21
29066	0	23	0	0	0	23
29067	0	0	0	21	0	21
29068	23	0	0	0	0	23
29069	21	0	0	0	0	21
29070	19	0	0	0	0	19
29071	0	0	21	0	0	21
29072	0	19	0	0	0	19
29073	18	0	0	0	0	18
29074	0	0	0	17	0	17
29075	17	0	1	0	0	18
29076	0	22	0	0	0	22
29077	19	0	0	0	0	19
29078	19	0	0	0	0	19
29079	0	0	0	18	0	18
29080	1	0	20	0	0	21
29081	0	0	0	17	0	17
29082	19	0	0	0	0	19
29083	18	0	1	0	0	19
29084	0	21	0	0	0	21
29085	19	0	0	0	0	19
29086	0	19	0	0	0	19
29087	17	0	0	0	0	17
29088	17	0	0	0	0	17
29089	0	0	17	0	0	17
29090	0	17	0	0	0	17
29091	0	0	0	16	0	16
29092	0	0	0	15	0	15
29093	0	0	0	16	0	16
29094	0	15	0	0	0	15
29095	0	0	16	0	0	16
29096	0	0	16	0	0	16
29097	0	17	0	0	0	17
29098	15	0	0	0	0	15
29099	0	0	16	0	0	16
29100	14	0	0	0	0	14
29101	0	16	0	0	0	16
29102	0	0	15	0	0	15
29103	0	0	0	14	0	14
29104	0	0	13	0	0	13
29105	0	0	12	0	0	12
29106	0	0	0	16	0	16
29107	0	14	0	0	0	14
29108	0	15	0	0	0	15
29109	12	0	0	0	0	12
29110	0	0	15	0	0	15
29111	16	0	0	0	0	16
29112	13	0	0	0	0	13
29113	0	15	0	0	0	15
29114	11	0	0	0	0	11
29115	12	0	0	0	0	12
29116	10	0	0	0	0	10
29117	0	12	0	0	0	12
29118	0	12	0	0	0	12
29119	0	10	0	0	0	10
29120	8	0	0	0	0	8
29121	9	0	0	0	0	9
29122	0	0	8	0	0	8
29123	0	0	10	0	0	10
29124	9	0	0	0	0	9
29125	7	0	0	0	0	7
29126	10	0	0	0	0	10
29127	0	0	0	10	0	10
29128	0	0	0	11	0	11
29129	0	0	0	12	0	12
29130	0	1	0	11	0	12
29131	0	0	11	0	0	11
29132	0	0	13	0	0	13
29133	0	0	11	0	0	11
29134	0	0	13	0	0	13
29135	15	0	0	0	0	15
29136	0	15	0	0	0	15
29137	0	10	0	0	0	10
29138	14	0	0	0	0	14
29139	0	0	13	0	0	13
29140	0	0	14	0	0	14
29141	14	0	0	0	0	14
29142	14	0	0	0	0	14
29143	0	15	0	0	0	15
29144	0	0	0	14	0	14
29145	14	0	0	0	0	14
29146	16	0	0	0	0	16
29147	0	1	0	15	0	16
29148	0	17	0	0	0	17
29149	16	0	0	0	0	16
29150	0	0	17	0	0	17
29151	16	0	0	0	0	16
29152	0	16	0	0	0	16
29153	17	0	0	0	0	17
29154	15	0	0	0	0	15
29155	0	0	17	0	0	17
29156	0	0	16	0	0	16
29157	15	0	0	0	0	15
29158	13	0	0	0	0	13
29159	0	17	0	0	0	17
29160	0	0	0	17	0	17
29161	0	0	17	0	0	17
29162	15	0	0	0	0	15
29163	0	0	0	14	0	14
29164	0	0	0	14	0	14
29165	17	0	0	0	0	17
29166	0	17	0	0	0	17
29167	15	0	0	0	0	15
29168	15	0	0	0	0	15
29169	16	0	0	0	0	16
29170	0	17	0	0	0	17
29171	17	0	0	0	0	17
29172	0	0	0	16	0	16
29173	0	0	0	15	0	15
29174	0	0	13	0	0	13
29175	0	0	13	0	0	13
29176	0	13	0	0	0	13
29177	0	10	0	0	0	10
29178	0	0	13	0	0	13
29179	0	11	0	2	0	13
29180	14	0	0	0	0	14
29181	14	0	0	0	0	14
29182	14	0	0	0	0	14
29183	0	0	0	15	0	15
29184	0	2	0	14	0	16
29185	0	0	16	0	0	16
29186	0	16	0	0	0	16
29187	17	0	0	0	0	17
29188	0	17	0	0	0	17
29189	17	0	0	0	0	17
29190	15	0	0	0	0	15
29191	0	0	0	13	0	13
29192	0	0	0	16	0	16
29193	0	0	0	17	0	17
29194	0	0	19	0	0	19
29195	0	20	0	0	0	20
29196	0	20	0	0	0	20
29197	0	19	0	0	0	19
29198	0	18	0	0	0	18
29199	0	19	0	0	0	19
29200	17	0	0	0	0	17
29201	0	0	17	0	0	17
29202	0	20	0	0	0	20
29203	0	0	20	0	0	20
29204	0	20	0	0	0	20
29205	0	0	0	19	0	19
29206	0	0	0	19	0	19
29207	0	20	0	0	0	20
29208	20	0	0	0	0	20
29209	0	0	20	0	0	20
29210	0	17	0	2	0	19
29211	0	0	20	0	0	20
29212	0	0	0	19	0	19
29213	0	0	0	22	0	22
29214	0	22	0	0	0	22
29215	0	0	0	19	0	19
29216	0	0	0	21	0	21
29217	0	21	0	0	0	21
29218	0	0	22	0	0	22
29219	0	0	20	0	0	20
29220	22	0	0	0	0	22
29221	13	0	0	0	0	13
29222	0	0	0	22	0	22
29223	0	0	22	0	0	22
29224	0	0	0	22	0	22
29225	0	20	0	0	0	20
29226	0	0	19	0	0	19
29227	0	18	0	0	0	18
29228	0	0	19	0	0	19
29229	0	19	0	0	0	19
29230	19	0	0	0	0	19
29231	0	0	0	15	0	15
29232	0	0	0	18	0	18
29233	0	0	16	0	0	16
29234	0	0	18	0	0	18
29235	0	19	0	0	0	19
29236	19	0	0	0	0	19
29237	0	0	0	20	0	20
29238	0	0	19	0	0	19
29239	0	0	20	0	0	20
29240	19	0	0	0	0	19
29241	19	0	0	0	0	19
29242	0	0	19	0	0	19
29243	0	3	0	16	0	19
29244	0	20	0	0	0	20
29245	19	0	0	0	0	19
29246	0	19	0	0	0	19
29247	20	0	0	0	0	20
29248	0	20	0	0	0	20
29249	0	17	0	0	0	17
29250	0	0	0	16	0	16
29251	0	0	0	16	0	16
29252	0	17	0	0	0	17
29253	0	0	15	0	0	15
29254	0	0	17	0	0	17
29255	0	0	14	0	0	14
29256	16	0	0	0	0	16
29257	13	0	0	0	0	13
29258	0	15	0	0	0	15
29259	0	0	15	0	0	15
29260	0	0	0	16	0	16
29261	0	0	15	0	0	15
29262	0	0	15	0	0	15
29263	0	0	0	16	0	16
29264	0	0	0	16	0	16
29265	0	0	16	0	0	16
29266	15	0	0	0	0	15
29267	0	14	0	0	0	14
29268	0	17	0	0	0	17
29269	0	0	0	18	0	18
29270	18	0	0	0	0	18
29271	0	20	0	0	0	20
29272	19	0	0	0	0	19
29273	0	18	0	0	0	18
29274	13	0	0	0	0	13
29275	0	0	14	0	0	14
29276	0	0	12	0	0	12
29277	0	0	0	14	0	14
29278	0	0	13	0	0	13
29279	0	13	0	0	0	13
29280	0	12	0	0	0	12
29281	13	0	0	0	0	13
29282	0	0	0	12	0	12
29283	0	13	0	0	0	13
29284	11	0	0	1	0	12
29285	13	0	0	0	0	13
29286	13	0	0	0	0	13
29287	0	0	0	10	0	10
29288	0	0	0	12	0	12
29289	0	0	10	0	0	10
29290	0	0	11	0	0	11
29291	11	0	0	0	0	11
29292	0	0	0	9	0	9
29293	0	0	11	0	0	11
29294	11	0	0	0	0	11
29295	0	10	0	0	0	10
29296	11	0	0	0	0	11
29297	11	0	0	0	0	11
29298	11	0	0	0	0	11
29299	0	0	11	0	0	11
29300	11	0	0	0	0	11
29301	0	0	0	11	0	11
29302	0	9	0	0	0	9
29303	0	9	0	0	0	9
29304	10	0	0	0	0	10
29305	10	0	0	0	0	10
29306	9	0	0	0	0	9
29307	0	0	0	8	0	8
29308	0	0	0	8	0	8
29309	0	0	0	10	0	10
29310	0	9	0	0	0	9
29311	10	0	0	0	0	10
29312	9	0	0	0	0	9
29313	10	0	0	0	0	10
29314	0	0	10	0	0	10
29315	9	0	0	0	0	9
29316	0	0	0	9	0	9
29317	0	9	0	0	0	9
29318	10	0	0	0	0	10
29319	9	0	0	0	0	9
29320	0	0	10	0	0	10
29321	0	0	0	10	0	10
29322	0	10	0	0	0	10
29323	10	0	0	0	0	10
29324	0	0	0	7	0	7
29325	0	0	0	9	0	9
29326	0	0	0	10	0	10
29327	0	0	0	9	0	9
29328	0	0	9	0	0	9
29329	0	10	0	0	0	10
29330	0	0	0	9	0	9
29331	0	0	10	0	0	10
29332	9	0	0	0	0	9
29333	9	0	0	0	0	9
29334	0	0	0	9	0	9
29335	9	0	0	0	0	9
29336	7	0	0	0	0	7
29337	0	0	10	0	0	10
29338	0	11	0	0	0	11
29339	11	0	0	0	0	11
29340	0	0	0	8	0	8
29341	11	0	0	0	0	11
29342	0	0	0	10	0	10
29343	0	0	0	10	0	10
29344	0	0	8	0	0	8
29345	11	0	0	0	0	11
29346	0	9	0	0	0	9
29347	0	0	7	0	0	7
29348	0	9	0	0	0	9
29349	9	0	0	0	0	9
29350	0	0	0	8	0	8
29351	9	0	0	0	0	9
29352	0	9	0	0	0	9
29353	7	0	0	0	0	7
29354	8	0	0	0	0	8
29355	9	0	0	0	0	9
29356	9	0	0	0	0	9
29357	0	9	0	0	0	9
29358	7	0	1	0	0	8
29359	0	0	0	8	0	8
29360	0	0	0	7	0	7
29361	0	7	0	0	0	7
29362	0	8	0	0	0	8
29363	0	10	0	0	0	10
29364	9	0	0	0	0	9
29365	0	9	0	0	0	9
29366	0	10	0	0	0	10
29367	9	0	0	0	0	9
29368	10	0	0	0	0	10
29369	0	10	0	0	0	10
29370	9	0	0	0	0	9
29371	0	0	11	0	0	11
29372	10	0	1	0	0	11
29373	0	0	12	0	0	12
29374	0	11	0	0	0	11
29375	0	11	0	0	0	11
29376	0	0	0	9	0	9
29377	10	0	0	0	0	10
29378	10	0	0	0	0	10
29379	9	0	0	0	0	9
29380	9	0	0	0	0	9
29381	10	0	0	0	0	10
29382	0	0	8	0	0	8
29383	0	0	9	0	0	9
29384	9	0	0	0	0	9
29385	0	9	0	0	0	9
29386	9	0	0	0	0	9
29387	8	0	0	0	0	8
29388	8	0	0	0	0	8
29389	7	0	0	0	0	7
29390	8	0	0	0	0	8
29391	0	0	9	0	0	9
29392	8	0	0	0	0	8
29393	9	0	0	0	0	9
29394	0	0	8	0	0	8
29395	8	0	0	0	0	8
29396	9	0	0	0	0	9
29397	0	0	9	0	0	9
29398	0	0	8	0	0	8
29399	0	9	0	0	0	9
29400	0	0	0	9	0	9
29401	0	0	10	0	0	10
29402	10	0	0	0	0	10
29403	0	0	0	9	0	9
29404	0	0	9	0	0	9
29405	10	0	0	0	0	10
29406	10	0	0	0	0	10
29407	10	0	0	0	0	10
29408	0	8	0	0	0	8
29409	0	0	0	8	0	8
29410	0	8	0	0	0	8
29411	9	0	0	0	0	9
29412	8	0	0	0	0	8
29413	0	1	7	0	0	8
29414	0	7	0	0	0	7
29415	0	5	0	0	0	5
29416	0	0	0	5	0	5
29417	0	0	0	5	0	5
29418	6	0	0	0	0	6
29419	0	5	0	0	0	5
29420	0	5	0	0	0	5
29421	0	0	5	0	0	5
29422	0	6	0	0	0	6
29423	6	0	0	0	0	6
29424	0	0	5	0	0	5
29425	6	0	0	0	0	6
29426	0	0	7	0	0	7
29427	6	0	0	0	0	6
29428	0	7	0	0	0	7
29429	7	0	0	0	0	7
29430	0	0	7	0	0	7
29431	7	0	0	0	0	7
29432	6	0	0	0	0	6
29433	0	0	7	0	0	7
29434	7	0	0	0	0	7
29435	7	0	0	0	0	7
29436	7	0	0	0	0	7
29437	0	8	0	0	0	8
29438	8	0	0	0	0	8
29439	0	0	7	0	0	7
29440	0	8	0	0	0	8
29441	8	0	0	0	0	8
29442	7	0	0	0	0	7
29443	8	0	0	0	0	8
29444	0	9	0	0	0	9
29445	0	0	0	9	0	9
29446	0	0	8	0	0	8
29447	0	0	0	9	0	9
29448	0	0	7	0	0	7
29449	9	0	0	0	0	9
29450	0	9	0	0	0	9
29451	0	0	0	9	0	9
29452	0	9	0	0	0	9
29453	0	0	0	8	0	8
29454	0	0	0	8	0	8
29455	0	8	0	0	0	8
29456	0	0	0	9	0	9
29457	0	0	0	9	0	9
29458	0	10	0	0	0	10
29459	0	10	0	0	0	10
29460	0	1	0	9	0	10
29461	0	0	10	0	0	10
29462	0	13	0	0	0	13
29463	0	0	0	13	0	13
29464	0	0	14	0	0	14
29465	0	14	0	0	0	14
29466	12	0	0	0	0	12
29467	0	0	14	0	0	14
29468	13	0	0	0	0	13
29469	0	0	0	12	0	12
29470	0	0	0	14	0	14
29471	0	0	0	11	0	11
29472	0	0	11	0	0	11
29473	0	0	14	0	0	14
29474	13	0	0	0	0	13
29475	0	0	0	14	0	14
29476	0	0	14	0	0	14
29477	14	0	0	0	0	14
29478	0	0	0	13	0	13
29479	0	0	0	12	0	12
29480	0	1	0	14	0	15
29481	0	13	0	0	0	13
29482	0	0	0	14	0	14
29483	0	15	0	0	0	15
29484	0	15	0	0	0	15
29485	13	0	0	0	0	13
29486	15	0	0	0	0	15
29487	15	0	0	0	0	15
29488	0	16	0	0	0	16
29489	16	0	0	0	0	16
29490	14	0	0	0	0	14
29491	0	0	0	17	0	17
29492	0	0	0	15	0	15
29493	0	0	16	0	0	16
29494	0	17	0	0	0	17
29495	16	0	0	0	0	16
29496	16	0	0	0	0	16
29497	0	19	0	0	0	19
29498	15	0	2	0	0	17
29499	19	0	0	0	0	19
29500	0	0	0	20	0	20
29501	0	20	0	0	0	20
29502	0	19	0	0	0	19
29503	19	0	0	0	0	19
29504	0	0	0	16	0	16
29505	0	0	20	0	0	20
29506	20	0	0	0	0	20
29507	0	0	19	0	0	19
29508	0	18	0	0	0	18
29509	17	0	0	0	0	17
29510	0	0	18	0	0	18
29511	0	0	0	18	0	18
29512	0	0	19	0	0	19
29513	0	16	0	0	0	16
29514	0	0	0	16	0	16
29515	0	0	17	0	0	17
29516	16	0	0	0	0	16
29517	0	17	0	0	0	17
29518	0	0	0	17	0	17
29519	0	17	0	0	0	17
29520	18	0	0	0	0	18
29521	18	0	0	0	0	18
29522	0	17	0	0	0	17
29523	0	0	0	17	0	17
29524	0	17	0	0	0	17
29525	16	0	0	0	0	16
29526	0	0	15	0	0	15
29527	0	0	18	0	0	18
29528	0	18	0	0	0	18
29529	0	17	0	0	0	17
29530	0	0	0	18	0	18
29531	19	0	0	0	0	19
29532	17	0	0	0	0	17
29533	17	0	0	0	0	17
29534	0	21	0	0	0	21
29535	1	0	0	19	0	20
29536	0	22	0	0	0	22
29537	24	0	0	0	0	24
29538	0	0	0	23	0	23
29539	0	0	23	0	0	23
29540	0	24	0	0	0	24
29541	23	0	0	0	0	23
29542	0	0	25	0	0	25
29543	22	0	0	0	0	22
29544	0	24	0	3	0	27
29545	0	36	0	0	0	36
29546	39	3	1	11	0	54
29547	0	68	0	0	0	68
29548	72	0	0	0	0	72
29549	0	74	4	1	0	79
29550	82	0	2	0	0	84
29551	94	2	0	3	0	99
29552	0	6	94	7	0	107
29553	0	0	105	3	0	108
29554	0	112	0	3	0	115
29555	114	0	0	0	0	114
29556	0	0	114	0	0	114
29557	115	0	0	0	0	115
29558	0	0	0	114	0	114
29559	0	0	122	0	0	122
29560	0	0	118	0	0	118
29561	0	0	122	0	0	122
29562	0	122	0	0	0	122
29563	0	2	0	117	0	119
29564	136	0	0	0	0	136
29565	0	0	0	134	0	134
29566	139	0	0	0	0	139
29567	0	0	0	140	0	140
29568	130	0	0	1	0	131
29569	128	0	1	0	0	129
29570	137	0	0	0	0	137
29571	0	140	0	0	0	140
29572	0	0	142	0	0	142
29573	0	0	0	127	0	127
29574	0	0	0	130	0	130
29575	0	0	0	130	0	130
29576	0	0	0	144	0	144
29577	0	140	0	0	0	140
29578	0	0	134	0	0	134
29579	0	146	0	0	0	146
29580	0	1	0	138	0	139
29581	0	1	0	134	0	135
29582	0	0	0	135	0	135
29583	0	0	3	144	0	147
29584	1	130	0	0	0	131
29585	0	131	0	0	0	131
29586	0	0	133	0	0	133
29587	0	0	0	131	0	131
29588	0	0	0	124	0	124
29589	0	0	0	132	0	132
29590	136	0	0	0	0	136
29591	0	136	0	0	0	136
29592	0	0	129	0	0	129
29593	138	0	0	0	0	138
29594	0	0	0	119	0	119
29595	137	0	0	0	0	137
29596	0	0	0	138	0	138
29597	136	1	1	0	0	138
29598	0	1	0	140	0	141
29599	136	0	0	3	0	139
29600	0	0	149	0	0	149
29601	0	0	0	146	0	146
29602	0	142	0	0	0	142
29603	0	0	0	139	0	139
29604	138	0	0	0	0	138
29605	0	139	0	0	0	139
29606	0	0	0	140	0	140
29607	0	136	0	0	0	136
29608	0	4	0	120	0	124
29609	0	0	0	121	0	121
29610	0	0	131	0	0	131
29611	0	3	0	120	0	123
29612	0	0	132	0	0	132
29613	0	129	0	4	0	133
29614	105	0	1	1	0	107
29615	0	0	125	0	0	125
29616	121	0	0	0	0	121
29617	119	0	1	0	0	120
29618	0	5	0	118	0	123
29619	0	0	125	0	0	125
29620	125	0	1	0	0	126
29621	116	0	0	0	0	116
29622	0	3	0	109	0	112
29623	0	0	0	124	0	124
29624	0	117	0	0	0	117
29625	0	0	0	123	0	123
29626	0	116	0	0	0	116
29627	0	0	124	0	0	124
29628	1	0	0	134	0	135
29629	134	0	0	0	0	134
29630	130	0	3	0	0	133
29631	0	139	0	1	0	140
29632	0	0	0	139	0	139
29633	145	0	0	1	0	146
29634	0	149	0	0	0	149
29635	141	0	1	0	0	142
29636	1	0	0	138	0	139
29637	123	0	0	0	0	123
29638	0	0	147	0	0	147
29639	0	146	0	0	0	146
29640	138	0	0	0	0	138
29641	0	150	0	0	0	150
29642	141	0	0	0	0	141
29643	149	0	0	0	0	149
29644	0	0	151	0	0	151
29645	0	0	0	145	0	145
29646	148	0	0	0	0	148
29647	0	0	147	0	0	147
29648	148	0	0	0	0	148
29649	0	2	0	144	0	146
29650	0	0	150	0	0	150
29651	0	0	0	149	0	149
29652	145	0	0	0	0	145
29653	0	0	148	0	0	148
29654	0	1	0	134	0	135
29655	0	0	0	132	0	132
29656	131	0	0	0	0	131
29657	144	0	2	0	0	146
29658	0	148	0	0	0	148
29659	0	0	0	140	0	140
29660	0	0	0	133	0	133
29661	0	0	0	140	0	140
29662	137	0	0	0	0	137
29663	133	0	1	0	0	134
29664	0	0	0	143	0	143
29665	0	143	0	0	0	143
29666	0	0	0	137	0	137
29667	0	137	0	0	0	137
29668	142	0	1	0	0	143
29669	0	144	0	0	0	144
29670	133	0	3	0	0	136
29671	0	0	0	136	0	136
29672	130	2	0	0	0	132
29673	0	0	144	0	0	144
29674	0	139	0	0	0	139
29675	137	0	0	0	0	137
29676	128	0	0	0	0	128
29677	0	0	0	136	0	136
29678	0	141	0	0	0	141
29679	0	0	0	130	0	130
29680	0	1	0	125	0	126
29681	0	0	0	133	0	133
29682	130	0	0	0	0	130
29683	121	0	2	0	0	123
29684	0	2	0	131	0	133
29685	0	133	0	0	0	133
29686	102	0	0	0	0	102
29687	0	0	99	0	0	99
29688	0	0	1	103	0	104
29689	0	0	104	0	0	104
29690	0	0	0	96	0	96
29691	0	0	104	0	0	104
29692	1	1	0	95	0	97
29693	102	0	0	0	0	102
29694	97	0	1	0	0	98
29695	0	92	0	2	0	94
29696	67	0	1	0	0	68
29697	0	0	0	61	0	61
29698	1	0	0	59	0	60
29699	61	0	0	0	0	61
29700	0	0	61	0	0	61
29701	0	0	64	0	0	64
29702	0	0	55	0	0	55
29703	63	0	0	0	0	63
29704	0	0	65	0	0	65
29705	0	0	66	0	0	66
29706	63	0	0	0	0	63
29707	0	70	0	0	0	70
29708	0	0	0	69	0	69
29709	0	0	0	63	0	63
29710	0	0	63	0	0	63
29711	65	0	0	0	0	65
29712	58	0	0	0	0	58
29713	54	0	2	0	0	56
29714	0	0	63	0	0	63
29715	61	0	0	0	0	61
29716	0	0	60	0	0	60
29717	0	62	0	0	0	62
29718	0	58	0	0	0	58
29719	61	0	0	0	0	61
29720	0	62	0	0	0	62
29721	0	57	0	0	0	57
29722	65	0	0	0	0	65
29723	0	64	0	0	0	64
29724	64	0	1	0	0	65
29725	0	0	0	57	0	57
29726	0	1	0	58	0	59
29727	0	0	0	64	0	64
29728	0	0	0	68	0	68
29729	0	69	0	0	0	69
29730	65	0	2	0	0	67
29731	0	76	0	0	0	76
29732	0	65	0	0	0	65
29733	0	0	74	0	0	74
29734	72	0	0	0	0	72
29735	0	0	72	0	0	72
29736	0	0	75	0	0	75
29737	0	75	0	0	0	75
29738	0	72	0	0	0	72
29739	75	0	2	0	0	77
29740	0	73	0	0	0	73
29741	0	0	75	0	0	75
29742	0	74	0	0	0	74
29743	0	0	70	0	0	70
29744	0	0	77	0	0	77
29745	86	0	0	0	0	86
29746	0	0	86	0	0	86
29747	0	0	0	79	0	79
29748	83	0	0	0	0	83
29749	0	79	0	0	0	79
29750	0	0	80	0	0	80
29751	81	0	0	0	0	81
29752	0	1	0	72	0	73
29753	0	77	0	0	0	77
29754	0	0	79	0	0	79
29755	83	0	0	0	0	83
29756	0	0	84	0	0	84
29757	0	0	0	78	0	78
29758	0	0	85	0	0	85
29759	0	0	0	83	0	83
29760	80	0	1	0	0	81
29761	0	82	0	0	0	82
29762	81	0	1	0	0	82
29763	0	0	84	0	0	84
29764	0	0	0	77	0	77
29765	0	0	71	0	0	71
29766	72	0	0	0	0	72
29767	67	0	0	0	0	67
29768	0	78	0	0	0	78
29769	75	0	0	0	0	75
29770	66	0	0	0	0	66
29771	0	0	0	68	0	68
29772	0	0	74	0	0	74
29773	0	71	0	1	0	72
29774	0	0	0	60	0	60
29775	70	0	0	0	0	70
29776	0	0	68	0	0	68
29777	0	0	67	1	0	68
29778	0	0	67	0	0	67
29779	58	0	0	1	0	59
29780	0	0	59	1	0	60
29781	58	0	0	0	0	58
29782	0	0	57	0	0	57
29783	0	57	0	0	0	57
29784	0	0	0	54	0	54
29785	0	0	57	0	0	57
29786	0	51	0	0	0	51
29787	0	56	0	0	0	56
29788	0	0	0	58	0	58
29789	56	0	0	1	0	57
29790	0	0	0	56	0	56
29791	53	0	0	0	0	53
29792	0	0	0	58	0	58
29793	0	0	58	0	0	58
29794	0	0	51	0	0	51
29795	52	0	0	0	0	52
29796	44	0	0	0	0	44
29797	0	0	52	0	0	52
29798	46	0	1	0	0	47
29799	0	0	49	0	0	49
29800	0	45	0	0	0	45
29801	0	43	0	0	0	43
29802	0	47	0	0	0	47
29803	0	1	0	46	0	47
29804	47	0	0	0	0	47
29805	43	0	0	0	0	43
29806	0	0	0	41	0	41
29807	0	0	45	0	0	45
29808	0	0	0	33	0	33
29809	0	0	34	0	0	34
29810	0	0	0	34	0	34
29811	31	0	0	0	0	31
29812	31	0	1	0	0	32
29813	30	0	0	0	0	30
29814	29	0	0	0	0	29
29815	0	0	0	27	0	27
29816	0	0	0	27	0	27
29817	27	0	0	0	0	27
29818	28	0	0	0	0	28
29819	0	1	0	27	0	28
29820	0	0	0	26	0	26
29821	0	0	0	26	0	26
29822	0	0	0	23	0	23
29823	28	0	0	0	0	28
29824	0	0	29	0	0	29
29825	0	0	0	27	0	27
29826	27	0	0	0	0	27
29827	0	0	28	0	0	28
29828	0	0	0	27	0	27
29829	1	0	27	0	0	28
29830	0	27	0	0	0	27
29831	0	1	0	22	0	23
29832	23	0	0	0	0	23
29833	0	0	0	23	0	23
29834	0	23	0	0	0	23
29835	0	23	0	0	0	23
29836	0	19	0	0	0	19
29837	0	18	0	0	0	18
29838	14	0	0	0	0	14
29839	0	0	0	13	0	13
29840	0	0	12	0	0	12
29841	0	0	0	9	0	9
29842	0	0	9	0	0	9
29843	7	0	0	0	0	7
29844	0	0	0	7	0	7
29845	1	0	0	6	0	7
29846	0	0	0	5	0	5
29847	0	0	0	5	0	5
29848	5	0	0	0	0	5
29849	5	0	0	0	0	5
29850	0	0	0	5	0	5
29851	5	0	0	0	0	5
29852	0	0	5	0	0	5
29853	0	4	0	0	0	4
29854	0	0	0	4	0	4
29855	0	0	0	4	0	4
29856	0	4	0	0	0	4
29857	0	0	0	4	0	4
29858	0	0	0	4	0	4
29859	3	0	0	0	0	3
29860	0	0	4	0	0	4
29861	0	0	4	0	0	4
29862	3	0	0	0	0	3
29863	0	0	3	0	0	3
29864	3	0	0	0	0	3
29865	3	0	0	0	0	3
29866	0	0	0	3	0	3
29867	0	0	3	0	0	3
29868	3	0	0	0	0	3
29869	0	3	0	0	0	3
29870	3	0	0	0	0	3
29871	2	0	0	0	0	2
