Pos	A	C	G	T	Other	Total
0	0	0	0	0	0
1	0	0	0	0	0
2	0	0	0	0	0
3	0	0	0	0	0
4	1	0	0	0	0	1
5	1	0	0	1	0	2
6	0	0	19	0	0	19
7	0	0	52	0	0	52
8	0	0	0	51	0	51
9	0	0	0	52	0	52
10	0	0	0	53	0	53
11	0	0	0	58	0	58
12	0	0	0	72	0	72
13	76	0	0	0	0	76
14	0	77	0	0	0	77
15	0	93	0	0	0	93
16	1	0	0	123	0	124
17	0	0	0	138	0	138
18	0	154	0	0	0	154
19	0	158	0	0	0	158
20	0	159	0	1	0	160
21	165	0	0	0	0	165
22	0	0	222	0	0	222
23	0	0	265	0	0	265
24	0	0	0	277	0	277
25	277	0	0	0	0	277
26	277	0	0	0	0	277
27	0	282	0	0	0	282
28	287	0	2	0	0	289
29	294	0	1	0	0	295
30	294	0	1	0	0	295
31	0	300	0	0	0	300
32	0	301	0	0	0	301
33	302	0	0	0	0	302
34	310	0	2	0	0	312
35	0	313	0	0	0	313
36	0	309	0	0	0	309
37	313	0	0	0	0	313
38	315	0	0	0	0	315
39	0	330	0	0	0	330
40	0	0	0	335	0	335
41	0	0	0	337	0	337
42	0	0	0	338	0	338
43	0	337	0	0	0	337
44	0	0	335	0	0	335
45	337	0	0	0	0	337
46	0	0	0	341	0	341
47	0	374	0	1	0	375
48	0	3	0	358	0	361
49	0	561	0	0	0	561
50	0	2	0	573	0	575
51	0	1	0	582	0	583
52	0	0	593	0	0	593
53	0	1	0	594	0	595
54	593	1	0	0	0	594
55	2	0	597	0	0	599
56	600	0	1	0	0	601
57	0	3	0	620	0	623
58	0	627	0	0	0	627
59	0	1	0	659	0	660
60	0	0	680	0	0	680
61	0	2	0	686	0	688
62	1	4	0	688	0	693
63	1	712	0	0	0	713
64	0	0	0	720	0	720
65	0	750	0	0	0	750
66	0	0	0	749	0	749
67	743	0	1	0	0	744
68	740	0	0	0	0	740
69	744	0	0	0	0	744
70	0	748	0	0	0	748
71	4	0	736	0	0	740
72	728	0	1	0	0	729
73	747	0	0	0	0	747
74	0	805	0	1	0	806
75	0	2	0	802	0	804
76	0	0	0	805	0	805
77	1	1	0	811	0	813
78	814	0	1	0	0	815
79	803	0	4	1	0	808
80	810	0	0	0	0	810
81	820	0	2	0	0	822
82	0	1	0	809	0	810
83	0	793	0	0	0	793
84	0	0	0	788	0	788
85	0	0	806	1	0	807
86	0	3	0	803	0	806
87	2	0	798	0	0	800
88	0	4	2	790	0	796
89	2	0	776	0	0	778
90	1	0	789	0	0	790
91	0	730	0	0	0	730
92	0	4	0	727	0	731
93	0	0	745	0	0	745
94	0	0	0	767	0	767
95	0	769	0	1	0	770
96	783	0	2	0	0	785
97	0	684	0	0	0	684
98	0	5	0	661	0	666
99	0	677	0	1	0	678
100	1	0	666	1	0	668
101	3	0	683	0	0	686
102	0	690	0	0	0	690
103	0	1	0	699	0	700
104	2	0	712	0	0	714
105	0	728	0	0	0	728
106	728	0	2	0	0	730
107	0	0	0	805	0	805
108	2	0	856	0	0	858
109	0	882	0	0	0	882
110	0	2	0	891	0	893
111	0	2	0	899	0	901
112	898	0	0	1	0	899
113	0	0	928	0	0	928
114	0	2	1	937	0	940
115	2	0	916	0	0	918
116	0	943	0	0	0	943
117	943	0	5	0	0	948
118	0	968	0	0	0	968
119	0	3	0	954	0	957
120	0	972	0	0	0	972
121	988	0	4	0	0	992
122	0	955	0	0	0	955
123	0	0	955	0	0	955
124	0	853	0	4	0	857
125	858	0	0	1	0	859
126	0	0	1169	0	0	1169
127	0	1	0	1176	0	1177
128	1195	0	0	0	0	1195
129	0	0	0	1205	0	1205
130	1193	0	1	0	0	1194
131	1265	0	1	0	0	1266
132	0	1	0	1270	0	1271
133	0	1	0	1249	0	1250
134	1248	0	1	1	0	1250
135	1191	0	5	0	0	1196
136	0	0	0	1205	0	1205
137	1193	0	4	0	0	1197
138	1275	0	2	0	0	1277
139	1	1275	0	1	0	1277
140	0	0	0	1264	0	1264
141	1302	0	0	0	0	1302
142	1307	0	1	0	0	1308
143	0	1	0	1335	0	1336
144	0	2	0	1322	0	1324
145	1328	0	1	0	0	1329
146	0	1293	0	0	0	1293
147	1	0	0	1287	0	1288
148	1	0	1374	0	0	1375
149	0	4	0	1369	0	1373
150	0	1384	0	1	0	1385
151	1	0	1396	0	0	1397
152	0	3	0	1394	0	1397
153	1	6	2	1387	0	1396
154	0	0	1396	1	0	1397
155	1390	0	10	0	0	1400
156	0	1411	0	0	0	1411
157	1394	1	1	1	0	1397
158	1	0	1449	0	0	1450
159	0	0	1436	0	0	1436
160	1424	0	7	0	0	1431
161	0	1421	1	0	0	1422
162	1432	2	2	0	0	1436
163	0	1486	0	2	0	1488
164	2	0	1495	0	0	1497
165	1496	0	4	0	0	1500
166	1	0	1492	0	0	1493
167	0	1	0	1502	0	1503
168	1498	0	4	0	0	1502
169	1495	0	8	1	0	1504
170	0	1496	0	0	0	1496
171	0	7	0	1470	0	1477
172	0	1520	0	1	0	1521
173	4	0	1515	0	0	1519
174	1	3	0	1548	0	1552
175	0	1527	0	0	0	1527
176	0	3	0	1529	0	1532
177	1606	0	2	0	0	1608
178	0	5	1	1572	0	1578
179	0	1591	0	2	0	1593
180	1	1	1	1588	0	1591
181	0	3	1	1630	0	1634
182	0	1477	0	4	0	1481
183	0	1	0	1484	0	1485
184	1	0	1471	0	0	1472
185	0	1464	1	3	0	1468
186	1458	0	3	0	0	1461
187	1	0	1449	1	0	1451
188	0	0	1431	0	0	1431
189	0	1393	0	1	0	1394
190	0	4	0	1397	0	1401
191	1	0	1458	0	0	1459
192	0	1477	0	1	0	1478
193	0	5	1	1515	0	1521
194	0	0	0	1531	0	1531
195	1532	1	0	0	0	1533
196	0	1516	0	0	0	1516
197	2	0	1513	0	0	1515
198	1	0	1519	1	0	1521
199	0	2	0	1538	0	1540
200	1	3	0	1457	0	1461
201	0	3	0	1456	0	1459
202	0	1159	0	0	0	1159
203	1	0	1154	0	0	1155
204	0	3	0	1140	0	1143
205	0	1145	0	0	0	1145
206	1	1080	0	1	0	1082
207	0	0	1109	0	0	1109
208	0	3	0	1120	0	1123
209	0	0	1122	0	0	1122
210	0	4	0	1137	0	1141
211	0	4	0	1133	0	1137
212	5	0	1094	1	0	1100
213	0	1045	0	0	0	1045
214	1037	0	3	0	0	1040
215	2	0	1022	0	0	1024
216	0	986	0	2	0	988
217	0	983	0	1	0	984
218	2	0	990	0	0	992
219	998	1	1	0	0	1000
220	1	2	0	991	0	994
221	0	1011	0	0	0	1011
222	1008	0	2	1	0	1011
223	0	2	0	1009	0	1011
224	0	932	0	0	0	932
225	917	0	7	3	0	927
226	1	0	931	0	0	932
227	0	951	0	0	0	951
228	945	0	4	0	0	949
229	0	1021	0	1	0	1022
230	1017	1	2	0	0	1020
231	0	3	1	1032	0	1036
232	0	1017	0	0	0	1017
233	0	1	0	990	0	991
234	1013	0	0	0	0	1013
235	0	0	1016	0	0	1016
236	1	0	1019	0	0	1020
237	1	6	0	1042	0	1049
238	0	5	0	1043	0	1048
239	0	2	0	995	0	997
240	0	988	0	0	0	988
241	0	1	1021	0	0	1022
242	0	1	0	1026	0	1027
243	2	1010	0	0	0	1012
244	0	993	0	3	0	996
245	6	1	1003	0	0	1010
246	2	0	1003	0	0	1005
247	0	0	1010	0	0	1010
248	0	6	0	975	0	981
249	0	0	975	0	0	975
250	0	1	0	956	0	957
251	0	0	956	0	0	956
252	959	0	0	0	0	959
253	0	909	0	4	0	913
254	0	883	0	0	0	883
255	1	0	882	0	0	883
256	937	1	3	0	0	941
257	894	0	1	0	0	895
258	909	0	2	0	0	911
259	0	0	958	0	0	958
260	0	0	1020	1	0	1021
261	0	0	0	1024	0	1024
262	1027	0	1	0	0	1028
263	1018	0	2	0	0	1020
264	0	0	1050	0	0	1050
265	1080	0	3	1	0	1084
266	0	1	0	1087	0	1088
267	2	0	1014	0	0	1016
268	0	0	1010	0	0	1010
269	956	0	6	0	0	962
270	2	0	958	1	0	961
271	941	0	3	1	0	945
272	0	0	974	2	0	976
273	0	999	0	1	0	1000
274	0	996	0	0	0	996
275	0	3	0	1022	0	1025
276	0	1	0	1031	0	1032
277	2	0	1043	0	0	1045
278	1	4	0	1051	0	1056
279	0	1059	1	2	0	1062
280	0	1052	0	2	0	1054
281	0	1008	0	2	0	1010
282	0	0	0	1009	0	1009
283	2	0	1011	0	0	1013
284	0	0	1028	0	0	1028
285	0	9	0	999	0	1008
286	0	4	0	1047	0	1051
287	0	4	0	1041	0	1045
288	1	1058	0	0	0	1059
289	1069	0	3	0	0	1072
290	1074	1	2	0	0	1077
291	0	1080	0	0	0	1080
292	0	0	1081	0	0	1081
293	1082	0	0	0	0	1082
294	0	0	1089	0	0	1089
295	1075	0	3	1	0	1079
296	1100	0	1	0	0	1101
297	1096	0	4	0	0	1100
298	1135	0	0	0	0	1135
299	0	1137	0	1	0	1138
300	1147	0	0	0	0	1147
301	0	1135	0	3	0	1138
302	1115	0	4	0	0	1119
303	0	1165	1	2	0	1168
304	10	0	1182	0	0	1192
305	0	1	1	1116	0	1118
306	0	1066	0	0	0	1066
307	0	1073	0	0	0	1073
308	1170	0	3	0	0	1173
309	1185	0	4	1	0	1190
310	0	1195	0	1	0	1196
311	1	2	2	1188	0	1193
312	0	1210	0	0	0	1210
313	1151	1	2	0	0	1154
314	3	0	1174	0	0	1177
315	0	3	0	1224	0	1227
316	0	2	0	1215	0	1217
317	0	3	0	1195	0	1198
318	2	0	1184	0	0	1186
319	0	1182	0	4	0	1186
320	0	1182	0	0	0	1182
321	1	3	0	1163	0	1167
322	0	0	1284	0	0	1284
323	0	0	1	1301	0	1302
324	0	2	0	1336	0	1338
325	0	3	0	1349	0	1352
326	0	1	0	1361	0	1362
327	1353	0	4	0	0	1357
328	0	1337	0	0	0	1337
329	1328	0	2	0	0	1330
330	0	0	1350	0	0	1350
331	0	0	1345	0	0	1345
332	0	1	0	1418	0	1419
333	1	4	0	1438	0	1443
334	0	1365	0	1	0	1366
335	0	0	1369	0	0	1369
336	0	1316	0	8	0	1324
337	0	0	1324	0	0	1324
338	1326	0	3	0	0	1329
339	0	1300	0	2	0	1302
340	0	0	1320	0	0	1320
341	0	1	0	1303	0	1304
342	1	0	1301	1	0	1303
343	0	1330	0	2	0	1332
344	3	5	0	1321	0	1329
345	2	1350	0	3	0	1355
346	5	0	1361	1	0	1367
347	0	0	0	1392	0	1392
348	1360	0	1	0	0	1361
349	0	1328	0	1	0	1329
350	2	0	1312	0	0	1314
351	0	3	0	1293	0	1296
352	0	0	1270	0	0	1270
353	2	0	1361	0	0	1363
354	0	1357	0	1	0	1358
355	0	5	0	1349	0	1354
356	0	4	0	1371	0	1375
357	0	6	0	1388	0	1394
358	1	0	1377	2	0	1380
359	7	0	1371	0	0	1378
360	1341	0	9	1	0	1351
361	3	0	1356	0	0	1359
362	1332	0	3	0	0	1335
363	0	1361	0	0	0	1361
364	0	7	0	1335	0	1342
365	0	1392	0	2	0	1394
366	0	1387	0	6	0	1393
367	0	0	1409	0	0	1409
368	0	5	0	1381	0	1386
369	2	0	1358	0	0	1360
370	0	0	1383	0	0	1383
371	1349	0	6	0	0	1355
372	1	0	1348	0	0	1349
373	2	0	1336	0	0	1338
374	1295	0	3	0	0	1298
375	0	0	1352	0	0	1352
376	0	0	1378	1	0	1379
377	1	8	2	1359	0	1370
378	0	1323	0	0	0	1323
379	1	3	1	1301	0	1306
380	0	1	2	1391	0	1394
381	1406	0	0	0	0	1406
382	1	4	1	1392	0	1398
383	0	1390	0	0	0	1390
384	1284	1	5	0	0	1290
385	1	0	1276	0	0	1277
386	1301	0	5	0	0	1306
387	3	0	1304	1	0	1308
388	0	0	1293	0	0	1293
389	1	1236	0	0	0	1237
390	1257	1	6	1	0	1265
391	1	1291	0	2	0	1294
392	2	0	1288	0	0	1290
393	1	3	1	1286	0	1291
394	1	1338	0	2	0	1341
395	1417	1	3	0	0	1421
396	1477	0	5	0	0	1482
397	0	1431	0	0	0	1431
398	1499	0	6	0	0	1505
399	0	1	0	1536	0	1537
400	1	1542	0	1	0	1544
401	1	2	0	1537	0	1540
402	0	1	1	1554	0	1556
403	1559	0	0	1	0	1560
404	1560	0	1	0	0	1561
405	1560	0	6	1	0	1567
406	1	0	1556	0	0	1557
407	1471	0	4	0	0	1475
408	1	12	0	1422	0	1435
409	1	0	1414	0	0	1415
410	2	2	1409	0	0	1413
411	0	1410	0	1	0	1411
412	1439	1	3	0	0	1443
413	0	1462	0	1	0	1463
414	1	4	0	1461	0	1466
415	0	4	0	1454	0	1458
416	1	0	1424	0	0	1425
417	0	0	0	1427	0	1427
418	1	0	1404	0	0	1405
419	1	0	1399	0	0	1400
420	1	1368	0	0	0	1369
421	1	4	2	1350	0	1357
422	0	2	0	1380	0	1382
423	1378	0	1	0	0	1379
424	1	0	1395	0	0	1396
425	1	2	0	1403	0	1406
426	1393	0	1	0	0	1394
427	0	0	1390	0	0	1390
428	1352	0	2	2	0	1356
429	1299	0	6	0	0	1305
430	1	0	1304	0	0	1305
431	0	6	0	1289	0	1295
432	0	4	0	1285	0	1289
433	0	0	1292	0	0	1292
434	1275	0	4	0	0	1279
435	1311	0	2	0	0	1313
436	1319	1	2	0	0	1322
437	1323	0	1	0	0	1324
438	1303	0	10	0	0	1313
439	0	0	1279	0	0	1279
440	1	0	1279	0	0	1280
441	0	1242	0	2	0	1244
442	3	0	1242	0	0	1245
443	0	7	0	1292	0	1299
444	0	3	0	1297	0	1300
445	0	3	0	1311	0	1314
446	1	1	0	1391	0	1393
447	2	0	1404	1	0	1407
448	1	1392	0	4	0	1397
449	0	1355	0	1	0	1356
450	0	7	0	1350	0	1357
451	0	1359	0	0	0	1359
452	1427	0	3	0	0	1430
453	1455	0	2	0	0	1457
454	0	1385	0	0	0	1385
455	0	0	0	1384	0	1384
456	0	2	0	1367	0	1369
457	0	0	1406	0	0	1406
458	1427	0	2	0	0	1429
459	1424	0	2	0	0	1426
460	0	1428	1	0	0	1429
461	1361	0	2	0	0	1363
462	2	0	1519	1	0	1522
463	0	1555	0	4	0	1559
464	0	1556	1	1	0	1558
465	0	1556	0	0	0	1556
466	1	2	0	1542	0	1545
467	1554	0	0	0	0	1554
468	5	3	0	1571	0	1579
469	6	0	1606	0	0	1612
470	1	4	0	1542	0	1547
471	2	0	1475	1	0	1478
472	0	6	0	1416	0	1422
473	0	2	0	1368	0	1370
474	0	1241	0	0	0	1241
475	1251	0	6	0	0	1257
476	0	1	0	1226	0	1227
477	0	1245	0	0	0	1245
478	1234	0	2	0	0	1236
479	1241	0	3	0	0	1244
480	1290	0	4	0	0	1294
481	0	1282	0	0	0	1282
482	4	0	1283	0	0	1287
483	0	4	0	1281	0	1285
484	0	1	0	1274	0	1275
485	1	1306	0	0	0	1307
486	2	0	1302	0	0	1304
487	0	0	1298	1	0	1299
488	1297	0	1	1	0	1299
489	0	1	0	1301	0	1302
490	1	0	1294	0	0	1295
491	0	1397	1	0	0	1398
492	0	10	0	1362	0	1372
493	0	1411	0	3	0	1414
494	1	0	1423	0	0	1424
495	1391	0	4	0	0	1395
496	1430	0	2	0	0	1432
497	0	1415	0	1	0	1416
498	1	6	0	1404	0	1411
499	1	0	1416	1	0	1418
500	1	1428	0	0	0	1429
501	1454	0	5	0	0	1459
502	2	1504	0	0	0	1506
503	1	1491	0	2	0	1494
504	0	6	0	1463	0	1469
505	0	1516	0	0	0	1516
506	1490	3	4	0	0	1497
507	0	0	0	1540	0	1540
508	0	0	1536	0	0	1536
509	2	0	1605	1	0	1608
510	1	5	0	1602	0	1608
511	1	1576	0	0	0	1577
512	1579	0	5	0	0	1584
513	0	4	0	1717	0	1721
514	0	0	1732	0	0	1732
515	1	5	2	1773	0	1781
516	0	3	0	1769	0	1772
517	1778	1	3	0	0	1782
518	0	4	1	1725	0	1730
519	6	0	1737	0	0	1743
520	11	0	1740	0	0	1751
521	0	4	1	1814	0	1819
522	0	3	0	1708	0	1711
523	3	0	1708	0	0	1711
524	1649	1	6	0	0	1656
525	3	0	1711	0	0	1714
526	0	1646	0	4	0	1650
527	0	4	0	1629	0	1633
528	0	0	1645	0	0	1645
529	0	0	1650	0	0	1650
530	0	5	0	1650	0	1655
531	1638	0	5	1	0	1644
532	0	0	1640	0	0	1640
533	1	1600	0	1	0	1602
534	1595	0	8	1	0	1604
535	0	0	1599	0	0	1599
536	1627	0	6	0	0	1633
537	1640	0	7	0	0	1647
538	0	1474	0	0	0	1474
539	0	7	0	1475	0	1482
540	0	1488	0	0	0	1488
541	7	0	1477	0	0	1484
542	1479	0	0	1	0	1480
543	1474	0	3	0	0	1477
544	1	0	1462	0	0	1463
545	2	0	1445	1	0	1448
546	0	1466	0	1	0	1467
547	1528	0	4	0	0	1532
548	0	1	0	1529	0	1530
549	1	2	0	1532	0	1535
550	0	1547	0	1	0	1548
551	1548	0	4	1	0	1553
552	0	0	1602	0	0	1602
553	12	3	0	1615	0	1630
554	1607	0	5	0	0	1612
555	0	1592	2	4	0	1598
556	3	0	1547	0	0	1550
557	1	0	1624	0	0	1625
558	0	1	0	1670	0	1671
559	0	1652	0	0	0	1652
560	1	0	1680	0	0	1681
561	0	5	0	1650	0	1655
562	1639	0	2	0	0	1641
563	3	0	1651	1	0	1655
564	1	8	0	1660	0	1669
565	4	0	1660	0	0	1664
566	0	1	1634	0	0	1635
567	0	5	0	1575	0	1580
568	4	0	1549	1	0	1554
569	1518	0	3	0	0	1521
570	2	1	1540	1	0	1544
571	1546	0	6	0	0	1552
572	1	1545	0	0	0	1546
573	1541	0	3	1	0	1545
574	0	1561	0	0	0	1561
575	0	9	0	1560	0	1569
576	2	3	0	1585	0	1590
577	2	0	1560	0	0	1562
578	1	0	1576	0	0	1577
579	1	8	0	1650	0	1659
580	3	0	1635	0	0	1638
581	0	4	0	1677	0	1681
582	1	1665	0	1	0	1667
583	0	1590	0	2	0	1592
584	3	4	0	1577	0	1584
585	2	7	0	1574	0	1583
586	1	0	1618	1	0	1620
587	0	7	0	1661	0	1668
588	0	1520	0	0	0	1520
589	0	1514	0	1	0	1515
590	0	1479	0	1	0	1480
591	0	6	0	1451	0	1457
592	2	1472	0	0	0	1474
593	1479	0	6	0	0	1485
594	0	2	0	1507	0	1509
595	2	0	1497	0	0	1499
596	0	2	2	1432	0	1436
597	0	0	1409	1	0	1410
598	4	0	1401	1	0	1406
599	3	0	1407	2	0	1412
600	0	1415	0	1	0	1416
601	1	0	1415	0	0	1416
602	1447	0	3	0	0	1450
603	1444	1	1	0	0	1446
604	1436	0	6	0	0	1442
605	0	2	0	1463	0	1465
606	1497	0	3	0	0	1500
607	0	1498	0	1	0	1499
608	0	1479	0	2	0	1481
609	1464	0	2	1	0	1467
610	0	0	1486	0	0	1486
611	0	1	0	1452	0	1453
612	1	0	1468	0	0	1469
613	5	0	1467	1	0	1473
614	0	1486	1	1	0	1488
615	0	4	0	1465	0	1469
616	0	1	0	1475	0	1476
617	1484	1	1	0	0	1486
618	0	1484	0	2	0	1486
619	0	1474	0	5	0	1479
620	0	0	1478	0	0	1478
621	4	1399	0	1	0	1404
622	1461	0	6	0	0	1467
623	1392	0	3	0	0	1395
624	0	0	1401	0	0	1401
625	3	0	1445	1	0	1449
626	1	6	0	1394	0	1401
627	1	3	0	1403	0	1407
628	0	1352	0	1	0	1353
629	0	6	0	1360	0	1366
630	0	4	0	1355	0	1359
631	0	1285	0	0	0	1285
632	1	5	0	1254	0	1260
633	1	1	0	1278	0	1280
634	0	1234	0	0	0	1234
635	2	0	1232	0	0	1234
636	0	3	0	1217	0	1220
637	1202	1	3	0	0	1206
638	1192	0	3	5	0	1200
639	0	0	1205	0	0	1205
640	1186	0	4	1	0	1191
641	1251	0	2	0	0	1253
642	0	1263	0	4	0	1267
643	3	0	1253	0	0	1256
644	2	0	1411	0	0	1413
645	1	1	1	1428	0	1431
646	1466	0	3	0	0	1469
647	1473	0	5	0	0	1478
648	0	0	0	1470	0	1470
649	1467	0	1	0	0	1468
650	1412	0	4	0	0	1416
651	1360	0	8	1	0	1369
652	0	0	1365	1	0	1366
653	0	0	1350	0	0	1350
654	1229	1	2	0	0	1232
655	0	0	1262	0	0	1262
656	0	1261	0	1	0	1262
657	0	1	1	1244	0	1246
658	0	0	1257	0	0	1257
659	0	0	1253	0	0	1253
660	0	0	0	1261	0	1261
661	2	0	1263	0	0	1265
662	1	0	1228	0	0	1229
663	0	1178	0	4	0	1182
664	0	1171	0	2	0	1173
665	1177	0	5	0	0	1182
666	0	4	0	1218	0	1222
667	1211	0	3	0	0	1214
668	0	0	1222	0	0	1222
669	0	2	0	1225	0	1227
670	0	0	0	1182	0	1182
671	1175	0	1	0	0	1176
672	0	1159	0	3	0	1162
673	1	0	1146	0	0	1147
674	1	0	1140	0	0	1141
675	0	1127	0	2	0	1129
676	1	0	1123	1	0	1125
677	0	1096	0	1	0	1097
678	0	1092	0	0	0	1092
679	0	0	1122	0	0	1122
680	1130	0	0	0	0	1130
681	0	2	0	1108	0	1110
682	0	1185	0	1	0	1186
683	0	3	0	1188	0	1191
684	1235	0	1	1	0	1237
685	1229	0	5	0	0	1234
686	1223	0	6	0	0	1229
687	1	0	1232	0	0	1233
688	0	3	0	1254	0	1257
689	0	1292	0	0	0	1292
690	1299	0	3	0	0	1302
691	0	3	1	1294	0	1298
692	0	2	0	1313	0	1315
693	0	3	0	1317	0	1320
694	0	0	1326	0	0	1326
695	1375	0	0	1	0	1376
696	0	1372	0	0	0	1372
697	0	5	0	1393	0	1398
698	0	0	0	1390	0	1390
699	1373	0	0	0	0	1373
700	0	0	1375	0	0	1375
701	0	0	1424	0	0	1424
702	1	1433	0	0	0	1434
703	2	0	1425	1	0	1428
704	1420	0	2	0	0	1422
705	0	1417	0	0	0	1417
706	3	0	1421	0	0	1424
707	1444	0	6	0	0	1450
708	0	0	1536	0	0	1536
709	0	1532	0	2	0	1534
710	1	7	0	1526	0	1534
711	1	5	0	1540	0	1546
712	1	0	1536	0	0	1537
713	1	0	1548	1	0	1550
714	0	1549	0	2	0	1551
715	1564	0	2	1	0	1567
716	0	1517	0	1	0	1518
717	0	5	0	1455	0	1460
718	1	0	1471	0	0	1472
719	1476	0	3	0	0	1479
720	1	3	0	1367	0	1371
721	0	1350	0	0	0	1350
722	0	1284	0	0	0	1284
723	2	0	0	1303	0	1305
724	0	2	0	1325	0	1327
725	1400	0	2	0	0	1402
726	0	8	0	1391	0	1399
727	8	0	1377	0	0	1385
728	1376	0	3	0	0	1379
729	1341	0	2	0	0	1343
730	1	0	1346	0	0	1347
731	1329	0	2	0	0	1331
732	0	1	1	1285	0	1287
733	0	3	0	1305	0	1308
734	0	3	0	1300	0	1303
735	0	4	1	1320	0	1325
736	0	1312	0	0	0	1312
737	1407	1	5	0	0	1413
738	1399	0	4	0	0	1403
739	0	0	1389	0	0	1389
740	1396	0	2	1	0	1399
741	1400	0	1	0	0	1401
742	1386	0	9	0	0	1395
743	1415	0	6	0	0	1421
744	0	1411	0	6	0	1417
745	0	0	0	1425	0	1425
746	0	0	1422	0	0	1422
747	1	0	1435	1	0	1437
748	1458	0	1	0	0	1459
749	1510	0	2	0	0	1512
750	0	1523	0	0	0	1523
751	1545	0	1	0	0	1546
752	0	1554	0	0	0	1554
753	0	3	0	1581	0	1584
754	1676	0	1	0	0	1677
755	1643	0	2	0	0	1645
756	1702	0	6	0	0	1708
757	0	1713	0	2	0	1715
758	1595	0	5	0	0	1600
759	0	3	0	1629	0	1632
760	1576	0	5	0	0	1581
761	0	0	1619	0	0	1619
762	0	1618	0	2	0	1620
763	1524	1	4	0	0	1529
764	0	0	1545	0	0	1545
765	0	2	0	1489	0	1491
766	0	0	1522	0	0	1522
767	1	0	1570	0	0	1571
768	2	4	0	1552	0	1558
769	1	3	1560	0	0	1564
770	0	6	0	1496	0	1502
771	0	1	0	1494	0	1495
772	1514	0	5	0	0	1519
773	0	1509	0	0	0	1509
774	0	1506	1	1	0	1508
775	0	1438	0	0	0	1438
776	1	0	1429	0	0	1430
777	0	4	0	1403	0	1407
778	1	0	1393	0	0	1394
779	1436	0	6	0	0	1442
780	1448	0	4	0	0	1452
781	0	1453	0	1	0	1454
782	1	2	0	1402	0	1405
783	0	1348	0	1	0	1349
784	1395	0	2	0	0	1397
785	0	5	0	1410	0	1415
786	1	0	1399	2	0	1402
787	0	1506	0	0	0	1506
788	2	0	1508	0	0	1510
789	1	3	0	1501	0	1505
790	5	0	1487	0	0	1492
791	1460	0	6	0	0	1466
792	1	0	1528	0	0	1529
793	0	1501	0	5	0	1506
794	0	2	0	1517	0	1519
795	0	1	0	1539	0	1540
796	1539	1	0	1	0	1541
797	1548	0	2	0	0	1550
798	0	1595	0	2	0	1597
799	2	0	1573	0	0	1575
800	0	0	1579	0	0	1579
801	1481	0	7	0	0	1488
802	0	0	1514	0	0	1514
803	2	0	1502	1	0	1505
804	0	0	1513	1	0	1514
805	2	0	1553	0	0	1555
806	0	1567	1	2	0	1570
807	1615	0	3	0	0	1618
808	0	3	0	1646	0	1649
809	1651	0	2	0	0	1653
810	0	1657	0	1	0	1658
811	1630	0	4	0	0	1634
812	0	1665	0	0	0	1665
813	0	0	0	1562	0	1562
814	0	1578	0	0	0	1578
815	1	0	1573	0	0	1574
816	0	1554	0	3	0	1557
817	0	0	1	1561	0	1562
818	1572	0	1	2	0	1575
819	0	3	2	1542	0	1547
820	1	0	1569	1	0	1571
821	0	2	0	1565	0	1567
822	0	1580	0	4	0	1584
823	1	0	1561	0	0	1562
824	1569	0	2	0	0	1571
825	0	2	0	1527	0	1529
826	1504	0	5	0	0	1509
827	1507	0	1	0	0	1508
828	1	1513	0	2	0	1516
829	1460	0	3	1	0	1464
830	1406	0	1	0	0	1407
831	0	1359	0	0	0	1359
832	0	1	0	1341	0	1342
833	0	2	0	1338	0	1340
834	0	1309	0	0	0	1309
835	0	1	0	1300	0	1301
836	6	0	1293	0	0	1299
837	0	1	0	1306	0	1307
838	3	0	1300	0	0	1303
839	1	0	1307	0	0	1308
840	1	1293	1	0	0	1295
841	0	1263	0	1	0	1264
842	0	1256	0	0	0	1256
843	0	0	1	1236	0	1237
844	3	0	1249	0	0	1252
845	1246	0	4	0	0	1250
846	0	1	2	1266	0	1269
847	0	0	1268	1	0	1269
848	1	0	1241	2	0	1244
849	0	1239	0	2	0	1241
850	0	3	0	1231	0	1234
851	1269	0	3	1	0	1273
852	1	1262	1	1	0	1265
853	0	1266	0	2	0	1268
854	0	1287	0	0	0	1287
855	0	2	0	1234	0	1236
856	0	1272	0	0	0	1272
857	0	4	0	1266	0	1270
858	0	1	0	1269	0	1270
859	0	0	1262	0	0	1262
860	1220	1	1	1	0	1223
861	0	0	1210	0	0	1210
862	0	4	0	1146	0	1150
863	2	0	1137	0	0	1139
864	0	1162	0	2	0	1164
865	1163	0	3	0	0	1166
866	0	2	0	1278	0	1280
867	0	1	0	1283	0	1284
868	1255	0	0	0	0	1255
869	1299	0	0	0	0	1299
870	1267	0	6	0	0	1273
871	0	0	1255	0	0	1255
872	1255	0	2	0	0	1257
873	0	1252	0	1	0	1253
874	0	1220	0	0	0	1220
875	0	1	0	1216	0	1217
876	1	3	0	1489	0	1493
877	0	1507	0	0	0	1507
878	2	2	0	1508	0	1512
879	1512	0	2	1	0	1515
880	3	0	1474	0	0	1477
881	1	1524	0	1	0	1526
882	1525	1	1	0	0	1527
883	0	1480	0	3	0	1483
884	2	0	1455	0	0	1457
885	0	1	0	1466	0	1467
886	0	0	1438	0	0	1438
887	0	1414	0	0	0	1414
888	1	5	0	1391	0	1397
889	1	0	1413	0	0	1414
890	0	0	1448	0	0	1448
891	0	4	0	1457	0	1461
892	1468	0	0	0	0	1468
893	1450	0	6	0	0	1456
894	1433	0	5	0	0	1438
895	0	0	1444	0	0	1444
896	0	1433	1	0	0	1434
897	0	5	0	1418	0	1423
898	0	6	0	1396	0	1402
899	0	1388	0	2	0	1390
900	1401	0	3	0	0	1404
901	1	1	0	1409	0	1411
902	0	0	1403	0	0	1403
903	0	1420	0	0	0	1420
904	1408	0	3	0	0	1411
905	0	1397	0	2	0	1399
906	0	3	0	1374	0	1377
907	1	3	0	1391	0	1395
908	0	3	0	1395	0	1398
909	2	0	1394	0	0	1396
910	1	2	0	1381	0	1384
911	0	1374	0	0	0	1374
912	0	1376	0	4	0	1380
913	1	0	1374	0	0	1375
914	1361	0	3	0	0	1364
915	1366	1	7	0	0	1374
916	0	1375	0	2	0	1377
917	1429	0	3	0	0	1432
918	1442	0	3	0	0	1445
919	0	1435	0	0	0	1435
920	0	2	3	1425	0	1430
921	1	0	1439	0	0	1440
922	4	0	1431	0	0	1435
923	1443	0	3	0	0	1446
924	0	1445	0	3	0	1448
925	0	7	0	1422	0	1429
926	0	2	0	1435	0	1437
927	1	0	0	1406	0	1407
928	1508	0	1	0	0	1509
929	0	1	0	1501	0	1502
930	1	6	0	1474	0	1481
931	0	0	1477	0	0	1477
932	1437	0	3	1	0	1441
933	0	1482	0	1	0	1483
934	1478	0	2	0	0	1480
935	0	1488	0	3	0	1491
936	0	1	0	1491	0	1492
937	1499	1	0	0	0	1500
938	1486	0	4	1	0	1491
939	2	0	1474	0	0	1476
940	1466	0	3	0	0	1469
941	0	0	1431	0	0	1431
942	0	0	1342	6	0	1348
943	4	0	1377	0	0	1381
944	0	0	1425	1	0	1426
945	0	3	0	1409	0	1412
946	1	0	1440	0	0	1441
947	0	1	0	1446	0	1447
948	1424	0	2	0	0	1426
949	0	0	0	1414	0	1414
950	1371	0	3	0	0	1374
951	0	1365	0	1	0	1366
952	0	0	0	1064	0	1064
953	1	0	1053	0	0	1054
954	0	1047	0	0	0	1047
955	0	2	0	978	0	980
956	2	0	1920	0	0	1922
957	0	2059	5	1	0	2065
958	0	2128	0	1	0	2129
959	7	0	2774	0	0	2781
960	0	2	1	2758	0	2761
961	3	0	3620	0	0	3623
962	3652	0	3	0	0	3655
963	3690	0	4	1	0	3695
964	0	3784	0	1	0	3785
965	3752	0	4	0	0	3756
966	0	1	0	3768	0	3769
967	4	0	3858	1	0	3863
968	3851	0	12	2	0	3865
969	1	0	4527	0	0	4528
970	0	4514	1	2	0	4517
971	4520	0	5	1	0	4526
972	1	7	1	4643	0	4652
973	9	0	4687	0	0	4696
974	4911	2	9	2	0	4924
975	4894	1	17	1	0	4913
976	4958	0	10	1	0	4969
977	0	12	1	4986	0	4999
978	1	10	0	4985	0	4996
979	1	0	5348	1	0	5350
980	1	5385	1	9	0	5396
981	1	16	1	5447	0	5465
982	1	13	0	5507	0	5521
983	7	0	5610	2	0	5619
984	1	2	7020	1	0	7024
985	0	9	0	7067	0	7076
986	7337	0	9	0	0	7346
987	0	7392	0	5	0	7397
988	7394	0	21	0	0	7415
989	1	7506	1	8	0	7516
990	18	0	7502	2	0	7522
991	3	0	7587	3	0	7593
992	7605	1	12	5	0	7623
993	7617	1	29	1	0	7648
994	0	7686	0	9	0	7695
995	5	1	8643	2	0	8651
996	1	37	3	8683	0	8724
997	1	40	0	8830	0	8871
998	1	8919	0	8	0	8928
999	2	25	2	8901	0	8930
1000	7	0	9305	1	0	9313
1001	9223	1	23	4	0	9251
1002	9264	1	29	2	0	9296
1003	9247	0	26	1	0	9274
1004	9095	0	49	6	0	9150
1005	5	0	9445	3	0	9453
1006	9349	0	29	1	0	9379
1007	11	0	9756	2	0	9769
1008	1	9781	0	6	0	9788
1009	0	17	2	9756	0	9775
1010	9987	2	18	0	0	10007
1011	3	23	2	9995	0	10023
1012	4	1	10470	6	0	10481
1013	10433	1	27	4	0	10465
1014	10555	2	21	2	0	10580
1015	3	28	2	10716	0	10749
1016	3	15	0	10676	0	10694
1017	14	1	10763	8	0	10786
1018	2	10789	0	13	0	10804
1019	10787	2	35	6	0	10830
1020	6	0	10804	3	0	10813
1021	10715	1	36	3	0	10755
1022	0	10936	0	5	0	10941
1023	10978	1	21	2	0	11002
1024	0	11639	0	3	0	11642
1025	2	11620	0	7	0	11629
1026	4	54	2	11618	0	11678
1027	1	36	1	11717	0	11755
1028	4	21	4	11727	0	11756
1029	1	26	1	11734	0	11762
1030	4	0	11734	0	0	11738
1031	11611	5	30	18	0	11664
1032	10787	3	38	6	0	10834
1033	10628	2	73	6	0	10709
1034	0	11	1	10722	0	10734
1035	1	7	0	10134	0	10142
1036	10113	0	5	1	0	10119
1037	9635	3	21	1	0	9660
1038	9637	1	22	0	0	9660
1039	1	11	0	9680	0	9692
1040	2	22	0	9571	0	9595
1041	12	0	9572	3	0	9587
1042	12	0	9522	7	0	9541
1043	0	9581	2	15	0	9598
1044	9559	0	21	2	0	9582
1045	9157	1	15	2	0	9175
1046	9054	0	39	5	0	9098
1047	5	0	9310	1	0	9316
1048	9322	3	15	1	0	9341
1049	9411	0	23	0	0	9434
1050	9356	1	16	0	0	9373
1051	1	17	1	9474	0	9493
1052	5	8	0	9566	0	9579
1053	0	22	0	9544	0	9566
1054	20	0	9413	3	0	9436
1055	9131	2	23	0	0	9156
1056	0	9069	0	1	0	9070
1057	9087	0	67	3	0	9157
1058	1	9760	0	2	0	9763
1059	0	9128	0	2	0	9130
1060	1	41	0	9140	0	9182
1061	2	20	0	9632	0	9654
1062	0	9581	0	19	0	9600
1063	9630	0	18	2	0	9650
1064	9619	8	21	3	0	9651
1065	3	15	1	9591	0	9610
1066	12	1	9637	1	0	9651
1067	8	0	9538	4	0	9550
1068	34	1	9528	9	0	9572
1069	9	0	9602	0	0	9611
1070	9392	0	23	7	0	9422
1071	8545	2	30	3	0	8580
1072	0	11	1	8678	0	8690
1073	9	0	8903	0	0	8912
1074	1	34	0	8922	0	8957
1075	0	8531	1	5	0	8537
1076	2	8488	3	10	0	8503
1077	8536	0	12	4	0	8552
1078	8520	0	25	3	0	8548
1079	8749	0	10	2	0	8761
1080	1	9	0	8949	0	8959
1081	2	9	0	8736	0	8747
1082	1	25	1	8936	0	8963
1083	2	26	0	8760	0	8788
1084	6	0	8900	0	0	8906
1085	0	9	0	8959	0	8968
1086	8708	0	11	0	0	8719
1087	2	41	0	8664	0	8707
1088	0	22	0	8224	0	8246
1089	2	25	1	8234	0	8262
1090	1	8742	1	3	0	8747
1091	1	8747	0	7	0	8755
1092	1	8766	0	9	0	8776
1093	3	15	0	8919	0	8937
1094	0	7	0	9178	0	9185
1095	9212	0	15	2	0	9229
1096	9158	0	20	1	0	9179
1097	9221	0	13	1	0	9235
1098	1	23	2	9222	0	9248
1099	2	27	0	9122	0	9151
1100	0	8978	0	1	0	8979
1101	2	8935	0	7	0	8944
1102	9002	0	19	3	0	9024
1103	2	22	0	9529	0	9553
1104	11375	3	14	1	0	11393
1105	11749	1	30	2	0	11782
1106	2	32	2	11778	0	11814
1107	0	11715	0	13	0	11728
1108	11777	0	14	4	0	11795
1109	12168	0	36	5	0	12209
1110	2	0	12181	2	0	12185
1111	12166	1	31	5	0	12203
1112	1	13157	0	7	0	13165
1113	5	26	0	12698	0	12729
1114	13449	2	14	0	0	13465
1115	0	31	1	13477	0	13509
1116	8	35	0	13464	0	13507
1117	1	13521	0	7	0	13529
1118	13524	0	27	3	0	13554
1119	14071	0	29	2	0	14102
1120	2	14181	2	10	0	14195
1121	0	13900	0	14	0	13914
1122	13928	0	14	2	0	13944
1123	13532	2	18	1	0	13553
1124	8	3	13718	6	0	13735
1125	22	0	13729	3	0	13754
1126	17	0	13792	4	0	13813
1127	4	37	0	13613	0	13654
1128	0	37	2	13515	0	13554
1129	10	0	13617	2	0	13629
1130	13566	0	19	6	0	13591
1131	13606	1	33	1	0	13641
1132	13605	2	35	5	0	13647
1133	13483	0	99	3	0	13585
1134	1	0	13148	1	0	13150
1135	12609	3	37	1	0	12650
1136	12559	1	31	1	0	12592
1137	12216	7	30	5	0	12258
1138	12042	3	23	5	0	12073
1139	12000	1	46	2	0	12049
1140	11	0	12068	2	0	12081
1141	0	12086	0	7	0	12093
1142	3	36	0	12067	0	12106
1143	2	23	1	12026	0	12052
1144	14	1	11941	1	0	11957
1145	12057	1	20	3	0	12081
1146	3	22	1	12134	0	12160
1147	9	1	12280	1	0	12291
1148	10	1	12696	5	0	12712
1149	0	12611	0	12	0	12623
1150	0	43	1	12588	0	12632
1151	3	29	1	12592	0	12625
1152	0	12	1	12811	0	12824
1153	13075	0	17	4	0	13096
1154	4	16	0	13034	0	13054
1155	13	0	12937	0	0	12950
1156	19	0	13577	7	0	13603
1157	23	0	13624	7	0	13654
1158	6	23	0	13818	0	13847
1159	13663	3	19	4	0	13689
1160	6	1	14021	4	0	14032
1161	14219	1	37	3	0	14260
1162	14526	2	24	9	0	14561
1163	4	31	0	14793	0	14828
1164	2	19	0	14838	0	14859
1165	1	14344	1	14	0	14360
1166	7	0	14248	6	0	14261
1167	14377	1	27	2	0	14407
1168	3	36	2	14149	0	14190
1169	4	14233	0	15	0	14252
1170	5	59	0	14304	0	14368
1171	13	0	16688	5	0	16706
1172	3	56	0	16789	0	16848
1173	1	17024	2	12	0	17039
1174	6	33	1	17026	0	17066
1175	17945	0	8	4	0	17957
1176	4	42	0	17388	0	17434
1177	4	17540	0	9	0	17553
1178	3	17507	2	13	0	17525
1179	17020	2	27	2	0	17051
1180	11	1	15292	0	0	15304
1181	3	17	0	14963	0	14983
1182	3	37	5	14818	0	14863
1183	28	0	14643	4	0	14675
1184	0	14586	0	30	0	14616
1185	12	1	14643	2	0	14658
1186	5	50	0	14646	0	14701
1187	1	14091	0	11	0	14103
1188	14125	4	42	1	0	14172
1189	1	13593	0	3	0	13597
1190	3	13622	0	17	0	13642
1191	13777	10	27	4	0	13818
1192	13980	2	27	4	0	14013
1193	13858	7	30	2	0	13897
1194	2	15	0	13801	0	13818
1195	11	0	13412	1	0	13424
1196	13224	2	34	2	0	13262
1197	13370	1	49	2	0	13422
1198	4	20	0	13404	0	13428
1199	23	1	13347	6	0	13377
1200	1	13327	0	18	0	13346
1201	13719	2	31	1	0	13753
1202	13824	1	31	4	0	13860
1203	3	13822	0	13	0	13838
1204	3	14014	2	3	0	14022
1205	14222	2	19	5	0	14248
1206	14417	2	18	8	0	14445
1207	14435	3	42	3	0	14483
1208	1	22	1	14493	0	14517
1209	10	0	14528	1	0	14539
1210	7	37	4	14017	0	14065
1211	15	1	14042	1	0	14059
1212	6	14285	3	10	0	14304
1213	0	14197	0	3	0	14200
1214	3	74	3	14711	0	14791
1215	1	51	1	14736	0	14789
1216	6	70	1	14650	0	14727
1217	6	14647	1	7	0	14661
1218	14649	5	25	2	0	14681
1219	14807	0	27	2	0	14836
1220	1	15100	0	6	0	15107
1221	12	69	3	14747	0	14831
1222	1	15878	0	11	0	15890
1223	9	75	0	15340	0	15424
1224	0	16218	0	6	0	16224
1225	16197	0	24	2	0	16223
1226	5	46	1	16221	0	16273
1227	5	0	16280	1	0	16286
1228	15993	3	52	6	0	16054
1229	15925	10	51	3	0	15989
1230	6	0	16822	1	0	16829
1231	7	30	1	16116	0	16154
1232	7	0	16254	0	0	16261
1233	2	48	2	15884	0	15936
1234	30	1	16036	0	0	16067
1235	15999	0	38	7	0	16044
1236	5	35	1	15947	0	15988
1237	1	15833	0	14	0	15848
1238	15773	2	22	7	0	15804
1239	4	17	1	15681	0	15703
1240	0	39	2	15521	0	15562
1241	7	0	15447	7	0	15461
1242	8	32	2	15479	0	15521
1243	21	0	15599	1	0	15621
1244	10	0	15747	5	0	15762
1245	1	40	2	15920	0	15963
1246	34	0	15464	9	0	15507
1247	13518	4	23	4	0	13549
1248	13523	1	52	2	0	13578
1249	13467	3	33	2	0	13505
1250	0	13207	0	5	0	13212
1251	0	36	0	13135	0	13171
1252	2	38	2	13125	0	13167
1253	1	13063	0	11	0	13075
1254	13049	3	33	2	0	13087
1255	9	33	2	13439	0	13483
1256	7	0	13367	2	0	13376
1257	8	0	13558	13	0	13579
1258	0	13586	1	13	0	13600
1259	13229	4	20	2	0	13255
1260	6	0	13230	0	0	13236
1261	13681	1	39	5	0	13726
1262	1	13732	0	13	0	13746
1263	17	0	13690	3	0	13710
1264	10	2	13898	5	0	13915
1265	9	1	13996	6	0	14012
1266	0	13909	0	19	0	13928
1267	25	0	13980	0	0	14005
1268	14291	1	13	3	0	14308
1269	1	45	1	14333	0	14380
1270	3	45	2	14384	0	14434
1271	3	34	0	14387	0	14424
1272	3	45	1	14584	0	14633
1273	20	1	15170	9	0	15200
1274	4	33	1	15247	0	15285
1275	6	22	0	15216	0	15244
1276	14978	2	23	6	0	15009
1277	14537	1	30	8	0	14576
1278	14342	1	35	4	0	14382
1279	24	1	14376	0	0	14401
1280	2	14741	0	9	0	14752
1281	0	14556	0	8	0	14564
1282	14458	0	34	4	0	14496
1283	0	14488	0	3	0	14491
1284	0	37	5	14410	0	14452
1285	2	19	2	14624	0	14647
1286	40	0	14528	3	0	14571
1287	3	14311	0	16	0	14330
1288	4	0	14325	0	0	14329
1289	14216	3	35	8	0	14262
1290	13772	1	20	0	0	13793
1291	0	42	1	13908	0	13951
1292	4	30	0	13952	0	13986
1293	1	16	0	14355	0	14372
1294	1	30	1	14352	0	14384
1295	17	1	14110	4	0	14132
1296	7	35	2	13993	0	14037
1297	16	0	13848	3	0	13867
1298	15	1	12534	9	0	12559
1299	2	12080	0	13	0	12095
1300	12094	2	25	7	0	12128
1301	3	12293	0	13	0	12309
1302	2	25	1	12131	0	12159
1303	3	0	12232	0	0	12235
1304	12138	1	22	6	0	12167
1305	7	1	12220	0	0	12228
1306	11932	1	38	5	0	11976
1307	11935	0	29	0	0	11964
1308	1	11	3	11644	0	11659
1309	1	19	2	11571	0	11593
1310	5	32	2	11340	0	11379
1311	8	0	11724	2	0	11734
1312	11799	1	32	3	0	11835
1313	2	11742	0	8	0	11752
1314	0	17	2	11588	0	11607
1315	11786	0	14	0	0	11800
1316	11975	1	49	1	0	12026
1317	11912	1	38	4	0	11955
1318	4	0	11894	1	0	11899
1319	11769	0	22	3	0	11794
1320	11228	0	27	4	0	11259
1321	15	0	11194	1	0	11210
1322	16	0	12032	5	0	12053
1323	4	23	2	12125	0	12154
1324	20	2	12038	3	0	12063
1325	5	11726	1	8	0	11740
1326	3	12002	0	19	0	12024
1327	12224	0	22	4	0	12250
1328	3	12809	0	5	0	12817
1329	1	25	0	13060	0	13086
1330	13727	1	21	3	0	13752
1331	2	13381	0	4	0	13387
1332	3	54	1	13212	0	13270
1333	4	29	3	13652	0	13688
1334	14	2	13828	3	0	13847
1335	3	32	1	13974	0	14010
1336	24	1	13907	1	0	13933
1337	7	0	13943	6	0	13956
1338	5	32	4	14382	0	14423
1339	1	12	2	14577	0	14592
1340	14858	0	15	5	0	14878
1341	1	14837	0	6	0	14844
1342	1	28	1	14667	0	14697
1343	8	23	1	14611	0	14643
1344	14174	1	10	0	0	14185
1345	3	15221	0	14	0	15238
1346	5	15042	0	8	0	15055
1347	3	15123	0	4	0	15130
1348	3	14540	0	4	0	14547
1349	14622	6	25	2	0	14655
1350	15119	0	20	1	0	15140
1351	15146	0	21	4	0	15171
1352	15277	2	24	4	0	15307
1353	0	30	0	15565	0	15595
1354	9	2	14991	1	0	15003
1355	3	14939	1	12	0	14955
1356	1	50	5	14753	0	14809
1357	9	0	14912	2	0	14923
1358	5	49	1	15597	0	15652
1359	4	49	2	15785	0	15840
1360	26	0	16098	1	0	16125
1361	4	35	0	16201	0	16240
1362	5	14	2	16229	0	16250
1363	16476	2	8	4	0	16490
1364	16407	4	17	3	0	16431
1365	16632	2	19	0	0	16653
1366	16747	2	20	1	0	16770
1367	0	12	0	16615	0	16627
1368	0	12	0	16769	0	16781
1369	0	20	0	16525	0	16545
1370	16476	0	12	0	0	16488
1371	2	33	0	16677	0	16712
1372	4	42	0	16586	0	16632
1373	14	0	17123	11	0	17148
1374	5	48	0	16994	0	17047
1375	2	16844	1	16	0	16863
1376	4	16813	1	17	0	16835
1377	16655	1	30	4	0	16690
1378	14	2	17039	1	0	17056
1379	8	17092	0	10	0	17110
1380	17224	1	39	2	0	17266
1381	4	51	7	17091	0	17153
1382	11	0	16661	1	0	16673
1383	8	68	3	16896	0	16975
1384	3	16872	1	20	0	16896
1385	16887	1	46	8	0	16942
1386	2	16665	0	39	0	16706
1387	16306	1	29	2	0	16338
1388	18332	1	36	4	0	18373
1389	1	38	1	18234	0	18274
1390	4	53	2	18129	0	18188
1391	3	18012	1	38	0	18054
1392	17833	5	33	2	0	17873
1393	2	0	18034	1	0	18037
1394	17102	5	33	26	0	17166
1395	17325	1	55	5	0	17386
1396	13	0	17475	0	0	17488
1397	4	19	2	17098	0	17123
1398	16639	1	39	2	0	16681
1399	25	0	16600	1	0	16626
1400	29	0	16804	6	0	16839
1401	16968	0	40	5	0	17013
1402	9	16690	1	11	0	16711
1403	6	15675	0	7	0	15688
1404	4	34	3	15757	0	15798
1405	18	0	16669	8	0	16695
1406	16789	1	38	3	0	16831
1407	34	0	17236	2	0	17272
1408	0	17182	0	23	0	17205
1409	16934	1	27	6	0	16968
1410	4	33	0	16862	0	16899
1411	16343	1	26	1	0	16371
1412	10	1	17217	4	0	17232
1413	7	62	3	17667	0	17739
1414	3	16674	2	18	0	16697
1415	4	50	1	16338	0	16393
1416	4	41	2	16167	0	16214
1417	31	0	16391	11	0	16433
1418	9	16545	1	34	0	16589
1419	5	16618	1	14	0	16638
1420	30	1	16843	1	0	16875
1421	15891	1	15	7	0	15914
1422	16177	1	22	1	0	16201
1423	1	28	0	16350	0	16379
1424	17329	3	24	1	0	17357
1425	2	18039	0	11	0	18052
1426	1	17557	0	5	0	17563
1427	17941	1	28	5	0	17975
1428	0	27	1	18224	0	18252
1429	18254	1	27	6	0	18288
1430	19274	0	25	2	0	19301
1431	3	38	0	19131	0	19172
1432	11	1	19116	3	0	19131
1433	19052	1	36	9	0	19098
1434	18724	1	51	2	0	18778
1435	2	42	0	18573	0	18617
1436	2	18294	2	5	0	18303
1437	5	51	1	18063	0	18120
1438	21	8	18140	2	0	18171
1439	13	0	18156	4	0	18173
1440	1	18050	0	19	0	18070
1441	1	39	2	17966	0	18008
1442	0	46	2	17939	0	17987
1443	4	0	17940	3	0	17947
1444	18080	2	29	4	0	18115
1445	18193	3	35	2	0	18233
1446	18512	3	60	5	0	18580
1447	18425	9	45	2	0	18481
1448	1	18511	1	41	0	18554
1449	1	18424	0	8	0	18433
1450	18413	1	22	5	0	18441
1451	4	53	4	18595	0	18656
1452	1	55	2	18532	0	18590
1453	2	18517	0	1	0	18520
1454	3	50	2	18201	0	18256
1455	3	38	6	20781	0	20828
1456	1	21011	0	6	0	21018
1457	45	0	20919	3	0	20967
1458	1	39	2	21228	0	21270
1459	21043	1	26	2	0	21072
1460	20871	6	52	5	0	20934
1461	6	0	21223	1	0	21230
1462	30	1	21305	5	0	21341
1463	45	0	21527	4	0	21576
1464	1	20	3	19549	0	19573
1465	18	1	19437	2	0	19458
1466	16	1	19661	4	0	19682
1467	4	67	1	19821	0	19893
1468	1	19620	0	45	0	19666
1469	35	6	19652	1	0	19694
1470	13	19403	1	14	0	19431
1471	19656	1	41	3	0	19701
1472	3	20346	0	2	0	20351
1473	2	26	2	20278	0	20308
1474	20523	1	16	1	0	20541
1475	5	53	4	20537	0	20599
1476	1	37	3	20164	0	20205
1477	21	1	20091	10	0	20123
1478	5	20543	0	30	0	20578
1479	3	19850	0	17	0	19870
1480	2	61	1	19745	0	19809
1481	2	52	6	20423	0	20483
1482	3	30	1	20390	0	20424
1483	20	1	19977	5	0	20003
1484	17	1	20101	6	0	20125
1485	19941	2	57	3	0	20003
1486	17	1	20122	1	0	20141
1487	10	2	20865	3	0	20880
1488	9	20281	0	9	0	20299
1489	12	65	2	20081	0	20160
1490	10	2	20774	1	0	20787
1491	6	53	4	21613	0	21676
1492	12	1	22092	1	0	22106
1493	8	69	3	21921	0	22001
1494	32	0	22079	2	0	22113
1495	5	71	0	21982	0	22058
1496	2	86	0	22247	0	22335
1497	0	23521	2	10	0	23533
1498	13	93	5	23384	0	23495
1499	0	24192	0	11	0	24203
1500	2	63	2	23878	0	23945
1501	4	20	3	24049	0	24076
1502	24160	2	34	2	0	24198
1503	3	86	1	23820	0	23910
1504	9	0	23563	0	0	23572
1505	2	50	2	23364	0	23418
1506	2	41	3	22539	0	22585
1507	9	1	22365	14	0	22389
1508	27	1	22054	7	0	22089
1509	6	73	1	22108	0	22188
1510	2	57	2	22122	0	22183
1511	19	2	22582	1	0	22604
1512	9	23299	1	46	0	23355
1513	3	23438	0	26	0	23467
1514	23604	1	41	13	0	23659
1515	4	47	3	24421	0	24475
1516	24300	2	22	6	0	24330
1517	24359	3	52	6	0	24420
1518	4	24589	0	9	0	24602
1519	24448	2	52	7	0	24509
1520	24100	6	51	0	0	24157
1521	27	0	24146	1	0	24174
1522	7	74	1	24179	0	24261
1523	26	0	24385	2	0	24413
1524	7	84	7	24117	0	24215
1525	41	2	24541	2	0	24586
1526	4	24548	3	20	0	24575
1527	1	24743	1	13	0	24758
1528	7	56	4	24654	0	24721
1529	25003	1	20	2	0	25026
1530	3	64	2	25149	0	25218
1531	3	36	2	23738	0	23779
1532	30	0	23565	4	0	23599
1533	38	1	23368	13	0	23420
1534	16	1	23565	12	0	23594
1535	7	94	3	23432	0	23536
1536	1	67	1	23164	0	23233
1537	4	23309	1	10	0	23324
1538	3	23067	0	9	0	23079
1539	23299	1	41	2	0	23343
1540	1	23257	0	17	0	23275
1541	21	1	23242	6	0	23270
1542	5	65	1	23466	0	23537
1543	12	3	22600	34	0	22649
1544	2	23170	0	19	0	23191
1545	3	45	5	23324	0	23377
1546	23109	2	64	6	0	23181
1547	26	0	23237	4	0	23267
1548	3	23758	0	33	0	23794
1549	61	1	23759	2	0	23823
1550	1	23850	1	16	0	23868
1551	2	41	0	23833	0	23876
1552	25634	4	43	1	0	25682
1553	25518	11	44	5	0	25578
1554	1	25413	0	20	0	25434
1555	25341	1	56	3	0	25401
1556	3	28	5	25038	0	25074
1557	24141	2	37	4	0	24184
1558	15	1	25310	4	0	25330
1559	12	0	25671	2	0	25685
1560	3	53	5	25710	0	25771
1561	2	33	2	24633	0	24670
1562	22	0	24725	0	0	24747
1563	1	28	1	24968	0	24998
1564	24976	1	22	0	0	24999
1565	24944	8	52	6	0	25010
1566	4	25400	0	16	0	25420
1567	2	24094	0	13	0	24109
1568	24434	2	35	3	0	24474
1569	3	27	2	24556	0	24588
1570	24335	0	39	7	0	24381
1571	2	24340	0	9	0	24351
1572	23551	2	45	2	0	23600
1573	38	0	22534	3	0	22575
1574	28	1	22988	2	0	23019
1575	1	59	4	21049	0	21113
1576	13	0	21127	3	0	21143
1577	2	54	0	21996	0	22052
1578	9	51	3	21890	0	21953
1579	13	0	22292	1	0	22306
1580	12	82	2	23007	0	23103
1581	4	42	3	22993	0	23042
1582	9	0	22705	6	0	22720
1583	7	0	22810	4	0	22821
1584	22442	8	68	13	0	22531
1585	9	1	22894	4	0	22908
1586	22606	5	65	8	0	22684
1587	22198	9	48	3	0	22258
1588	19	1	21711	1	0	21732
1589	21	1	22186	6	0	22214
1590	2	59	1	22130	0	22192
1591	7	36	3	21416	0	21462
1592	1	21442	4	15	0	21462
1593	7	21116	1	34	0	21158
1594	18	0	21250	1	0	21269
1595	22015	1	38	7	0	22061
1596	21652	5	65	4	0	21726
1597	8	1	21814	3	0	21826
1598	14	1	22484	6	0	22505
1599	4	69	0	22257	0	22330
1600	2	21750	0	8	0	21760
1601	2	57	3	21844	0	21906
1602	2	28	1	21908	0	21939
1603	22462	1	15	5	0	22483
1604	22634	1	42	7	0	22684
1605	2	51	2	22684	0	22739
1606	16	0	22346	1	0	22363
1607	21504	6	61	9	0	21580
1608	1	21310	0	31	0	21342
1609	21063	1	80	4	0	21148
1610	21267	3	58	4	0	21332
1611	3	21422	0	9	0	21434
1612	2	21143	0	4	0	21149
1613	2	78	1	21184	0	21265
1614	4	70	1	22242	0	22317
1615	2	22412	0	2	0	22416
1616	2	42	1	22576	0	22621
1617	4	48	2	22588	0	22642
1618	8	3	22367	1	0	22379
1619	22637	2	63	12	0	22714
1620	22444	1	64	10	0	22519
1621	22440	2	80	1	0	22523
1622	0	45	1	22327	0	22373
1623	21702	3	27	1	0	21733
1624	2	21459	0	8	0	21469
1625	2	74	1	21105	0	21182
1626	8	21302	0	5	0	21315
1627	3	19648	1	8	0	19660
1628	19662	2	42	6	0	19712
1629	19675	0	23	2	0	19700
1630	19097	1	63	5	0	19166
1631	19318	1	28	0	0	19347
1632	19108	4	103	1	0	19216
1633	5	2	19318	2	0	19327
1634	17676	1	48	10	0	17735
1635	6	0	17779	1	0	17786
1636	17638	5	53	3	0	17699
1637	17672	1	46	4	0	17723
1638	17564	4	64	2	0	17634
1639	8	1	17382	2	0	17393
1640	3	36	1	17293	0	17333
1641	2	16438	0	8	0	16448
1642	16335	2	41	2	0	16380
1643	16684	8	34	4	0	16730
1644	3	16607	0	26	0	16636
1645	16659	0	31	2	0	16692
1646	8	31	0	17774	0	17813
1647	3	17898	0	5	0	17906
1648	17574	5	43	3	0	17625
1649	17989	0	26	4	0	18019
1650	2	37	0	17907	0	17946
1651	18066	1	17	1	0	18085
1652	2	33	2	18122	0	18159
1653	6	27	1	16892	0	16926
1654	12	0	17153	3	0	17168
1655	6	31	0	16488	0	16525
1656	4	30	3	16157	0	16194
1657	19	0	16131	4	0	16154
1658	15	1	15749	12	0	15777
1659	5	25	2	15873	0	15905
1660	10	0	15826	3	0	15839
1661	16119	2	40	3	0	16164
1662	1	16794	0	4	0	16799
1663	2	41	0	16461	0	16504
1664	4	31	2	16434	0	16471
1665	3	13	1	16120	0	16137
1666	16278	1	4	4	0	16287
1667	16850	3	43	1	0	16897
1668	17069	4	40	1	0	17114
1669	1	17670	0	26	0	17697
1670	2	35	1	17062	0	17100
1671	5	8	3	16877	0	16893
1672	17163	2	21	8	0	17194
1673	16937	2	43	3	0	16985
1674	0	33	4	16679	0	16716
1675	15	0	16762	0	0	16777
1676	16591	3	32	3	0	16629
1677	16500	1	56	2	0	16559
1678	11	1	16558	4	0	16574
1679	15540	2	52	3	0	15597
1680	13	0	15539	0	0	15552
1681	16873	1	48	3	0	16925
1682	5	25	2	17301	0	17333
1683	3	17427	2	25	0	17457
1684	12	0	17483	1	0	17496
1685	5	17909	0	9	0	17923
1686	4	17809	0	12	0	17825
1687	17788	1	34	6	0	17829
1688	1	30	1	17757	0	17789
1689	1	20	2	17727	0	17750
1690	17323	1	12	1	0	17337
1691	3	16	0	17067	0	17086
1692	4	43	1	16966	0	17014
1693	2	23	0	16926	0	16951
1694	5	34	2	16390	0	16431
1695	21	0	16146	7	0	16174
1696	32	1	16129	11	0	16173
1697	3	16302	0	10	0	16315
1698	16473	1	29	2	0	16505
1699	3	42	1	16348	0	16394
1700	0	16372	0	4	0	16376
1701	3	69	0	16359	0	16431
1702	1	20	2	16993	0	17016
1703	3	41	3	16915	0	16962
1704	1	40	2	17627	0	17670
1705	11	29	1	17619	0	17660
1706	0	17451	1	5	0	17457
1707	1	24	0	17381	0	17406
1708	15	0	17461	1	0	17477
1709	4	17606	2	19	0	17631
1710	5	62	1	17885	0	17953
1711	15	33	1	17902	0	17951
1712	5	18253	0	14	0	18272
1713	1	18237	0	12	0	18250
1714	18464	2	55	9	0	18530
1715	4	18207	1	23	0	18235
1716	18179	4	66	6	0	18255
1717	17975	5	74	12	0	18066
1718	6	0	18210	4	0	18220
1719	3	29	2	17862	0	17896
1720	14	1	17290	3	0	17308
1721	3	16481	2	28	0	16514
1722	4	97	1	16310	0	16412
1723	2	33	3	16452	0	16490
1724	5	39	0	16489	0	16533
1725	3	21	1	16168	0	16193
1726	13	0	16297	4	0	16314
1727	3	36	4	16121	0	16164
1728	14	1	15878	1	0	15894
1729	7	0	16014	1	0	16022
1730	15425	2	45	4	0	15476
1731	15450	2	58	5	0	15515
1732	15458	3	48	3	0	15512
1733	0	15528	0	8	0	15536
1734	0	40	0	15235	0	15275
1735	12	1	15549	8	0	15570
1736	11	30	0	15445	0	15486
1737	8	0	15442	0	0	15450
1738	14654	6	43	15	0	14718
1739	14625	3	54	2	0	14684
1740	14655	2	66	4	0	14727
1741	3	0	15184	0	0	15187
1742	8	0	15129	1	0	15138
1743	2	32	6	14869	0	14909
1744	1	22	0	14729	0	14752
1745	7	21	1	14584	0	14613
1746	15	0	15071	2	0	15088
1747	12	0	15259	3	0	15274
1748	15126	0	23	2	0	15151
1749	3	43	4	15475	0	15525
1750	2	25	1	14879	0	14907
1751	14893	1	19	3	0	14916
1752	1	18	0	14932	0	14951
1753	14983	1	16	1	0	15001
1754	14895	1	32	12	0	14940
1755	13439	3	45	3	0	13490
1756	11	0	13493	5	0	13509
1757	3	13839	1	20	0	13863
1758	13418	0	30	3	0	13451
1759	0	34	0	13306	0	13340
1760	6	19	2	14145	0	14172
1761	0	13767	1	13	0	13781
1762	13927	5	30	1	0	13963
1763	13992	1	42	2	0	14037
1764	13995	7	38	3	0	14043
1765	3	13936	2	3	0	13944
1766	13627	1	29	4	0	13661
1767	13741	1	36	4	0	13782
1768	13675	0	32	5	0	13712
1769	2	20	3	14093	0	14118
1770	2	23	0	14104	0	14129
1771	5	1	14764	0	0	14770
1772	1	42	0	14948	0	14991
1773	1	30	0	14865	0	14896
1774	5	0	14704	7	0	14716
1775	14967	0	33	9	0	15009
1776	14854	2	37	1	0	14894
1777	5	36	2	16118	0	16161
1778	2	15797	0	10	0	15809
1779	1	16354	0	10	0	16365
1780	1	30	2	15636	0	15669
1781	10	0	15894	1	0	15905
1782	5	23	0	16230	0	16258
1783	15	0	16165	3	0	16183
1784	4	0	16133	5	0	16142
1785	1	24	0	15854	0	15879
1786	15672	0	29	1	0	15702
1787	15875	1	13	4	0	15893
1788	6	26	2	15742	0	15776
1789	0	18	1	16027	0	16046
1790	1	20	2	15920	0	15943
1791	0	20	2	16015	0	16037
1792	16253	0	8	7	0	16268
1793	16700	1	15	1	0	16717
1794	16575	5	53	1	0	16634
1795	14	0	16782	5	0	16801
1796	2	29	4	17416	0	17451
1797	1	15	4	17117	0	17137
1798	17380	1	33	5	0	17419
1799	7	17259	1	4	0	17271
1800	17328	1	30	2	0	17361
1801	17207	1	45	2	0	17255
1802	17106	1	50	3	0	17160
1803	17152	0	62	6	0	17220
1804	3	0	17028	1	0	17032
1805	3	0	17149	1	0	17153
1806	17352	2	58	4	0	17416
1807	17596	3	58	1	0	17658
1808	17694	5	66	4	0	17769
1809	17324	3	109	4	0	17440
1810	47	0	17551	3	0	17601
1811	7	17607	1	27	0	17642
1812	2	18	7	17712	0	17739
1813	17715	2	30	4	0	17751
1814	17824	3	47	5	0	17879
1815	17833	2	25	2	0	17862
1816	18006	2	34	2	0	18044
1817	17802	0	31	1	0	17834
1818	17290	1	64	2	0	17357
1819	31	1	17013	0	0	17045
1820	6	0	17280	3	0	17289
1821	2	36	3	16947	0	16988
1822	23	0	16496	1	0	16520
1823	14	16577	0	30	0	16621
1824	4	16204	0	21	0	16229
1825	11	34	1	16292	0	16338
1826	29	0	16308	0	0	16337
1827	28	1	17293	14	0	17336
1828	17341	2	25	8	0	17376
1829	17434	1	47	1	0	17483
1830	1	17	1	17444	0	17463
1831	17238	2	27	6	0	17273
1832	4	28	3	17188	0	17223
1833	4	21	2	16844	0	16871
1834	25	0	16860	3	0	16888
1835	10	0	16963	2	0	16975
1836	4	24	1	16051	0	16080
1837	9	0	15980	1	0	15990
1838	15851	0	39	13	0	15903
1839	15995	1	65	0	0	16061
1840	1	15940	0	17	0	15958
1841	15761	0	32	3	0	15796
1842	1	1	15909	4	0	15915
1843	15851	1	45	3	0	15900
1844	16884	0	53	4	0	16941
1845	16591	3	64	0	0	16658
1846	8	28	1	17043	0	17080
1847	3	16591	0	11	0	16605
1848	16376	3	33	8	0	16420
1849	17251	1	45	6	0	17303
1850	3	26	1	19260	0	19290
1851	19189	0	24	4	0	19217
1852	2	18846	1	12	0	18861
1853	7	34	6	17195	0	17242
1854	9	0	17302	7	0	17318
1855	16820	5	53	6	0	16884
1856	14	2	17180	2	0	17198
1857	4	23	1	17026	0	17054
1858	1	16735	0	9	0	16745
1859	2	17047	0	11	0	17060
1860	4	36	0	17527	0	17567
1861	0	18622	0	7	0	18629
1862	4	53	1	18724	0	18782
1863	7	33	3	18725	0	18768
1864	3	18	1	18698	0	18720
1865	18351	1	33	2	0	18387
1866	2	35	0	18309	0	18346
1867	12	2	18272	4	0	18290
1868	1	18272	1	24	0	18298
1869	17788	0	42	3	0	17833
1870	1	28	3	16711	0	16743
1871	2	17	1	16756	0	16776
1872	2	44	2	16733	0	16781
1873	8	0	16980	6	0	16994
1874	2	17299	1	20	0	17322
1875	17530	0	36	1	0	17567
1876	6	43	3	17838	0	17890
1877	2	17751	0	4	0	17757
1878	17494	5	43	8	0	17550
1879	6	0	17599	3	0	17608
1880	18310	4	67	6	0	18387
1881	11	0	18441	3	0	18455
1882	24	0	18467	3	0	18494
1883	1	18138	0	11	0	18150
1884	0	30	8	17965	0	18003
1885	22	0	18030	2	0	18054
1886	3	17793	0	18	0	17814
1887	9	32	2	17639	0	17682
1888	3	17823	1	13	0	17840
1889	56	0	18280	0	0	18336
1890	5	35	5	18292	0	18337
1891	24	0	18329	1	0	18354
1892	2	37	1	19025	0	19065
1893	2	42	3	18899	0	18946
1894	12	0	18794	4	0	18810
1895	1	20	0	19622	0	19643
1896	19532	3	42	3	0	19580
1897	0	20050	1	22	0	20073
1898	9	0	19539	2	0	19550
1899	19585	3	56	6	0	19650
1900	2	39	3	19874	0	19918
1901	6	19979	0	8	0	19993
1902	20715	1	26	2	0	20744
1903	19965	2	27	2	0	19996
1904	6	45	2	20040	0	20093
1905	5	39	3	19925	0	19972
1906	1	38	2	19989	0	20030
1907	9	36	1	20084	0	20130
1908	1	19798	1	12	0	19812
1909	7	42	5	19512	0	19566
1910	1	19659	2	7	0	19669
1911	4	19560	0	29	0	19593
1912	2	19834	0	9	0	19845
1913	17	0	19792	3	0	19812
1914	2	19812	1	17	0	19832
1915	19799	4	41	4	0	19848
1916	2	21194	0	9	0	21205
1917	7	43	2	21188	0	21240
1918	3	20919	2	9	0	20933
1919	6	29	3	20960	0	20998
1920	3	45	0	20961	0	21009
1921	13	0	20842	7	0	20862
1922	20890	1	81	7	0	20979
1923	21905	1	108	2	0	22016
1924	22364	9	77	7	0	22457
1925	5	21460	1	10	0	21476
1926	2	32	1	19265	0	19300
1927	22	2	19379	0	0	19403
1928	0	20151	0	12	0	20163
1929	4	38	1	19964	0	20007
1930	10	20251	0	8	0	20269
1931	20405	1	15	3	0	20424
1932	20111	2	21	2	0	20136
1933	20408	4	33	0	0	20445
1934	20492	0	38	4	0	20534
1935	5	39	1	20368	0	20413
1936	4	35	2	19744	0	19785
1937	3	19178	0	8	0	19189
1938	3	38	2	18952	0	18995
1939	26	1	18972	1	0	19000
1940	5	36	2	18875	0	18918
1941	13	0	18839	3	0	18855
1942	2	20204	1	43	0	20250
1943	26	0	20375	2	0	20403
1944	8	55	0	20610	0	20673
1945	8	0	21140	1	0	21149
1946	5	41	17	21230	0	21293
1947	5	45	3	21450	0	21503
1948	11	53	4	21642	0	21710
1949	2	26	0	21672	0	21700
1950	21366	1	41	3	0	21411
1951	1	21170	0	19	0	21190
1952	20733	0	76	8	0	20817
1953	7	0	20771	1	0	20779
1954	20375	2	75	9	0	20461
1955	20072	0	75	3	0	20150
1956	21	0	20049	0	0	20070
1957	27	0	19707	0	0	19734
1958	7	20142	0	31	0	20180
1959	7	20104	0	18	0	20129
1960	30	2	20303	3	0	20338
1961	1	20622	1	6	0	20630
1962	3	30	0	20827	0	20860
1963	21109	2	32	11	0	21154
1964	2	32	3	21343	0	21380
1965	20976	2	41	1	0	21020
1966	20972	2	64	6	0	21044
1967	4	21072	0	5	0	21081
1968	20714	2	34	3	0	20753
1969	20885	1	32	1	0	20919
1970	6	42	1	19992	0	20041
1971	20218	1	19	1	0	20239
1972	1	20418	2	5	0	20426
1973	1	25	0	19524	0	19550
1974	19399	2	34	2	0	19437
1975	8	1	19363	1	0	19373
1976	19010	2	43	6	0	19061
1977	1	35	1	19024	0	19061
1978	12	0	18275	1	0	18288
1979	19	0	18601	2	0	18622
1980	18591	0	41	6	0	18638
1981	18850	0	35	3	0	18888
1982	7	50	3	19073	0	19133
1983	2	63	1	18978	0	19044
1984	10	46	2	19214	0	19272
1985	3	19287	0	18	0	19308
1986	19322	2	58	10	0	19392
1987	4	19380	0	13	0	19397
1988	18950	3	50	5	0	19008
1989	18	0	19921	1	0	19940
1990	2	15	3	19966	0	19986
1991	20789	0	20	3	0	20812
1992	1	48	1	19465	0	19515
1993	14	48	3	19009	0	19074
1994	1	19649	0	17	0	19667
1995	19718	2	54	4	0	19778
1996	0	20668	0	17	0	20685
1997	5	34	1	21744	0	21784
1998	12	1	21538	1	0	21552
1999	20015	3	68	11	0	20097
2000	8	0	20134	0	0	20142
2001	20326	1	69	9	0	20405
2002	3	20277	2	27	0	20309
2003	7	42	12	19483	0	19544
2004	2	27691	1	10	0	27704
2005	27995	7	43	3	0	28048
2006	5	28	1	28887	0	28921
2007	9	39	1	28745	0	28794
2008	14	1	29577	14	0	29606
2009	44477	2	98	8	0	44585
2010	9	38	2	45303	0	45352
2011	26	4	52084	8	0	52122
2012	4	53571	1	18	0	53594
2013	2	39	4	53199	0	53244
2014	58356	3	54	11	0	58424
2015	12	31	4	58555	0	58602
2016	28	0	60451	7	0	60486
2017	60409	3	69	15	0	60496
2018	5	60	5	59420	0	59490
2019	34	0	64811	13	0	64858
2020	6	255	5	64510	0	64776
2021	39	285	12	63850	0	64186
2022	7	63936	0	43	0	63986
2023	63981	15	171	17	0	64184
2024	2	68042	0	55	0	68099
2025	67845	5	163	2	0	68015
2026	33	227	7	67691	0	67958
2027	6	68000	0	19	0	68025
2028	16	176	15	67658	0	67865
2029	48	0	70131	4	0	70183
2030	69307	21	154	28	0	69510
2031	7	180	7	70001	0	70195
2032	16	247	4	71474	0	71741
2033	20	185	11	70836	0	71052
2034	61	4	71624	50	0	71739
2035	71	4	72845	49	0	72969
2036	5	73269	4	86	0	73364
2037	7	160	5	73927	0	74099
2038	75330	7	105	23	0	75465
2039	5	76391	0	40	0	76436
2040	16	165	10	77098	0	77289
2041	76840	12	113	8	0	76973
2042	76881	15	173	23	0	77092
2043	3	78340	1	64	0	78408
2044	77257	11	152	13	0	77433
2045	81589	10	174	19	0	81792
2046	26	214	13	81366	0	81619
2047	5	82443	0	33	0	82481
2048	16	177	5	81447	0	81645
2049	84681	5	120	19	0	84825
2050	111	1	85795	12	0	85919
2051	17	272	4	86720	0	87013
2052	16	226	22	86369	0	86633
2053	45	19	89848	9	0	89921
2054	8	148	2	90120	0	90278
2055	93599	6	121	8	0	93734
2056	93800	6	189	6	0	94001
2057	14	158	9	94147	0	94328
2058	87	3	97133	24	0	97247
2059	98	7	97452	66	0	97623
2060	17	97452	6	123	0	97598
2061	10	100022	5	72	0	100109
2062	24	226	12	100579	0	100841
2063	115821	14	149	35	0	116019
2064	5	124073	1	122	0	124201
2065	124324	9	204	10	0	124547
2066	25	287	15	127719	0	128046
2067	13	93	3	127299	0	127408
2068	126885	6	186	15	0	127092
2069	2	126898	3	79	0	126982
2070	125746	22	302	69	0	126139
2071	112	2	127486	23	0	127623
2072	109	1	126483	41	0	126634
2073	21	286	15	124673	0	124995
2074	85	3	124056	30	0	124174
2075	237	5	126660	62	0	126964
2076	43	380	15	128685	0	129123
2077	251	2	129114	11	0	129378
2078	18	400	7	130230	0	130655
2079	22	423	13	129768	0	130226
2080	123	1	123751	16	0	123891
2081	18	437	11	124544	0	125010
2082	38	370	9	124697	0	125114
2083	6	124169	2	54	0	124231
2084	123536	21	239	40	0	123836
2085	103	0	110264	6	0	110373
2086	15	347	12	111460	0	111834
2087	53	304	22	104350	0	104729
2088	114	4	102501	39	0	102658
2089	103327	13	211	20	0	103571
2090	5	97637	1	50	0	97693
2091	26	325	15	97811	0	98177
2092	35	228	5	98783	0	99051
2093	7	97892	2	87	0	97988
2094	151	8	97583	23	0	97765
2095	10	93005	1	60	0	93076
2096	92672	11	177	22	0	92882
2097	60	1	93373	48	0	93482
2098	27	164	16	94827	0	95034
2099	120	0	97249	24	0	97393
2100	108	2	99970	50	0	100130
2101	9	100081	5	86	0	100181
2102	19	222	22	99480	0	99743
2103	101515	10	137	13	0	101675
2104	103556	21	206	22	0	103805
2105	3	103478	0	85	0	103566
2106	11	205	6	103339	0	103561
2107	103388	11	148	6	0	103553
2108	101917	12	267	27	0	102223
2109	7	104088	2	53	0	104150
2110	108767	8	222	27	0	109024
2111	28	363	12	109191	0	109594
2112	7	112016	3	84	0	112110
2113	30	370	19	110653	0	111072
2114	22	125	6	111164	0	111317
2115	50	266	13	110340	0	110669
2116	114	9	109061	30	0	109214
2117	115	27	108531	60	0	108733
2118	12	110025	3	247	0	110287
2119	110345	15	223	32	0	110615
2120	8	109540	2	45	0	109595
2121	13	247	6	108636	0	108902
2122	58	1	119811	5	0	119875
2123	19	383	40	118553	0	118995
2124	34	303	30	118377	0	118744
2125	21	223	8	116475	0	116727
2126	115814	6	188	25	0	116033
2127	20	310	3	115773	0	116106
2128	68	4	116007	10	0	116089
2129	112169	15	312	47	0	112543
2130	111659	22	364	24	0	112069
2131	107801	10	366	41	0	108218
2132	107143	29	226	21	0	107419
2133	109586	79	319	9	0	109993
2134	1	106197	1	36	0	106235
2135	22	319	28	105209	0	105578
2136	10	104031	2	35	0	104078
2137	103463	18	237	29	0	103747
2138	103773	12	196	18	0	103999
2139	90182	15	237	11	0	90445
2140	19	82591	0	27	0	82637
2141	15	80414	5	53	0	80487
2142	11	79651	3	83	0	79748
2143	100	9	81961	8	0	82078
2144	29	283	11	83519	0	83842
2145	17	82905	0	45	0	82967
2146	5	82313	2	44	0	82364
2147	11	241	7	82841	0	83100
2148	9	239	6	83247	0	83501
2149	86	1	83404	3	0	83494
2150	82781	12	146	26	0	82965
2151	10	140	11	82958	0	83119
2152	30	230	16	81268	0	81544
2153	82	2	81806	14	0	81904
2154	62	5	82010	39	0	82116
2155	6	81069	2	48	0	81125
2156	22	263	13	80867	0	81165
2157	17	286	13	81833	0	82149
2158	59	2	82097	9	0	82167
2159	81272	7	181	23	0	81483
2160	81437	11	289	11	0	81748
2161	80	0	81399	6	0	81485
2162	79463	5	204	44	0	79716
2163	68	2	80090	5	0	80165
2164	79181	7	210	30	0	79428
2165	79872	8	219	20	0	80119
2166	33	1	86297	2	0	86333
2167	14	216	26	85500	0	85756
2168	13	177	15	84915	0	85120
2169	8	84	3	85815	0	85910
2170	85350	11	116	14	0	85491
2171	85062	8	172	22	0	85264
2172	49	2	85307	2	0	85360
2173	38	1	84992	17	0	85048
2174	82745	7	174	20	0	82946
2175	72780	17	234	28	0	73059
2176	48	0	76081	12	0	76141
2177	89	2	82036	15	0	82142
2178	17	244	39	81515	0	81815
2179	58	2	81270	7	0	81337
2180	11	230	8	80014	0	80263
2181	78402	3	153	13	0	78571
2182	37	3	78875	10	0	78925
2183	78038	10	172	16	0	78236
2184	33	1	81212	5	0	81251
2185	10	265	18	76784	0	77077
2186	11	222	7	72469	0	72709
2187	19	309	4	76201	0	76533
2188	4	74339	1	21	0	74365
2189	39	191	18	73770	0	74018
2190	3	72	0	74479	0	74554
2191	73688	4	116	13	0	73821
2192	8	3	73647	4	0	73662
2193	70024	7	191	25	0	70247
2194	42	1	70460	9	0	70512
2195	70215	5	170	11	0	70401
2196	2	69426	7	26	0	69461
2197	91	2	68619	8	0	68720
2198	45	0	63683	17	0	63745
2199	20	183	7	63167	0	63377
2200	21	162	11	63191	0	63385
2201	93	2	63529	12	0	63636
2202	109	2	63190	16	0	63317
2203	50	2	63535	14	0	63601
2204	62085	10	149	51	0	62295
2205	62096	13	235	15	0	62359
2206	66277	13	143	29	0	66462
2207	4	106	6	66390	0	66506
2208	1	135	5	68983	0	69124
2209	25	0	68136	4	0	68165
2210	28	229	3	68822	0	69082
2211	18	36	0	68957	0	69011
2212	68958	1	78	12	0	69049
2213	69347	6	122	3	0	69478
2214	69876	7	123	6	0	70012
2215	14	89	53	70182	0	70338
2216	7	109	5	69218	0	69339
2217	4	102	5	70168	0	70279
2218	76436	7	79	7	0	76529
2219	13	259	5	76809	0	77086
2220	9	77366	2	33	0	77410
2221	26	350	12	76307	0	76695
2222	8	77947	1	34	0	77990
2223	78232	12	162	18	0	78424
2224	79839	17	229	16	0	80101
2225	22	80874	1	63	0	80960
2226	14	78675	5	39	0	78733
2227	14	200	4	77314	0	77532
2228	91	2	78887	6	0	78986
2229	13	201	8	81869	0	82091
2230	124	25	81164	26	0	81339
2231	13	87024	2	48	0	87087
2232	20	345	10	87053	0	87428
2233	35	312	6	86280	0	86633
2234	85	4	86126	2	0	86217
2235	15	231	16	85873	0	86135
2236	117	3	85757	10	0	85887
2237	84484	9	229	60	0	84782
2238	85012	14	217	13	0	85256
2239	84856	18	225	25	0	85124
2240	4	91	6	84914	0	85015
2241	3	115	5	83978	0	84101
2242	81	2	78745	14	0	78842
2243	11	180	4	78953	0	79148
2244	14	78539	2	60	0	78615
2245	136	4	78130	11	0	78281
2246	120	1	78467	30	0	78618
2247	24	215	7	78760	0	79006
2248	97	2	78098	10	0	78207
2249	74	3	78934	25	0	79036
2250	79787	7	166	28	0	79988
2251	10	77106	1	62	0	77179
2252	77054	9	145	11	0	77219
2253	73085	4	171	21	0	73281
2254	76684	11	134	26	0	76855
2255	7	121	7	76579	0	76714
2256	30	242	19	76539	0	76830
2257	56	3	76392	20	0	76471
2258	58	301	8	75569	0	75936
2259	18	73523	2	49	0	73592
2260	74081	9	133	16	0	74239
2261	19	73329	0	61	0	73409
2262	11	72218	3	67	0	72299
2263	27	199	12	70066	0	70304
2264	78	2	73668	4	0	73752
2265	14	254	12	73664	0	73944
2266	103	2	73471	13	0	73589
2267	15	73380	1	55	0	73451
2268	75048	6	157	15	0	75226
2269	75562	23	222	32	0	75839
2270	74756	10	237	9	0	75012
2271	19	0	76327	3	0	76349
2272	68	0	80768	11	0	80847
2273	83018	24	272	39	0	83353
2274	83532	14	283	15	0	83844
2275	87115	6	200	31	0	87352
2276	15	134	10	88994	0	89153
2277	11	113	5	90815	0	90944
2278	91323	2	78	9	0	91412
2279	91115	9	185	26	0	91335
2280	59	3	91241	10	0	91313
2281	113	3	91609	48	0	91773
2282	86187	15	213	30	0	86445
2283	65	2	86747	5	0	86819
2284	83057	13	233	43	0	83346
2285	92	1	87827	4	0	87924
2286	11	208	24	87101	0	87344
2287	90	0	91267	5	0	91362
2288	10	282	10	92881	0	93183
2289	38	307	15	92429	0	92789
2290	10	92397	4	74	0	92485
2291	91946	21	216	42	0	92225
2292	64	14	92899	6	0	92983
2293	92254	11	280	28	0	92573
2294	6	87914	1	59	0	87980
2295	85264	8	184	14	0	85470
2296	9	418	3	88196	0	88626
2297	23	358	8	90126	0	90515
2298	3	92122	3	46	0	92174
2299	22	427	7	91114	0	91570
2300	11	259	8	91279	0	91557
2301	7	133	5	92292	0	92437
2302	92107	3	89	19	0	92218
2303	91201	15	207	24	0	91447
2304	47	0	90482	5	0	90534
2305	10	87122	3	42	0	87177
2306	18	326	15	85816	0	86175
2307	7	153	8	83127	0	83295
2308	50	2	83843	9	0	83904
2309	11	97	6	84161	0	84275
2310	83486	7	86	7	0	83586
2311	83478	9	140	15	0	83642
2312	83663	2	150	19	0	83834
2313	12	43	5	84103	0	84163
2314	83873	4	76	6	0	83959
2315	83621	9	189	15	0	83834
2316	84593	5	104	15	0	84717
2317	12	80	6	84642	0	84740
2318	9	81	6	84144	0	84240
2319	15	103	3	84263	0	84384
2320	11	85	4	85504	0	85604
2321	18	196	7	85384	0	85605
2322	57	2	84492	37	0	84588
2323	85	2	84834	50	0	84971
2324	5	84230	3	46	0	84284
2325	17	276	16	83588	0	83897
2326	19	267	15	83965	0	84266
2327	16	254	13	84493	0	84776
2328	63	1	86430	27	0	86521
2329	30	277	18	85446	0	85771
2330	64	1	84532	8	0	84605
2331	30	230	14	85404	0	85678
2332	136	4	84727	14	0	84881
2333	14	91084	4	111	0	91213
2334	21	293	12	91021	0	91347
2335	120	1	93441	17	0	93579
2336	96030	3	203	29	0	96265
2337	11	101941	1	19	0	101972
2338	17	445	16	99382	0	99860
2339	5	98587	1	52	0	98645
2340	18	243	36	101419	0	101716
2341	105689	8	150	15	0	105862
2342	55	373	14	105837	0	106279
2343	5	108472	6	91	0	108574
2344	107430	8	173	8	0	107619
2345	5	250	15	110928	0	111198
2346	5	217	4	114964	0	115190
2347	113903	9	137	11	0	114060
2348	9	177	9	111073	0	111268
2349	23	252	17	107867	0	108159
2350	178	1	105118	47	0	105344
2351	155	2	102904	30	0	103091
2352	15	240	11	101782	0	102048
2353	101	5	98730	25	0	98861
2354	68	5	100145	34	0	100252
2355	98244	8	313	45	0	98610
2356	130	1	100651	7	0	100789
2357	7	102129	1	91	0	102228
2358	11	240	6	103231	0	103488
2359	103754	5	145	7	0	103911
2360	103199	12	246	19	0	103476
2361	103014	31	268	18	0	103331
2362	8	100560	1	23	0	100592
2363	16	276	11	99739	0	100042
2364	20	66	3	99783	0	99872
2365	99296	8	96	24	0	99424
2366	98421	11	205	20	0	98657
2367	98281	10	324	48	0	98663
2368	109	4	99436	7	0	99556
2369	27	99589	0	75	0	99691
2370	14	93571	1	46	0	93632
2371	11	241	13	93289	0	93554
2372	11	191	4	93502	0	93708
2373	74	1	93196	55	0	93326
2374	89787	8	156	28	0	89979
2375	90372	4	198	7	0	90581
2376	8	57	6	90948	0	91019
2377	10	138	9	89082	0	89239
2378	6	61	5	89864	0	89936
2379	89622	7	108	37	0	89774
2380	83	1	89893	5	0	89982
2381	102	2	93158	23	0	93285
2382	18	317	9	91292	0	91636
2383	37	30	91150	24	0	91241
2384	93111	4	260	41	0	93416
2385	93363	7	211	9	0	93590
2386	93672	33	278	15	0	93998
2387	5	95119	0	62	0	95186
2388	94881	6	139	4	0	95030
2389	8	291	16	94946	0	95261
2390	32	133	4	95185	0	95354
2391	21	234	8	96107	0	96370
2392	104	2	95747	10	0	95863
2393	37	388	10	96201	0	96636
2394	15	96376	3	54	0	96448
2395	96919	10	246	35	0	97210
2396	30	95956	0	67	0	96053
2397	167	4	95638	13	0	95822
2398	22	96096	1	65	0	96184
2399	96523	15	234	67	0	96839
2400	10	105277	1	59	0	105347
2401	38	377	9	105794	0	106218
2402	15	109111	5	52	0	109183
2403	109157	10	203	13	0	109383
2404	107393	12	288	18	0	107711
2405	106966	17	309	33	0	107325
2406	87	2	104936	15	0	105040
2407	119	2	105762	25	0	105908
2408	54	2	106402	23	0	106481
2409	99896	17	245	43	0	100201
2410	20	267	11	100632	0	100930
2411	32	298	11	95643	0	95984
2412	98	3	109089	8	0	109198
2413	17	197	6	104849	0	105069
2414	105039	3	161	8	0	105211
2415	6	102186	4	76	0	102272
2416	98363	8	274	47	0	98692
2417	78	56	95230	8	0	95372
2418	95528	16	240	39	0	95823
2419	94589	11	339	19	0	94958
2420	93704	14	331	12	0	94061
2421	109	0	91054	2	0	91165
2422	17	227	17	82500	0	82761
2423	101	1	84714	3	0	84819
2424	36	247	9	84042	0	84334
2425	131	3	85657	4	0	85795
2426	26	237	5	85599	0	85867
2427	23	111	2	85440	0	85576
2428	86954	7	120	41	0	87122
2429	86786	6	171	7	0	86970
2430	86197	10	219	13	0	86439
2431	15	170	7	84930	0	85122
2432	14	83999	3	65	0	84081
2433	12	83101	3	54	0	83170
2434	82471	11	186	28	0	82696
2435	30	2	83127	8	0	83167
2436	83191	12	186	20	0	83409
2437	41	3	82899	24	0	82967
2438	83825	10	233	21	0	84089
2439	82947	13	245	9	0	83214
2440	43	1	83582	9	0	83635
2441	86706	6	239	24	0	86975
2442	87529	7	255	20	0	87811
2443	87775	17	247	13	0	88052
2444	3	86421	3	95	0	86522
2445	30	201	10	86564	0	86805
2446	51	1	89857	37	0	89946
2447	157	12	89487	40	0	89696
2448	17	92164	4	95	0	92280
2449	18	95200	1	95	0	95314
2450	8	238	6	94959	0	95211
2451	99897	7	125	10	0	100039
2452	2	100349	1	72	0	100424
2453	29	293	22	98917	0	99261
2454	11	99949	3	62	0	100025
2455	97625	7	177	12	0	97821
2456	21	287	19	97165	0	97492
2457	144	5	97587	13	0	97749
2458	19	99837	9	62	0	99927
2459	13	100711	1	53	0	100778
2460	34	458	12	98620	0	99124
2461	5	100307	2	101	0	100415
2462	18	203	12	99871	0	100104
2463	100728	1	51	3	0	100783
2464	100310	7	178	18	0	100513
2465	99322	11	158	6	0	99497
2466	98603	12	434	21	0	99070
2467	56	2	98252	5	0	98315
2468	28	100380	7	228	0	100643
2469	39	99205	3	66	0	99313
2470	32	99057	3	91	0	99183
2471	31	99695	3	45	0	99774
2472	100270	27	98	14	0	100409
2473	100329	6	163	12	0	100510
2474	98596	4	148	10	0	98758
2475	98474	8	314	9	0	98805
2476	14	2	91802	4	0	91822
2477	89528	6	185	25	0	89744
2478	87423	12	167	11	0	87613
2479	89063	4	177	15	0	89259
2480	9	94	9	88524	0	88636
2481	4	140	2	88955	0	89101
2482	90778	1	58	4	0	90841
2483	20	217	5	88952	0	89194
2484	6	89147	2	44	0	89199
2485	10	281	5	88051	0	88347
2486	32	247	11	90660	0	90950
2487	4	80458	1	72	0	80535
2488	11	183	12	79277	0	79483
2489	2	46	8	80143	0	80199
2490	79894	7	126	7	0	80034
2491	110	0	79846	2	0	79958
2492	85856	7	273	26	0	86162
2493	99	2	86939	7	0	87047
2494	88	2	86652	13	0	86755
2495	85	5	88218	21	0	88329
2496	85892	7	279	37	0	86215
2497	43	4	86685	9	0	86741
2498	87623	7	305	55	0	87990
2499	86797	7	253	19	0	87076
2500	87058	20	330	22	0	87430
2501	7	92968	0	72	0	93047
2502	92174	11	226	25	0	92436
2503	5	95185	2	95	0	95287
2504	22	340	15	93146	0	93523
2505	41	304	7	96764	0	97116
2506	42	96887	6	48	0	96983
2507	37	99054	3	72	0	99166
2508	12	99591	5	104	0	99712
2509	100075	17	185	43	0	100320
2510	5	99757	2	46	0	99810
2511	98904	11	249	26	0	99190
2512	56	48	100231	2	0	100337
2513	98473	10	155	21	0	98659
2514	98781	15	308	15	0	99119
2515	186	0	103901	6	0	104093
2516	12	256	9	102059	0	102336
2517	166	3	101614	2	0	101785
2518	17	283	17	102583	0	102900
2519	27	152	8	103332	0	103519
2520	103124	9	193	36	0	103362
2521	101841	9	247	27	0	102124
2522	8	98599	3	54	0	98664
2523	93401	21	225	24	0	93671
2524	50	2	94380	8	0	94440
2525	90890	10	344	43	0	91287
2526	56	34	92012	5	0	92107
2527	54	4	90638	22	0	90718
2528	89625	13	169	22	0	89829
2529	89718	5	321	19	0	90063
2530	146	1	90421	35	0	90603
2531	16	230	8	91286	0	91540
2532	6	255	7	90121	0	90389
2533	49	2	91316	6	0	91373
2534	27	437	11	89642	0	90117
2535	7	87496	2	30	0	87535
2536	24	360	9	92541	0	92934
2537	16	297	13	92629	0	92955
2538	99	0	92144	30	0	92273
2539	93288	11	206	23	0	93528
2540	93303	22	286	11	0	93622
2541	93364	13	328	9	0	93714
2542	92148	62	220	22	0	92452
2543	6	94158	0	42	0	94206
2544	20	225	8	93716	0	93969
2545	130	1	94706	14	0	94851
2546	95	3	94915	6	0	95019
2547	13	226	16	94910	0	95165
2548	91	1	95401	7	0	95500
2549	99621	15	324	19	0	99979
2550	21	217	18	101843	0	102099
2551	18	284	18	101752	0	102072
2552	3	108	3	101048	0	101162
2553	101060	10	148	18	0	101236
2554	4	100126	3	44	0	100177
2555	99262	15	318	16	0	99611
2556	100616	13	304	23	0	100956
2557	38	115015	1	60	0	115114
2558	11	120524	1	99	0	120635
2559	120067	12	195	17	0	120291
2560	23	332	19	119462	0	119836
2561	4	158	8	119413	0	119583
2562	116799	7	185	17	0	117008
2563	78	0	115675	6	0	115759
2564	115490	6	317	15	0	115828
2565	115346	13	435	19	0	115813
2566	3	115639	3	95	0	115740
2567	107831	10	268	14	0	108123
2568	116542	17	340	18	0	116917
2569	18	115061	3	174	0	115256
2570	12	114887	2	95	0	114996
2571	12	189	8	115227	0	115436
2572	115823	9	190	37	0	116059
2573	9	116468	3	114	0	116594
2574	22	213	12	117848	0	118095
2575	117924	4	203	19	0	118150
2576	112	0	117875	6	0	117993
2577	25	270	23	110277	0	110595
2578	61	2	109763	22	0	109848
2579	106944	11	405	59	0	107419
2580	106606	14	392	18	0	107030
2581	61	2	103942	17	0	104022
2582	9	100872	0	89	0	100970
2583	15	260	21	100285	0	100581
2584	72	3	103773	2	0	103850
2585	18	250	9	104858	0	105135
2586	17	353	18	112397	0	112785
2587	75	3	113114	18	0	113210
2588	112189	8	300	32	0	112529
2589	111444	12	485	18	0	111959
2590	104	3	109417	10	0	109534
2591	14	105521	1	61	0	105597
2592	38	379	10	103996	0	104423
2593	19	108050	2	50	0	108121
2594	8	107561	1	68	0	107638
2595	108257	15	186	16	0	108474
2596	7	255	12	108737	0	109011
2597	38	192	11	108688	0	108929
2598	109	1	109477	23	0	109610
2599	142	5	109720	18	0	109885
2600	14	202	18	112517	0	112751
2601	53	282	17	113117	0	113469
2602	146	1	110584	22	0	110753
2603	134	7	115872	35	0	116048
2604	14	202	3	117150	0	117369
2605	118954	2	193	17	0	119166
2606	53	119235	3	89	0	119380
2607	123955	26	374	26	0	124381
2608	34	123913	3	92	0	124042
2609	7	123478	2	75	0	123562
2610	125080	20	227	35	0	125362
2611	91	0	125605	15	0	125711
2612	31	355	30	123687	0	124103
2613	29	335	16	123532	0	123912
2614	17	382	12	123734	0	124145
2615	98	6	131109	7	0	131220
2616	11	171	11	131850	0	132043
2617	131524	6	156	13	0	131699
2618	23	233	15	131287	0	131558
2619	17	88	6	132224	0	132335
2620	130215	11	219	19	0	130464
2621	129534	9	332	18	0	129893
2622	8	130131	2	161	0	130302
2623	155	8	129441	23	0	129627
2624	186	3	136183	41	0	136413
2625	143	9	137386	42	0	137580
2626	23	137983	1	136	0	138143
2627	27	375	19	138510	0	138931
2628	26	228	8	139274	0	139536
2629	140432	6	144	13	0	140595
2630	48	363	29	140699	0	141139
2631	161	1	140999	8	0	141169
2632	48	432	15	141093	0	141588
2633	13	221	13	124211	0	124458
2634	145	2	116371	51	0	116569
2635	18	116515	7	90	0	116630
2636	47	464	16	114133	0	114660
2637	13	116579	4	95	0	116691
2638	153	5	116585	7	0	116750
2639	116940	7	223	23	0	117193
2640	121651	4	208	19	0	121882
2641	122611	14	355	15	0	122995
2642	16	311	9	122203	0	122539
2643	22	114514	2	52	0	114590
2644	114317	9	405	15	0	114746
2645	113877	12	307	16	0	114212
2646	111698	18	445	41	0	112202
2647	28	3	111744	14	0	111789
2648	111628	17	385	35	0	112065
2649	14	110074	1	69	0	110158
2650	109168	14	343	31	0	109556
2651	16	109313	8	77	0	109414
2652	108710	12	365	51	0	109138
2653	81	1	118920	8	0	119010
2654	120584	19	211	47	0	120861
2655	121914	14	513	19	0	122460
2656	123077	7	258	20	0	123362
2657	121676	17	682	22	0	122397
2658	105	18	124527	7	0	124657
2659	7	177	6	124854	0	125044
2660	121653	11	160	19	0	121843
2661	2	121656	8	91	0	121757
2662	39	279	14	112564	0	112896
2663	76	3	113205	23	0	113307
2664	29	262	7	113869	0	114167
2665	225	5	112786	48	0	113064
2666	26	116075	8	150	0	116259
2667	51	114953	4	151	0	115159
2668	9	114760	3	51	0	114823
2669	39	338	17	114277	0	114671
2670	29	392	8	114505	0	114934
2671	142	10	114105	34	0	114291
2672	31	114190	1	147	0	114369
2673	117516	13	275	27	0	117831
2674	26	121234	5	128	0	121393
2675	14	117568	1	72	0	117655
2676	19	209	22	119729	0	119979
2677	121870	4	107	9	0	121990
2678	124110	17	272	22	0	124421
2679	88	120	8	118891	0	119107
2680	118716	8	172	24	0	118920
2681	15	237	12	118928	0	119192
2682	64	0	117943	26	0	118033
2683	114179	14	330	28	0	114551
2684	22	187	13	115759	0	115981
2685	112	1	114231	13	0	114357
2686	92	4	116749	26	0	116871
2687	23	213	9	120347	0	120592
2688	120229	2	231	12	0	120474
2689	120472	16	331	43	0	120862
2690	11	114682	3	43	0	114739
2691	116226	19	238	10	0	116493
2692	118670	7	226	13	0	118916
2693	119009	61	408	61	0	119539
2694	12	122145	0	63	0	122220
2695	118011	30	284	24	0	118349
2696	118563	16	381	11	0	118971
2697	9	147	6	119119	0	119281
2698	119569	6	203	21	0	119799
2699	31	109673	10	81	0	109795
2700	8	120844	3	89	0	120944
2701	19	374	13	119127	0	119533
2702	71	345	13	124952	0	125381
2703	16	124874	3	76	0	124969
2704	125015	9	370	20	0	125414
2705	8	125125	1	142	0	125276
2706	124610	11	350	17	0	124988
2707	7	133066	2	65	0	133140
2708	49	498	23	128731	0	129301
2709	17	134306	3	86	0	134412
2710	134395	21	285	18	0	134719
2711	134876	16	347	24	0	135263
2712	134420	24	510	26	0	134980
2713	54	4	135764	17	0	135839
2714	73	3	136009	40	0	136125
2715	11	136886	11	142	0	137050
2716	122	5	132552	21	0	132700
2717	116	4	132706	18	0	132844
2718	31	392	17	132033	0	132473
2719	317	5	132020	20	0	132362
2720	54	131834	4	144	0	132036
2721	133448	15	519	28	0	134010
2722	51	136803	3	148	0	137005
2723	45	136298	7	109	0	136459
2724	137480	20	307	40	0	137847
2725	137884	15	352	23	0	138274
2726	22	136023	0	98	0	136143
2727	134979	14	268	7	0	135268
2728	134660	17	260	13	0	134950
2729	123965	18	395	14	0	124392
2730	42	0	126191	10	0	126243
2731	183	11	124573	8	0	124775
2732	20	299	24	123485	0	123828
2733	3	111	6	124842	0	124962
2734	123515	4	197	10	0	123726
2735	5	124267	1	38	0	124311
2736	30	488	25	123192	0	123735
2737	23	226	25	122984	0	123258
2738	22	234	20	123019	0	123295
2739	36	151	25	121484	0	121696
2740	91	3	122741	72	0	122907
2741	132	3	124299	20	0	124454
2742	21	286	19	124814	0	125140
2743	93	2	124657	17	0	124769
2744	123387	16	464	43	0	123910
2745	28	314	13	124180	0	124535
2746	92	2	124091	10	0	124195
2747	126962	22	502	49	0	127535
2748	11	126303	5	91	0	126410
2749	124436	14	382	26	0	124858
2750	11	114691	9	119	0	114830
2751	42	266	9	115441	0	115758
2752	45	2	123482	3	0	123532
2753	47	320	28	125804	0	126199
2754	262	5	126735	5	0	127007
2755	127204	17	518	56	0	127795
2756	16	169	16	127742	0	127943
2757	124838	23	299	61	0	125221
2758	134	2	125018	10	0	125164
2759	124002	12	428	37	0	124479
2760	121176	18	493	19	0	121706
2761	85	0	121019	4	0	121108
2762	19	228	7	112523	0	112777
2763	122	2	112454	7	0	112585
2764	44	111628	5	118	0	111795
2765	113380	10	375	26	0	113791
2766	112994	21	481	44	0	113540
2767	87	1	117440	7	0	117535
2768	59	0	124117	21	0	124197
2769	31	328	23	123503	0	123885
2770	5	208	7	120931	0	121151
2771	139718	23	265	34	0	140040
2772	29	141964	4	104	0	142101
2773	145875	8	342	20	0	146245
2774	145477	12	494	39	0	146022
2775	105	1	144270	6	0	144382
2776	129677	9	568	39	0	130293
2777	41	1	132542	3	0	132587
2778	26	338	11	127305	0	127680
2779	91	0	128196	0	0	128287
2780	36	288	22	128531	0	128877
2781	122	5	129770	5	0	129902
2782	130641	18	479	56	0	131194
2783	123000	3	303	16	0	123322
2784	15	171	14	122537	0	122737
2785	119227	6	154	14	0	119401
2786	53	310	14	118038	0	118415
2787	14	118539	3	64	0	118620
2788	117351	11	363	32	0	117757
2789	8	122662	3	40	0	122713
2790	17	644	12	119607	0	120280
2791	11	211	17	125355	0	125594
2792	24	284	15	125826	0	126149
2793	16	254	12	125155	0	125437
2794	84	3	124955	13	0	125055
2795	123939	6	331	39	0	124315
2796	125388	8	419	10	0	125825
2797	12	126987	2	84	0	127085
2798	26	299	10	123701	0	124036
2799	39	238	26	125678	0	125981
2800	133	2	126703	9	0	126847
2801	126752	14	445	27	0	127238
2802	17	245	10	127322	0	127594
2803	251	2	127093	50	0	127396
2804	126470	15	463	49	0	126997
2805	126891	26	529	18	0	127464
2806	125684	19	531	21	0	126255
2807	48	5	126717	99	0	126869
2808	33	1	128567	17	0	128618
2809	126770	4	387	21	0	127182
2810	9	221	10	129732	0	129972
2811	45	223	10	128542	0	128820
2812	71	1	130094	13	0	130179
2813	132998	14	493	31	0	133536
2814	35	138	7	133956	0	134136
2815	134550	6	322	23	0	134901
2816	132639	20	299	50	0	133008
2817	128446	8	572	18	0	129044
2818	45	2	131269	3	0	131319
2819	11	217	6	131626	0	131860
2820	132992	5	233	14	0	133244
2821	10	132672	2	54	0	132738
2822	30	284	15	129619	0	129948
2823	18	134	11	130171	0	130334
2824	132091	1	159	15	0	132266
2825	131802	10	295	10	0	132117
2826	17	212	20	129110	0	129359
2827	59	2	128369	8	0	128438
2828	117787	9	509	50	0	118355
2829	53	4	118379	9	0	118445
2830	116415	10	483	48	0	116956
2831	116171	16	464	16	0	116667
2832	70	3	117952	5	0	118030
2833	14	193	15	115762	0	115984
2834	162	4	115452	15	0	115633
2835	11	117120	3	100	0	117234
2836	46	233	13	115291	0	115583
2837	15	118060	3	80	0	118158
2838	25	181	8	117853	0	118067
2839	99	3	129311	25	0	129438
2840	39	129379	7	257	0	129682
2841	18	123207	9	182	0	123416
2842	41	209	15	121991	0	122256
2843	123650	9	213	26	0	123898
2844	21	191	10	117694	0	117916
2845	117087	7	206	19	0	117319
2846	8	117696	1	45	0	117750
2847	98653	10	245	15	0	98923
2848	45	3	95945	11	0	96004
2849	14	210	26	93489	0	93739
2850	14	250	9	91551	0	91824
2851	104	1	90157	31	0	90293
2852	88922	9	398	33	0	89362
2853	94608	5	339	6	0	94958
2854	3	95305	1	63	0	95372
2855	29	115	7	93378	0	93529
2856	17	94654	4	75	0	94750
2857	192	2	93348	11	0	93553
2858	137	2	101109	13	0	101261
2859	14	133	7	104630	0	104784
2860	104043	6	215	24	0	104288
2861	3	103636	1	64	0	103704
2862	102641	14	300	30	0	102985
2863	116	1	106454	3	0	106574
2864	113707	8	301	40	0	114056
2865	109404	8	467	11	0	109890
2866	40	4	112127	19	0	112190
2867	14	100	9	109518	0	109641
2868	110024	4	142	10	0	110180
2869	109697	21	372	19	0	110109
2870	109693	18	254	7	0	109972
2871	12	176	6	112071	0	112265
2872	99	3	112739	4	0	112845
2873	107674	14	398	29	0	108115
2874	134	0	108959	6	0	109099
2875	19	206	1	107829	0	108055
2876	46	219	12	107732	0	108009
2877	15	109521	3	106	0	109645
2878	157	13	109866	6	0	110042
2879	119	110455	3	97	0	110674
2880	28	108345	4	71	0	108448
2881	25	249	10	107913	0	108197
2882	81	0	110923	3	0	111007
2883	26	243	20	112768	0	113057
2884	93	5	114589	6	0	114693
2885	25	273	15	121483	0	121796
2886	32	239	15	117524	0	117810
2887	78	2	117075	50	0	117205
2888	104	221	20	115971	0	116316
2889	146	4	112801	36	0	112987
2890	215	11	114564	44	0	114834
2891	9	113578	2	191	0	113780
2892	111435	18	391	42	0	111886
2893	113	4	111222	10	0	111349
2894	113260	13	291	38	0	113602
2895	11	210	16	113321	0	113558
2896	92	4	111970	11	0	112077
2897	10	116266	2	89	0	116367
2898	77	273	12	115429	0	115791
2899	141	4	116754	7	0	116906
2900	53	330	14	118810	0	119207
2901	21	120850	7	74	0	120952
2902	123646	3	349	20	0	124018
2903	20	133	9	122831	0	122993
2904	131576	3	145	26	0	131750
2905	130193	12	127	30	0	130362
2906	129806	11	173	7	0	129997
2907	134344	22	271	11	0	134648
2908	132665	36	191	8	0	132900
2909	3	135059	1	31	0	135094
2910	17	445	30	131103	0	131595
2911	38	282	7	132053	0	132380
2912	17	247	11	137662	0	137937
2913	138	1	135238	22	0	135399
2914	12	124493	5	141	0	124651
2915	124931	7	373	19	0	125330
2916	125184	11	355	31	0	125581
2917	46	128465	6	84	0	128601
2918	14	127384	3	114	0	127515
2919	127025	24	306	21	0	127376
2920	156	5	131320	7	0	131488
2921	20	140	6	132579	0	132745
2922	131705	6	237	21	0	131969
2923	40	266	11	130631	0	130948
2924	15	130918	1	102	0	131036
2925	22	247	16	130051	0	130336
2926	40	7	132104	5	0	132156
2927	138257	12	391	56	0	138716
2928	138909	7	256	14	0	139186
2929	36	218	19	132676	0	132949
2930	5	119	4	132472	0	132600
2931	137886	10	216	14	0	138126
2932	11	130419	1	37	0	130468
2933	43	272	22	130056	0	130393
2934	14	190	5	130640	0	130849
2935	128835	10	205	13	0	129063
2936	33	130380	1	113	0	130527
2937	130535	18	449	28	0	131030
2938	29	128994	5	107	0	129135
2939	8	126701	3	110	0	126822
2940	121923	15	239	34	0	122211
2941	8	118522	0	95	0	118625
2942	55	179	18	115561	0	115813
2943	90	5	115945	13	0	116053
2944	138	4	114793	24	0	114959
2945	153	12	115785	9	0	115959
2946	22	117719	0	90	0	117831
2947	116125	3	249	31	0	116408
2948	6	216	13	115008	0	115243
2949	10	177	7	115010	0	115204
2950	30	2	117301	7	0	117340
2951	122480	12	278	24	0	122794
2952	15	270	17	132227	0	132529
2953	28	266	27	130052	0	130373
2954	9	135	7	131366	0	131517
2955	130633	9	207	19	0	130868
2956	42	0	131550	4	0	131596
2957	136675	14	396	25	0	137110
2958	22	207	20	134125	0	134374
2959	92	4	132827	5	0	132928
2960	123126	8	414	46	0	123594
2961	61	2	125683	1	0	125747
2962	32	189	31	127136	0	127388
2963	187	0	125461	11	0	125659
2964	93	3	129049	25	0	129170
2965	129401	10	465	34	0	129910
2966	109	2	131923	3	0	132037
2967	22	174	3	133487	0	133686
2968	132406	5	218	19	0	132648
2969	35	240	19	132172	0	132466
2970	111	0	129081	10	0	129202
2971	168	9	130492	25	0	130694
2972	21	131266	4	207	0	131498
2973	16	207	5	123685	0	123913
2974	129703	12	290	24	0	130029
2975	10	126819	1	74	0	126904
2976	127429	10	317	15	0	127771
2977	20	171	12	125907	0	126110
2978	124240	9	159	17	0	124425
2979	16	126477	0	55	0	126548
2980	13	184	9	117434	0	117640
2981	117521	14	179	27	0	117741
2982	9	116958	1	60	0	117028
2983	37	197	11	112301	0	112546
2984	19	124	5	117984	0	118132
2985	115445	3	70	5	0	115523
2986	25	216	13	115511	0	115765
2987	11	169	10	115571	0	115761
2988	24	236	13	110799	0	111072
2989	45	6	111018	11	0	111080
2990	111315	12	252	22	0	111601
2991	17	222	10	112336	0	112585
2992	85	3	112049	7	0	112144
2993	106604	24	431	45	0	107104
2994	44	1	108632	14	0	108691
2995	27	189	10	108504	0	108730
2996	11	106003	3	65	0	106082
2997	43	175	11	105912	0	106141
2998	72	3	105903	4	0	105982
2999	95	2	106520	21	0	106638
3000	39	228	11	105677	0	105955
3001	113	4	105733	6	0	105856
3002	96217	19	370	60	0	96666
3003	48	2	97416	3	0	97469
3004	11	188	29	97190	0	97418
3005	11	160	20	96755	0	96946
3006	17	80	6	96746	0	96849
3007	92935	4	77	15	0	93031
3008	91320	9	175	14	0	91518
3009	93164	6	151	6	0	93327
3010	9	152	8	92474	0	92643
3011	13	132	4	92123	0	92272
3012	63	1	89527	11	0	89602
3013	109	0	90097	11	0	90217
3014	11	88110	3	76	0	88200
3015	28	285	13	88646	0	88972
3016	69	247	14	89829	0	90159
3017	23	92315	3	39	0	92380
3018	92876	20	281	22	0	93199
3019	4	94479	1	34	0	94518
3020	94159	15	267	26	0	94467
3021	12	228	6	92967	0	93213
3022	92686	5	188	22	0	92901
3023	24	203	12	93461	0	93700
3024	37	1	95656	4	0	95698
3025	16	148	7	98302	0	98473
3026	93237	11	102	6	0	93356
3027	13	187	9	90053	0	90262
3028	22	178	6	79458	0	79664
3029	54	3	79687	5	0	79749
3030	15	243	8	86652	0	86918
3031	33	220	10	94879	0	95142
3032	13	94744	3	56	0	94816
3033	31	367	12	104925	0	105335
3034	17	277	8	106049	0	106351
3035	21	302	17	111756	0	112096
3036	17	113043	5	100	0	113165
3037	26	153	14	113273	0	113466
3038	112947	6	166	15	0	113134
3039	43	112345	5	149	0	112542
3040	46	109066	6	119	0	109237
3041	12	109687	0	55	0	109754
3042	40	249	25	106225	0	106539
3043	48	108990	3	70	0	109111
3044	13	108816	1	70	0	108900
3045	108186	18	267	40	0	108511
3046	68	2	108508	2	0	108580
3047	106607	8	340	21	0	106976
3048	12	207	19	105773	0	106011
3049	78	2	106442	9	0	106531
3050	99301	28	366	50	0	99745
3051	102	3	100359	10	0	100474
3052	73	2	99301	6	0	99382
3053	99734	11	252	23	0	100020
3054	22	179	21	99782	0	100004
3055	68	3	97402	32	0	97505
3056	97538	8	306	44	0	97896
3057	97302	15	455	29	0	97801
3058	73	4	98101	5	0	98183
3059	97499	7	300	25	0	97831
3060	91626	9	335	18	0	91988
3061	26	1	91726	2	0	91755
3062	90624	15	274	21	0	90934
3063	90627	7	343	44	0	91021
3064	65	1	90075	7	0	90148
3065	76	1	90056	6	0	90139
3066	14	241	18	88277	0	88550
3067	61	2	87602	0	0	87665
3068	86802	7	264	24	0	87097
3069	9	204	14	86291	0	86518
3070	15	204	16	85302	0	85537
3071	45	2	85748	3	0	85798
3072	19	201	18	84793	0	85031
3073	88	2	84647	5	0	84742
3074	84375	10	289	52	0	84726
3075	84340	10	300	24	0	84674
3076	32	3	84872	3	0	84910
3077	84285	7	188	20	0	84500
3078	83788	7	312	23	0	84130
3079	56	1	83706	1	0	83764
3080	82824	7	176	18	0	83025
3081	82279	13	331	14	0	82637
3082	54	0	82832	4	0	82890
3083	81161	9	299	27	0	81496
3084	35	2	82209	1	0	82247
3085	16	156	15	79906	0	80093
3086	10	97	10	79330	0	79447
3087	15	119	10	79276	0	79420
3088	34	2	78610	4	0	78650
3089	76445	18	342	22	0	76827
3090	64	4	78391	3	0	78462
3091	40	77085	3	85	0	77213
3092	11	75551	2	43	0	75607
3093	74268	11	156	19	0	74454
3094	23	123	6	73883	0	74035
3095	15	72165	2	92	0	72274
3096	72464	10	194	21	0	72689
3097	72738	2	178	3	0	72921
3098	2	71711	1	7	0	71721
3099	19	60	4	69368	0	69451
3100	33	71258	2	7	0	71300
3101	68337	12	40	5	0	68394
3102	69279	3	43	4	0	69329
3103	15	36	2	69072	0	69125
3104	68278	9	17	11	0	68315
3105	13	35	3	66972	0	67023
3106	25	12	59834	7	0	59878
3107	49355	8	60	12	0	49435
3108	15	1	51203	3	0	51222
3109	5	34	3	34606	0	34648
3110	32869	0	20	1	0	32890
3111	7	61	5	26112	0	26185
3112	27	1	24393	6	0	24427
3113	19	1	26469	1	0	26490
3114	3	29	0	25847	0	25879
3115	22823	0	25	5	0	22853
3116	0	21381	1	10	0	21392
3117	3	58	1	20650	0	20712
3118	18	0	21150	0	0	21168
3119	21156	3	28	11	0	21198
3120	21126	5	69	9	0	21209
3121	12	0	21370	1	0	21383
3122	20079	5	36	4	0	20124
3123	2	50	0	20862	0	20914
3124	17	0	20937	0	0	20954
3125	20745	2	37	6	0	20790
3126	7	28	3	21232	0	21270
3127	2	41	0	20799	0	20842
3128	21033	3	27	4	0	21067
3129	0	20879	0	8	0	20887
3130	0	20646	0	5	0	20651
3131	20558	3	33	17	0	20611
3132	21040	3	25	4	0	21072
3133	11	0	21275	1	0	21287
3134	14	0	21374	2	0	21390
3135	0	40	1	21489	0	21530
3136	21360	2	20	0	0	21382
3137	21189	1	46	1	0	21237
3138	22236	15	48	1	0	22300
3139	4	22589	0	12	0	22605
3140	4	22729	0	10	0	22743
3141	1	75	5	22166	0	22247
3142	2	38	2	22426	0	22468
3143	7	42	3	22425	0	22477
3144	6	0	22383	2	0	22391
3145	20	0	22350	2	0	22372
3146	22004	8	44	9	0	22065
3147	22212	1	39	3	0	22255
3148	1	47	2	21749	0	21799
3149	3	32	3	21946	0	21984
3150	5	33	1	21968	0	22007
3151	48	0	21981	1	0	22030
3152	12	0	21713	5	0	21730
3153	13	61	1	21908	0	21983
3154	31	1	21641	5	0	21678
3155	7	21674	1	12	0	21694
3156	0	21883	0	20	0	21903
3157	22237	3	39	8	0	22287
3158	0	22259	0	8	0	22267
3159	3	81	6	22168	0	22258
3160	7	46	2	22322	0	22377
3161	2	22483	0	10	0	22495
3162	6	69	3	22490	0	22568
3163	27	0	22447	4	0	22478
3164	2	22606	0	44	0	22652
3165	12	55	7	22623	0	22697
3166	32	1	22702	1	0	22736
3167	1	22501	3	23	0	22528
3168	10	59	2	22653	0	22724
3169	1	23092	1	11	0	23105
3170	9	92	1	23124	0	23226
3171	2	50	2	23125	0	23179
3172	0	22355	0	9	0	22364
3173	22361	0	35	1	0	22397
3174	22338	5	41	2	0	22386
3175	1	20996	0	21	0	21018
3176	2	20150	1	28	0	20181
3177	6	73	6	20156	0	20241
3178	34	0	20673	1	0	20708
3179	20572	1	43	4	0	20620
3180	20630	1	30	3	0	20664
3181	24	0	20667	1	0	20692
3182	19739	0	39	1	0	19779
3183	19142	1	69	2	0	19214
3184	31	0	17800	2	0	17833
3185	17561	6	57	9	0	17633
3186	19	0	17853	0	0	17872
3187	6	18302	0	16	0	18324
3188	18472	0	36	2	0	18510
3189	16250	3	39	9	0	16301
3190	14	2	16657	1	0	16674
3191	17528	1	32	5	0	17566
3192	17491	0	44	4	0	17539
3193	8	1	17680	0	0	17689
3194	17293	2	36	4	0	17335
3195	17227	3	39	9	0	17278
3196	5	0	17397	0	0	17402
3197	18099	5	31	4	0	18139
3198	1	32	5	18131	0	18169
3199	2	14	4	17598	0	17618
3200	20	3	18201	6	0	18230
3201	12	0	18603	2	0	18617
3202	2	54	2	18390	0	18448
3203	2	30	1	18255	0	18288
3204	17917	3	27	4	0	17951
3205	22	1	18737	1	0	18761
3206	18845	3	38	4	0	18890
3207	5	37	3	18932	0	18977
3208	13	0	18500	1	0	18514
3209	17954	3	39	8	0	18004
3210	5	44	5	17913	0	17967
3211	6	0	18072	1	0	18079
3212	18314	0	46	11	0	18371
3213	7	34	2	18570	0	18613
3214	17579	2	21	2	0	17604
3215	10	1	17375	1	0	17387
3216	5	51	5	17172	0	17233
3217	9	17279	3	7	0	17298
3218	17514	3	27	3	0	17547
3219	17924	0	36	10	0	17970
3220	2	17901	0	7	0	17910
3221	17723	0	45	4	0	17772
3222	17766	1	36	0	0	17803
3223	17660	5	41	3	0	17709
3224	1	18181	0	6	0	18188
3225	2	35	4	17832	0	17873
3226	14	0	17942	3	0	17959
3227	1	44	3	17992	0	18040
3228	5	40	3	18842	0	18890
3229	27	0	18777	7	0	18811
3230	23	0	19070	1	0	19094
3231	9	83	3	19093	0	19188
3232	14	18780	1	7	0	18802
3233	18910	0	28	6	0	18944
3234	18622	3	32	4	0	18661
3235	1	18887	0	9	0	18897
3236	18871	2	45	1	0	18919
3237	18852	4	41	1	0	18898
3238	9	0	18765	5	0	18779
3239	18601	0	48	4	0	18653
3240	0	18715	2	13	0	18730
3241	28	0	18439	0	0	18467
3242	17	1	19250	4	0	19272
3243	6	19583	1	15	0	19605
3244	19532	1	45	5	0	19583
3245	41	0	19397	2	0	19440
3246	3	29	2	19457	0	19491
3247	17	1	19592	3	0	19613
3248	19686	1	47	11	0	19745
3249	214	0	19528	1	0	19743
3250	22	1	19227	2	0	19252
3251	19307	0	27	3	0	19337
3252	4	19806	1	14	0	19825
3253	19559	0	33	4	0	19596
3254	19467	1	42	1	0	19511
3255	5	53	2	20430	0	20490
3256	0	20486	1	8	0	20495
3257	20349	1	44	4	0	20398
3258	14	1	20848	2	0	20865
3259	20885	3	55	7	0	20950
3260	1	22106	1	15	0	22123
3261	21306	2	38	4	0	21350
3262	23232	0	41	5	0	23278
3263	1	23872	0	11	0	23884
3264	4	48	3	24457	0	24512
3265	24505	1	35	2	0	24543
3266	0	24115	0	10	0	24125
3267	6	31	6	23287	0	23330
3268	23618	3	29	6	0	23656
3269	5	81	0	23429	0	23515
3270	6	51	0	23526	0	23583
3271	2	23358	0	4	0	23364
3272	23005	2	31	4	0	23042
3273	23081	4	35	2	0	23122
3274	23035	3	56	1	0	23095
3275	2	22674	0	6	0	22682
3276	22442	0	29	2	0	22473
3277	22888	6	35	1	0	22930
3278	2	37	0	24049	0	24088
3279	2	59	0	24075	0	24136
3280	40	1	24270	0	0	24311
3281	2	72	4	23498	0	23576
3282	4	71	1	23300	0	23376
3283	33	0	23053	3	0	23089
3284	22438	2	70	14	0	22524
3285	41	2	22649	2	0	22694
3286	51	1	22756	3	0	22811
3287	4	80	4	22530	0	22618
3288	9	70	4	22335	0	22418
3289	2	23158	3	24	0	23187
3290	23203	1	69	4	0	23277
3291	23126	2	44	5	0	23177
3292	6	22936	0	13	0	22955
3293	2	22829	2	6	0	22839
3294	10	73	5	22283	0	22371
3295	25	22974	0	10	0	23009
3296	23467	4	34	8	0	23513
3297	24453	0	31	4	0	24488
3298	3	44	5	24280	0	24332
3299	3	17	2	24533	0	24555
3300	23885	1	30	4	0	23920
3301	11	1	23946	0	0	23958
3302	23457	3	84	6	0	23550
3303	9	2	24012	6	0	24029
3304	23364	2	67	6	0	23439
3305	6	57	2	23495	0	23560
3306	26	0	23170	4	0	23200
3307	24	3	24583	3	0	24613
3308	25691	5	60	11	0	25767
3309	26685	0	91	1	0	26777
3310	0	26517	0	32	0	26549
3311	3	69	2	26280	0	26354
3312	4	32	2	26595	0	26633
3313	26478	0	25	3	0	26506
3314	4	27357	1	19	0	27381
3315	27441	7	91	6	0	27545
3316	8	27491	0	10	0	27509
3317	0	26702	1	17	0	26720
3318	26081	6	39	15	0	26141
3319	31	2	26370	1	0	26404
3320	4	63	2	26174	0	26243
3321	3	58	3	26355	0	26419
3322	21	0	27216	0	0	27237
3323	3	110	6	27095	0	27214
3324	8	65	1	26973	0	27047
3325	1	27002	1	9	0	27013
3326	26532	6	62	5	0	26605
3327	29	0	27255	3	0	27287
3328	26653	4	51	7	0	26715
3329	3	28599	0	9	0	28611
3330	2	50	7	28316	0	28375
3331	28574	3	26	3	0	28606
3332	4	69	1	28499	0	28573
3333	3	59	1	28700	0	28763
3334	24	2	28234	4	0	28264
3335	28153	2	69	6	0	28230
3336	26842	2	82	3	0	26929
3337	11	0	27081	1	0	27093
3338	6	45	2	24931	0	24984
3339	8	1	24892	3	0	24904
3340	24408	4	72	8	0	24492
3341	24502	5	65	20	0	24592
3342	6	41	1	24642	0	24690
3343	24370	0	30	2	0	24402
3344	17	0	25422	1	0	25440
3345	4	75	12	25231	0	25322
3346	3	49	4	25123	0	25179
3347	4	35	6	25114	0	25159
3348	3	16	2	24452	0	24473
3349	24312	0	21	4	0	24337
3350	19	0	24392	2	0	24413
3351	6	59	3	24221	0	24289
3352	18	0	24220	2	0	24240
3353	19	1	23296	2	0	23318
3354	10	60	2	22085	0	22157
3355	3	40	0	22755	0	22798
3356	23796	0	12	1	0	23809
3357	0	50	5	23805	0	23860
3358	1	24	1	23931	0	23957
3359	18	11	1	23943	0	23973
3360	24004	1	20	5	0	24030
3361	23679	2	42	2	0	23725
3362	23490	3	36	1	0	23530
3363	24014	12	74	2	0	24102
3364	1	24882	0	7	0	24890
3365	6	51	4	23972	0	24033
3366	0	30	0	24212	0	24242
3367	24186	4	32	3	0	24225
3368	0	23828	0	10	0	23838
3369	5	83	2	23729	0	23819
3370	14	2	24058	4	0	24078
3371	24104	2	52	15	0	24173
3372	6	24900	2	18	0	24926
3373	24246	4	56	6	0	24312
3374	24898	4	71	4	0	24977
3375	3	45	1	25315	0	25364
3376	30	0	26195	1	0	26226
3377	8	52	4	26221	0	26285
3378	26242	1	37	7	0	26287
3379	5	61	1	26077	0	26144
3380	25683	0	24	4	0	25711
3381	3	26597	0	13	0	26613
3382	25709	2	42	4	0	25757
3383	4	46	2	25219	0	25271
3384	4	5	2	24539	0	24550
3385	23643	0	18	5	0	23666
3386	23582	1	16	5	0	23604
3387	23500	2	14	2	0	23518
3388	23981	1	24	3	0	24009
3389	24503	2	37	3	0	24545
3390	1	24	0	23592	0	23617
3391	15	1	23535	1	0	23552
3392	1	23177	1	33	0	23212
3393	23046	0	73	3	0	23122
3394	10	0	23138	4	0	23152
3395	23421	2	82	9	0	23514
3396	1	24175	0	16	0	24192
3397	23822	3	43	1	0	23869
3398	2	64	2	23634	0	23702
3399	7	52	2	23575	0	23636
3400	33	0	23959	4	0	23996
3401	12	65	2	24041	0	24120
3402	22	0	24018	2	0	24042
3403	13	0	23294	6	0	23313
3404	23256	3	60	12	0	23331
3405	21120	3	79	9	0	21211
3406	11	0	21153	13	0	21177
3407	20607	1	41	4	0	20653
3408	20689	0	68	2	0	20759
3409	19	0	20819	0	0	20838
3410	1	20783	1	21	0	20806
3411	9	23	5	20727	0	20764
3412	20794	1	26	0	0	20821
3413	20758	3	17	3	0	20781
3414	20692	1	43	0	0	20736
3415	19936	1	49	1	0	19987
3416	19831	6	69	4	0	19910
3417	28	2	20149	0	0	20179
3418	10	1	21507	2	0	21520
3419	1	21	1	21756	0	21779
3420	20400	1	23	2	0	20426
3421	20298	3	54	0	0	20355
3422	21454	1	57	2	0	21514
3423	21619	13	67	4	0	21703
3424	2	21690	0	12	0	21704
3425	2	21679	0	20	0	21701
3426	21697	3	33	2	0	21735
3427	21699	1	61	5	0	21766
3428	0	21704	3	14	0	21721
3429	21661	1	36	2	0	21700
3430	30	0	22069	2	0	22101
3431	12	42	5	22976	0	23035
3432	42	1	22169	2	0	22214
3433	20	1	22490	2	0	22513
3434	7	59	2	23230	0	23298
3435	1	66	4	23790	0	23861
3436	16	0	24060	0	0	24076
3437	3	69	2	23924	0	23998
3438	2	31	0	23966	0	23999
3439	23713	0	24	2	0	23739
3440	22996	1	58	1	0	23056
3441	1	37	0	22876	0	22914
3442	26	1	22574	2	0	22603
3443	2	22320	1	28	0	22351
3444	21937	1	66	5	0	22009
3445	18	0	22337	2	0	22357
3446	21	21829	3	30	0	21883
3447	18	21046	0	6	0	21070
3448	21336	3	31	6	0	21376
3449	22232	2	28	1	0	22263
3450	1	27	2	21713	0	21743
3451	23	0	21371	0	0	21394
3452	3	75	20	20338	0	20436
3453	2	54	1	20095	0	20152
3454	1	30	1	20219	0	20251
3455	20591	0	41	2	0	20634
3456	5	19995	1	19	0	20020
3457	2	19873	0	8	0	19883
3458	4	41	3	19473	0	19521
3459	4	8	1	19971	0	19984
3460	20084	0	14	4	0	20102
3461	20595	0	38	3	0	20636
3462	20956	6	49	2	0	21013
3463	0	20987	0	18	0	21005
3464	20908	1	50	3	0	20962
3465	4	20	1	20417	0	20442
3466	23	0	20273	3	0	20299
3467	37	0	20538	2	0	20577
3468	20380	2	83	10	0	20475
3469	22	0	20590	1	0	20613
3470	20	0	20517	1	0	20538
3471	19877	2	64	11	0	19954
3472	18	0	19793	2	0	19813
3473	24	0	22089	1	0	22114
3474	2	51	1	21503	0	21557
3475	20	1	21563	0	0	21584
3476	4	64	0	23010	0	23078
3477	3	62	1	22989	0	23055
3478	10	0	22985	1	0	22996
3479	2	22907	2	17	0	22928
3480	22836	2	68	7	0	22913
3481	11	1	22670	0	0	22682
3482	12	3	22280	4	0	22299
3483	21768	3	72	2	0	21845
3484	28	0	22830	1	0	22859
3485	21	24411	0	38	0	24470
3486	3	25121	0	18	0	25142
3487	5	61	2	25195	0	25263
3488	5	21	0	25414	0	25440
3489	26170	5	20	2	0	26197
3490	26202	3	36	4	0	26245
3491	26269	0	46	4	0	26319
3492	3	16	1	26192	0	26212
3493	24334	0	25	1	0	24360
3494	23946	1	68	8	0	24023
3495	5	2	24563	1	0	24571
3496	22	0	25495	3	0	25520
3497	3	25053	0	19	0	25075
3498	3	33	2	24647	0	24685
3499	25226	1	32	1	0	25260
3500	2	25208	2	8	0	25220
3501	3	50	2	26008	0	26063
3502	26444	0	28	3	0	26475
3503	26273	8	46	2	0	26329
3504	3	26027	0	18	0	26048
3505	24452	5	65	2	0	24524
3506	24459	2	61	0	0	24522
3507	1	35	1	24643	0	24680
3508	16	1	24251	3	0	24271
3509	9	23604	4	248	0	23865
3510	5	22642	0	25	0	22672
3511	22800	1	43	5	0	22849
3512	1	53	1	22721	0	22776
3513	16	1	22592	4	0	22613
3514	3	22661	0	21	0	22685
3515	22504	1	51	3	0	22559
3516	22841	2	62	8	0	22913
3517	21	0	22833	1	0	22855
3518	5	54	4	23336	0	23399
3519	0	50	1	23108	0	23159
3520	18	1	22976	2	0	22997
3521	22939	1	49	10	0	22999
3522	22935	2	65	1	0	23003
3523	9	53	5	23153	0	23220
3524	0	22644	0	6	0	22650
3525	3	54	3	22048	0	22108
3526	13	0	22661	0	0	22674
3527	22827	7	78	15	0	22927
3528	2	32	2	24342	0	24378
3529	24	1	24403	0	0	24428
3530	24263	1	51	3	0	24318
3531	4	36	3	24636	0	24679
3532	0	24	1	24294	0	24319
3533	24547	0	40	8	0	24595
3534	0	24594	0	10	0	24604
3535	24076	0	46	2	0	24124
3536	4	29	7	24057	0	24097
3537	23343	2	46	4	0	23395
3538	28	2	24183	4	0	24217
3539	1	25414	0	23	0	25438
3540	1	45	0	25102	0	25148
3541	25515	1	59	12	0	25587
3542	6	26520	1	5	0	26532
3543	6	31	2	26426	0	26465
3544	26339	4	40	1	0	26384
3545	26217	1	63	3	0	26284
3546	3	38	1	26114	0	26156
3547	19	1	24274	4	0	24298
3548	17	1	24117	11	0	24146
3549	23405	2	55	6	0	23468
3550	4	23391	0	22	0	23417
3551	2	22069	0	13	0	22084
3552	22924	3	51	6	0	22984
3553	1	24113	0	15	0	24129
3554	10	47	4	24069	0	24130
3555	1	16	4	24114	0	24135
3556	24167	3	14	3	0	24187
3557	24102	1	36	1	0	24140
3558	24062	6	63	3	0	24134
3559	8	1	24226	0	0	24235
3560	2	29	5	22524	0	22560
3561	21	1	21776	4	0	21802
3562	11	0	21250	3	0	21264
3563	15	0	21330	8	0	21353
3564	11	39	3	21716	0	21769
3565	10	0	20913	1	0	20924
3566	15	0	21184	3	0	21202
3567	1	30	1	21392	0	21424
3568	21186	1	39	2	0	21228
3569	14	0	21280	2	0	21296
3570	3	52	4	21928	0	21987
3571	9	55	8	21026	0	21098
3572	13	0	20710	1	0	20724
3573	4	49	1	20444	0	20498
3574	11	0	20752	2	0	20765
3575	3	65	3	20271	0	20342
3576	0	32	0	19972	0	20004
3577	4	40	4	19597	0	19645
3578	0	14	2	19459	0	19475
3579	19368	2	14	4	0	19388
3580	19295	5	33	5	0	19338
3581	12	0	19373	3	0	19388
3582	2	19020	3	19	0	19044
3583	19	0	18747	2	0	18768
3584	27	1	18844	8	0	18880
3585	20040	3	49	11	0	20103
3586	0	20006	1	43	0	20050
3587	23207	2	56	6	0	23271
3588	0	23396	0	10	0	23406
3589	23312	1	62	4	0	23379
3590	23713	2	54	5	0	23774
3591	6	47	1	23500	0	23554
3592	0	23419	0	10	0	23429
3593	7	47	5	23174	0	23233
3594	11	56	4	23300	0	23371
3595	28	0	23923	2	0	23953
3596	5	23919	2	22	0	23948
3597	2	32	2	23910	0	23946
3598	23903	2	39	1	0	23945
3599	23407	3	47	4	0	23461
3600	23637	10	73	3	0	23723
3601	1	23229	0	9	0	23239
3602	22803	5	64	8	0	22880
3603	1	21571	0	12	0	21584
3604	12	43	9	20305	0	20369
3605	7	0	21626	71	0	21704
3606	8	56	2	21605	0	21671
3607	1	22102	1	3	0	22107
3608	3	93	5	21931	0	22032
3609	12	43	1	21887	0	21943
3610	9	21840	1	12	0	21862
3611	21841	2	53	3	0	21899
3612	0	43	4	21721	0	21768
3613	11	0	21633	1	0	21645
3614	1	48	1	19224	0	19274
3615	2	33	4	18865	0	18904
3616	11	0	18637	6	0	18654
3617	5	28	1	18744	0	18778
3618	4	17290	0	20	0	17314
3619	24	1	17216	5	0	17246
3620	18	1	17336	5	0	17360
3621	7	17299	3	16	0	17325
3622	10	17615	0	15	0	17640
3623	3	17951	0	8	0	17962
3624	18716	3	29	5	0	18753
3625	18793	0	33	16	0	18842
3626	18775	1	36	1	0	18813
3627	3	31	5	18602	0	18641
3628	19	1	17868	1	0	17889
3629	7	39	0	17056	0	17102
3630	2	13	3	17282	0	17300
3631	17245	2	31	9	0	17287
3632	17261	5	49	5	0	17320
3633	2	17364	0	37	0	17403
3634	17304	1	35	3	0	17343
3635	17174	4	41	3	0	17222
3636	16889	1	52	5	0	16947
3637	12	0	16948	2	0	16962
3638	12	0	18034	7	0	18053
3639	5	49	7	19654	0	19715
3640	8	1	19565	0	0	19574
3641	19997	3	71	14	0	20085
3642	19631	3	89	11	0	19734
3643	5	0	19762	1	0	19768
3644	19762	2	72	4	0	19840
3645	0	19720	0	24	0	19744
3646	19050	0	44	2	0	19096
3647	0	52	1	19007	0	19060
3648	8	46	2	18959	0	19015
3649	1	18695	0	7	0	18703
3650	18677	4	36	1	0	18718
3651	18899	3	43	1	0	18946
3652	0	19386	0	13	0	19399
3653	3	52	1	19322	0	19378
3654	10	57	2	21114	0	21183
3655	1	21408	1	7	0	21417
3656	2	38	6	21413	0	21459
3657	0	14	1	21615	0	21630
3658	21575	2	25	1	0	21603
3659	21455	3	50	2	0	21510
3660	3	0	21283	2	0	21288
3661	19847	1	69	5	0	19922
3662	13	2	20052	0	0	20067
3663	7	24	2	17117	0	17150
3664	20	0	16955	1	0	16976
3665	3	16583	1	14	0	16601
3666	4	30	4	16629	0	16667
3667	1	27	2	19248	0	19278
3668	20688	0	27	2	0	20717
3669	3	32	1	21167	0	21203
3670	21	0	21051	1	0	21073
3671	20715	0	53	1	0	20769
3672	20858	2	31	1	0	20892
3673	20773	2	43	3	0	20821
3674	20910	2	6	2	0	20920
3675	7	23	1	20867	0	20898
3676	1	18	1	20695	0	20715
3677	2	38	2	21347	0	21389
3678	3	13	3	21455	0	21474
3679	23116	1	12	5	0	23134
3680	23095	0	22	3	0	23120
3681	2	22	2	21929	0	21955
3682	1	21846	0	15	0	21862
3683	21346	12	61	4	0	21423
3684	23	0	21595	3	0	21621
3685	10	21526	0	20	0	21556
3686	22030	0	79	7	0	22116
3687	3	22144	2	11	0	22160
3688	8	0	22101	1	0	22110
3689	22440	0	48	5	0	22493
3690	22290	1	88	7	0	22386
3691	4	0	22658	0	0	22662
3692	3	59	2	26358	0	26422
3693	10	58	4	25837	0	25909
3694	5	26170	1	72	0	26248
3695	6	41	2	26339	0	26388
3696	26656	3	41	1	0	26701
3697	0	26772	1	10	0	26783
3698	6	47	3	26138	0	26194
3699	9	50	0	26038	0	26097
3700	24	0	25246	2	0	25272
3701	12	24980	0	36	0	25028
3702	25537	2	59	5	0	25603
3703	10	25592	1	19	0	25622
3704	2	25504	0	17	0	25523
3705	26337	2	39	3	0	26381
3706	4	32	3	26332	0	26371
3707	2	27	1	26482	0	26512
3708	26852	0	22	2	0	26876
3709	2	22	2	26729	0	26755
3710	2	18	0	26549	0	26569
3711	26916	1	49	4	0	26970
3712	9	40	3	25820	0	25872
3713	2	25501	0	4	0	25507
3714	23307	6	64	7	0	23384
3715	13	1	23456	3	0	23473
3716	1	24220	0	23	0	24244
3717	8	28	8	23627	0	23671
3718	58	0	23721	1	0	23780
3719	33	0	24207	1	0	24241
3720	7	20	2	24250	0	24279
3721	24218	0	23	4	0	24245
3722	11	39	5	23962	0	24017
3723	4	30	4	24188	0	24226
3724	6	33	2	24090	0	24131
3725	0	18	5	24107	0	24130
3726	3	18	3	24415	0	24439
3727	25	1	24152	7	0	24185
3728	10	0	23957	5	0	23972
3729	6	37	0	23581	0	23624
3730	32	0	21535	3	0	21570
3731	4	21458	2	15	0	21479
3732	3	39	4	21365	0	21411
3733	13	0	21764	0	0	21777
3734	22539	4	34	7	0	22584
3735	8	23361	1	14	0	23384
3736	20	23373	0	34	0	23427
3737	7	23169	1	30	0	23207
3738	5	25	2	23260	0	23292
3739	23319	6	39	3	0	23367
3740	5	33	1	23439	0	23478
3741	23764	6	38	2	0	23810
3742	0	23885	0	16	0	23901
3743	21112	0	36	4	0	21152
3744	2	49	2	20044	0	20097
3745	9	47	0	19334	0	19390
3746	3	20760	0	3	0	20766
3747	5	58	3	20246	0	20312
3748	3	35	3	20099	0	20140
3749	2	13	1	20165	0	20181
3750	20046	1	17	1	0	20065
3751	19925	0	60	1	0	19986
3752	8	0	20110	0	0	20118
3753	19382	2	70	3	0	19457
3754	9	0	19676	1	0	19686
3755	2	37	2	17831	0	17872
3756	3	28	1	17945	0	17977
3757	1	29	1	18078	0	18109
3758	8	0	19731	3	0	19742
3759	7	60	2	19815	0	19884
3760	15	1	19845	1	0	19862
3761	0	31	1	19889	0	19921
3762	19484	1	44	6	0	19535
3763	12	0	19575	3	0	19590
3764	19636	2	66	6	0	19710
3765	5	21	1	19565	0	19592
3766	19361	2	32	2	0	19397
3767	6	18829	0	11	0	18846
3768	2	17	0	15480	0	15499
3769	9	0	15558	0	0	15567
3770	3	24	1	15188	0	15216
3771	8	22	0	15403	0	15433
3772	3	15067	3	15	0	15088
3773	39	3	15030	2	0	15074
3774	5	15177	0	14	0	15196
3775	15302	0	30	7	0	15339
3776	9	15295	0	10	0	15314
3777	15193	3	26	2	0	15224
3778	15476	0	56	2	0	15534
3779	15203	1	23	2	0	15229
3780	2	24	3	15394	0	15423
3781	13	1	14489	2	0	14505
3782	4	30	1	14551	0	14586
3783	3	14464	0	5	0	14472
3784	0	22	1	14470	0	14493
3785	14652	3	34	4	0	14693
3786	0	14702	0	10	0	14712
3787	2	14	2	14165	0	14183
3788	3	29	0	14185	0	14217
3789	13733	1	25	1	0	13760
3790	9	0	13647	2	0	13658
3791	0	13439	0	8	0	13447
3792	2	36	0	13072	0	13110
3793	14	0	13275	0	0	13289
3794	4	37	1	13036	0	13078
3795	1	13392	0	5	0	13398
3796	1	42	0	13371	0	13414
3797	1	18	0	13457	0	13476
3798	2	32	0	13450	0	13484
3799	8	0	13299	4	0	13311
3800	13381	2	40	2	0	13425
3801	2	7	2	13475	0	13486
3802	13165	0	26	2	0	13193
3803	13137	2	10	2	0	13151
3804	12976	0	14	1	0	12991
3805	13030	2	20	2	0	13054
3806	13044	1	18	0	0	13063
3807	1	9	0	13112	0	13122
3808	1	12507	0	3	0	12511
3809	5	22	0	12216	0	12243
3810	1	11283	0	2	0	11286
3811	2	8	0	11288	0	11298
3812	11735	2	14	1	0	11752
3813	3	31	5	11638	0	11677
3814	4	1	11474	3	0	11482
3815	11928	4	31	8	0	11971
3816	3	12124	1	5	0	12133
3817	11856	1	40	1	0	11898
3818	11928	2	15	3	0	11948
3819	11870	3	33	1	0	11907
3820	1	10311	0	5	0	10317
3821	0	19	1	10247	0	10267
3822	2	11	0	10376	0	10389
3823	11	0	10464	0	0	10475
3824	2	27	6	10422	0	10457
3825	2	24	1	10462	0	10489
3826	2	29	0	10646	0	10677
3827	2	10779	0	7	0	10788
3828	10914	4	38	4	0	10960
3829	10797	0	28	3	0	10828
3830	13	0	10717	0	0	10730
3831	0	10648	0	4	0	10652
3832	0	25	1	10486	0	10512
3833	1	24	0	10773	0	10798
3834	2	13	2	9218	0	9235
3835	2	16	1	9079	0	9098
3836	1	14	3	10274	0	10292
3837	11	0	10159	2	0	10172
3838	10	0	10224	1	0	10235
3839	10345	5	40	5	0	10395
3840	10168	2	50	2	0	10222
3841	10235	5	25	0	0	10265
3842	0	19	3	10198	0	10220
3843	8	0	10131	0	0	10139
3844	10283	0	26	3	0	10312
3845	10127	0	45	5	0	10177
3846	4	0	10198	1	0	10203
3847	9807	1	28	2	0	9838
3848	11	0	10058	1	0	10070
3849	2	19	2	10444	0	10467
3850	2	2	10385	3	0	10392
3851	10449	0	41	10	0	10500
3852	10225	0	44	0	0	10269
3853	10196	4	46	1	0	10247
3854	9750	0	62	4	0	9816
3855	6	0	9744	1	0	9751
3856	4	9993	0	11	0	10008
3857	9796	1	29	1	0	9827
3858	9774	1	34	1	0	9810
3859	16	0	9498	0	0	9514
3860	0	16	1	9973	0	9990
3861	1	22	3	9973	0	9999
3862	3	0	10041	1	0	10045
3863	10056	2	27	2	0	10087
3864	10336	0	31	1	0	10368
3865	3	10285	0	8	0	10296
3866	10240	1	19	0	0	10260
3867	10260	0	34	0	0	10294
3868	10289	1	24	0	0	10314
3869	10034	1	41	2	0	10078
3870	5	0	10111	0	0	10116
3871	10336	0	29	2	0	10367
3872	4	10	4	10374	0	10392
3873	2	10741	1	9	0	10753
3874	8	0	10713	0	0	10721
3875	3	10650	1	21	0	10675
3876	3	32	2	10610	0	10647
3877	7	0	10714	0	0	10721
3878	10541	4	32	4	0	10581
3879	16	0	10732	1	0	10749
3880	10989	2	36	3	0	11030
3881	0	18	1	11108	0	11127
3882	2	29	0	11105	0	11136
3883	2	10909	1	8	0	10920
3884	1	10928	0	5	0	10934
3885	1	16	1	10999	0	11017
3886	10985	0	12	0	0	10997
3887	11112	1	21	1	0	11135
3888	10647	2	53	1	0	10703
3889	7	0	10932	0	0	10939
3890	10300	0	33	1	0	10334
3891	18	0	10327	1	0	10346
3892	9	0	10821	1	0	10831
3893	11030	0	26	3	0	11059
3894	11432	1	46	2	0	11481
3895	10	0	11868	1	0	11879
3896	3	21	1	12023	0	12048
3897	2	11	2	11936	0	11951
3898	11815	0	21	6	0	11842
3899	11728	2	19	0	0	11749
3900	18	7	11879	0	0	11904
3901	11	12198	0	11	0	12220
3902	2	12129	1	3	0	12135
3903	14684	1	32	3	0	14720
3904	0	35	5	14710	0	14750
3905	2	28	5	15138	0	15173
3906	0	16	1	15325	0	15342
3907	15321	0	17	0	0	15338
3908	4	22	1	15270	0	15297
3909	15034	1	20	1	0	15056
3910	15242	1	39	6	0	15288
3911	0	16187	1	31	0	16219
3912	7	23	2	14880	0	14912
3913	18	2	15088	0	0	15108
3914	15119	0	39	6	0	15164
3915	15746	2	58	5	0	15811
3916	15838	3	50	1	0	15892
3917	4	0	16033	0	0	16037
3918	1	17	1	16206	0	16225
3919	16066	0	23	1	0	16090
3920	16013	0	34	8	0	16055
3921	16639	6	43	6	0	16694
3922	5	17164	0	13	0	17182
3923	0	17028	0	12	0	17040
3924	0	44	1	16542	0	16587
3925	8	38	3	16484	0	16533
3926	0	17382	1	11	0	17394
3927	17282	0	35	3	0	17320
3928	17	0	17664	1	0	17682
3929	4	35	3	17786	0	17828
3930	2	30	1	17346	0	17379
3931	26	1	17530	3	0	17560
3932	17824	1	44	3	0	17872
3933	17889	1	64	1	0	17955
3934	2	17831	0	12	0	17845
3935	17309	4	35	4	0	17352
3936	13	5	17947	2	0	17967
3937	17759	1	57	10	0	17827
3938	17	5	17920	2	0	17944
3939	18105	3	54	9	0	18171
3940	18020	1	57	6	0	18084
3941	18130	2	61	10	0	18203
3942	18175	30	56	5	0	18266
3943	0	18324	0	10	0	18334
3944	18139	0	52	2	0	18193
3945	17546	1	53	5	0	17605
3946	10	0	17664	0	0	17674
3947	17789	1	41	3	0	17834
3948	7	30	4	17981	0	18022
3949	10	0	17642	1	0	17653
3950	17489	1	43	5	0	17538
3951	3	16	1	17675	0	17695
3952	18337	0	37	1	0	18375
3953	18265	4	48	3	0	18320
3954	12	0	18399	1	0	18412
3955	18285	2	28	6	0	18321
3956	18308	1	35	4	0	18348
3957	18375	3	46	2	0	18426
3958	18802	4	32	2	0	18840
3959	14	35	3	20146	0	20198
3960	3	20385	0	4	0	20392
3961	20495	3	42	4	0	20544
3962	20482	1	50	5	0	20538
3963	20378	2	51	6	0	20437
3964	25	0	20456	1	0	20482
3965	2	20917	0	8	0	20927
3966	8	51	4	20654	0	20717
3967	14	63	5	20317	0	20399
3968	20	0	20765	1	0	20786
3969	11	65	3	20559	0	20638
3970	22	1	20328	3	0	20354
3971	2	67	1	21034	0	21104
3972	2	39	3	20938	0	20982
3973	14	0	20880	10	0	20904
3974	20923	1	62	5	0	20991
3975	20845	0	69	7	0	20921
3976	7	0	20750	2	0	20759
3977	20493	2	38	5	0	20538
3978	21084	0	89	6	0	21179
3979	11	1	18739	0	0	18751
3980	9	34	3	18667	0	18713
3981	4	34	2	18372	0	18412
3982	18535	0	31	4	0	18570
3983	5	19654	1	20	0	19680
3984	19609	7	62	7	0	19685
3985	19699	0	64	7	0	19770
3986	2	19480	0	11	0	19493
3987	18732	4	44	2	0	18782
3988	19075	0	54	0	0	19129
3989	1	18633	0	11	0	18645
3990	10	39	0	18267	0	18316
3991	2	18276	0	14	0	18292
3992	2	41	1	18278	0	18322
3993	13	0	18411	0	0	18424
3994	36	0	18948	2	0	18986
3995	19162	3	43	5	0	19213
3996	19140	5	66	8	0	19219
3997	22	1	18578	1	0	18602
3998	18326	0	60	3	0	18389
3999	18267	2	44	3	0	18316
4000	18445	2	60	3	0	18510
4001	2	17753	0	18	0	17773
4002	0	19	2	17638	0	17659
4003	17735	0	14	1	0	17750
4004	17265	4	47	8	0	17324
4005	14	2	17458	1	0	17475
4006	2	59	1	17439	0	17501
4007	4	33	3	16743	0	16783
4008	4	17004	1	9	0	17018
4009	1	16752	0	11	0	16764
4010	6	61	2	16654	0	16723
4011	4	16219	0	8	0	16231
4012	16230	3	41	2	0	16276
4013	0	16281	0	7	0	16288
4014	16026	0	38	3	0	16067
4015	8	0	16129	1	0	16138
4016	16061	0	25	5	0	16091
4017	15894	0	42	1	0	15937
4018	15781	1	29	1	0	15812
4019	16147	12	43	0	0	16202
4020	1	16169	1	6	0	16177
4021	3	26	3	15949	0	15981
4022	6	38	0	15807	0	15851
4023	5	0	15844	0	0	15849
4024	4	36	3	15661	0	15704
4025	3	19	1	15650	0	15673
4026	16325	3	83	2	0	16413
4027	2	16358	0	3	0	16363
4028	1	67	0	15554	0	15622
4029	3	32	2	15551	0	15588
4030	3	26	0	15508	0	15537
4031	16363	1	13	2	0	16379
4032	1	19	0	16286	0	16306
4033	15951	3	16	0	0	15970
4034	3	31	1	15545	0	15580
4035	8	41	2	13744	0	13795
4036	9	1	13698	5	0	13713
4037	13657	5	42	3	0	13707
4038	1	14205	0	6	0	14212
4039	14180	2	28	1	0	14211
4040	1	25	2	13362	0	13390
4041	1	10	0	13396	0	13407
4042	13384	1	27	0	0	13412
4043	13377	2	23	2	0	13404
4044	3	23	2	13386	0	13414
4045	16	0	13235	2	0	13253
4046	23	0	12957	11	0	12991
4047	1	12653	0	15	0	12669
4048	14290	1	28	7	0	14326
4049	14635	2	20	2	0	14659
4050	1	34	3	14946	0	14984
4051	2	14984	0	5	0	14991
4052	0	57	4	14894	0	14955
4053	3	37	1	14902	0	14943
4054	1	14198	1	9	0	14209
4055	14205	3	15	1	0	14224
4056	5	30	0	14247	0	14282
4057	8	14079	1	6	0	14094
4058	3	13880	0	7	0	13890
4059	12749	2	18	2	0	12771
4060	8	0	12864	1	0	12873
4061	13035	0	22	1	0	13058
4062	1	29	2	13051	0	13083
4063	8	25	2	12844	0	12879
4064	0	12186	0	6	0	12192
4065	3	35	2	11927	0	11967
4066	18	1	11987	1	0	12007
4067	2	12041	0	12	0	12055
4068	0	12009	1	7	0	12017
4069	11552	4	17	6	0	11579
4070	0	11770	0	6	0	11776
4071	2	41	0	11414	0	11457
4072	1	11563	1	8	0	11573
4073	7	39	2	11366	0	11414
4074	1	27	1	11563	0	11592
4075	11	0	11716	1	0	11728
4076	8	26	3	11547	0	11584
4077	1	17	0	11588	0	11606
4078	11499	1	24	3	0	11527
4079	45	0	11493	0	0	11538
4080	0	41	0	11775	0	11816
4081	11	0	11676	0	0	11687
4082	11783	1	37	5	0	11826
4083	1	11846	0	12	0	11859
4084	11829	1	20	2	0	11852
4085	1	34	1	11803	0	11839
4086	1	46	1	11874	0	11922
4087	8	0	11903	4	0	11915
4088	12002	1	27	4	0	12034
4089	1	12136	0	13	0	12150
4090	12098	0	24	2	0	12124
4091	5	40	0	11935	0	11980
4092	0	11948	0	3	0	11951
4093	12162	0	19	4	0	12185
4094	0	12586	0	8	0	12594
4095	1	34	2	12600	0	12637
4096	1	22	0	12710	0	12733
4097	1	49	0	12660	0	12710
4098	1	12815	0	2	0	12818
4099	4	40	1	12779	0	12824
4100	1	10	0	12832	0	12843
4101	12872	0	12	3	0	12887
4102	12160	3	22	4	0	12189
4103	12041	2	53	5	0	12101
4104	12	1	12147	0	0	12160
4105	12152	1	24	3	0	12180
4106	12377	2	23	2	0	12404
4107	11468	5	48	0	0	11521
4108	6	1	11557	3	0	11567
4109	11569	1	19	1	0	11590
4110	0	18	1	11605	0	11624
4111	15	0	12049	3	0	12067
4112	2	11793	0	3	0	11798
4113	5	42	1	12346	0	12394
4114	2	16242	0	12	0	16256
4115	1	17012	2	8	0	17023
4116	19026	1	29	0	0	19056
4117	2	36	0	19212	0	19250
4118	19514	1	20	4	0	19539
4119	1	25	4	19621	0	19651
4120	19695	0	12	2	0	19709
4121	4	23	0	19670	0	19697
4122	18898	0	21	0	0	18919
4123	31	0	19094	3	0	19128
4124	5	25	1	17562	0	17593
4125	12	1	17534	4	0	17551
4126	25	0	17240	6	0	17271
4127	14	1	17396	5	0	17416
4128	3	39	2	17425	0	17469
4129	26	1	17312	1	0	17340
4130	17497	3	38	3	0	17541
4131	1	44	1	17535	0	17581
4132	10	0	17573	0	0	17583
4133	2	57	2	17788	0	17849
4134	4	58	0	17550	0	17612
4135	19	0	18790	1	0	18810
4136	2	65	1	18628	0	18696
4137	4	48	1	18655	0	18708
4138	0	18697	0	10	0	18707
4139	18546	2	44	3	0	18595
4140	18415	2	34	6	0	18457
4141	28	0	18513	1	0	18542
4142	18204	1	75	5	0	18285
4143	7	0	18482	1	0	18490
4144	7	2	18275	3	0	18287
4145	22	0	18826	5	0	18853
4146	3	57	2	18613	0	18675
4147	15	9	19043	3	0	19070
4148	4	57	10	18699	0	18770
4149	0	30	1	18717	0	18748
4150	2	49	3	18618	0	18672
4151	3	26	0	18662	0	18691
4152	18541	3	20	4	0	18568
4153	18558	3	24	5	0	18590
4154	1	18574	0	10	0	18585
4155	1	37	0	18298	0	18336
4156	14	0	18646	2	0	18662
4157	1	18605	0	9	0	18615
4158	10	63	5	18586	0	18664
4159	29	0	18794	4	0	18827
4160	8	47	5	18935	0	18995
4161	39	0	20973	7	0	21019
4162	22	0	21236	9	0	21267
4163	2	60	6	21138	0	21206
4164	4	34	2	21296	0	21336
4165	21171	7	24	3	0	21205
4166	2	31	0	22063	0	22096
4167	22049	2	27	3	0	22081
4168	2	22117	0	21	0	22140
4169	2	22720	2	16	0	22740
4170	5	50	2	22245	0	22302
4171	22660	1	18	2	0	22681
4172	0	23164	0	7	0	23171
4173	2	20	2	23214	0	23238
4174	23106	1	23	4	0	23134
4175	23048	5	22	8	0	23083
4176	23049	1	53	0	0	23103
4177	23427	4	48	1	0	23480
4178	23203	1	83	0	0	23287
4179	13	0	23317	7	0	23337
4180	11	1	23366	11	0	23389
4181	1	23374	0	9	0	23384
4182	16	46	2	23228	0	23292
4183	26	0	23204	4	0	23234
4184	12	0	23258	8	0	23278
4185	3	47	1	23382	0	23433
4186	19	0	23109	10	0	23138
4187	41	1	22787	7	0	22836
4188	9	21944	1	14	0	21968
4189	21781	2	26	6	0	21815
4190	2	16333	0	7	0	16342
4191	3	36	0	16231	0	16270
4192	16968	0	26	5	0	16999
4193	1	16650	0	5	0	16656
4194	1	35	2	16855	0	16893
4195	7	0	16823	5	0	16835
4196	16974	0	24	12	0	17010
4197	16900	1	30	1	0	16932
4198	16956	3	34	1	0	16994
4199	0	37	2	16655	0	16694
4200	22	0	16619	4	0	16645
4201	0	15948	1	19	0	15968
4202	3	36	0	16758	0	16797
4203	16806	5	15	4	0	16830
4204	15	0	16813	1	0	16829
4205	1	16681	0	10	0	16692
4206	11	6	16636	1	0	16654
4207	16989	0	31	4	0	17024
4208	17007	4	28	2	0	17041
4209	16731	1	42	2	0	16776
4210	4	2	16951	0	0	16957
4211	1	17243	1	3	0	17248
4212	5	56	5	17521	0	17587
4213	3	67	3	17698	0	17771
4214	1	55	1	17784	0	17841
4215	7	0	17668	10	0	17685
4216	17696	2	37	8	0	17743
4217	9	0	17810	1	0	17820
4218	17789	0	38	5	0	17832
4219	17588	1	36	14	0	17639
4220	18580	1	51	9	0	18641
4221	18092	4	58	1	0	18155
4222	13	2	18221	1	0	18237
4223	5	26	0	17881	0	17912
4224	10	0	17774	5	0	17789
4225	6	17800	2	13	0	17821
4226	10	17748	2	12	0	17772
4227	17900	1	23	9	0	17933
4228	18035	13	27	3	0	18078
4229	2	17944	0	5	0	17951
4230	17938	0	35	0	0	17973
4231	3	0	18140	0	0	18143
4232	18036	0	24	4	0	18064
4233	15	18889	0	8	0	18912
4234	19212	1	47	2	0	19262
4235	19570	1	33	3	0	19607
4236	3	14	1	20561	0	20579
4237	1	5	4	18647	0	18657
4238	18954	1	18	1	0	18974
4239	3	11	1	19081	0	19096
4240	18918	1	12	0	0	18931
4241	1	17	0	19173	0	19191
4242	18165	3	23	1	0	18192
4243	18155	3	31	6	0	18195
4244	2	18456	1	17	0	18476
4245	0	17827	0	7	0	17834
4246	17665	1	19	8	0	17693
4247	2	16825	0	2	0	16829
4248	1	43	3	16656	0	16703
4249	0	7	0	16735	0	16742
4250	16773	1	17	2	0	16793
4251	1	17075	0	9	0	17085
4252	3	17079	0	14	0	17096
4253	1	17070	1	16	0	17088
4254	24	2	16854	2	0	16882
4255	13	0	17033	1	0	17047
4256	10	1	17055	14	0	17080
4257	4	44	1	16945	0	16994
4258	6	16859	2	6	0	16873
4259	16820	4	31	7	0	16862
4260	12	0	17213	1	0	17226
4261	20	0	17789	1	0	17810
4262	19	0	18317	2	0	18338
4263	3	45	4	18453	0	18505
4264	0	22	1	18277	0	18300
4265	2	11	0	18593	0	18606
4266	18251	1	12	1	0	18265
4267	18334	3	24	3	0	18364
4268	17862	2	15	1	0	17880
4269	3	14	2	18326	0	18345
4270	10	0	18245	0	0	18255
4271	15	0	18951	8	0	18974
4272	8	59	3	19196	0	19266
4273	0	44	1	19288	0	19333
4274	19718	2	25	3	0	19748
4275	1	19815	0	26	0	19842
4276	20327	0	28	6	0	20361
4277	0	22188	1	8	0	22197
4278	4	77	3	21186	0	21270
4279	29	0	22778	6	0	22813
4280	3	40	2	23042	0	23087
4281	22874	0	34	2	0	22910
4282	10	0	22892	1	0	22903
4283	22326	1	59	9	0	22395
4284	19	0	22377	1	0	22397
4285	14	0	22058	4	0	22076
4286	20516	1	50	3	0	20570
4287	21	2	21539	7	0	21569
4288	20	3	21166	10	0	21199
4289	6	21225	1	13	0	21245
4290	21221	3	28	6	0	21258
4291	21295	2	35	5	0	21337
4292	21280	14	74	5	0	21373
4293	20	1	21325	4	0	21350
4294	21185	2	38	5	0	21230
4295	2	21295	1	12	0	21310
4296	20102	4	44	4	0	20154
4297	28	1	20408	1	0	20438
4298	4	53	0	20542	0	20599
4299	15	1	21003	5	0	21024
4300	0	21140	1	16	0	21157
4301	3	45	8	20971	0	21027
4302	4	14	0	21046	0	21064
4303	21170	1	12	2	0	21185
4304	21001	1	27	0	0	21029
4305	20981	3	23	2	0	21009
4306	20752	2	41	4	0	20799
4307	20108	1	89	3	0	20201
4308	12	0	20680	0	0	20692
4309	2	54	1	19763	0	19820
4310	23	1	19790	1	0	19815
4311	1	19	0	19572	0	19592
4312	18501	1	24	1	0	18527
4313	18291	2	27	6	0	18326
4314	17850	1	16	1	0	17868
4315	17628	0	48	3	0	17679
4316	10	0	17629	0	0	17639
4317	4	54	1	17156	0	17215
4318	18	0	17464	3	0	17485
4319	2	17048	1	12	0	17063
4320	1	17062	0	5	0	17068
4321	7	71	2	17017	0	17097
4322	1	50	1	17126	0	17178
4323	6	50	4	17116	0	17176
4324	0	17	2	17251	0	17270
4325	17881	1	28	5	0	17915
4326	1	17783	0	14	0	17798
4327	17412	4	30	6	0	17452
4328	0	46	2	17606	0	17654
4329	4	47	1	17331	0	17383
4330	3	17706	0	13	0	17722
4331	1	41	1	17724	0	17767
4332	18309	0	22	2	0	18333
4333	1	18224	1	15	0	18241
4334	1	17851	0	13	0	17865
4335	18018	2	29	6	0	18055
4336	6	53	0	17901	0	17960
4337	2	19182	0	10	0	19194
4338	2	31	1	19081	0	19115
4339	19192	1	12	0	0	19205
4340	2	50	2	19304	0	19358
4341	2	31	1	19014	0	19048
4342	19183	3	19	1	0	19206
4343	5	80	2	19720	0	19807
4344	1	19285	0	23	0	19309
4345	0	104	6	18374	0	18484
4346	1	18459	0	2	0	18462
4347	7	40	2	18206	0	18255
4348	18247	0	15	1	0	18263
4349	18209	5	23	5	0	18242
4350	3	31	5	17862	0	17901
4351	5	0	17694	3	0	17702
4352	16888	2	62	3	0	16955
4353	2	0	15186	1	0	15189
4354	15233	2	53	1	0	15289
4355	13447	1	41	3	0	13492
4356	15	0	13543	0	0	13558
4357	0	13811	0	9	0	13820
4358	14267	0	32	3	0	14302
4359	14257	0	30	4	0	14291
4360	6	1	14246	1	0	14254
4361	14115	2	40	1	0	14158
4362	14268	0	15	0	0	14283
4363	13481	3	36	1	0	13521
4364	1	14	1	13651	0	13667
4365	4	28	2	13794	0	13828
4366	0	13846	0	4	0	13850
4367	4	34	2	13840	0	13880
4368	1	19	0	13926	0	13946
4369	7	0	13870	3	0	13880
4370	10	1	13988	8	0	14007
4371	13961	2	22	5	0	13990
4372	14254	0	36	3	0	14293
4373	2	13464	0	5	0	13471
4374	1	26	4	13295	0	13326
4375	10	2	13515	1	0	13528
4376	3	54	4	13388	0	13449
4377	0	42	3	13564	0	13609
4378	2	63	1	13536	0	13602
4379	1	13833	0	8	0	13842
4380	6	28	5	13860	0	13899
4381	1	37	3	13889	0	13930
4382	12	0	13792	3	0	13807
4383	10	0	13830	4	0	13844
4384	13185	0	28	2	0	13215
4385	13308	1	20	1	0	13330
4386	4	10	1	13229	0	13244
4387	0	25	0	13268	0	13293
4388	1	28	0	13263	0	13292
4389	24	0	13200	2	0	13226
4390	2	13189	1	17	0	13209
4391	9	0	13247	0	0	13256
4392	13842	0	45	4	0	13891
4393	7	0	13895	2	0	13904
4394	13764	2	37	4	0	13807
4395	13659	1	33	2	0	13695
4396	16501	2	40	1	0	16544
4397	0	19	1	16653	0	16673
4398	19	5	16587	3	0	16614
4399	1	16632	0	7	0	16640
4400	3	53	2	16597	0	16655
4401	6	37	3	16979	0	17025
4402	38	0	16909	2	0	16949
4403	9	16510	0	15	0	16534
4404	16821	3	39	2	0	16865
4405	3	16203	0	12	0	16218
4406	17729	2	32	2	0	17765
4407	2	37	1	18356	0	18396
4408	27	3	17774	2	0	17806
4409	8	17827	0	8	0	17843
4410	17820	0	46	5	0	17871
4411	14	0	17860	1	0	17875
4412	20096	3	30	4	0	20133
4413	18585	3	46	2	0	18636
4414	5	0	18600	0	0	18605
4415	18273	0	31	5	0	18309
4416	18123	1	39	2	0	18165
4417	18086	2	56	3	0	18147
4418	1	17634	1	2	0	17638
4419	17787	2	46	2	0	17837
4420	1	17555	0	4	0	17560
4421	34	0	17420	2	0	17456
4422	12	16999	1	11	0	17023
4423	17381	8	24	0	0	17413
4424	18009	2	42	5	0	18058
4425	18356	1	22	3	0	18382
4426	3	10	2	18983	0	18998
4427	3	14	0	19012	0	19029
4428	20313	0	12	0	0	20325
4429	20326	0	25	1	0	20352
4430	5	48	2	20372	0	20427
4431	24	1	20462	2	0	20489
4432	10	20253	1	15	0	20279
4433	3	20076	0	8	0	20087
4434	11	64	3	19633	0	19711
4435	12	1	19944	0	0	19957
4436	2	54	1	20205	0	20262
4437	8	20015	1	5	0	20029
4438	7	54	2	20152	0	20215
4439	17	7	20585	1	0	20610
4440	4	60	2	20599	0	20665
4441	29	0	20779	0	0	20808
4442	2	45	6	20979	0	21032
4443	21	1	20739	1	0	20762
4444	14	1	21225	3	0	21243
4445	21493	0	42	6	0	21541
4446	21523	4	80	6	0	21613
4447	21685	10	63	3	0	21761
4448	3	21733	0	7	0	21743
4449	1	16	2	21505	0	21524
4450	21469	1	25	1	0	21496
4451	21186	6	31	7	0	21230
4452	21160	3	88	2	0	21253
4453	18	1	21159	0	0	21178
4454	10	21593	3	28	0	21634
4455	2	21497	0	45	0	21544
4456	21538	1	49	10	0	21598
4457	5	24	3	21628	0	21660
4458	22109	0	29	2	0	22140
4459	13	0	22399	1	0	22413
4460	6	85	5	22546	0	22642
4461	2	71	3	22393	0	22469
4462	4	75	3	22233	0	22315
4463	7	24152	0	4	0	24163
4464	24398	2	40	3	0	24443
4465	25202	1	35	5	0	25243
4466	6	25282	0	17	0	25305
4467	6	44	2	24862	0	24914
4468	25087	1	30	0	0	25118
4469	3	38	4	25055	0	25100
4470	25022	0	32	2	0	25056
4471	5	24805	1	24	0	24835
4472	21580	2	64	3	0	21649
4473	25	1	22926	2	0	22954
4474	3	22313	4	11	0	22331
4475	22	0	22480	2	0	22504
4476	0	26	2	22836	0	22864
4477	22571	0	17	2	0	22590
4478	22851	2	26	6	0	22885
4479	25038	1	39	3	0	25081
4480	0	23	2	25142	0	25167
4481	25231	3	35	4	0	25273
4482	0	9	3	23371	0	23383
4483	22886	0	25	1	0	22912
4484	22691	0	53	3	0	22747
4485	7	0	22950	1	0	22958
4486	35	1	22768	3	0	22807
4487	13	1	23196	6	0	23216
4488	4	33	1	20810	0	20848
4489	20995	0	25	3	0	21023
4490	2	19	0	21007	0	21028
4491	3	6	2	21049	0	21060
4492	21158	2	6	1	0	21167
4493	21777	4	18	11	0	21810
4494	21487	5	24	1	0	21517
4495	23201	4	41	3	0	23249
4496	0	13	0	22892	0	22905
4497	23500	3	23	5	0	23531
4498	0	23632	0	19	0	23651
4499	23697	1	49	7	0	23754
4500	22971	2	67	10	0	23050
4501	5	0	22729	3	0	22737
4502	22080	3	84	6	0	22173
4503	14	0	22624	4	0	22642
4504	12	1	21306	5	0	21324
4505	13	1	21604	7	0	21625
4506	6	49	6	21612	0	21673
4507	16	0	21719	2	0	21737
4508	10	28	3	22100	0	22141
4509	22	2	22208	2	0	22234
4510	17	1	22760	3	0	22781
4511	5	60	0	22574	0	22639
4512	1	43	7	22707	0	22758
4513	13	0	22938	2	0	22953
4514	22592	1	55	7	0	22655
4515	1	31	4	22420	0	22456
4516	2	31	1	22593	0	22627
4517	22487	4	35	4	0	22530
4518	5	35	1	22297	0	22338
4519	42	1	21762	1	0	21806
4520	28	1	22408	5	0	22442
4521	5	59	3	22181	0	22248
4522	38	0	21707	6	0	21751
4523	2	21856	1	14	0	21873
4524	1	36	0	21906	0	21943
4525	22168	1	40	2	0	22211
4526	5	1	22233	2	0	22241
4527	22117	1	33	1	0	22152
4528	2	61	2	22313	0	22378
4529	0	38	1	21992	0	22031
4530	9	50	1	22082	0	22142
4531	4	36	0	22223	0	22263
4532	22358	2	12	3	0	22375
4533	0	22037	2	13	0	22052
4534	3	89	4	21904	0	22000
4535	2	28	1	21871	0	21902
4536	2	48	2	21879	0	21931
4537	1	14	1	21943	0	21959
4538	21921	1	23	3	0	21948
4539	1	20212	1	24	0	20238
4540	20181	2	64	5	0	20252
4541	2	19801	0	11	0	19814
4542	0	19406	0	113	0	19519
4543	19607	0	46	11	0	19664
4544	21	2	19773	0	0	19796
4545	4	13	1	20427	0	20445
4546	20379	1	26	2	0	20408
4547	20643	2	57	10	0	20712
4548	20715	3	73	3	0	20794
4549	19639	6	60	3	0	19708
4550	0	20056	0	9	0	20065
4551	19747	2	57	2	0	19808
4552	21249	4	32	4	0	21289
4553	1	19074	0	17	0	19092
4554	4	48	1	19250	0	19303
4555	5	1	19397	2	0	19405
4556	6	36	0	19442	0	19484
4557	19271	0	28	1	0	19300
4558	13	0	19254	6	0	19273
4559	1	19145	0	31	0	19177
4560	28	2	19206	0	0	19236
4561	6	51	8	19171	0	19236
4562	4	18528	0	12	0	18544
4563	18666	2	39	4	0	18711
4564	2	19577	0	1	0	19580
4565	3	48	2	19447	0	19500
4566	1	30	1	20055	0	20087
4567	20266	1	30	0	0	20297
4568	5	30	2	20406	0	20443
4569	5	19728	1	13	0	19747
4570	19684	2	55	8	0	19749
4571	18067	1	73	3	0	18144
4572	1	17797	0	30	0	17828
4573	17324	1	46	3	0	17374
4574	1	18024	0	11	0	18036
4575	17728	5	52	5	0	17790
4576	3	18087	1	16	0	18107
4577	4	29	5	17797	0	17835
4578	6	27	2	17832	0	17867
4579	17576	1	23	2	0	17602
4580	17502	0	50	5	0	17557
4581	0	17174	0	19	0	17193
4582	13	0	17092	5	0	17110
4583	17238	2	38	1	0	17279
4584	4	42	5	17240	0	17291
4585	0	16572	1	93	0	16666
4586	2	21	2	16545	0	16570
4587	17503	1	14	2	0	17520
4588	16994	1	41	0	0	17036
4589	20537	1	28	1	0	20567
4590	1	28	1	20619	0	20649
4591	8	0	20636	1	0	20645
4592	20680	1	43	7	0	20731
4593	20589	1	77	2	0	20669
4594	20678	8	65	2	0	20753
4595	0	20631	0	3	0	20634
4596	9	58	3	20303	0	20373
4597	3	20901	1	5	0	20910
4598	3	54	5	20888	0	20950
4599	6	45	2	20998	0	21051
4600	11	0	21133	4	0	21148
4601	9	47	4	21476	0	21536
4602	0	31	3	21545	0	21579
4603	21442	0	52	4	0	21498
4604	3	21308	1	11	0	21323
4605	20962	2	51	0	0	21015
4606	20881	4	55	3	0	20943
4607	1	43	4	20820	0	20868
4608	38	1	20940	4	0	20983
4609	13	20845	0	14	0	20872
4610	0	20853	0	17	0	20870
4611	20971	5	73	9	0	21058
4612	1	21110	0	17	0	21128
4613	12	30	5	21036	0	21083
4614	0	35	5	21385	0	21425
4615	20	0	21292	6	0	21318
4616	23	2	21560	5	0	21590
4617	4	21156	0	17	0	21177
4618	2	27	1	20900	0	20930
4619	22696	2	31	2	0	22731
4620	5	53	2	22350	0	22410
4621	6	1	22993	1	0	23001
4622	1	35	2	23084	0	23122
4623	22652	0	29	0	0	22681
4624	22638	5	62	4	0	22709
4625	3	21977	0	25	0	22005
4626	21874	4	63	6	0	21947
4627	4	21559	1	10	0	21574
4628	20431	5	67	6	0	20509
4629	5	30	7	20219	0	20261
4630	38	1	19676	4	0	19719
4631	17	2	19831	7	0	19857
4632	1	19721	1	11	0	19734
4633	4	32	5	19508	0	19549
4634	1	4	2	19896	0	19903
4635	19985	1	10	2	0	19998
4636	19944	2	16	0	0	19962
4637	19607	2	7	0	0	19616
4638	2	24	3	19601	0	19630
4639	0	24	2	19441	0	19467
4640	1	33	1	19012	0	19047
4641	16	0	18983	3	0	19002
4642	13	0	18471	5	0	18489
4643	19671	2	55	5	0	19733
4644	19343	1	73	1	0	19418
4645	8	0	19375	1	0	19384
4646	19631	2	55	4	0	19692
4647	19530	4	58	5	0	19597
4648	22	1	19596	1	0	19620
4649	3	18428	0	27	0	18458
4650	3	39	2	19337	0	19381
4651	24	0	19435	3	0	19462
4652	0	21356	1	7	0	21364
4653	10	46	4	21081	0	21141
4654	2	21806	2	32	0	21842
4655	42	0	21679	5	0	21726
4656	35	2	26661	4	0	26702
4657	0	26	1	26971	0	26998
4658	27369	0	47	4	0	27420
4659	3	39	1	26963	0	27006
4660	26725	4	44	2	0	26775
4661	5	63	19	26836	0	26923
4662	12	0	26811	2	0	26825
4663	25558	2	102	7	0	25669
4664	5	1	25786	5	0	25797
4665	22181	3	65	5	0	22254
4666	4	54	3	21942	0	22003
4667	1	22427	0	6	0	22434
4668	10	79	1	22176	0	22266
4669	0	22238	1	11	0	22250
4670	7	52	1	22052	0	22112
4671	2	22139	1	5	0	22147
4672	22159	1	42	6	0	22208
4673	21939	0	24	2	0	21965
4674	21801	1	77	2	0	21881
4675	9	0	21973	1	0	21983
4676	1	45	3	21756	0	21805
4677	24	1	21415	6	0	21446
4678	10	21402	1	36	0	21449
4679	3	21484	0	15	0	21502
4680	21486	4	73	10	0	21573
4681	13	1	21568	3	0	21585
4682	3	21398	2	23	0	21426
4683	3	44	2	21520	0	21569
4684	21359	2	41	9	0	21411
4685	0	21096	0	14	0	21110
4686	20958	2	58	2	0	21020
4687	14	0	21167	0	0	21181
4688	2	53	3	21247	0	21305
4689	5	59	3	21311	0	21378
4690	10	55	1	21107	0	21173
4691	2	19029	0	4	0	19035
4692	4	40	2	19080	0	19126
4693	19	0	19201	0	0	19220
4694	2	53	6	19321	0	19382
4695	1	56	1	19586	0	19644
4696	6	37	1	19777	0	19821
4697	2	19207	3	5	0	19217
4698	1	61	1	19110	0	19173
4699	7	46	3	19066	0	19122
4700	0	19048	0	8	0	19056
4701	19347	5	48	1	0	19401
4702	6	19414	0	8	0	19428
4703	5	19265	0	10	0	19280
4704	7	32	5	18971	0	19015
4705	10	1	19036	5	0	19052
4706	18999	5	53	6	0	19063
4707	0	29	2	19240	0	19271
4708	16	0	19254	1	0	19271
4709	1	20224	0	12	0	20237
4710	4	31	1	20034	0	20070
4711	26	0	20408	2	0	20436
4712	5	39	2	20496	0	20542
4713	1	35	0	20535	0	20571
4714	20463	2	35	5	0	20505
4715	2	20428	1	18	0	20449
4716	19682	2	85	2	0	19771
4717	8	1	20311	2	0	20322
4718	1	19261	0	17	0	19279
4719	35	2	20893	2	0	20932
4720	2	26	0	20615	0	20643
4721	20619	2	19	5	0	20645
4722	3	11	1	20588	0	20603
4723	20529	2	12	0	0	20543
4724	20799	5	58	6	0	20868
4725	3	21	1	20927	0	20952
4726	18	1	19988	2	0	20009
4727	8	3	20108	7	0	20126
4728	8	51	4	19611	0	19674
4729	4	30	0	19709	0	19743
4730	19522	0	33	0	0	19555
4731	3	42	7	19723	0	19775
4732	2	14836	0	2	0	14840
4733	6	21	1	14630	0	14658
4734	3	15	1	14904	0	14923
4735	14644	0	21	5	0	14670
4736	0	14609	2	6	0	14617
4737	4	46	0	14390	0	14440
4738	14	42	1	14344	0	14401
4739	2	15859	0	2	0	15863
4740	5	53	3	15334	0	15395
4741	7	38	1	15355	0	15401
4742	0	15137	0	7	0	15144
4743	3	43	2	15105	0	15153
4744	4	38	1	17000	0	17043
4745	0	16944	0	5	0	16949
4746	10	18	0	16892	0	16920
4747	16943	0	17	0	0	16960
4748	16890	0	52	1	0	16943
4749	16975	2	32	1	0	17010
4750	17037	3	64	6	0	17110
4751	0	17045	0	8	0	17053
4752	16769	2	33	0	0	16804
4753	2	17471	1	17	0	17491
4754	0	18071	1	6	0	18078
4755	1	20	8	18048	0	18077
4756	9	0	18130	1	0	18140
4757	18854	1	57	12	0	18924
4758	18773	1	74	2	0	18850
4759	20	0	18841	0	0	18861
4760	18864	4	47	5	0	18920
4761	19643	0	53	3	0	19699
4762	0	19524	1	26	0	19551
4763	20051	1	44	2	0	20098
4764	12	19	5	19991	0	20027
4765	1	27	2	19879	0	19909
4766	2	24	3	20011	0	20040
4767	2	11	2	20434	0	20449
4768	21700	1	10	1	0	21712
4769	4	33	3	21601	0	21641
4770	3	28	0	21502	0	21533
4771	15	0	21020	7	0	21042
4772	20633	0	67	2	0	20702
4773	20698	1	73	4	0	20776
4774	20784	6	62	3	0	20855
4775	3	20966	0	32	0	21001
4776	1	20885	0	6	0	20892
4777	20748	2	32	1	0	20783
4778	7	54	2	21718	0	21781
4779	2	21988	0	18	0	22008
4780	13	59	4	21663	0	21739
4781	1	22229	1	13	0	22244
4782	22142	1	55	10	0	22208
4783	1	21239	0	20	0	21260
4784	5	42	1	20902	0	20950
4785	4	54	0	20905	0	20963
4786	15	0	20911	4	0	20930
4787	1	20625	1	34	0	20661
4788	5	42	2	21234	0	21283
4789	27	0	21168	1	0	21196
4790	20	0	21032	8	0	21060
4791	1	54	1	22118	0	22174
4792	4	44	2	22052	0	22102
4793	8	21564	0	21	0	21593
4794	1	20443	0	9	0	20453
4795	1	29	0	20760	0	20790
4796	20907	0	31	4	0	20942
4797	3	12	2	21192	0	21209
4798	21900	1	23	1	0	21925
4799	21870	1	17	3	0	21891
4800	21463	0	33	3	0	21499
4801	7	1	21471	1	0	21480
4802	22805	0	33	1	0	22839
4803	3	25	4	21572	0	21604
4804	3	32	3	21149	0	21187
4805	15	1	20939	4	0	20959
4806	13	0	21929	3	0	21945
4807	9	38	1	21703	0	21751
4808	11	21726	1	22	0	21760
4809	4	21704	1	11	0	21720
4810	7	42	3	22541	0	22593
4811	24063	0	17	0	0	24080
4812	5	54	3	23956	0	24018
4813	6	51	3	23797	0	23857
4814	4	24154	0	10	0	24168
4815	4	47	2	22502	0	22555
4816	9	0	22568	1	0	22578
4817	16	1	22716	7	0	22740
4818	23682	0	74	7	0	23763
4819	7	23509	0	17	0	23533
4820	21878	1	43	4	0	21926
4821	22805	1	54	1	0	22861
4822	6	41	2	22630	0	22679
4823	9	23117	0	10	0	23136
4824	2	47	1	23368	0	23418
4825	23620	2	36	3	0	23661
4826	10	23329	0	16	0	23355
4827	23528	0	76	5	0	23609
4828	5	23685	0	27	0	23717
4829	23218	3	99	5	0	23325
4830	22998	5	84	2	0	23089
4831	4	23042	0	30	0	23076
4832	3	30	4	22121	0	22158
4833	22268	2	43	3	0	22316
4834	8	0	22354	0	0	22362
4835	25	3	23131	6	0	23165
4836	5	19	0	23308	0	23332
4837	22708	0	49	5	0	22762
4838	1	20	0	22652	0	22673
4839	21911	2	38	3	0	21954
4840	12	0	21926	1	0	21939
4841	22114	1	12	5	0	22132
4842	22016	1	22	0	0	22039
4843	1	45	3	21543	0	21592
4844	3	43	2	20295	0	20343
4845	6	64	0	21547	0	21617
4846	1	21764	0	10	0	21775
4847	9	46	2	21689	0	21746
4848	0	15	1	21881	0	21897
4849	21798	0	22	3	0	21823
4850	21702	1	67	4	0	21774
4851	9	0	21602	8	0	21619
4852	21472	1	106	1	0	21580
4853	15	0	21697	0	0	21712
4854	20240	2	89	5	0	20336
4855	24	0	20754	3	0	20781
4856	9	1	21288	2	0	21300
4857	4	32	3	21189	0	21228
4858	11	0	21351	2	0	21364
4859	21347	3	73	5	0	21428
4860	21	16	1	21430	0	21468
4861	21370	0	48	1	0	21419
4862	22575	0	43	4	0	22622
4863	22540	4	54	4	0	22602
4864	22084	0	79	1	0	22164
4865	27	0	22679	3	0	22709
4866	3	26	2	21833	0	21864
4867	7	1	22474	0	0	22482
4868	1	32	0	22436	0	22469
4869	23247	0	43	5	0	23295
4870	3	28	4	22954	0	22989
4871	22773	1	22	0	0	22796
4872	2	41	1	23039	0	23083
4873	0	25	0	22861	0	22886
4874	22299	0	55	2	0	22356
4875	2	22411	0	9	0	22422
4876	21484	1	54	1	0	21540
4877	0	22717	0	11	0	22728
4878	9	28	3	21841	0	21881
4879	21867	1	31	4	0	21903
4880	15	1	21871	22	0	21909
4881	1	25	0	21705	0	21731
4882	20915	2	29	2	0	20948
4883	20733	4	59	4	0	20800
4884	5	37	0	21743	0	21785
4885	3	21850	0	9	0	21862
4886	1	19624	1	11	0	19637
4887	2	24	3	19685	0	19714
4888	19966	2	36	1	0	20005
4889	2	20318	1	8	0	20329
4890	3	20307	1	20	0	20331
4891	20453	1	44	5	0	20503
4892	1	20450	0	11	0	20462
4893	19472	1	41	1	0	19515
4894	0	45	2	19851	0	19898
4895	2	42	1	19676	0	19721
4896	4	19055	1	21	0	19081
4897	0	20336	0	21	0	20357
4898	20473	1	44	6	0	20524
4899	3	20685	1	11	0	20700
4900	1	20443	0	21	0	20465
4901	4	15	1	20298	0	20318
4902	20197	1	40	4	0	20242
4903	11	0	20267	2	0	20280
4904	20132	3	61	2	0	20198
4905	2	32	4	19982	0	20020
4906	30	0	19363	2	0	19395
4907	15	1	19428	5	0	19449
4908	2	39	4	20453	0	20498
4909	25	0	20316	4	0	20345
4910	20343	0	55	10	0	20408
4911	19621	1	82	2	0	19706
4912	4	0	19985	2	0	19991
4913	3	29	3	19930	0	19965
4914	1	26	2	20307	0	20336
4915	20437	1	16	4	0	20458
4916	12	36	8	20122	0	20178
4917	2	20304	2	166	0	20474
4918	20521	0	53	5	0	20579
4919	4	20844	0	27	0	20875
4920	1	19716	0	12	0	19729
4921	4	45	4	19414	0	19467
4922	1	39	0	19474	0	19514
4923	4	38	0	19564	0	19606
4924	9	0	19485	3	0	19497
4925	20334	2	81	12	0	20429
4926	2	20419	0	14	0	20435
4927	20048	4	57	1	0	20110
4928	20086	5	38	5	0	20134
4929	0	34	4	20828	0	20866
4930	2	20343	0	2	0	20347
4931	4	41	6	20216	0	20267
4932	0	18	4	20314	0	20336
4933	20303	4	34	4	0	20345
4934	19982	4	64	7	0	20057
4935	9	1	20060	0	0	20070
4936	20090	2	73	9	0	20174
4937	0	20237	0	17	0	20254
4938	18936	3	70	4	0	19013
4939	0	18478	0	10	0	18488
4940	7	62	1	18251	0	18321
4941	2	37	2	18303	0	18344
4942	0	17742	0	6	0	17748
4943	3	55	1	17733	0	17792
4944	2	42	1	18813	0	18858
4945	4	39	1	17892	0	17936
4946	0	17505	0	1	0	17506
4947	4	63	5	17340	0	17412
4948	3	37	3	17268	0	17311
4949	4	35	1	17403	0	17443
4950	18	0	17205	8	0	17231
4951	16940	5	68	4	0	17017
4952	15	0	17149	1	0	17165
4953	15809	1	79	3	0	15892
4954	7	0	15992	0	0	15999
4955	17184	0	74	3	0	17261
4956	17271	6	67	2	0	17346
4957	3	0	17377	1	0	17381
4958	2	15	1	17428	0	17446
4959	14	0	17247	2	0	17263
4960	16150	0	56	9	0	16215
4961	19	0	16158	2	0	16179
4962	15	0	16318	1	0	16334
4963	17217	3	45	6	0	17271
4964	5	17491	0	14	0	17510
4965	3	12	1	17091	0	17107
4966	17749	3	17	5	0	17774
4967	1	24	5	17574	0	17604
4968	2	11	2	17669	0	17684
4969	17696	1	14	2	0	17713
4970	17205	3	36	1	0	17245
4971	7	0	17209	3	0	17219
4972	11	0	17313	2	0	17326
4973	1	25	2	15710	0	15738
4974	22	1	16013	0	0	16036
4975	1	46	21	15472	0	15540
4976	3	42	2	15679	0	15726
4977	2	19	2	15810	0	15833
4978	15816	0	24	2	0	15842
4979	4	15450	0	16	0	15470
4980	15558	1	33	0	0	15592
4981	15520	2	65	1	0	15588
4982	1	15485	0	12	0	15498
4983	14231	0	27	4	0	14262
4984	8	0	14398	1	0	14407
4985	3	22	0	14532	0	14557
4986	14541	0	30	4	0	14575
4987	12	1	14416	2	0	14431
4988	14130	0	57	6	0	14193
4989	13	14471	0	7	0	14491
4990	14264	1	40	3	0	14308
4991	14538	1	46	0	0	14585
4992	0	14609	1	14	0	14624
4993	14243	1	39	0	0	14283
4994	0	15	1	14416	0	14432
4995	4	11	1	13996	0	14012
4996	14028	0	20	1	0	14049
4997	13950	1	34	1	0	13986
4998	4	13863	0	38	0	13905
4999	2	16560	0	11	0	16573
5000	8	42	1	15513	0	15564
5001	5	15676	0	9	0	15690
5002	1	15700	4	10	0	15715
5003	15772	5	32	0	0	15809
5004	1	15056	0	11	0	15068
5005	15113	4	24	3	0	15144
5006	1	15058	0	14	0	15073
5007	33	1	14882	3	0	14919
5008	2	14880	0	7	0	14889
5009	15138	0	27	2	0	15167
5010	15043	0	47	2	0	15092
5011	4	0	15232	0	0	15236
5012	4	37	1	15240	0	15282
5013	1	28	0	14968	0	14997
5014	19	0	14988	1	0	15008
5015	4	43	1	15403	0	15451
5016	27	2	15259	2	0	15290
5017	30	1	15291	2	0	15324
5018	15339	3	60	4	0	15406
5019	4	15203	1	15	0	15223
5020	14157	0	30	1	0	14188
5021	1	25	1	14286	0	14313
5022	8	0	14342	0	0	14350
5023	8	26	1	14606	0	14641
5024	4	14796	2	11	0	14813
5025	14815	0	35	5	0	14855
5026	14864	0	25	4	0	14893
5027	3	32	0	14797	0	14832
5028	10	2	14773	1	0	14786
5029	15195	0	53	5	0	15253
5030	6	14444	0	19	0	14469
5031	13649	3	49	4	0	13705
5032	3	14	0	13512	0	13529
5033	13494	0	18	1	0	13513
5034	7	18	0	13776	0	13801
5035	18	1	13618	0	0	13637
5036	11	0	13618	0	0	13629
5037	13397	1	53	6	0	13457
5038	5	13256	0	11	0	13272
5039	12792	2	37	2	0	12833
5040	12292	1	36	0	0	12329
5041	1	11947	0	9	0	11957
5042	11535	2	34	1	0	11572
5043	15	0	11573	0	0	11588
5044	1	26	3	11821	0	11851
5045	3	13	3	11740	0	11759
5046	4	17	0	11860	0	11881
5047	8	0	11553	3	0	11564
5048	12	1	11955	1	0	11969
5049	0	23	0	12227	0	12250
5050	2	11722	0	13	0	11737
5051	4	11572	0	8	0	11584
5052	11477	1	33	2	0	11513
5053	11680	2	25	1	0	11708
5054	0	11729	0	1	0	11730
5055	3	28	2	11964	0	11997
5056	1	22	1	11840	0	11864
5057	11571	0	13	1	0	11585
5058	3	16	0	11473	0	11492
5059	3	18	0	11564	0	11585
5060	3	15	2	12155	0	12175
5061	16	0	11944	1	0	11961
5062	4	0	11848	0	0	11852
5063	11848	0	40	3	0	11891
5064	0	20	2	12342	0	12364
5065	9	0	11858	0	0	11867
5066	7	0	11837	2	0	11846
5067	11751	3	52	3	0	11809
5068	18	0	11911	1	0	11930
5069	4	12305	1	7	0	12317
5070	5	20	3	12006	0	12034
5071	7	0	12035	1	0	12043
5072	12886	0	39	0	0	12925
5073	2	29	0	13028	0	13059
5074	2	0	13034	1	0	13037
5075	6	29	0	11721	0	11756
5076	0	9	1	11872	0	11882
5077	12274	0	12	3	0	12289
5078	2	12245	0	5	0	12252
5079	4	13	0	12301	0	12318
5080	12303	0	14	1	0	12318
5081	12425	0	15	0	0	12440
5082	12477	0	15	0	0	12492
5083	12524	0	9	3	0	12536
5084	3	13	1	12435	0	12452
5085	12302	0	3	0	0	12305
5086	12340	2	20	0	0	12362
5087	12161	0	22	0	0	12183
5088	12685	3	44	0	0	12732
5089	3	13628	0	4	0	13635
5090	2	13165	1	4	0	13172
5091	6	39	2	13045	0	13092
5092	1	13277	0	6	0	13284
5093	13219	0	26	4	0	13249
5094	1	14	0	13174	0	13189
5095	13041	3	14	1	0	13059
5096	13136	1	33	1	0	13171
5097	4	47	4	12897	0	12952
5098	11	45	6	12255	0	12317
5099	1	12471	0	4	0	12476
5100	12149	3	37	3	0	12192
5101	0	12293	0	5	0	12298
5102	12177	0	36	4	0	12217
5103	1	31	2	12068	0	12102
5104	9	0	12172	1	0	12182
5105	11736	2	34	1	0	11773
5106	11702	1	39	4	0	11746
5107	4	0	11690	2	0	11696
5108	12	0	11667	0	0	11679
5109	0	15	3	11651	0	11669
5110	11306	1	15	0	0	11322
5111	11277	0	34	1	0	11312
5112	11245	1	22	0	0	11268
5113	11236	3	41	0	0	11280
5114	0	11258	0	4	0	11262
5115	10717	2	18	0	0	10737
5116	1	18	1	10396	0	10416
5117	2	18	3	9969	0	9992
5118	3	23	3	10014	0	10043
5119	4	12	0	10169	0	10185
5120	10269	0	6	0	0	10275
5121	2	21	1	10171	0	10195
5122	4	0	10160	0	0	10164
5123	2	25	1	9706	0	9734
5124	2	34	2	9352	0	9390
5125	3	18	2	9296	0	9319
5126	1	9	1	9339	0	9350
5127	9380	0	11	1	0	9392
5128	10	9233	0	3	0	9246
5129	0	9104	0	4	0	9108
5130	1	10	0	9000	0	9011
5131	8750	0	9	0	0	8759
5132	8755	1	16	1	0	8773
5133	1	10	0	8702	0	8713
5134	5	0	8673	0	0	8678
5135	8652	1	23	0	0	8676
5136	3	16	0	7806	0	7825
5137	13	0	7758	2	0	7773
5138	7716	0	40	1	0	7757
5139	0	7734	0	9	0	7743
5140	7141	3	24	0	0	7168
5141	0	7152	0	5	0	7157
5142	7	21	0	6520	0	6548
5143	0	6606	0	4	0	6610
5144	2	6	1	6207	0	6216
5145	6209	1	13	1	0	6224
5146	0	6247	0	8	0	6255
5147	3	0	6085	0	0	6088
5148	1	14	1	5314	0	5330
5149	1	0	5259	0	0	5260
5150	0	8	0	3786	0	3794
5151	0	7	16	3569	0	3592
5152	0	0	3406	0	0	3406
5153	2933	0	4	0	0	2937
5154	0	0	2842	0	0	2842
5155	0	0	2796	0	0	2796
5156	0	2427	0	1	0	2428
5157	0	0	1	2146	0	2147
5158	1	0	0	2026	0	2027
5159	0	0	0	2026	0	2026
5160	0	0	0	2022	0	2022
5161	1	0	2020	0	0	2021
5162	1853	0	3	1	0	1857
5163	0	0	1832	2	0	1834
5164	0	0	0	1296	0	1296
5165	408	0	0	0	0	408
5166	0	383	1	0	0	384
5167	0	0	0	18	0	18
5168	14	0	0	0	0	14
5169	0	14	0	0	0	14
5170	0	15	0	0	0	15
5171	15	0	0	0	0	15
5172	0	15	0	0	0	15
5173	15	0	0	0	0	15
5174	0	15	0	0	0	15
5175	15	0	0	0	0	15
5176	15	0	0	0	0	15
5177	0	15	0	0	0	15
5178	0	0	0	15	0	15
5179	0	0	16	0	0	16
5180	16	0	0	0	0	16
5181	0	0	0	17	0	17
5182	0	14	0	0	0	14
5183	0	14	0	0	0	14
5184	0	1	0	13	0	14
5185	13	0	0	0	0	13
5186	0	0	14	0	0	14
5187	0	0	0	14	0	14
5188	0	0	0	15	0	15
5189	0	0	0	13	0	13
5190	0	0	0	13	0	13
5191	0	12	0	0	0	12
5192	0	0	0	12	0	12
5193	0	0	12	0	0	12
5194	0	0	12	0	0	12
5195	0	0	12	0	0	12
5196	0	0	0	13	0	13
5197	13	0	0	0	0	13
5198	0	0	13	0	0	13
5199	0	0	13	0	0	13
5200	0	0	0	13	0	13
5201	13	0	0	0	0	13
5202	0	13	0	0	0	13
5203	12	0	0	0	0	12
5204	0	0	0	11	0	11
5205	0	0	12	0	0	12
5206	0	0	0	12	0	12
5207	0	11	0	0	0	11
5208	10	0	0	0	0	10
5209	0	0	11	0	0	11
5210	0	12	0	0	0	12
5211	12	0	0	0	0	12
5212	0	0	0	12	0	12
5213	0	0	0	12	0	12
5214	13	0	0	0	0	13
5215	14	0	0	0	0	14
5216	13	0	0	0	0	13
5217	0	0	0	14	0	14
5218	0	14	0	0	0	14
5219	12	0	0	0	0	12
5220	0	14	0	0	0	14
5221	13	0	1	0	0	14
5222	0	14	0	0	0	14
5223	0	0	0	14	0	14
5224	14	0	0	0	0	14
5225	14	0	0	0	0	14
5226	14	0	0	0	0	14
5227	14	0	0	0	0	14
5228	13	0	0	0	0	13
5229	0	0	13	0	0	13
5230	0	0	0	12	0	12
5231	0	0	12	0	0	12
5232	0	0	12	0	0	12
5233	13	0	0	0	0	13
5234	14	0	0	0	0	14
5235	14	0	0	0	0	14
5236	0	0	0	14	0	14
5237	15	0	0	0	0	15
5238	0	16	0	0	0	16
5239	0	15	0	1	0	16
5240	0	16	0	0	0	16
5241	15	0	1	0	0	16
5242	0	15	0	0	0	15
5243	15	0	0	0	0	15
5244	16	0	0	0	0	16
5245	0	0	16	0	0	16
5246	0	0	0	17	0	17
5247	0	0	0	17	0	17
5248	17	0	0	0	0	17
5249	17	0	0	0	0	17
5250	0	0	0	17	0	17
5251	0	0	17	0	0	17
5252	0	0	17	0	0	17
5253	0	0	0	17	0	17
5254	0	0	0	17	0	17
5255	0	0	0	16	0	16
5256	16	0	0	0	0	16
5257	14	0	0	0	0	14
5258	0	16	0	0	0	16
5259	0	0	0	16	0	16
5260	0	0	0	16	0	16
5261	0	16	0	0	0	16
5262	0	0	0	16	0	16
5263	16	0	0	0	0	16
5264	0	0	0	15	0	15
5265	0	0	0	16	0	16
5266	16	0	0	0	0	16
5267	17	0	0	0	0	17
5268	17	0	0	0	0	17
5269	0	0	0	17	0	17
5270	0	0	17	0	0	17
5271	0	0	17	0	0	17
5272	0	0	16	0	0	16
5273	0	16	0	0	0	16
5274	16	0	0	0	0	16
5275	0	0	17	0	0	17
5276	16	0	0	0	0	16
5277	0	0	0	17	0	17
5278	17	0	0	0	0	17
5279	17	0	0	0	0	17
5280	0	17	0	0	0	17
5281	17	0	0	0	0	17
5282	16	0	0	0	0	16
5283	0	17	0	0	0	17
5284	0	0	0	16	0	16
5285	0	0	16	0	0	16
5286	0	0	0	17	0	17
5287	0	0	0	18	0	18
5288	16	2	0	0	0	18
5289	0	0	0	29	0	29
5290	0	29	0	0	0	29
5291	0	0	0	28	0	28
5292	0	0	0	28	0	28
5293	0	0	26	0	0	26
5294	0	29	0	0	0	29
5295	0	26	0	0	0	26
5296	29	0	0	0	0	29
5297	0	28	0	1	0	29
5298	0	0	0	29	0	29
5299	0	0	31	0	0	31
5300	0	31	0	0	0	31
5301	32	0	0	0	0	32
5302	0	0	0	33	0	33
5303	0	0	0	33	0	33
5304	0	0	33	0	0	33
5305	0	0	0	33	0	33
5306	0	0	0	34	0	34
5307	34	0	0	0	0	34
5308	32	0	0	0	0	32
5309	0	32	0	0	0	32
5310	30	0	2	0	0	32
5311	0	31	0	0	0	31
5312	0	0	0	30	0	30
5313	0	29	0	0	0	29
5314	0	29	0	0	0	29
5315	27	0	1	0	0	28
5316	28	0	0	0	0	28
5317	0	29	0	0	0	29
5318	29	0	0	0	0	29
5319	30	0	0	0	0	30
5320	29	0	0	0	0	29
5321	0	0	0	29	0	29
5322	27	0	0	0	0	27
5323	0	0	27	0	0	27
5324	26	0	0	0	0	26
5325	0	0	27	0	0	27
5326	0	0	0	28	0	28
5327	0	0	0	28	0	28
5328	0	0	28	0	0	28
5329	28	0	0	0	0	28
5330	26	0	0	0	0	26
5331	0	0	29	0	0	29
5332	0	0	0	30	0	30
5333	0	0	0	29	0	29
5334	0	0	0	28	0	28
5335	27	0	0	0	0	27
5336	28	0	0	0	0	28
5337	0	0	0	28	0	28
5338	0	27	0	0	0	27
5339	0	26	0	0	0	26
5340	26	0	0	0	0	26
5341	0	24	0	0	0	24
5342	0	24	0	0	0	24
5343	0	0	0	23	0	23
5344	0	0	25	0	0	25
5345	0	25	0	0	0	25
5346	0	1	0	22	0	23
5347	0	31	0	0	0	31
5348	0	0	0	31	0	31
5349	32	0	0	0	0	32
5350	0	30	0	0	0	30
5351	38	0	0	0	0	38
5352	37	0	0	0	0	37
5353	0	0	36	0	0	36
5354	36	0	0	0	0	36
5355	0	0	0	36	0	36
5356	0	0	36	0	0	36
5357	0	33	0	1	0	34
5358	0	0	0	34	0	34
5359	0	0	0	35	0	35
5360	35	0	0	0	0	35
5361	0	0	0	35	0	35
5362	0	0	0	35	0	35
5363	34	0	0	0	0	34
5364	0	34	0	0	0	34
5365	29	0	1	0	0	30
5366	0	0	30	0	0	30
5367	31	0	0	0	0	31
5368	0	0	30	0	0	30
5369	0	30	0	0	0	30
5370	30	0	0	0	0	30
5371	30	0	0	0	0	30
5372	1	0	28	0	0	29
5373	0	0	27	0	0	27
5374	0	0	29	0	0	29
5375	0	24	0	0	0	24
5376	0	0	0	25	0	25
5377	0	0	25	0	0	25
5378	0	0	25	0	0	25
5379	0	0	0	28	0	28
5380	0	0	28	0	0	28
5381	28	0	0	0	0	28
5382	27	0	0	0	0	27
5383	0	0	27	0	0	27
5384	0	29	0	0	0	29
5385	0	0	0	30	0	30
5386	0	0	31	0	0	31
5387	0	33	0	0	0	33
5388	0	0	0	33	0	33
5389	33	0	0	0	0	33
5390	33	0	0	0	0	33
5391	0	33	0	0	0	33
5392	0	0	0	34	0	34
5393	0	0	0	34	0	34
5394	0	0	0	34	0	34
5395	0	0	0	33	0	33
5396	0	0	33	0	0	33
5397	0	0	0	33	0	33
5398	0	0	33	0	0	33
5399	0	36	0	0	0	36
5400	36	0	0	0	0	36
5401	0	37	0	0	0	37
5402	0	0	0	36	0	36
5403	0	0	0	37	0	37
5404	37	0	0	0	0	37
5405	0	0	0	38	0	38
5406	0	37	0	0	0	37
5407	0	0	0	37	0	37
5408	0	0	0	36	0	36
5409	38	0	0	0	0	38
5410	0	0	39	0	0	39
5411	0	40	0	0	0	40
5412	0	41	0	0	0	41
5413	0	0	0	40	0	40
5414	40	0	0	0	0	40
5415	0	39	0	0	0	39
5416	0	0	0	40	0	40
5417	0	0	47	0	0	47
5418	0	0	0	47	0	47
5419	45	0	0	0	0	45
5420	45	0	0	0	0	45
5421	0	0	0	44	0	44
5422	45	0	0	0	0	45
5423	39	0	0	0	0	39
5424	0	0	40	0	0	40
5425	39	0	0	0	0	39
5426	0	39	0	0	0	39
5427	32	0	0	0	0	32
5428	0	0	33	0	0	33
5429	0	0	0	33	0	33
5430	32	0	0	1	0	33
5431	0	0	33	0	0	33
5432	0	0	32	0	0	32
5433	0	0	0	32	0	32
5434	0	0	34	0	0	34
5435	33	0	0	0	0	33
5436	0	0	34	0	0	34
5437	0	0	0	38	0	38
5438	0	0	0	37	0	37
5439	37	0	0	0	0	37
5440	0	0	37	0	0	37
5441	0	0	37	0	0	37
5442	0	0	0	37	0	37
5443	0	0	37	0	0	37
5444	37	0	0	0	0	37
5445	0	0	0	38	0	38
5446	0	0	38	0	0	38
5447	0	0	0	38	0	38
5448	0	0	0	38	0	38
5449	38	0	0	0	0	38
5450	0	0	38	0	0	38
5451	39	0	0	0	0	39
5452	0	0	39	0	0	39
5453	38	0	0	0	0	38
5454	37	0	0	0	0	37
5455	36	0	0	0	0	36
5456	0	37	0	0	0	37
5457	37	0	0	0	0	37
5458	40	0	0	0	0	40
5459	0	0	0	39	0	39
5460	0	0	39	0	0	39
5461	37	0	0	0	0	37
5462	0	0	37	0	0	37
5463	0	0	0	35	0	35
5464	0	0	0	35	0	35
5465	34	0	0	0	0	34
5466	0	33	0	0	0	33
5467	0	0	0	34	0	34
5468	0	0	0	35	0	35
5469	0	0	35	0	0	35
5470	0	0	0	35	0	35
5471	0	1	0	33	0	34
5472	0	0	0	35	0	35
5473	0	33	0	0	0	33
5474	34	0	0	0	0	34
5475	30	0	0	0	0	30
5476	0	31	0	0	0	31
5477	30	0	0	0	0	30
5478	0	0	0	31	0	31
5479	0	0	30	0	0	30
5480	0	30	0	0	0	30
5481	0	30	0	0	0	30
5482	31	0	0	0	0	31
5483	32	0	0	0	0	32
5484	0	0	0	32	0	32
5485	0	0	0	30	0	30
5486	0	0	0	30	0	30
5487	29	0	0	0	0	29
5488	0	0	28	0	0	28
5489	30	0	0	0	0	30
5490	0	0	0	29	0	29
5491	0	0	0	29	0	29
5492	0	23	0	0	0	23
5493	0	0	0	24	0	24
5494	0	0	0	24	0	24
5495	0	0	24	0	0	24
5496	0	24	0	0	0	24
5497	25	0	0	0	0	25
5498	25	0	0	0	0	25
5499	33	0	0	0	0	33
5500	32	0	0	0	0	32
5501	0	0	32	0	0	32
5502	32	0	0	0	0	32
5503	0	0	35	0	0	35
5504	0	0	0	39	0	39
5505	0	39	0	0	0	39
5506	1	0	0	38	0	39
5507	0	0	0	39	0	39
5508	0	0	40	0	0	40
5509	39	0	0	0	0	39
5510	39	0	0	0	0	39
5511	0	39	0	0	0	39
5512	0	0	35	0	0	35
5513	0	0	0	35	0	35
5514	0	0	34	0	0	34
5515	0	0	35	0	0	35
5516	1	0	0	36	0	37
5517	0	0	37	0	0	37
5518	0	0	0	36	0	36
5519	0	0	37	0	0	37
5520	0	0	0	36	0	36
5521	40	0	0	0	0	40
5522	40	0	0	0	0	40
5523	40	0	0	0	0	40
5524	40	0	0	0	0	40
5525	0	37	0	0	0	37
5526	0	1	0	39	0	40
5527	0	0	0	39	0	39
5528	0	0	40	0	0	40
5529	0	0	0	39	0	39
5530	0	0	38	0	0	38
5531	0	0	39	0	0	39
5532	40	0	0	0	0	40
5533	0	39	0	0	0	39
5534	37	0	0	0	0	37
5535	36	0	0	0	0	36
5536	0	36	0	0	0	36
5537	36	0	0	0	0	36
5538	0	0	36	0	0	36
5539	0	36	0	0	0	36
5540	36	0	0	0	0	36
5541	0	0	35	0	0	35
5542	36	0	0	0	0	36
5543	0	36	0	0	0	36
5544	34	0	0	0	0	34
5545	34	0	0	0	0	34
5546	0	37	0	0	0	37
5547	0	37	0	0	0	37
5548	0	37	0	0	0	37
5549	0	0	0	37	0	37
5550	0	0	0	37	0	37
5551	37	0	0	0	0	37
5552	37	0	0	0	0	37
5553	0	0	37	0	0	37
5554	0	0	40	0	0	40
5555	0	0	40	0	0	40
5556	0	0	0	37	0	37
5557	0	0	37	0	0	37
5558	0	0	0	38	0	38
5559	37	0	1	0	0	38
5560	0	0	38	0	0	38
5561	38	0	0	0	0	38
5562	38	0	0	0	0	38
5563	0	0	34	0	0	34
5564	0	38	0	0	0	38
5565	0	0	0	38	0	38
5566	0	0	45	0	0	45
5567	0	0	0	45	0	45
5568	0	0	0	45	0	45
5569	44	0	0	0	0	44
5570	0	0	0	44	0	44
5571	0	0	45	0	0	45
5572	0	0	0	45	0	45
5573	44	0	0	0	0	44
5574	0	44	0	0	0	44
5575	37	0	0	0	0	37
5576	0	0	0	37	0	37
5577	0	0	36	0	0	36
5578	0	0	36	0	0	36
5579	0	0	33	0	0	33
5580	0	29	0	0	0	29
5581	29	0	0	0	0	29
5582	0	29	0	0	0	29
5583	30	0	0	0	0	30
5584	0	29	0	0	0	29
5585	0	0	0	29	0	29
5586	0	0	0	28	0	28
5587	0	1	0	27	0	28
5588	0	29	0	0	0	29
5589	0	0	0	28	0	28
5590	0	0	0	28	0	28
5591	28	0	0	0	0	28
5592	0	1	0	27	0	28
5593	0	0	27	0	0	27
5594	28	0	0	0	0	28
5595	27	0	0	0	0	27
5596	0	26	0	0	0	26
5597	24	0	0	0	0	24
5598	24	0	0	0	0	24
5599	0	0	0	24	0	24
5600	0	0	0	24	0	24
5601	0	0	0	25	0	25
5602	24	0	0	0	0	24
5603	24	0	0	0	0	24
5604	0	0	24	0	0	24
5605	25	0	0	0	0	25
5606	25	0	0	0	0	25
5607	24	0	0	0	0	24
5608	0	0	24	0	0	24
5609	0	0	23	1	0	24
5610	0	0	0	25	0	25
5611	0	0	25	0	0	25
5612	0	0	0	25	0	25
5613	0	0	0	25	0	25
5614	0	25	0	0	0	25
5615	25	0	0	0	0	25
5616	0	0	26	0	0	26
5617	26	0	0	0	0	26
5618	0	0	0	26	0	26
5619	26	0	0	0	0	26
5620	0	26	0	0	0	26
5621	0	24	0	0	0	24
5622	0	0	0	24	0	24
5623	0	0	0	24	0	24
5624	0	0	24	0	0	24
5625	0	0	0	24	0	24
5626	25	0	0	0	0	25
5627	0	25	0	0	0	25
5628	0	0	25	0	0	25
5629	0	0	0	22	0	22
5630	0	0	21	0	0	21
5631	0	0	0	23	0	23
5632	0	0	22	0	0	22
5633	0	0	23	0	0	23
5634	0	0	0	22	0	22
5635	23	0	0	0	0	23
5636	24	0	0	0	0	24
5637	24	0	0	0	0	24
5638	0	24	0	0	0	24
5639	21	0	0	0	0	21
5640	20	0	0	0	0	20
5641	0	0	21	0	0	21
5642	0	15	0	0	0	15
5643	0	0	0	17	0	17
5644	18	0	0	0	0	18
5645	0	18	0	0	0	18
5646	18	0	0	0	0	18
5647	16	0	0	0	0	16
5648	16	0	0	0	0	16
5649	17	0	0	0	0	17
5650	0	0	0	17	0	17
5651	17	0	0	0	0	17
5652	0	0	0	17	0	17
5653	0	17	0	0	0	17
5654	0	0	0	20	0	20
5655	20	0	0	0	0	20
5656	0	0	22	0	0	22
5657	0	0	0	22	0	22
5658	21	0	0	0	0	21
5659	0	21	0	0	0	21
5660	21	0	0	0	0	21
5661	22	0	0	0	0	22
5662	0	22	0	0	0	22
5663	22	0	0	0	0	22
5664	0	0	20	0	0	20
5665	0	0	21	0	0	21
5666	18	0	0	0	0	18
5667	0	0	22	0	0	22
5668	0	0	0	22	0	22
5669	0	22	0	0	0	22
5670	21	0	0	0	0	21
5671	0	22	0	0	0	22
5672	0	22	0	0	0	22
5673	0	0	0	22	0	22
5674	0	0	0	21	0	21
5675	0	0	0	22	0	22
5676	0	0	0	22	0	22
5677	0	0	20	0	0	20
5678	0	0	0	24	0	24
5679	0	0	0	23	0	23
5680	23	0	0	0	0	23
5681	0	0	0	23	0	23
5682	0	0	23	0	0	23
5683	24	0	0	0	0	24
5684	0	0	0	27	0	27
5685	0	0	27	0	0	27
5686	0	0	0	26	0	26
5687	0	25	0	1	0	26
5688	25	0	0	0	0	25
5689	0	0	27	0	0	27
5690	0	26	0	0	0	26
5691	27	0	0	0	0	27
5692	0	26	0	0	0	26
5693	0	25	0	0	0	25
5694	27	0	0	0	0	27
5695	0	26	0	0	0	26
5696	0	26	0	0	0	26
5697	0	0	0	27	0	27
5698	0	0	28	0	0	28
5699	0	27	0	0	0	27
5700	0	0	0	26	0	26
5701	0	28	0	0	0	28
5702	26	0	0	0	0	26
5703	0	0	27	0	0	27
5704	0	0	0	32	0	32
5705	33	0	0	0	0	33
5706	0	0	0	32	0	32
5707	0	0	32	0	0	32
5708	32	0	0	0	0	32
5709	31	0	0	0	0	31
5710	0	32	0	0	0	32
5711	0	0	0	30	0	30
5712	0	0	0	30	0	30
5713	29	0	0	0	0	29
5714	30	0	0	0	0	30
5715	0	0	30	0	0	30
5716	0	32	0	0	0	32
5717	32	0	0	0	0	32
5718	0	0	0	32	0	32
5719	0	0	31	0	0	31
5720	0	0	32	0	0	32
5721	0	0	0	33	0	33
5722	33	0	0	0	0	33
5723	0	34	0	0	0	34
5724	34	0	0	0	0	34
5725	0	0	0	33	0	33
5726	0	0	0	33	0	33
5727	0	0	0	32	0	32
5728	32	0	0	0	0	32
5729	0	32	0	0	0	32
5730	0	0	0	31	0	31
5731	0	0	0	31	0	31
5732	0	0	30	0	0	30
5733	0	0	0	31	0	31
5734	0	0	31	0	0	31
5735	0	30	0	0	0	30
5736	0	0	0	30	0	30
5737	31	0	0	0	0	31
5738	0	0	31	0	0	31
5739	0	0	0	32	0	32
5740	0	0	33	0	0	33
5741	33	0	0	0	0	33
5742	0	0	34	0	0	34
5743	0	0	0	34	0	34
5744	34	0	0	0	0	34
5745	0	34	0	0	0	34
5746	34	0	0	0	0	34
5747	0	35	0	0	0	35
5748	0	0	0	33	0	33
5749	0	0	37	0	0	37
5750	0	0	37	0	0	37
5751	0	0	0	38	0	38
5752	38	0	0	0	0	38
5753	37	0	0	0	0	37
5754	0	0	0	36	0	36
5755	0	0	0	36	0	36
5756	36	0	0	0	0	36
5757	0	37	0	0	0	37
5758	0	36	0	0	0	36
5759	35	0	0	0	0	35
5760	0	0	33	0	0	33
5761	0	0	0	32	0	32
5762	0	0	32	0	0	32
5763	0	0	0	34	0	34
5764	0	0	35	0	0	35
5765	0	0	33	0	0	33
5766	0	0	0	33	0	33
5767	0	33	0	0	0	33
5768	34	0	0	0	0	34
5769	0	44	0	0	0	44
5770	0	0	0	43	0	43
5771	43	0	0	0	0	43
5772	0	0	0	43	0	43
5773	40	0	0	0	0	40
5774	40	0	1	0	0	41
5775	39	0	0	0	0	39
5776	0	43	0	0	0	43
5777	42	0	0	0	0	42
5778	0	0	0	39	0	39
5779	35	0	1	0	0	36
5780	0	0	0	35	0	35
5781	36	0	0	0	0	36
5782	36	0	0	0	0	36
5783	0	35	0	0	0	35
5784	0	0	0	36	0	36
5785	0	0	0	36	0	36
5786	0	36	0	0	0	36
5787	0	0	0	36	0	36
5788	37	0	0	0	0	37
5789	36	0	0	0	0	36
5790	37	0	0	0	0	37
5791	0	0	37	0	0	37
5792	35	0	0	0	0	35
5793	35	1	0	0	0	36
5794	36	0	0	0	0	36
5795	0	33	0	0	0	33
5796	0	0	0	33	0	33
5797	0	0	0	33	0	33
5798	0	0	0	33	0	33
5799	0	0	30	0	0	30
5800	0	0	0	32	0	32
5801	31	0	0	0	0	31
5802	0	0	0	32	0	32
5803	0	2	0	30	0	32
5804	0	0	30	0	0	30
5805	0	30	0	0	0	30
5806	30	0	0	0	0	30
5807	0	0	0	30	0	30
5808	28	0	0	0	0	28
5809	0	0	28	0	0	28
5810	29	0	0	0	0	29
5811	0	30	0	0	0	30
5812	0	0	30	0	0	30
5813	0	0	25	0	0	25
5814	0	0	0	28	0	28
5815	0	0	28	0	0	28
5816	0	26	0	0	0	26
5817	0	0	0	24	0	24
5818	0	0	0	26	0	26
5819	0	0	0	26	0	26
5820	28	0	0	0	0	28
5821	0	27	0	0	0	27
5822	0	0	0	27	0	27
5823	0	0	0	28	0	28
5824	28	0	0	0	0	28
5825	0	26	0	0	0	26
5826	26	0	0	0	0	26
5827	26	0	0	0	0	26
5828	25	0	0	0	0	25
5829	0	0	25	0	0	25
5830	0	0	0	24	0	24
5831	0	22	0	0	0	22
5832	0	25	0	0	0	25
5833	0	0	0	25	0	25
5834	0	25	0	0	0	25
5835	25	0	0	0	0	25
5836	0	0	27	0	0	27
5837	27	0	0	0	0	27
5838	26	0	0	0	0	26
5839	0	0	0	30	0	30
5840	29	0	0	0	0	29
5841	0	29	0	0	0	29
5842	29	0	0	0	0	29
5843	29	0	0	0	0	29
5844	30	0	0	0	0	30
5845	0	0	21	0	0	21
5846	0	0	21	0	0	21
5847	0	0	0	21	0	21
5848	0	22	0	0	0	22
5849	0	22	0	0	0	22
5850	0	0	0	21	0	21
5851	22	0	0	0	0	22
5852	0	0	0	22	0	22
5853	0	0	0	21	0	21
5854	25	0	0	0	0	25
5855	0	25	0	0	0	25
5856	0	0	25	0	0	25
5857	0	0	24	0	0	24
5858	24	0	0	0	0	24
5859	0	0	0	25	0	25
5860	0	0	25	0	0	25
5861	0	0	0	25	0	25
5862	0	0	0	24	0	24
5863	0	0	0	28	0	28
5864	0	0	0	27	0	27
5865	0	27	0	0	0	27
5866	0	0	0	27	0	27
5867	27	0	0	0	0	27
5868	0	26	0	1	0	27
5869	25	0	0	0	0	25
5870	23	0	0	0	0	23
5871	25	0	0	0	0	25
5872	0	0	25	0	0	25
5873	25	0	0	0	0	25
5874	25	0	0	0	0	25
5875	28	0	0	0	0	28
5876	29	0	0	0	0	29
5877	0	29	0	0	0	29
5878	29	0	0	0	0	29
5879	0	0	29	0	0	29
5880	0	0	0	30	0	30
5881	0	0	0	32	0	32
5882	32	0	0	0	0	32
5883	0	32	0	0	0	32
5884	31	0	0	0	0	31
5885	0	31	0	0	0	31
5886	30	0	0	0	0	30
5887	31	0	0	0	0	31
5888	0	29	0	0	0	29
5889	29	0	0	0	0	29
5890	28	0	0	0	0	28
5891	0	28	0	0	0	28
5892	0	29	0	0	0	29
5893	29	0	0	0	0	29
5894	0	0	0	29	0	29
5895	28	0	0	0	0	28
5896	28	0	0	0	0	28
5897	27	0	0	0	0	27
5898	28	0	0	0	0	28
5899	0	27	0	0	0	27
5900	0	25	0	0	0	25
5901	24	0	0	0	0	24
5902	0	0	25	0	0	25
5903	0	0	0	24	0	24
5904	0	0	0	24	0	24
5905	24	0	0	0	0	24
5906	0	25	0	0	0	25
5907	0	1	0	24	0	25
5908	0	0	0	24	0	24
5909	23	0	0	0	0	23
5910	0	0	0	23	0	23
5911	23	0	0	0	0	23
5912	22	0	0	0	0	22
5913	22	0	0	0	0	22
5914	0	0	0	21	0	21
5915	0	0	0	18	0	18
5916	0	0	18	0	0	18
5917	0	0	17	0	0	17
5918	18	0	0	0	0	18
5919	0	0	0	18	0	18
5920	0	0	18	0	0	18
5921	0	0	18	0	0	18
5922	0	0	0	17	0	17
5923	0	0	18	0	0	18
5924	0	0	0	16	0	16
5925	0	0	0	19	0	19
5926	0	0	19	0	0	19
5927	0	0	0	19	0	19
5928	0	0	0	17	0	17
5929	0	0	0	17	0	17
5930	0	0	16	0	0	16
5931	0	0	0	16	0	16
5932	15	0	1	0	0	16
5933	0	16	0	0	0	16
5934	16	0	0	0	0	16
5935	0	0	15	0	0	15
5936	21	0	0	0	0	21
5937	20	0	1	0	0	21
5938	21	0	0	0	0	21
5939	0	0	0	18	0	18
5940	0	0	0	18	0	18
5941	0	0	17	0	0	17
5942	18	0	0	0	0	18
5943	0	19	0	0	0	19
5944	0	19	0	0	0	19
5945	0	19	0	0	0	19
5946	0	0	0	19	0	19
5947	18	0	0	0	0	18
5948	19	0	0	0	0	19
5949	0	0	19	0	0	19
5950	0	0	0	20	0	20
5951	0	0	0	18	0	18
5952	0	0	18	0	0	18
5953	0	0	18	0	0	18
5954	17	0	1	0	0	18
5955	0	17	0	0	0	17
5956	15	0	0	0	0	15
5957	15	0	0	0	0	15
5958	0	0	0	14	0	14
5959	0	0	0	15	0	15
5960	15	0	0	0	0	15
5961	0	0	0	15	0	15
5962	0	0	0	15	0	15
5963	14	0	0	0	0	14
5964	0	0	0	14	0	14
5965	14	0	0	0	0	14
5966	14	0	0	0	0	14
5967	0	0	14	0	0	14
5968	14	0	0	0	0	14
5969	14	0	0	0	0	14
5970	13	0	0	0	0	13
5971	0	0	13	0	0	13
5972	13	0	0	0	0	13
5973	0	13	0	0	0	13
5974	13	0	0	0	0	13
5975	13	0	0	0	0	13
5976	0	0	0	13	0	13
5977	0	0	0	13	0	13
5978	0	16	0	0	0	16
5979	0	0	0	32	0	32
5980	0	0	0	41	0	41
5981	241	0	0	0	0	241
5982	0	0	1	251	0	252
5983	0	0	0	269	0	269
5984	0	0	0	596	0	596
5985	0	597	0	0	0	597
5986	608	0	0	0	0	608
5987	0	692	0	0	0	692
5988	714	0	0	0	0	714
5989	0	0	1253	0	0	1253
5990	1245	0	0	0	0	1245
5991	0	0	1464	1	0	1465
5992	0	1491	0	1	0	1492
5993	1623	0	0	0	0	1623
5994	1759	8	0	0	0	1767
5995	0	1950	0	0	0	1950
5996	0	2773	0	0	0	2773
5997	2918	0	10	0	0	2928
5998	2940	1	6	2	0	2949
5999	0	11	0	2964	0	2975
6000	0	12	0	2956	0	2968
6001	2	0	2983	1	0	2986
6002	4150	1	14	1	0	4166
6003	0	14	0	4252	0	4266
6004	0	4305	0	1	0	4306
6005	2	21	0	4304	0	4327
6006	1	12	1	4320	0	4334
6007	3	0	5228	0	0	5231
6008	1	10	0	5270	0	5281
6009	5267	0	10	1	0	5278
6010	0	5257	0	1	0	5258
6011	0	5229	0	6	0	5235
6012	5476	0	12	4	0	5492
6013	5763	1	5	0	0	5769
6014	5802	1	18	3	0	5824
6015	0	5821	0	2	0	5823
6016	0	5826	0	4	0	5830
6017	6015	0	18	1	0	6034
6018	6435	0	15	0	0	6450
6019	0	6479	0	3	0	6482
6020	0	6483	0	3	0	6486
6021	6514	0	9	1	0	6524
6022	0	11	3	6614	0	6628
6023	6850	0	5	0	0	6855
6024	2	25	1	6822	0	6850
6025	2	6868	1	4	0	6875
6026	1	6883	0	4	0	6888
6027	6910	1	12	1	0	6924
6028	6927	0	16	0	0	6943
6029	6967	1	19	2	0	6989
6030	0	7001	0	5	0	7006
6031	11	0	7003	0	0	7014
6032	5	6988	1	5	0	6999
6033	6956	3	17	0	0	6976
6034	6983	0	25	2	0	7010
6035	3	0	7049	1	0	7053
6036	0	7128	0	6	0	7134
6037	2	33	1	6963	0	6999
6038	0	15	1	7089	0	7105
6039	0	7121	0	10	0	7131
6040	3	0	7141	2	0	7146
6041	7097	0	8	2	0	7107
6042	0	6	0	7130	0	7136
6043	7256	0	11	2	0	7269
6044	7422	3	9	0	0	7434
6045	0	10	0	7621	0	7631
6046	0	4	2	7583	0	7589
6047	1	11	0	7629	0	7641
6048	0	6	0	7682	0	7688
6049	7631	0	10	1	0	7642
6050	7547	0	17	0	0	7564
6051	0	0	7937	0	0	7937
6052	1	19	1	7854	0	7875
6053	2	25	0	7884	0	7911
6054	1	19	7	7908	0	7935
6055	3	0	8630	1	0	8634
6056	1	16	0	8663	0	8680
6057	8460	2	6	1	0	8469
6058	3	48	3	8482	0	8536
6059	6	0	8582	2	0	8590
6060	4	38	3	8493	0	8538
6061	2	0	8528	6	0	8536
6062	8482	1	18	8	0	8509
6063	0	14	0	8518	0	8532
6064	8534	0	6	1	0	8541
6065	8259	1	19	3	0	8282
6066	0	13	1	8482	0	8496
6067	8235	0	9	2	0	8246
6068	4	24	0	8012	0	8040
6069	0	8017	0	0	0	8017
6070	7955	0	15	2	0	7972
6071	7942	2	15	2	0	7961
6072	7149	1	16	4	0	7170
6073	0	9	0	7056	0	7065
6074	0	15	1	7052	0	7068
6075	1	16	4	7039	0	7060
6076	3	0	7016	4	0	7023
6077	0	5830	2	5	0	5837
6078	0	14	2	5823	0	5839
6079	5	0	5837	0	0	5842
6080	5789	1	3	3	0	5796
6081	5	18	0	5923	0	5946
6082	1	0	6245	0	0	6246
6083	6036	1	7	6	0	6050
6084	0	7	1	6073	0	6081
6085	0	6	0	6078	0	6084
6086	0	1	2	6105	0	6108
6087	6093	1	5	1	0	6100
6088	5963	1	11	0	0	5975
6089	5688	6	17	1	0	5712
6090	1	5837	0	6	0	5844
6091	1	5837	0	3	0	5841
6092	5929	1	12	1	0	5943
6093	4	0	6025	0	0	6029
6094	0	12	2	5795	0	5809
6095	0	13	0	5797	0	5810
6096	5842	1	9	3	0	5855
6097	5823	1	14	1	0	5839
6098	0	5470	0	6	0	5476
6099	3	11	2	5477	0	5493
6100	5	0	6487	2	0	6494
6101	5	0	6659	2	0	6666
6102	0	15	0	6800	0	6815
6103	1	12	1	6836	0	6850
6104	6859	1	12	0	0	6872
6105	2	12	1	7243	0	7258
6106	7178	0	10	0	0	7188
6107	7158	4	11	1	0	7174
6108	2	0	7165	1	0	7168
6109	7492	0	18	0	0	7510
6110	7432	0	27	1	0	7460
6111	7623	3	20	2	0	7648
6112	0	7529	0	5	0	7534
6113	0	7470	0	6	0	7476
6114	2	14	2	7623	0	7641
6115	10	0	7778	1	0	7789
6116	1	8607	0	3	0	8611
6117	1	23	1	8617	0	8642
6118	3	36	0	8642	0	8681
6119	2	8558	0	5	0	8565
6120	8668	0	17	2	0	8687
6121	8455	0	16	1	0	8472
6122	3	0	8480	0	0	8483
6123	8388	1	25	2	0	8416
6124	3	0	8510	1	0	8514
6125	8341	0	23	2	0	8366
6126	6	0	8689	0	0	8695
6127	3	8542	1	4	0	8550
6128	1	21	0	8530	0	8552
6129	1	9	0	8691	0	8701
6130	9029	1	13	4	0	9047
6131	8500	1	13	2	0	8516
6132	8493	1	17	1	0	8512
6133	1	0	8574	0	0	8575
6134	0	28	2	8563	0	8593
6135	0	8	0	8474	0	8482
6136	8362	1	6	2	0	8371
6137	0	8396	0	3	0	8399
6138	8425	2	9	0	0	8436
6139	0	24	2	8380	0	8406
6140	4	23	0	8299	0	8326
6141	0	20	2	8109	0	8131
6142	1	12	0	8171	0	8184
6143	4	17	0	8178	0	8199
6144	1	8193	0	6	0	8200
6145	2	8158	0	0	0	8160
6146	0	8136	0	7	0	8143
6147	0	159	1	8028	0	8188
6148	12	0	8697	0	0	8709
6149	8774	0	19	5	0	8798
6150	0	9422	0	3	0	9425
6151	1	21	0	9380	0	9402
6152	0	7	0	9441	0	9448
6153	9504	1	11	2	0	9518
6154	9491	1	26	0	0	9518
6155	9758	2	24	3	0	9787
6156	1	19	1	9875	0	9896
6157	13	0	9751	1	0	9765
6158	6	0	9735	1	0	9742
6159	2	19	1	9242	0	9264
6160	13	0	9163	3	0	9179
6161	9622	0	20	5	0	9647
6162	1	29	1	9765	0	9796
6163	10	1	9927	0	0	9938
6164	4	24	1	9943	0	9972
6165	6	0	9800	4	0	9810
6166	10	0	9752	3	0	9765
6167	5	26	4	9710	0	9745
6168	9	0	9683	2	0	9694
6169	25	6	9558	5	0	9594
6170	0	9763	1	11	0	9775
6171	2	19	0	9705	0	9726
6172	9781	0	8	0	0	9789
6173	3	22	2	9775	0	9802
6174	0	11	0	10013	0	10024
6175	3	0	10293	3	0	10299
6176	10316	2	20	3	0	10341
6177	0	16	1	10550	0	10567
6178	0	4	0	10677	0	10681
6179	10752	3	13	1	0	10769
6180	0	6	1	10725	0	10732
6181	10565	1	9	1	0	10576
6182	10497	1	14	8	0	10520
6183	11138	8	26	2	0	11174
6184	1	11398	0	17	0	11416
6185	11019	0	20	2	0	11041
6186	0	12000	0	4	0	12004
6187	2	19	0	11852	0	11873
6188	12017	1	8	2	0	12028
6189	0	11987	1	7	0	11995
6190	11923	2	35	5	0	11965
6191	2	11522	0	4	0	11528
6192	11300	1	33	2	0	11336
6193	5	11443	0	11	0	11459
6194	6	11249	1	11	0	11267
6195	0	11348	0	8	0	11356
6196	2	39	2	11224	0	11267
6197	0	12280	0	2	0	12282
6198	1	56	0	12295	0	12352
6199	2	21	4	12286	0	12313
6200	3	38	1	12249	0	12291
6201	1	9	1	12358	0	12369
6202	12415	0	17	2	0	12434
6203	12363	0	20	6	0	12389
6204	10	0	12443	0	0	12453
6205	12542	0	51	3	0	12596
6206	12234	1	15	2	0	12252
6207	12034	0	24	6	0	12064
6208	8	0	12035	0	0	12043
6209	11	0	12167	4	0	12182
6210	12302	1	32	4	0	12339
6211	14	1	12598	0	0	12613
6212	1	12704	0	5	0	12710
6213	1	16	1	12688	0	12706
6214	12841	3	17	2	0	12863
6215	12983	3	22	2	0	13010
6216	13002	4	30	1	0	13037
6217	3	10	1	13374	0	13388
6218	2	13	0	13197	0	13212
6219	17	0	13160	3	0	13180
6220	4	44	2	13614	0	13664
6221	1	26	2	14345	0	14374
6222	15083	2	23	3	0	15111
6223	0	14611	0	12	0	14623
6224	14658	1	31	4	0	14694
6225	1	9	0	14677	0	14687
6226	14128	3	20	1	0	14152
6227	15046	2	27	3	0	15078
6228	15337	2	25	2	0	15366
6229	3	15402	0	3	0	15408
6230	2	15294	0	3	0	15299
6231	3	31	2	15215	0	15251
6232	15434	3	13	0	0	15450
6233	0	46	3	15498	0	15547
6234	0	23	0	15239	0	15262
6235	8	8	15388	1	0	15405
6236	3	50	1	15025	0	15079
6237	1	19	2	14869	0	14891
6238	3	25	1	14837	0	14866
6239	21	1	14468	1	0	14491
6240	9	1	14725	12	0	14747
6241	1	14893	1	14	0	14909
6242	15046	2	20	6	0	15074
6243	2	43	1	15202	0	15248
6244	19	0	15243	2	0	15264
6245	3	44	2	15208	0	15257
6246	0	26	0	15346	0	15372
6247	15397	2	20	2	0	15421
6248	15370	2	37	2	0	15411
6249	1	15378	0	12	0	15391
6250	15166	2	21	1	0	15190
6251	14915	2	28	4	0	14949
6252	6	22	0	13968	0	13996
6253	13	1	13605	2	0	13621
6254	1	13504	1	4	0	13510
6255	13413	1	34	1	0	13449
6256	13594	1	32	1	0	13628
6257	0	12958	0	11	0	12969
6258	4	29	5	13689	0	13727
6259	14133	1	6	0	0	14140
6260	13860	2	14	1	0	13877
6261	2	8	0	13918	0	13928
6262	12907	1	26	1	0	12935
6263	12830	2	27	0	0	12859
6264	12723	2	41	2	0	12768
6265	14	0	12816	1	0	12831
6266	2	12762	0	18	0	12782
6267	5	12327	0	9	0	12341
6268	12525	1	18	2	0	12546
6269	3	13035	1	5	0	13044
6270	14	2	13774	0	0	13790
6271	0	19	1	13632	0	13652
6272	13550	2	17	1	0	13570
6273	2	10	0	12750	0	12762
6274	12745	1	8	0	0	12754
6275	12717	5	24	8	0	12754
6276	13525	1	31	1	0	13558
6277	2	13939	0	7	0	13948
6278	2	13843	0	1	0	13846
6279	13515	0	15	2	0	13532
6280	13481	2	30	4	0	13517
6281	13655	1	23	4	0	13683
6282	1	14	0	14194	0	14209
6283	14332	1	16	1	0	14350
6284	1	14350	1	17	0	14369
6285	2	13972	0	6	0	13980
6286	6	38	3	13731	0	13778
6287	18	0	14982	3	0	15003
6288	11	0	16984	8	0	17003
6289	4	42	1	17083	0	17130
6290	9	0	17104	2	0	17115
6291	1	29	3	17034	0	17067
6292	17089	0	17	3	0	17109
6293	2	30	2	17030	0	17064
6294	17082	2	24	1	0	17109
6295	0	17121	0	17	0	17138
6296	16	2	16588	3	0	16609
6297	4	29	0	15834	0	15867
6298	0	37	2	15240	0	15279
6299	10	0	15629	2	0	15641
6300	5	59	0	16244	0	16308
6301	0	15640	1	3	0	15644
6302	2	59	2	15507	0	15570
6303	0	9	0	15625	0	15634
6304	1	18	5	15582	0	15606
6305	10	0	15397	3	0	15410
6306	13	1	15651	12	0	15677
6307	15340	2	40	7	0	15389
6308	29	0	15452	1	0	15482
6309	5	15443	1	19	0	15468
6310	15524	0	33	1	0	15558
6311	1	15442	0	48	0	15491
6312	15484	0	21	3	0	15508
6313	15490	2	23	5	0	15520
6314	15574	0	36	0	0	15610
6315	15587	0	26	1	0	15614
6316	1	15265	0	14	0	15280
6317	0	15093	0	8	0	15101
6318	15081	3	19	5	0	15108
6319	19	0	15077	1	0	15097
6320	1	21	0	14810	0	14832
6321	2	24	2	14726	0	14754
6322	1	0	14484	2	0	14487
6323	14531	0	27	4	0	14562
6324	14528	1	15	4	0	14548
6325	14889	4	29	2	0	14924
6326	0	15313	0	26	0	15339
6327	15300	2	24	2	0	15328
6328	2	22	2	15186	0	15212
6329	2	15072	0	7	0	15081
6330	14954	3	29	4	0	14990
6331	15080	1	16	0	0	15097
6332	14991	1	15	3	0	15010
6333	1	18	3	14825	0	14847
6334	1	28	1	14053	0	14083
6335	0	13820	0	7	0	13827
6336	7	0	13887	1	0	13895
6337	5	55	3	14045	0	14108
6338	3	24	1	14193	0	14221
6339	0	21	2	14227	0	14250
6340	11	0	14411	1	0	14423
6341	14831	3	50	4	0	14888
6342	0	41	0	14966	0	15007
6343	20	0	15341	4	0	15365
6344	3	25	0	15299	0	15327
6345	15052	0	21	4	0	15077
6346	1	14333	0	7	0	14341
6347	8	23	6	14288	0	14325
6348	5	0	14279	5	0	14289
6349	14669	0	23	4	0	14696
6350	14774	0	42	7	0	14823
6351	11	0	15017	0	0	15028
6352	8	31	1	14298	0	14338
6353	3	13900	0	12	0	13915
6354	13608	0	33	5	0	13646
6355	5	0	13682	0	0	13687
6356	13503	0	54	6	0	13563
6357	9	0	13497	0	0	13506
6358	1	0	13195	2	0	13198
6359	13368	1	19	1	0	13389
6360	1	12946	1	11	0	12959
6361	21	0	12935	1	0	12957
6362	2	12030	1	6	0	12039
6363	10	0	12050	0	0	12060
6364	5	10409	0	12	0	10426
6365	10421	1	20	1	0	10443
6366	3	0	10758	0	0	10761
6367	7	0	10945	0	0	10952
6368	18	0	11143	2	0	11163
6369	11263	0	17	3	0	11283
6370	11336	0	42	2	0	11380
6371	4	15	3	11365	0	11387
6372	10	1	11908	1	0	11920
6373	19	1	11917	5	0	11942
6374	11841	0	21	4	0	11866
6375	2	14	1	11132	0	11149
6376	11183	2	15	1	0	11201
6377	10926	3	17	1	0	10947
6378	0	34	2	11213	0	11249
6379	2	11261	0	1	0	11264
6380	2	30	2	11111	0	11145
6381	1	10	0	11281	0	11292
6382	14	0	11233	4	0	11251
6383	4	11224	0	8	0	11236
6384	1	11219	0	8	0	11228
6385	3	39	1	11230	0	11273
6386	11	1	11247	1	0	11260
6387	3	11426	0	11	0	11440
6388	5	0	11454	1	0	11460
6389	11401	2	18	1	0	11422
6390	11228	1	31	0	0	11260
6391	3	0	11734	0	0	11737
6392	12140	1	24	0	0	12165
6393	4	26	2	12549	0	12581
6394	0	12559	1	11	0	12571
6395	1	26	1	12605	0	12633
6396	12623	0	15	0	0	12638
6397	12651	0	34	0	0	12685
6398	12640	0	41	3	0	12684
6399	12654	7	45	2	0	12708
6400	2	12814	0	12	0	12828
6401	1	12171	0	10	0	12182
6402	11855	2	19	2	0	11878
6403	6	0	12024	0	0	12030
6404	4	44	4	12072	0	12124
6405	1	12215	0	2	0	12218
6406	4	51	1	12047	0	12103
6407	1	12907	0	14	0	12922
6408	1	33	4	13113	0	13151
6409	6	1	13253	0	0	13260
6410	13449	1	35	8	0	13493
6411	13374	1	51	2	0	13428
6412	13	0	13316	1	0	13330
6413	13528	1	33	2	0	13564
6414	13392	1	30	0	0	13423
6415	1	0	13753	1	0	13755
6416	0	22	1	13359	0	13382
6417	13041	0	20	1	0	13062
6418	8	0	13197	1	0	13206
6419	2	37	1	14408	0	14448
6420	15	0	14411	0	0	14426
6421	16	0	14259	5	0	14280
6422	14140	1	28	4	0	14173
6423	14362	2	23	4	0	14391
6424	13916	0	51	5	0	13972
6425	14706	2	28	2	0	14738
6426	1	23	4	14500	0	14528
6427	4	14311	0	9	0	14324
6428	0	14314	1	8	0	14323
6429	2	37	0	14274	0	14313
6430	14624	2	15	1	0	14642
6431	3	14562	0	17	0	14582
6432	2	14461	0	15	0	14478
6433	14672	2	27	2	0	14703
6434	3	37	0	14376	0	14416
6435	14526	2	20	6	0	14554
6436	1	14765	0	2	0	14768
6437	14420	3	32	2	0	14457
6438	5	1	14539	1	0	14546
6439	15061	0	27	6	0	15094
6440	15067	1	30	1	0	15099
6441	14995	1	43	2	0	15041
6442	5	0	14497	5	0	14507
6443	14480	1	32	1	0	14514
6444	0	14266	0	8	0	14274
6445	28	1	14238	0	0	14267
6446	2	45	0	14299	0	14346
6447	3	41	5	14120	0	14169
6448	0	13901	0	3	0	13904
6449	3	33	2	13904	0	13942
6450	1	26	4	13931	0	13962
6451	13	1	13964	0	0	13978
6452	13470	1	46	4	0	13521
6453	12	0	13770	1	0	13783
6454	3	41	8	13663	0	13715
6455	8	0	13716	0	0	13724
6456	1	24	1	13738	0	13764
6457	13336	2	9	0	0	13347
6458	13302	5	40	1	0	13348
6459	3	26	2	13396	0	13427
6460	5	0	13515	1	0	13521
6461	3	28	1	13364	0	13396
6462	18	0	13084	0	0	13102
6463	13241	0	41	7	0	13289
6464	13224	0	29	3	0	13256
6465	13157	4	54	3	0	13218
6466	13208	7	22	1	0	13238
6467	5	12718	1	14	0	12738
6468	3	28	1	12589	0	12621
6469	12632	0	24	2	0	12658
6470	5	12571	1	4	0	12581
6471	1	12508	1	12	0	12522
6472	5	0	12549	1	0	12555
6473	12796	4	6	1	0	12807
6474	12799	2	36	2	0	12839
6475	7	0	13082	0	0	13089
6476	1	37	2	13128	0	13168
6477	0	38	2	13767	0	13807
6478	7	1	14106	0	0	14114
6479	3	27	1	14441	0	14472
6480	14336	0	28	3	0	14367
6481	2	1	14235	6	0	14244
6482	3	0	14114	2	0	14119
6483	13429	1	44	1	0	13475
6484	10	1	13365	1	0	13377
6485	13953	2	36	8	0	13999
6486	3	14397	0	8	0	14408
6487	14218	1	33	3	0	14255
6488	3	44	4	14236	0	14287
6489	1	16	1	14263	0	14281
6490	14615	0	14	2	0	14631
6491	4	23	0	14397	0	14424
6492	15256	0	23	2	0	15281
6493	1	15120	0	5	0	15126
6494	1	42	1	13714	0	13758
6495	6	6	0	13399	0	13411
6496	13116	3	7	2	0	13128
6497	13210	1	24	0	0	13235
6498	13281	3	15	0	0	13299
6499	2	13026	0	3	0	13031
6500	1	12640	2	10	0	12653
6501	12020	1	18	3	0	12042
6502	27	0	12244	2	0	12273
6503	1	13487	0	9	0	13497
6504	13638	0	23	2	0	13663
6505	13657	2	18	1	0	13678
6506	13421	0	18	2	0	13441
6507	2	8	0	13522	0	13532
6508	13661	0	13	0	0	13674
6509	13426	2	20	1	0	13449
6510	1	6	0	13411	0	13418
6511	12755	1	12	2	0	12770
6512	2	1	12720	2	0	12725
6513	2	15	7	12442	0	12466
6514	2	15	3	12634	0	12654
6515	3	2	6	12718	0	12729
6516	12868	0	2	1	0	12871
6517	13042	1	6	0	0	13049
6518	13150	1	2	1	0	13154
6519	13009	4	20	0	0	13033
6520	13006	1	8	3	0	13018
6521	0	6	1	12950	0	12957
6522	5	6	2	12943	0	12956
6523	13038	3	16	3	0	13060
6524	0	12940	1	9	0	12950
6525	12894	1	29	2	0	12926
6526	10	1	12917	1	0	12929
6527	13424	0	14	7	0	13445
6528	13319	3	34	0	0	13356
6529	10	0	13254	1	0	13265
6530	12841	1	43	5	0	12890
6531	3	0	13098	6	0	13107
6532	14	0	13728	1	0	13743
6533	3	26	3	13843	0	13875
6534	2	25	5	14091	0	14123
6535	30	0	13961	0	0	13991
6536	27	0	13952	3	0	13982
6537	10	14861	3	35	0	14909
6538	4	14899	0	9	0	14912
6539	15037	1	44	9	0	15091
6540	6	15010	0	8	0	15024
6541	15149	1	30	1	0	15181
6542	7	14991	2	3	0	15003
6543	14553	1	33	2	0	14589
6544	9	0	15470	0	0	15479
6545	16096	1	33	2	0	16132
6546	1	47	3	16457	0	16508
6547	6	16582	0	2	0	16590
6548	2	57	0	16416	0	16475
6549	16552	1	9	1	0	16563
6550	16447	2	38	3	0	16490
6551	2	20	9	16236	0	16267
6552	14	1	16029	0	0	16044
6553	17	0	15302	3	0	15322
6554	2	14983	0	13	0	14998
6555	1	39	1	14639	0	14680
6556	15	1	14816	1	0	14833
6557	4	14880	0	6	0	14890
6558	3	31	1	14935	0	14970
6559	0	15	1	15586	0	15602
6560	15808	1	14	5	0	15828
6561	3	32	0	14916	0	14951
6562	12	2	14461	0	0	14475
6563	3	33	1	14395	0	14432
6564	14293	1	21	2	0	14317
6565	8	0	14263	2	0	14273
6566	13989	0	29	1	0	14019
6567	3	13601	2	80	0	13686
6568	13223	0	21	2	0	13246
6569	14472	1	24	2	0	14499
6570	1	42	0	14510	0	14553
6571	2	52	1	14444	0	14499
6572	5	14612	0	4	0	14621
6573	3	38	2	14541	0	14584
6574	14626	0	18	0	0	14644
6575	7	0	14735	1	0	14743
6576	4	34	2	14685	0	14725
6577	1	14410	0	4	0	14415
6578	4	40	1	13147	0	13192
6579	1	24	0	13208	0	13233
6580	13179	0	11	2	0	13192
6581	0	13406	0	1	0	13407
6582	3	29	1	13942	0	13975
6583	14225	10	16	0	0	14251
6584	0	45	0	15033	0	15078
6585	2	18	0	15298	0	15318
6586	15261	6	13	4	0	15284
6587	15237	1	21	3	0	15262
6588	5	0	15193	2	0	15200
6589	15128	0	30	0	0	15158
6590	14726	1	35	2	0	14764
6591	14849	0	44	2	0	14895
6592	0	15234	0	6	0	15240
6593	2	15009	0	7	0	15018
6594	1	35	1	14949	0	14986
6595	15140	0	28	2	0	15170
6596	15447	1	22	2	0	15472
6597	0	18	0	15583	0	15601
6598	1	0	16244	2	0	16247
6599	16047	2	21	6	0	16076
6600	15998	2	29	3	0	16032
6601	1	12	3	15853	0	15869
6602	1	6	3	16244	0	16254
6603	17656	1	27	0	0	17684
6604	2	21	3	17547	0	17573
6605	1	17671	0	6	0	17678
6606	4	28	0	17834	0	17866
6607	17234	2	33	3	0	17272
6608	9	1	17366	3	0	17379
6609	17802	3	61	5	0	17871
6610	10	0	18556	3	0	18569
6611	6	20	3	18760	0	18789
6612	17767	1	21	2	0	17791
6613	1	27	2	17758	0	17788
6614	0	18	1	17972	0	17991
6615	17830	3	47	2	0	17882
6616	8	0	17774	3	0	17785
6617	21	1	17920	5	0	17947
6618	1	33	1	17510	0	17545
6619	2	25	1	17261	0	17289
6620	0	19	3	16586	0	16608
6621	5	1	16471	3	0	16480
6622	16082	0	28	2	0	16112
6623	16069	1	21	1	0	16092
6624	16007	1	52	4	0	16064
6625	15965	5	52	0	0	16022
6626	2	16372	0	7	0	16381
6627	2	16251	0	19	0	16272
6628	2	16205	1	6	0	16214
6629	4	24	1	16287	0	16316
6630	2	31	0	16344	0	16377
6631	17	0	16323	6	0	16346
6632	1	16105	0	8	0	16114
6633	1	26	0	16155	0	16182
6634	16383	2	34	1	0	16420
6635	0	15775	0	12	0	15787
6636	9	57	0	15466	0	15532
6637	0	15672	0	17	0	15689
6638	15594	3	35	4	0	15636
6639	5	29	7	15762	0	15803
6640	20	0	15616	1	0	15637
6641	9	0	15845	3	0	15857
6642	2	30	4	16091	0	16127
6643	2	27	2	15699	0	15730
6644	2	18	0	15988	0	16008
6645	14724	2	23	3	0	14752
6646	23	0	14609	2	0	14634
6647	1	14601	1	16	0	14619
6648	2	43	2	14482	0	14529
6649	15	0	14755	7	0	14777
6650	0	15079	0	11	0	15090
6651	3	40	4	15274	0	15321
6652	4	0	15932	2	0	15938
6653	1	28	1	15982	0	16012
6654	5	19	0	16305	0	16329
6655	16496	1	19	6	0	16522
6656	17092	0	39	2	0	17133
6657	4	25	1	16846	0	16876
6658	16158	5	27	2	0	16192
6659	2	0	15871	1	0	15874
6660	3	34	3	14881	0	14921
6661	11	0	14746	2	0	14759
6662	4	50	2	14927	0	14983
6663	8	15078	0	11	0	15097
6664	4	15888	0	13	0	15905
6665	1	15857	1	16	0	15875
6666	1	42	4	16493	0	16540
6667	3	30	3	16530	0	16566
6668	10	0	16152	3	0	16165
6669	25	0	16198	4	0	16227
6670	22	2	16328	4	0	16356
6671	16095	3	49	6	0	16153
6672	2	27	0	15971	0	16000
6673	15721	2	21	3	0	15747
6674	0	15531	0	8	0	15539
6675	1	26	0	18074	0	18101
6676	18369	2	37	5	0	18413
6677	3	25	0	18437	0	18465
6678	17912	0	39	2	0	17953
6679	14	0	16807	1	0	16822
6680	1	16658	0	7	0	16666
6681	5	9	0	16775	0	16789
6682	16662	0	10	1	0	16673
6683	15926	3	13	2	0	15944
6684	1	11	0	15782	0	15794
6685	1	18	0	15563	0	15582
6686	15590	0	9	2	0	15601
6687	2	42	0	15538	0	15582
6688	15	0	15530	6	0	15551
6689	0	15525	0	19	0	15544
6690	3	28	0	15339	0	15370
6691	15698	3	26	3	0	15730
6692	15504	2	32	4	0	15542
6693	6	1	15662	2	0	15671
6694	10	15611	1	20	0	15642
6695	2	15558	0	37	0	15597
6696	2	66	5	15454	0	15527
6697	0	36	1	15852	0	15889
6698	2	33	1	16528	0	16564
6699	2	16	0	16589	0	16607
6700	0	16302	0	8	0	16310
6701	6	35	2	16202	0	16245
6702	2	21	0	16270	0	16293
6703	16146	0	26	3	0	16175
6704	16239	3	63	2	0	16307
6705	1	16774	1	12	0	16788
6706	16632	0	26	2	0	16660
6707	16553	2	5	6	0	16566
6708	16425	3	48	2	0	16478
6709	18	0	16742	0	0	16760
6710	2	33	1	16938	0	16974
6711	2	36	0	17019	0	17057
6712	23	0	17095	0	0	17118
6713	4	30	1	17190	0	17225
6714	1	29	1	17312	0	17343
6715	17173	1	47	4	0	17225
6716	4	3	17259	0	0	17266
6717	2	26	1	17138	0	17167
6718	17013	6	26	0	0	17045
6719	0	16965	0	31	0	16996
6720	16666	0	56	3	0	16725
6721	16959	5	45	1	0	17010
6722	0	17393	0	6	0	17399
6723	10	27	1	17533	0	17571
6724	17803	1	15	1	0	17820
6725	2	16759	0	7	0	16768
6726	1	24	0	17352	0	17377
6727	17344	0	30	3	0	17377
6728	16739	3	34	8	0	16784
6729	3	16989	0	11	0	17003
6730	16680	2	41	4	0	16727
6731	2	19	0	17687	0	17708
6732	16880	0	30	1	0	16911
6733	7	0	17314	0	0	17321
6734	1	54	1	17365	0	17421
6735	1	18	0	17275	0	17294
6736	17275	2	30	2	0	17309
6737	2	17076	0	9	0	17087
6738	16916	2	34	1	0	16953
6739	3	16710	0	18	0	16731
6740	11	1	15714	3	0	15729
6741	6	0	17266	3	0	17275
6742	2	29	3	16719	0	16753
6743	18	0	16999	1	0	17018
6744	0	25	7	17027	0	17059
6745	3	34	2	16754	0	16793
6746	3	29	0	16834	0	16866
6747	16719	0	8	3	0	16730
6748	16598	1	28	4	0	16631
6749	16465	0	37	0	0	16502
6750	3	15977	0	8	0	15988
6751	0	13160	0	13	0	13173
6752	13	1	13345	1	0	13360
6753	5	16	0	13392	0	13413
6754	5	0	13216	2	0	13223
6755	1	32	2	13145	0	13180
6756	1	28	2	13116	0	13147
6757	3	17	2	13012	0	13034
6758	26	0	13305	1	0	13332
6759	1	28	0	13461	0	13490
6760	13493	0	13	0	0	13506
6761	1	13192	0	11	0	13204
6762	3	9	0	12498	0	12510
6763	12825	0	13	1	0	12839
6764	12964	0	5	3	0	12972
6765	1	20	1	13679	0	13701
6766	2	10	0	13717	0	13729
6767	13235	0	3	1	0	13239
6768	0	8	0	13181	0	13189
6769	13009	4	13	4	0	13030
6770	2	27	0	12954	0	12983
6771	8	0	13025	4	0	13037
6772	2	13693	0	11	0	13706
6773	1	13549	0	3	0	13553
6774	2	22	1	12872	0	12897
6775	3	15	0	12907	0	12925
6776	13084	0	3	3	0	13090
6777	4	14	4	13476	0	13498
6778	3	35	0	13372	0	13410
6779	4	46	1	13537	0	13588
6780	0	13582	2	8	0	13592
6781	3	64	1	12931	0	12999
6782	3	24	4	13337	0	13368
6783	0	19	1	13350	0	13370
6784	14159	0	10	2	0	14171
6785	0	14059	0	4	0	14063
6786	0	36	0	13668	0	13704
6787	2	18	1	14466	0	14487
6788	2	15	1	14428	0	14446
6789	14472	0	6	2	0	14480
6790	1	13	0	14363	0	14377
6791	1	24	1	14419	0	14445
6792	14	7	14292	5	0	14318
6793	0	14923	1	9	0	14933
6794	1	28	0	15258	0	15287
6795	15283	1	21	2	0	15307
6796	0	15185	1	15	0	15201
6797	15608	1	34	1	0	15644
6798	15611	1	25	1	0	15638
6799	3	32	0	15602	0	15637
6800	2	35	3	15438	0	15478
6801	17	0	15364	7	0	15388
6802	4	35	1	15081	0	15121
6803	3	0	15041	4	0	15048
6804	7	28	1	16884	0	16920
6805	16716	0	28	10	0	16754
6806	2	16051	0	5	0	16058
6807	2	73	4	15629	0	15708
6808	3	31	2	15749	0	15785
6809	1	25	1	15306	0	15333
6810	1	11	0	15358	0	15370
6811	15375	0	22	2	0	15399
6812	0	15353	0	4	0	15357
6813	1	20	0	15353	0	15374
6814	15193	0	12	2	0	15207
6815	11	0	14951	1	0	14963
6816	14948	3	34	7	0	14992
6817	13613	1	45	1	0	13660
6818	8	0	13787	2	0	13797
6819	3	16	4	13426	0	13449
6820	13419	0	28	1	0	13448
6821	0	13536	1	11	0	13548
6822	13496	1	45	2	0	13544
6823	13445	2	28	1	0	13476
6824	13406	2	9	2	0	13419
6825	1	18	3	13585	0	13607
6826	1	21	1	13730	0	13753
6827	0	13282	0	7	0	13289
6828	2	21	4	13229	0	13256
6829	13249	1	18	4	0	13272
6830	15	0	13355	3	0	13373
6831	13354	0	36	3	0	13393
6832	13469	0	24	3	0	13496
6833	2	12	0	13629	0	13643
6834	0	10	1	13187	0	13198
6835	13168	0	8	1	0	13177
6836	13103	1	20	0	0	13124
6837	13034	0	48	0	0	13082
6838	8	0	13108	0	0	13116
6839	1	13422	0	14	0	13437
6840	13395	1	29	2	0	13427
6841	2	26	5	12724	0	12757
6842	4	12825	0	9	0	12838
6843	4	23	1	12779	0	12807
6844	12951	1	24	0	0	12976
6845	2	17	0	12913	0	12932
6846	10	8	12953	2	0	12973
6847	4	12644	2	17	0	12667
6848	1	12154	1	7	0	12163
6849	11	0	12253	3	0	12267
6850	12224	1	25	4	0	12254
6851	0	12200	0	9	0	12209
6852	0	22	0	12239	0	12261
6853	12283	0	18	0	0	12301
6854	1	12493	1	4	0	12499
6855	1	17	0	12359	0	12377
6856	12618	1	19	3	0	12641
6857	4	22	1	12625	0	12652
6858	12239	1	31	0	0	12271
6859	20	0	12351	0	0	12371
6860	3	11454	1	12	0	11470
6861	11514	2	20	0	0	11536
6862	11497	0	14	3	0	11514
6863	10625	1	24	1	0	10651
6864	7	0	10903	0	0	10910
6865	11240	0	11	2	0	11253
6866	11346	0	21	0	0	11367
6867	1	6	0	11281	0	11288
6868	10966	1	22	4	0	10993
6869	0	11406	1	5	0	11412
6870	5	23	3	11203	0	11234
6871	21	0	11565	0	0	11586
6872	3	33	1	11480	0	11517
6873	1	13	0	11327	0	11341
6874	11023	0	9	1	0	11033
6875	10759	3	21	6	0	10789
6876	4	0	10774	0	0	10778
6877	10739	3	36	2	0	10780
6878	4	0	10873	0	0	10877
6879	1	19	4	9073	0	9097
6880	6	0	9014	0	0	9020
6881	1	16	0	9790	0	9807
6882	2	9547	0	70	0	9619
6883	9	0	9596	1	0	9606
6884	7	0	9634	1	0	9642
6885	2	7	1	9706	0	9716
6886	9603	1	5	0	0	9609
6887	9518	1	13	1	0	9533
6888	9620	1	9	2	0	9632
6889	1	18	1	9603	0	9623
6890	2	12	4	9558	0	9576
6891	1	15	2	9532	0	9550
6892	0	16	2	9606	0	9624
6893	7	0	9736	0	0	9743
6894	2	25	2	9623	0	9652
6895	0	9644	1	6	0	9651
6896	1	7	1	9642	0	9651
6897	9470	2	24	0	0	9496
6898	8	0	9473	2	0	9483
6899	9477	0	30	2	0	9509
6900	15	0	9507	0	0	9522
6901	12	1	9523	2	0	9538
6902	0	9703	0	12	0	9715
6903	2	26	0	9661	0	9689
6904	1	26	0	9790	0	9817
6905	1	9681	0	9	0	9691
6906	9775	0	12	0	0	9787
6907	0	19	0	9861	0	9880
6908	2	12	0	9872	0	9886
6909	2	4	0	9742	0	9748
6910	9616	0	8	1	0	9625
6911	9602	1	8	2	0	9613
6912	0	16	1	9733	0	9750
6913	2	7	0	9735	0	9744
6914	9701	0	3	1	0	9705
6915	0	8	0	9111	0	9119
6916	1	9	0	9108	0	9118
6917	0	23	5	9070	0	9098
6918	3	0	9029	0	0	9032
6919	9110	0	16	2	0	9128
6920	9042	0	32	2	0	9076
6921	6	0	9085	0	0	9091
6922	2	22	0	9256	0	9280
6923	0	9166	0	3	0	9169
6924	9286	0	32	0	0	9318
6925	1	9191	1	5	0	9198
6926	2	8937	0	8	0	8947
6927	2	15	0	8992	0	9009
6928	8989	1	2	1	0	8993
6929	9055	0	16	0	0	9071
6930	2	10	0	8679	0	8691
6931	2	18	2	8670	0	8692
6932	1	20	2	8715	0	8738
6933	0	17	1	8685	0	8703
6934	1	23	0	8632	0	8656
6935	0	8403	1	1	0	8405
6936	1	17	0	8414	0	8432
6937	8412	0	6	0	0	8418
6938	8309	3	15	1	0	8328
6939	8358	3	26	2	0	8389
6940	0	8259	0	4	0	8263
6941	3	18	2	7941	0	7964
6942	4	0	8263	1	0	8268
6943	8535	1	26	1	0	8563
6944	0	5	1	8568	0	8574
6945	7630	2	10	0	0	7642
6946	7482	0	5	0	0	7487
6947	7813	0	8	0	0	7821
6948	2	6	0	7914	0	7922
6949	7757	0	6	2	0	7765
6950	2	6	0	7773	0	7781
6951	1	11	1	7470	0	7483
6952	7538	0	6	1	0	7545
6953	0	2	0	7525	0	7527
6954	7494	2	1	0	0	7497
6955	7503	1	4	1	0	7509
6956	0	21	1	6653	0	6675
6957	1	16	0	6546	0	6563
6958	4	17	1	6506	0	6528
6959	6	0	6642	1	0	6649
6960	9	0	6874	2	0	6885
6961	2	17	1	6791	0	6811
6962	0	17	2	6810	0	6829
6963	1	13	0	7033	0	7047
6964	0	8	0	7077	0	7085
6965	0	8	0	7090	0	7098
6966	7213	1	7	0	0	7221
6967	0	7682	0	5	0	7687
6968	1	3	0	7618	0	7622
6969	7989	0	15	6	0	8010
6970	3	20	2	7980	0	8005
6971	2	6	0	7984	0	7992
6972	7977	1	7	2	0	7987
6973	7906	1	14	1	0	7922
6974	7	0	8182	0	0	8189
6975	5	11	0	8903	0	8919
6976	0	0	8789	1	0	8790
6977	2	11	8	8563	0	8584
6978	1	14	1	8516	0	8532
6979	1	12	1	8638	0	8652
6980	3	1	8707	2	0	8713
6981	8	9304	0	13	0	9325
6982	1	9390	0	1	0	9392
6983	2	10	1	9373	0	9386
6984	9602	1	14	2	0	9619
6985	6	0	9844	1	0	9851
6986	7	0	10660	2	0	10669
6987	2	28	6	10778	0	10814
6988	1	29	2	12515	0	12547
6989	1	13988	0	8	0	13997
6990	0	28	2	14171	0	14201
6991	0	17	0	14933	0	14950
6992	2	17	1	15189	0	15209
6993	15828	0	8	5	0	15841
6994	15875	1	21	3	0	15900
6995	0	27	0	15729	0	15756
6996	0	17231	0	2	0	17233
6997	3	23	0	16967	0	16993
6998	17502	0	21	4	0	17527
6999	1	17524	15	6	0	17546
7000	6	47	2	17427	0	17482
7001	1	17609	0	16	0	17626
7002	17670	0	24	3	0	17697
7003	17755	2	55	3	0	17815
7004	0	17832	0	13	0	17845
7005	4	17704	1	24	0	17733
7006	9	0	17744	5	0	17758
7007	3	17630	0	11	0	17644
7008	2	17	2	17570	0	17591
7009	23	0	19058	2	0	19083
7010	1	19277	1	12	0	19291
7011	2	61	3	19231	0	19297
7012	3	39	2	19264	0	19308
7013	2	24	0	19432	0	19458
7014	19433	4	21	0	0	19458
7015	26	0	19495	1	0	19522
7016	6	1	20150	2	0	20159
7017	3	39	8	19999	0	20049
7018	12	1	19975	2	0	19990
7019	6	32	5	19835	0	19878
7020	1	41	3	19882	0	19927
7021	2	38	3	19922	0	19965
7022	3	20	0	20139	0	20162
7023	19442	3	12	3	0	19460
7024	19393	3	37	1	0	19434
7025	1	42	4	19392	0	19439
7026	17	0	19902	3	0	19922
7027	9	58	0	19799	0	19866
7028	1	19925	2	11	0	19939
7029	4	37	1	19860	0	19902
7030	20811	1	24	1	0	20837
7031	20959	2	37	2	0	21000
7032	2	16	1	21225	0	21244
7033	3	35	6	21172	0	21216
7034	3	24	2	21330	0	21359
7035	20956	1	37	2	0	20996
7036	10	0	20943	2	0	20955
7037	19	3	20988	9	0	21019
7038	4	22400	2	28	0	22434
7039	22316	4	48	7	0	22375
7040	2	48	2	22442	0	22494
7041	15	0	22914	0	0	22929
7042	3	24043	2	19	0	24067
7043	2	24031	0	8	0	24041
7044	1	54	3	24460	0	24518
7045	6	55	4	24430	0	24495
7046	0	25167	0	6	0	25173
7047	10	56	2	26365	0	26433
7048	1	47	1	29293	0	29342
7049	29493	1	34	5	0	29533
7050	1	29546	0	15	0	29562
7051	7	88	6	28617	0	28718
7052	10	2	29663	3	0	29678
7053	10	32	1	29738	0	29781
7054	29942	1	29	8	0	29980
7055	0	30373	0	21	0	30394
7056	6	55	3	29713	0	29777
7057	35	3	31113	24	0	31175
7058	14	0	31849	10	0	31873
7059	19	118	3	32195	0	32335
7060	6	46	3	32132	0	32187
7061	31600	1	55	8	0	31664
7062	1	31246	2	17	0	31266
7063	31104	0	71	12	0	31187
7064	12	3	29485	2	0	29502
7065	28181	0	95	12	0	28288
7066	26	2	28205	1	0	28234
7067	27552	4	77	8	0	27641
7068	27396	5	106	10	0	27517
7069	13	0	27132	1	0	27146
7070	15	0	27294	6	0	27315
7071	1	26562	0	21	0	26584
7072	1	39	2	26684	0	26726
7073	26937	2	39	2	0	26980
7074	2	61	4	26412	0	26479
7075	2	48	0	26498	0	26548
7076	6	76	2	26471	0	26555
7077	10	0	26273	4	0	26287
7078	26594	0	51	9	0	26654
7079	26918	0	47	4	0	26969
7080	1	27068	0	12	0	27081
7081	10	78	5	26692	0	26785
7082	13	28434	1	29	0	28477
7083	3	43	1	28476	0	28523
7084	28687	3	40	14	0	28744
7085	0	27262	0	15	0	27277
7086	5	68	3	27490	0	27566
7087	27895	5	37	2	0	27939
7088	28058	6	43	4	0	28111
7089	2	47	1	28387	0	28437
7090	24	1	28405	5	0	28435
7091	7	69	1	27799	0	27876
7092	5	27679	0	17	0	27701
7093	27680	5	52	8	0	27745
7094	10	28614	1	10	0	28635
7095	4	34	2	28630	0	28670
7096	29108	1	34	2	0	29145
7097	5	70	1	29650	0	29726
7098	1	58	1	29608	0	29668
7099	37	2	29391	15	0	29445
7100	1	29690	1	36	0	29728
7101	29667	0	60	4	0	29731
7102	29593	4	76	10	0	29683
7103	8	29453	0	10	0	29471
7104	3	30238	0	27	0	30268
7105	1	53	2	30261	0	30317
7106	30982	1	37	1	0	31021
7107	1	30860	0	8	0	30869
7108	15	64	2	30656	0	30737
7109	25	1	31957	1	0	31984
7110	5	64	2	31926	0	31997
7111	32390	0	30	6	0	32426
7112	1	32321	0	14	0	32336
7113	12	60	3	30917	0	30992
7114	39	0	32138	6	0	32183
7115	26	0	36056	14	0	36096
7116	7	104	2	36616	0	36729
7117	6	94	1	35963	0	36064
7118	1	33907	0	20	0	33928
7119	11	46	2	33818	0	33877
7120	34134	1	36	2	0	34173
7121	5	60	0	34205	0	34270
7122	34604	0	35	7	0	34646
7123	5	33636	1	22	0	33664
7124	3	30410	0	9	0	30422
7125	5	72	1	30565	0	30643
7126	7	81	3	30607	0	30698
7127	21	1	30768	5	0	30795
7128	7	36	5	30023	0	30071
7129	29560	2	40	3	0	29605
7130	14	0	29963	1	0	29978
7131	4	51	4	29044	0	29103
7132	14	0	29054	6	0	29074
7133	6	80	14	27149	0	27249
7134	4	59	6	26894	0	26963
7135	4	73	0	26725	0	26802
7136	30	1	27113	3	0	27147
7137	7	96	0	27310	0	27413
7138	0	27135	0	7	0	27142
7139	6	59	6	26335	0	26406
7140	1	32	1	26494	0	26528
7141	26130	7	42	5	0	26184
7142	18	0	26210	4	0	26232
7143	9	166	2	26106	0	26283
7144	31	0	26471	3	0	26505
7145	27	0	26093	6	0	26126
7146	3	49	12	25980	0	26044
7147	10	80	4	25822	0	25916
7148	1	22	0	25965	0	25988
7149	25548	3	21	3	0	25575
7150	3	2	25653	2	0	25660
7151	25272	1	49	5	0	25327
7152	4	73	3	25495	0	25575
7153	3	60	4	25080	0	25147
7154	2	25449	0	8	0	25459
7155	1	64	2	25607	0	25674
7156	3	31	5	25957	0	25996
7157	2	17	3	26032	0	26054
7158	24383	1	26	4	0	24414
7159	27	1	24318	5	0	24351
7160	24216	0	58	10	0	24284
7161	1	24687	0	12	0	24700
7162	24344	5	46	5	0	24400
7163	3	24334	0	12	0	24349
7164	3	23908	1	18	0	23930
7165	6	49	1	23917	0	23973
7166	23947	3	23	3	0	23976
7167	15	50	4	24167	0	24236
7168	6	23997	2	20	0	24025
7169	0	23646	0	12	0	23658
7170	2	63	3	22844	0	22912
7171	11	82	2	22969	0	23064
7172	2	22732	0	11	0	22745
7173	2	106	0	22466	0	22574
7174	9	47	0	22548	0	22604
7175	0	24	0	22645	0	22669
7176	22397	2	31	1	0	22431
7177	21	5	22316	2	0	22344
7178	22415	3	33	8	0	22459
7179	22385	1	38	3	0	22427
7180	20980	3	38	2	0	21023
7181	1	21629	0	4	0	21634
7182	4	39	2	22175	0	22220
7183	22528	2	19	2	0	22551
7184	1	44	0	22739	0	22784
7185	21662	3	27	4	0	21696
7186	0	22280	0	8	0	22288
7187	21566	3	41	2	0	21612
7188	21784	5	40	6	0	21835
7189	21998	2	26	4	0	22030
7190	4	40	4	18866	0	18914
7191	1	29	1	17017	0	17048
7192	16504	0	19	5	0	16528
7193	1	16592	1	10	0	16604
7194	0	17075	1	19	0	17095
7195	16979	0	22	1	0	17002
7196	1	38	0	16658	0	16697
7197	3	50	0	16537	0	16590
7198	2	44	1	15749	0	15796
7199	0	15162	1	7	0	15170
7200	15147	1	24	4	0	15176
7201	2	54	1	14943	0	15000
7202	0	14918	0	6	0	14924
7203	3	59	1	15013	0	15076
7204	1	20	0	15165	0	15186
7205	2	14	0	15564	0	15580
7206	4	11	0	15157	0	15172
7207	15135	1	15	4	0	15155
7208	14917	3	23	1	0	14944
7209	14977	3	21	1	0	15002
7210	2	29	2	15187	0	15220
7211	23	0	15080	1	0	15104
7212	8	0	14965	5	0	14978
7213	10	1	14892	5	0	14908
7214	14937	1	20	8	0	14966
7215	3	34	0	15484	0	15521
7216	3	35	0	15843	0	15881
7217	3	15	0	15961	0	15979
7218	15963	0	16	13	0	15992
7219	15966	0	16	1	0	15983
7220	1	15426	0	4	0	15431
7221	4	20	0	14964	0	14988
7222	12	0	15414	0	0	15426
7223	0	15399	1	2	0	15402
7224	6	52	1	12062	0	12121
7225	3	40	0	12082	0	12125
7226	3	27	1	12782	0	12813
7227	4	31	2	12865	0	12902
7228	9	0	12853	2	0	12864
7229	17	4	12658	4	0	12683
7230	2	11930	2	6	0	11940
7231	5	21	2	11778	0	11806
7232	2	9	0	12102	0	12113
7233	12078	3	16	0	0	12097
7234	3	0	12558	0	0	12561
7235	4	39	1	12686	0	12730
7236	3	37	2	12719	0	12761
7237	11	0	12351	1	0	12363
7238	2	11873	0	9	0	11884
7239	11834	0	28	6	0	11868
7240	14	0	11975	1	0	11990
7241	11596	3	22	6	0	11627
7242	6	0	11963	0	0	11969
7243	1	23	2	11615	0	11641
7244	8	0	11819	3	0	11830
7245	5	0	11964	2	0	11971
7246	1	39	16	11886	0	11942
7247	1	18	1	11753	0	11773
7248	3	30	5	11450	0	11488
7249	2	5	1	11271	0	11279
7250	1	28	5	11270	0	11304
7251	5	0	11260	2	0	11267
7252	10	3	11352	9	0	11374
7253	3	11470	1	9	0	11483
7254	11259	1	17	5	0	11282
7255	4	25	1	11489	0	11519
7256	11881	0	9	1	0	11891
7257	0	15	1	10915	0	10931
7258	11213	1	8	5	0	11227
7259	1	35	1	10990	0	11027
7260	0	24	1	10912	0	10937
7261	2	10865	1	9	0	10877
7262	1	44	0	10418	0	10463
7263	5	37	1	10716	0	10759
7264	2	33	2	10750	0	10787
7265	9	18	1	10902	0	10930
7266	2	11045	0	3	0	11050
7267	10899	1	15	4	0	10919
7268	0	11021	0	4	0	11025
7269	2	23	0	10974	0	10999
7270	11069	3	17	2	0	11091
7271	39	0	11110	0	0	11149
7272	16	0	11515	1	0	11532
7273	1	27	5	11460	0	11493
7274	1	22	4	11610	0	11637
7275	0	26	3	11750	0	11779
7276	2	16	0	11844	0	11862
7277	2	20	0	12088	0	12110
7278	1	11877	0	24	0	11902
7279	2	20	1	11869	0	11892
7280	12660	2	14	1	0	12677
7281	4	28	3	12275	0	12310
7282	10	0	12667	3	0	12680
7283	2	24	0	13027	0	13053
7284	13105	2	14	0	0	13121
7285	2	13461	0	11	0	13474
7286	3	37	0	13263	0	13303
7287	0	25	2	13556	0	13583
7288	12	0	13027	4	0	13043
7289	29	1	13030	1	0	13061
7290	12909	0	20	3	0	12932
7291	2	34	3	12568	0	12607
7292	3	18	0	12326	0	12347
7293	8	0	12648	11	0	12667
7294	19	4	12705	2	0	12730
7295	2	13046	1	15	0	13064
7296	1	51	0	13039	0	13091
7297	17	0	13057	3	0	13077
7298	3	13002	0	10	0	13015
7299	13401	0	16	2	0	13419
7300	13769	0	23	7	0	13799
7301	2	37	1	14242	0	14282
7302	1	13645	0	7	0	13653
7303	13661	1	23	4	0	13689
7304	3	24	0	13637	0	13664
7305	11	0	13524	1	0	13536
7306	5	14063	0	13	0	14081
7307	13971	0	37	2	0	14010
7308	13831	1	16	4	0	13852
7309	0	34	0	13877	0	13911
7310	2	30	0	13526	0	13558
7311	14	0	13632	1	0	13647
7312	2	46	10	13751	0	13809
7313	2	47	2	13627	0	13678
7314	0	39	2	13654	0	13695
7315	0	19	1	13647	0	13667
7316	2	30	1	13506	0	13539
7317	2	13453	0	3	0	13458
7318	13300	2	39	4	0	13345
7319	17	0	13468	0	0	13485
7320	2	13302	0	12	0	13316
7321	2	29	1	13230	0	13262
7322	13565	2	9	2	0	13578
7323	2	61	3	13500	0	13566
7324	6	17	2	13548	0	13573
7325	2	30	2	14083	0	14117
7326	0	29	0	14111	0	14140
7327	49	0	13909	5	0	13963
7328	3	13699	0	13	0	13715
7329	13552	0	36	7	0	13595
7330	9	0	13902	14	0	13925
7331	2	30	0	13842	0	13874
7332	14009	0	13	6	0	14028
7333	2	13921	0	23	0	13946
7334	13675	0	22	1	0	13698
7335	5	27	1	13936	0	13969
7336	1	16	1	14242	0	14260
7337	1	9	0	14614	0	14624
7338	2	4	0	14903	0	14909
7339	14618	0	8	2	0	14628
7340	0	19	1	14459	0	14479
7341	0	22	0	14453	0	14475
7342	14143	2	26	3	0	14174
7343	1	0	14248	1	0	14250
7344	4	18	1	14716	0	14739
7345	14649	0	15	1	0	14665
7346	14610	2	18	3	0	14633
7347	2	24	1	15938	0	15965
7348	2	51	1	15525	0	15579
7349	1	15589	0	2	0	15592
7350	5	39	3	15342	0	15389
7351	4	35	1	15429	0	15469
7352	13	1	15661	1	0	15676
7353	30	1	15451	8	0	15490
7354	2	15773	0	13	0	15788
7355	3	46	2	15523	0	15574
7356	1	29	0	14953	0	14983
7357	15013	2	10	4	0	15029
7358	3	34	2	14640	0	14679
7359	7	0	14449	2	0	14458
7360	2	40	4	14210	0	14256
7361	11	0	14211	1	0	14223
7362	10	0	14604	2	0	14616
7363	2	30	2	14437	0	14471
7364	1	33	0	15945	0	15979
7365	15786	2	18	4	0	15810
7366	16249	2	20	1	0	16272
7367	3	16	0	16875	0	16894
7368	17306	2	14	2	0	17324
7369	16926	0	18	3	0	16947
7370	5	19	0	16597	0	16621
7371	1	7	1	16260	0	16269
7372	16349	0	10	4	0	16363
7373	16929	2	13	1	0	16945
7374	1	50	0	17296	0	17347
7375	0	16954	0	4	0	16958
7376	4	47	0	16773	0	16824
7377	4	46	1	16474	0	16525
7378	23	0	16977	7	0	17007
7379	2	32	7	17332	0	17373
7380	17308	1	35	3	0	17347
7381	5	17346	1	3	0	17355
7382	16759	0	36	6	0	16801
7383	16841	1	42	2	0	16886
7384	17139	1	34	1	0	17175
7385	0	22	0	17138	0	17160
7386	10	0	16994	2	0	17006
7387	17	1	16586	13	0	16617
7388	4	16666	1	26	0	16697
7389	5	16545	0	28	0	16578
7390	7	16746	0	12	0	16765
7391	6	16929	0	16	0	16951
7392	9	0	17239	1	0	17249
7393	17194	2	20	3	0	17219
7394	3	48	2	17417	0	17470
7395	3	44	2	18063	0	18112
7396	2	42	1	18148	0	18193
7397	0	18017	0	5	0	18022
7398	17933	4	54	1	0	17992
7399	32	0	18136	0	0	18168
7400	2	18011	0	14	0	18027
7401	0	27	2	17695	0	17724
7402	17712	0	31	3	0	17746
7403	2	43	0	18028	0	18073
7404	12	0	18861	1	0	18874
7405	8	1	19278	5	0	19292
7406	2	57	1	19556	0	19616
7407	0	22	1	19596	0	19619
7408	19037	1	29	2	0	19069
7409	24	0	19381	0	0	19405
7410	19372	1	33	4	0	19410
7411	19404	1	47	0	0	19452
7412	6	43	2	19065	0	19116
7413	31	0	19154	5	0	19190
7414	12	38	3	19081	0	19134
7415	19056	0	38	2	0	19096
7416	0	18788	0	18	0	18806
7417	18699	3	35	3	0	18740
7418	4	84	1	18433	0	18522
7419	1	18516	0	7	0	18524
7420	2	70	5	18943	0	19020
7421	2	39	0	19376	0	19417
7422	1	18547	0	3	0	18551
7423	9	53	1	18144	0	18207
7424	4	36	0	18290	0	18330
7425	1	47	2	18167	0	18217
7426	54	0	18202	9	0	18265
7427	2	17802	0	19	0	17823
7428	18003	0	44	8	0	18055
7429	5	58	1	18022	0	18086
7430	1	17994	1	2	0	17998
7431	19372	1	21	2	0	19396
7432	4	32	4	19826	0	19866
7433	0	26	2	19801	0	19829
7434	5	20	1	19980	0	20006
7435	2	26	0	19872	0	19900
7436	20002	1	22	1	0	20026
7437	0	19	1	19932	0	19952
7438	2	27	1	19451	0	19481
7439	20276	2	28	1	0	20307
7440	8	43	0	18735	0	18786
7441	32	0	19308	56	0	19396
7442	2	29	2	19175	0	19208
7443	18842	1	25	0	0	18868
7444	3	40	0	18344	0	18387
7445	19	0	18224	2	0	18245
7446	11	0	18566	7	0	18584
7447	18587	2	32	8	0	18629
7448	18719	4	70	4	0	18797
7449	18161	1	29	3	0	18194
7450	17883	3	97	2	0	17985
7451	13	0	18707	4	0	18724
7452	3	53	5	18665	0	18726
7453	0	18	2	18557	0	18577
7454	18026	1	31	4	0	18062
7455	3	31	0	17835	0	17869
7456	13	2	17920	1	0	17936
7457	6	68	3	17921	0	17998
7458	42	0	17861	13	0	17916
7459	1	17847	0	29	0	17877
7460	17656	6	34	1	0	17697
7461	2	58	2	17793	0	17855
7462	18	0	19109	2	0	19129
7463	9	65	3	20036	0	20113
7464	1	33	1	20055	0	20090
7465	26	1	20170	2	0	20199
7466	6	51	1	20716	0	20774
7467	20460	3	39	3	0	20505
7468	15	2	20331	10	0	20358
7469	20406	3	53	6	0	20468
7470	0	20714	0	12	0	20726
7471	29	0	19858	1	0	19888
7472	7	4	21011	3	0	21025
7473	5	83	1	21155	0	21244
7474	7	60	0	21265	0	21332
7475	14	1	21235	1	0	21251
7476	9	52	0	21883	0	21944
7477	21935	0	20	4	0	21959
7478	21817	3	32	4	0	21856
7479	2	65	1	21521	0	21589
7480	7	50	1	20795	0	20853
7481	0	20078	0	17	0	20095
7482	20049	2	38	2	0	20091
7483	5	70	1	21246	0	21322
7484	1	21117	1	7	0	21126
7485	21468	2	52	2	0	21524
7486	21781	0	37	4	0	21822
7487	4	21642	0	3	0	21649
7488	7	67	0	21550	0	21624
7489	5	65	4	21842	0	21916
7490	24	17	22413	5	0	22459
7491	4	37	2	22507	0	22550
7492	22482	1	39	5	0	22527
7493	5	56	5	22856	0	22922
7494	13	0	22668	4	0	22685
7495	23151	1	39	11	0	23202
7496	4	62	2	22696	0	22764
7497	26	0	22743	4	0	22773
7498	13	55	3	22806	0	22877
7499	35	0	23167	1	0	23203
7500	7	69	5	23161	0	23242
7501	0	15	1	23209	0	23225
7502	23343	0	38	1	0	23382
7503	2	23625	2	15	0	23644
7504	23650	1	48	0	0	23699
7505	23439	3	39	5	0	23486
7506	23638	3	56	2	0	23699
7507	3	22597	1	19	0	22620
7508	22	1	22476	1	0	22500
7509	2	28	2	23536	0	23568
7510	23443	0	23	2	0	23468
7511	23419	1	57	3	0	23480
7512	3	28	2	23363	0	23396
7513	23060	0	30	7	0	23097
7514	11	2	23199	0	0	23212
7515	21930	5	95	7	0	22037
7516	13	0	22308	0	0	22321
7517	4	21842	1	36	0	21883
7518	22038	2	51	2	0	22093
7519	21977	3	63	8	0	22051
7520	1	21860	1	16	0	21878
7521	21887	1	53	4	0	21945
7522	21505	2	40	3	0	21550
7523	13	0	21422	1	0	21436
7524	20972	0	48	3	0	21023
7525	22	1	21167	1	0	21191
7526	8	43	1	21111	0	21163
7527	2	20362	2	11	0	20377
7528	19	1	20457	1	0	20478
7529	20376	1	51	5	0	20433
7530	20624	1	55	0	0	20680
7531	2	43	2	20653	0	20700
7532	13	0	21105	2	0	21120
7533	5	37	1	21168	0	21211
7534	20987	0	36	5	0	21028
7535	1	20959	1	15	0	20976
7536	21368	1	60	6	0	21435
7537	21525	0	47	2	0	21574
7538	2	19902	0	12	0	19916
7539	4	28	1	19515	0	19548
7540	19839	2	19	1	0	19861
7541	3	59	3	19562	0	19627
7542	4	29	2	20335	0	20370
7543	5	0	20546	4	0	20555
7544	4	52	0	20430	0	20486
7545	2	19	0	20387	0	20408
7546	20055	0	14	2	0	20071
7547	19835	5	55	4	0	19899
7548	3	33	0	18815	0	18851
7549	31	0	18542	3	0	18576
7550	8	0	20085	5	0	20098
7551	3	45	4	19473	0	19525
7552	9	0	19684	2	0	19695
7553	3	43	2	20690	0	20738
7554	0	28	1	20746	0	20775
7555	20555	1	33	4	0	20593
7556	8	0	20521	0	0	20529
7557	20351	3	50	5	0	20409
7558	20012	4	69	4	0	20089
7559	11	0	18687	2	0	18700
7560	20	0	19222	2	0	19244
7561	2	32	4	19248	0	19286
7562	9	18894	2	13	0	18918
7563	2	19363	0	30	0	19395
7564	1	66	1	19619	0	19687
7565	2	38	3	19708	0	19751
7566	4	41	3	19200	0	19248
7567	2	13	1	19322	0	19338
7568	20169	0	23	3	0	20195
7569	1	38	2	19855	0	19896
7570	17	1	20360	2	0	20380
7571	7	56	0	19497	0	19560
7572	7	19147	0	7	0	19161
7573	7	39	0	18976	0	19022
7574	19996	1	20	1	0	20018
7575	7	43	3	19993	0	20046
7576	40	1	20026	0	0	20067
7577	4	20151	0	12	0	20167
7578	3	41	2	20232	0	20278
7579	20469	1	32	2	0	20504
7580	20276	1	41	5	0	20323
7581	2	28	0	20289	0	20319
7582	15	1	19809	0	0	19825
7583	8	0	19653	9	0	19670
7584	18511	0	65	11	0	18587
7585	13	0	18828	2	0	18843
7586	17	0	19243	3	0	19263
7587	2	20	0	20274	0	20296
7588	20104	1	23	3	0	20131
7589	20083	1	42	1	0	20127
7590	19839	0	91	6	0	19936
7591	14	1	19860	2	0	19877
7592	16	0	19807	6	0	19829
7593	0	19654	0	12	0	19666
7594	3	66	2	19515	0	19586
7595	1	51	3	19694	0	19749
7596	6	73	2	19669	0	19750
7597	5	37	3	19786	0	19831
7598	23	1	19737	6	0	19767
7599	2	19619	2	32	0	19655
7600	19559	0	28	2	0	19589
7601	19574	2	58	4	0	19638
7602	19641	12	34	2	0	19689
7603	2	20058	0	14	0	20074
7604	2	35	1	20042	0	20080
7605	20467	1	37	5	0	20510
7606	7	20102	2	10	0	20121
7607	20156	0	62	6	0	20224
7608	2	20037	1	10	0	20050
7609	19880	2	26	4	0	19912
7610	20302	0	46	4	0	20352
7611	6	22	6	20191	0	20225
7612	5	34	4	19876	0	19919
7613	13	1	19513	13	0	19540
7614	6	0	19544	8	0	19558
7615	20647	3	59	9	0	20718
7616	20271	3	48	3	0	20325
7617	7	47	2	19937	0	19993
7618	2	51	2	19270	0	19325
7619	14	0	20299	1	0	20314
7620	4	49	1	20295	0	20349
7621	10	0	20387	1	0	20398
7622	2	46	2	20365	0	20415
7623	1	23	1	20418	0	20443
7624	20410	0	25	4	0	20439
7625	20927	0	24	5	0	20956
7626	0	30	1	19856	0	19887
7627	4	37	3	19859	0	19903
7628	16	0	20026	2	0	20044
7629	5	52	1	18992	0	19050
7630	14	0	19479	3	0	19496
7631	19348	7	73	3	0	19431
7632	2	32	1	19628	0	19663
7633	19699	0	41	5	0	19745
7634	2	19783	0	2	0	19787
7635	20499	1	59	0	0	20559
7636	4	60	0	20464	0	20528
7637	4	40	0	20112	0	20156
7638	0	19348	0	13	0	19361
7639	3	41	4	18770	0	18818
7640	20	0	19334	2	0	19356
7641	2	46	0	19623	0	19671
7642	27	5	19537	6	0	19575
7643	6	18970	0	30	0	19006
7644	12	40	2	18112	0	18166
7645	18	1	18782	0	0	18801
7646	11	1	19545	6	0	19563
7647	3	32	3	19610	0	19648
7648	19403	0	31	4	0	19438
7649	8	1	19538	2	0	19549
7650	3	19	1	18789	0	18812
7651	18545	4	34	3	0	18586
7652	0	18724	0	10	0	18734
7653	19234	1	32	0	0	19267
7654	1	31	3	18982	0	19017
7655	7	33	2	18874	0	18916
7656	1	12	3	20584	0	20600
7657	20739	0	13	3	0	20755
7658	1	30	1	20858	0	20890
7659	0	27	1	20875	0	20903
7660	20469	2	25	2	0	20498
7661	8	1	20517	1	0	20527
7662	2	40	1	19519	0	19562
7663	8	0	19471	1	0	19480
7664	19443	1	65	6	0	19515
7665	2	40	1	19771	0	19814
7666	26	1	19677	2	0	19706
7667	20136	2	34	9	0	20181
7668	20210	1	78	1	0	20290
7669	7	0	20248	2	0	20257
7670	1	36	1	20483	0	20521
7671	2	35	1	20307	0	20345
7672	11	0	20458	3	0	20472
7673	1	20886	1	38	0	20926
7674	16	1	20908	2	0	20927
7675	20767	4	56	6	0	20833
7676	28	0	20808	3	0	20839
7677	21801	2	66	5	0	21874
7678	18	1	22041	2	0	22062
7679	21814	2	60	4	0	21880
7680	1	21859	0	25	0	21885
7681	6	63	7	21655	0	21731
7682	5	65	6	22366	0	22442
7683	16	0	22482	5	0	22503
7684	11	61	3	22951	0	23026
7685	6	22730	1	13	0	22750
7686	22712	3	72	7	0	22794
7687	3	22807	0	9	0	22819
7688	3	50	2	23085	0	23140
7689	23031	1	49	1	0	23082
7690	2	22944	0	27	0	22973
7691	21632	1	79	5	0	21717
7692	13	0	22346	0	0	22359
7693	3	40	3	22551	0	22597
7694	2	32	4	22532	0	22570
7695	6	18	0	21490	0	21514
7696	21343	0	10	6	0	21359
7697	21314	3	27	1	0	21345
7698	21371	3	25	2	0	21401
7699	21098	3	91	3	0	21195
7700	11	0	21214	1	0	21226
7701	20790	2	91	6	0	20889
7702	3	20730	1	18	0	20752
7703	7	20650	0	21	0	20678
7704	20827	1	40	3	0	20871
7705	20867	0	50	0	0	20917
7706	0	13	2	20434	0	20449
7707	20733	0	11	1	0	20745
7708	20582	2	34	2	0	20620
7709	20671	1	39	2	0	20713
7710	5	34	1	20479	0	20519
7711	4	19571	0	8	0	19583
7712	1	20150	0	15	0	20166
7713	5	29	1	20133	0	20168
7714	20169	10	29	2	0	20210
7715	1	19698	0	3	0	19702
7716	1	43	1	19194	0	19239
7717	6	1	19361	1	0	19369
7718	19301	1	45	3	0	19350
7719	6	19275	0	14	0	19295
7720	2	18710	0	13	0	18725
7721	18252	3	34	5	0	18294
7722	30	0	19400	1	0	19431
7723	5	46	1	19590	0	19642
7724	1	19747	0	5	0	19753
7725	3	71	1	20018	0	20093
7726	5	38	0	20154	0	20197
7727	3	19204	1	7	0	19215
7728	3	38	2	19162	0	19205
7729	1	32	0	19243	0	19276
7730	19502	1	33	2	0	19538
7731	1	18950	0	17	0	18968
7732	17421	1	47	2	0	17471
7733	5	34	1	17338	0	17378
7734	0	17164	0	27	0	17191
7735	2	0	17390	1	0	17393
7736	0	28	2	17760	0	17790
7737	1	42	1	17382	0	17426
7738	9	1	17351	4	0	17365
7739	17341	1	33	10	0	17385
7740	1	30	0	17813	0	17844
7741	17513	1	31	0	0	17545
7742	17	0	18657	1	0	18675
7743	2	32	4	18413	0	18451
7744	12	0	18263	7	0	18282
7745	5	32	2	18158	0	18197
7746	3	24	0	18152	0	18179
7747	18276	2	34	12	0	18324
7748	1	18055	0	17	0	18073
7749	17536	3	44	2	0	17585
7750	8	1	18006	1	0	18016
7751	3	32	1	17185	0	17221
7752	5	1	17165	4	0	17175
7753	17138	1	57	2	0	17198
7754	16981	4	73	7	0	17065
7755	4	1	17243	1	0	17249
7756	17074	2	58	7	0	17141
7757	17037	1	50	0	0	17088
7758	1	20	0	16505	0	16526
7759	14	0	15738	0	0	15752
7760	17	0	15751	6	0	15774
7761	0	42	0	15658	0	15700
7762	3	36	0	15651	0	15690
7763	1	15509	1	28	0	15539
7764	1	15990	1	16	0	16008
7765	16081	0	29	2	0	16112
7766	3	40	1	15988	0	16032
7767	2	15399	1	11	0	15413
7768	0	15582	0	14	0	15596
7769	15328	0	27	4	0	15359
7770	1	20	1	15629	0	15651
7771	1	15649	0	3	0	15653
7772	5	54	2	15628	0	15689
7773	3	17	0	15547	0	15567
7774	1	11	0	16022	0	16034
7775	16505	1	13	3	0	16522
7776	0	16202	0	9	0	16211
7777	3	34	1	15804	0	15842
7778	1	22	1	15819	0	15843
7779	11	36	1	15666	0	15714
7780	13	0	16033	1	0	16047
7781	16215	1	42	4	0	16262
7782	2	11	2	16997	0	17012
7783	16634	0	20	2	0	16656
7784	16983	2	31	5	0	17021
7785	16658	3	76	1	0	16738
7786	11	0	16765	1	0	16777
7787	3	16456	0	17	0	16476
7788	7	14	4	15917	0	15942
7789	19	1	16003	2	0	16025
7790	11	3	16230	3	0	16247
7791	3	49	2	17249	0	17303
7792	5	17125	6	4	0	17140
7793	17288	1	22	2	0	17313
7794	17265	1	30	2	0	17298
7795	17184	0	26	1	0	17211
7796	17093	3	81	7	0	17184
7797	12	0	17319	1	0	17332
7798	16194	0	73	3	0	16270
7799	1	15940	0	2	0	15943
7800	4	31	1	15645	0	15681
7801	1	13	2	15774	0	15790
7802	15838	0	27	2	0	15867
7803	1	27	0	15778	0	15806
7804	7	0	15742	1	0	15750
7805	16162	0	47	4	0	16213
7806	15883	1	23	1	0	15908
7807	15697	3	83	2	0	15785
7808	4	0	15737	0	0	15741
7809	16882	2	60	3	0	16947
7810	0	16433	0	7	0	16440
7811	16135	0	38	4	0	16177
7812	2	34	1	16047	0	16084
7813	15	42	0	16774	0	16831
7814	2	16743	0	19	0	16764
7815	10	33	0	16784	0	16827
7816	0	16006	0	2	0	16008
7817	6	34	1	15631	0	15672
7818	0	15835	0	3	0	15838
7819	5	34	0	15625	0	15664
7820	3	15824	0	5	0	15832
7821	3	41	1	15931	0	15976
7822	1	16024	0	7	0	16032
7823	15921	1	12	0	0	15934
7824	1	28	3	15886	0	15918
7825	2	24	0	15694	0	15720
7826	0	21	2	15426	0	15449
7827	2	21	0	15148	0	15171
7828	5	0	14952	1	0	14958
7829	4	20	0	14975	0	14999
7830	1	17	0	14863	0	14881
7831	15076	0	15	4	0	15095
7832	15145	2	49	7	0	15203
7833	0	15212	0	13	0	15225
7834	4	28	1	15116	0	15149
7835	1	27	1	15641	0	15670
7836	15324	1	20	4	0	15349
7837	8	0	15351	3	0	15362
7838	15364	4	55	6	0	15429
7839	2	15327	1	11	0	15341
7840	14534	2	38	3	0	14577
7841	14831	0	44	2	0	14877
7842	6	14995	1	19	0	15021
7843	3	14975	0	12	0	14990
7844	1	33	2	14867	0	14903
7845	18	1	14882	1	0	14902
7846	14620	0	41	3	0	14664
7847	2	0	14909	2	0	14913
7848	14766	2	49	9	0	14826
7849	11	0	15186	1	0	15198
7850	1	14912	2	8	0	14923
7851	0	8	0	14554	0	14562
7852	14615	0	26	3	0	14644
7853	14657	0	19	5	0	14681
7854	2	19	2	14679	0	14702
7855	14312	0	17	3	0	14332
7856	13898	4	42	1	0	13945
7857	3	14413	0	6	0	14422
7858	13698	4	47	5	0	13754
7859	2	13746	0	23	0	13771
7860	0	25	0	13352	0	13377
7861	13356	0	23	1	0	13380
7862	13348	0	41	3	0	13392
7863	13242	1	37	2	0	13282
7864	10	0	13398	1	0	13409
7865	3	0	13306	2	0	13311
7866	3	39	2	12260	0	12304
7867	2	9	1	12231	0	12243
7868	1	12182	0	9	0	12192
7869	12081	1	36	1	0	12119
7870	1	32	4	12210	0	12247
7871	1	34	1	12230	0	12266
7872	30	0	12302	5	0	12337
7873	11	13622	2	7	0	13642
7874	1	13955	0	13	0	13969
7875	3	28	3	13863	0	13897
7876	14108	0	12	1	0	14121
7877	6	15	1	14033	0	14055
7878	4	6	1	13872	0	13883
7879	13850	0	17	3	0	13870
7880	14409	1	12	1	0	14423
7881	3	22	0	13947	0	13972
7882	4	0	14079	0	0	14083
7883	2	15	1	13030	0	13048
7884	2	15	3	13131	0	13151
7885	13104	1	19	2	0	13126
7886	2	18	3	13743	0	13766
7887	13752	1	10	0	0	13763
7888	4	0	13797	0	0	13801
7889	5	25	24	12806	0	12860
7890	2	34	1	12639	0	12676
7891	2	34	0	12484	0	12520
7892	3	24	1	12818	0	12846
7893	2	14	6	12844	0	12866
7894	10	0	12612	1	0	12623
7895	12503	1	41	9	0	12554
7896	0	14	3	12506	0	12523
7897	15	1	12178	0	0	12194
7898	17	0	13712	1	0	13730
7899	2	17	6	15102	0	15127
7900	15130	0	25	5	0	15160
7901	15124	0	45	2	0	15171
7902	15586	1	36	5	0	15628
7903	8	27	1	15573	0	15609
7904	1	15933	0	1	0	15935
7905	15924	1	40	3	0	15968
7906	16049	2	31	4	0	16086
7907	16195	1	36	3	0	16235
7908	16524	2	45	1	0	16572
7909	1	33	1	16721	0	16756
7910	9	0	17005	0	0	17014
7911	9	39	1	16385	0	16434
7912	15	0	16456	3	0	16474
7913	16446	3	63	0	0	16512
7914	16435	1	62	4	0	16502
7915	9	0	16491	1	0	16501
7916	16620	2	34	2	0	16658
7917	16287	2	65	1	0	16355
7918	8	17	5	16549	0	16579
7919	0	16329	0	13	0	16342
7920	16651	3	38	3	0	16695
7921	4	25	0	16517	0	16546
7922	2	16407	0	9	0	16418
7923	4	31	0	16374	0	16409
7924	19	0	16374	1	0	16394
7925	4	16321	0	9	0	16334
7926	16382	2	25	1	0	16410
7927	16700	3	58	7	0	16768
7928	16892	0	39	2	0	16933
7929	16940	2	53	2	0	16997
7930	4	20	3	16814	0	16841
7931	2	16868	0	20	0	16890
7932	16528	8	67	2	0	16605
7933	23	0	16146	5	0	16174
7934	0	16357	1	14	0	16372
7935	11	0	16382	0	0	16393
7936	7	36	5	17192	0	17240
7937	4	17353	0	9	0	17366
7938	4	23	1	17331	0	17359
7939	20	1	18068	0	0	18089
7940	10	72	37	18030	0	18149
7941	7	23	3	18222	0	18255
7942	5	27	0	18287	0	18319
7943	18400	0	39	1	0	18440
7944	2	18344	1	8	0	18355
7945	0	33	2	18651	0	18686
7946	18568	1	26	3	0	18598
7947	3	18310	1	16	0	18330
7948	16609	2	67	6	0	16684
7949	5	0	16682	1	0	16688
7950	5	11	2	15986	0	16004
7951	3	16003	1	8	0	16015
7952	15848	2	48	0	0	15898
7953	13	0	16206	1	0	16220
7954	3	15754	0	10	0	15767
7955	5	28	2	15726	0	15761
7956	6	9	1	15642	0	15658
7957	15633	1	30	2	0	15666
7958	3	24	4	15380	0	15411
7959	5	0	15585	0	0	15590
7960	2	38	4	15539	0	15583
7961	11	0	15529	2	0	15542
7962	4	58	3	14765	0	14830
7963	1	14583	1	7	0	14592
7964	14907	2	41	6	0	14956
7965	15245	0	32	1	0	15278
7966	6	15682	0	11	0	15699
7967	6	15821	0	7	0	15834
7968	6	15	1	15444	0	15466
7969	15590	4	22	1	0	15617
7970	1	20	1	15583	0	15605
7971	15564	6	27	3	0	15600
7972	0	15849	0	21	0	15870
7973	5	22	2	14296	0	14325
7974	5	0	14451	0	0	14456
7975	5	16	2	13393	0	13416
7976	5	8	0	13500	0	13513
7977	13574	3	21	4	0	13602
7978	1	12946	0	12	0	12959
7979	3	14	0	13856	0	13873
7980	13756	0	22	1	0	13779
7981	2	1	13696	0	0	13699
7982	13577	1	50	3	0	13631
7983	6	39	1	12904	0	12950
7984	1	12667	0	7	0	12675
7985	12399	2	41	1	0	12443
7986	8	0	12348	0	0	12356
7987	9	1	12418	5	0	12433
7988	5	12546	0	16	0	12567
7989	12561	1	26	1	0	12589
7990	1	13	2	12804	0	12820
7991	3	18	0	12936	0	12957
7992	13518	1	21	2	0	13542
7993	14	0	16485	1	0	16500
7994	6	15	13	17194	0	17228
7995	12	2	19433	1	0	19448
7996	3	37	1	19069	0	19110
7997	2	19112	1	4	0	19119
7998	9	18	4	19456	0	19487
7999	21	0	19918	1	0	19940
8000	21372	2	28	2	0	21404
8001	3	12	2	21395	0	21412
8002	23	1	25518	2	0	25544
8003	2	24	6	25023	0	25055
8004	6	21	4	26696	0	26727
8005	14	0	27332	4	0	27350
8006	194	0	27408	6	0	27608
8007	13	77	8	27552	0	27650
8008	21	2	27497	8	0	27528
8009	27272	4	80	10	0	27366
8010	3	41	2	27713	0	27759
8011	26778	1	41	6	0	26826
8012	23	0	28436	0	0	28459
8013	4	65	0	27983	0	28052
8014	24	0	27709	14	0	27747
8015	5	27328	1	57	0	27391
8016	33	0	27487	5	0	27525
8017	20	0	27486	7	0	27513
8018	27409	0	21	8	0	27438
8019	27244	1	81	4	0	27330
8020	33	0	27466	1	0	27500
8021	4	77	0	27422	0	27503
8022	2	67	3	27263	0	27335
8023	45	2	27121	7	0	27175
8024	3	27426	0	21	0	27450
8025	27481	3	59	9	0	27552
8026	21	1	28565	1	0	28588
8027	4	44	1	28504	0	28553
8028	4	21	3	28636	0	28664
8029	28505	2	20	6	0	28533
8030	28439	3	58	10	0	28510
8031	28468	5	53	4	0	28530
8032	28643	6	69	5	0	28723
8033	2	60	2	29234	0	29298
8034	19	0	29877	2	0	29898
8035	11	82	13	29272	0	29378
8036	9	48	3	29239	0	29299
8037	7	85	7	29185	0	29284
8038	16	3	29319	0	0	29338
8039	29674	4	94	7	0	29779
8040	7	46	3	29891	0	29947
8041	23	1	30048	2	0	30074
8042	3	29780	3	19	0	29805
8043	8	60	4	29643	0	29715
8044	5	52	2	29893	0	29952
8045	29785	2	40	2	0	29829
8046	0	32097	1	30	0	32128
8047	37	0	32426	2	0	32465
8048	7	70	6	32301	0	32384
8049	2	42	3	32222	0	32269
8050	31837	2	50	7	0	31896
8051	31749	1	69	4	0	31823
8052	6	59	1	31825	0	31891
8053	31853	1	35	3	0	31892
8054	1	31902	1	31	0	31935
8055	21	1	31073	3	0	31098
8056	6	85	27	30808	0	30926
8057	3	145	3	30797	0	30948
8058	2	110	2	31320	0	31434
8059	13	75	4	31475	0	31567
8060	3	31583	1	12	0	31599
8061	31596	3	97	3	0	31699
8062	12	124	3	31308	0	31447
8063	3	31767	2	15	0	31787
8064	31919	9	66	5	0	31999
8065	33250	4	57	25	0	33336
8066	1	33083	0	18	0	33102
8067	5	113	6	32851	0	32975
8068	9	93	2	32815	0	32919
8069	6	66	1	30271	0	30344
8070	6	47	1	32794	0	32848
8071	30690	2	38	7	0	30737
8072	30802	2	54	9	0	30867
8073	4	30482	1	21	0	30508
8074	37	3	30259	3	0	30302
8075	9	55	2	30168	0	30234
8076	29448	2	30	4	0	29484
8077	17	25396	3	19	0	25435
8078	5	25311	1	41	0	25358
8079	25338	6	46	14	0	25404
8080	23619	5	40	4	0	23668
8081	6	55	1	23471	0	23533
8082	8	0	23352	2	0	23362
8083	18	0	24915	4	0	24937
8084	24985	4	70	6	0	25065
8085	24898	4	69	2	0	24973
8086	24785	5	69	7	0	24866
8087	24795	4	69	3	0	24871
8088	23641	13	67	7	0	23728
8089	0	23959	0	27	0	23986
8090	6	49	1	23633	0	23689
8091	7	24125	1	23	0	24156
8092	24299	2	48	6	0	24355
8093	23771	3	649	1	0	24424
8094	24194	6	52	6	0	24258
8095	24440	8	65	3	0	24516
8096	1	25233	0	13	0	25247
8097	24930	3	70	6	0	25009
8098	2	25058	0	23	0	25083
8099	3	29	1	24805	0	24838
8100	25322	2	36	9	0	25369
8101	34	1	25320	4	0	25359
8102	12	69	1	24265	0	24347
8103	4	53	0	24218	0	24275
8104	18	1	24096	4	0	24119
8105	4	23919	0	34	0	23957
8106	26370	2	49	0	0	26421
8107	26358	0	49	8	0	26415
8108	0	25812	0	17	0	25829
8109	203	57	2	23653	0	23915
8110	18	1	23770	1	0	23790
8111	1	23873	1	12	0	23887
8112	23865	1	71	12	0	23949
8113	26	0	23902	3	0	23931
8114	24082	0	58	15	0	24155
8115	23936	5	65	5	0	24011
8116	13	0	23882	1	0	23896
8117	2	26087	0	11	0	26100
8118	3	64	2	26053	0	26122
8119	42	2	26026	4	0	26074
8120	26378	2	63	7	0	26450
8121	26552	2	94	5	0	26653
8122	1	24902	0	5	0	24908
8123	4	80	1	24801	0	24886
8124	2	53	0	25024	0	25079
8125	23	4	25123	3	0	25153
8126	2	25213	0	37	0	25252
8127	25241	0	68	10	0	25319
8128	25337	2	65	5	0	25409
8129	25211	5	102	5	0	25323
8130	13	1	26097	0	0	26111
8131	26081	1	59	4	0	26145
8132	26136	1	71	6	0	26214
8133	3	50	3	25929	0	25985
8134	14	0	25817	0	0	25831
8135	8	78	7	25536	0	25629
8136	16	0	26414	2	0	26432
8137	9	63	2	30066	0	30140
8138	10	30622	1	13	0	30646
8139	3	29391	3	73	0	29470
8140	15	66	6	29388	0	29475
8141	3	42	2	29543	0	29590
8142	29232	2	45	2	0	29281
8143	25	0	29950	1	0	29976
8144	29908	2	80	7	0	29997
8145	3	29589	1	9	0	29602
8146	25892	4	40	6	0	25942
8147	25924	5	64	6	0	25999
8148	3	56	0	26170	0	26229
8149	8	0	27870	3	0	27881
8150	2	94	4	27594	0	27694
8151	5	27540	1	11	0	27557
8152	7	69	3	26683	0	26762
8153	2	37	2	26765	0	26806
8154	27059	3	25	3	0	27090
8155	8	61	3	26932	0	27004
8156	1	26672	0	8	0	26681
8157	7	47	2	26074	0	26130
8158	25170	1	28	4	0	25203
8159	0	25297	0	8	0	25305
8160	2	103	2	24742	0	24849
8161	3	54	1	24773	0	24831
8162	2	50	3	24712	0	24767
8163	2	26	0	24968	0	24996
8164	24673	0	21	4	0	24698
8165	5	82	3	24467	0	24557
8166	2	49	1	24442	0	24494
8167	9	59	1	23926	0	23995
8168	2	23787	0	13	0	23802
8169	23362	5	59	4	0	23430
8170	21	1	23465	4	0	23491
8171	0	23118	1	17	0	23136
8172	22587	0	42	2	0	22631
8173	28	0	22609	2	0	22639
8174	1	22155	1	12	0	22169
8175	8	60	10	21634	0	21712
8176	8	22455	2	20	0	22485
8177	33	0	22397	2	0	22432
8178	22	1	22584	7	0	22614
8179	10	22491	1	9	0	22511
8180	22385	7	36	5	0	22433
8181	22322	3	56	3	0	22384
8182	5	0	22195	2	0	22202
8183	20	0	23188	10	0	23218
8184	10	1	23118	8	0	23137
8185	5	54	35	22145	0	22239
8186	2	42	0	22029	0	22073
8187	8	58	2	21838	0	21906
8188	29	0	21925	1	0	21955
8189	4	39	1	22096	0	22140
8190	7	36	5	21879	0	21927
8191	9	1	21129	6	0	21145
8192	19050	3	30	3	0	19086
8193	0	46	0	19104	0	19150
8194	3	54	1	19065	0	19123
8195	1	19082	1	6	0	19090
8196	18543	6	34	11	0	18594
8197	14	1	19161	3	0	19179
8198	19174	2	39	10	0	19225
8199	2	45	2	19482	0	19531
8200	16	0	19421	2	0	19439
8201	4	31	0	19319	0	19354
8202	19077	2	31	8	0	19118
8203	11	0	19015	3	0	19029
8204	19450	4	55	13	0	19522
8205	19928	0	82	4	0	20014
8206	19247	2	44	4	0	19297
8207	0	20094	0	10	0	20104
8208	0	27	0	20107	0	20134
8209	20030	1	28	1	0	20060
8210	19964	9	40	5	0	20018
8211	19977	4	63	8	0	20052
8212	9	0	19181	2	0	19192
8213	17519	5	35	4	0	17563
8214	0	43	4	17314	0	17361
8215	13	0	17589	1	0	17603
8216	2	48	3	17359	0	17412
8217	3	52	2	17718	0	17775
8218	7	0	17909	2	0	17918
8219	4	64	1	17288	0	17357
8220	1	50	1	17177	0	17229
8221	11	0	17238	1	0	17250
8222	17208	0	45	4	0	17257
8223	18000	2	29	2	0	18033
8224	1	37	4	18321	0	18363
8225	10	2	18315	1	0	18328
8226	5	70	1	18496	0	18572
8227	2	18273	0	2	0	18277
8228	4	46	5	18304	0	18359
8229	3	20	0	18399	0	18422
8230	18210	0	14	3	0	18227
8231	18240	1	28	1	0	18270
8232	18131	1	56	3	0	18191
8233	13	29	1	18270	0	18313
8234	1	46	3	17161	0	17211
8235	13	1	17014	5	0	17033
8236	7	71	0	17244	0	17322
8237	4	17169	1	4	0	17178
8238	17304	3	34	8	0	17349
8239	5	17221	0	7	0	17233
8240	17344	5	26	3	0	17378
8241	4	54	2	17214	0	17274
8242	5	17702	0	13	0	17720
8243	17815	3	27	2	0	17847
8244	18323	2	30	0	0	18355
8245	3	45	1	18247	0	18296
8246	1	18208	0	11	0	18220
8247	6	58	1	18130	0	18195
8248	20	1	18465	1	0	18487
8249	19406	1	37	7	0	19451
8250	4	19736	1	13	0	19754
8251	19981	1	46	1	0	20029
8252	1	37	0	19822	0	19860
8253	19616	3	22	9	0	19650
8254	4	0	19708	1	0	19713
8255	19684	1	40	5	0	19730
8256	19825	1	44	10	0	19880
8257	8	0	19919	1	0	19928
8258	2	39	1	19657	0	19699
8259	0	39	0	19129	0	19168
8260	19195	2	26	1	0	19224
8261	1	19043	0	8	0	19052
8262	6	40	1305	17654	0	19005
8263	26	1	19181	2	0	19210
8264	22	1	19215	6	0	19244
8265	9	19603	3	22	0	19637
8266	22	1	19634	3	0	19660
8267	19719	1	46	12	0	19778
8268	1	38	2	20047	0	20088
8269	20166	0	21	2	0	20189
8270	9	0	20741	0	0	20750
8271	3	45	1	21306	0	21355
8272	3	31	1	21341	0	21376
8273	10	1	21567	2	0	21580
8274	2	41	0	22457	0	22500
8275	22689	0	26	5	0	22720
8276	22631	4	54	5	0	22694
8277	1	15	0	22830	0	22846
8278	23052	2	27	4	0	23085
8279	25392	2	49	3	0	25446
8280	0	26827	1	1	0	26829
8281	3	47	0	26527	0	26577
8282	26468	0	23	3	0	26494
8283	2	32	1	25515	0	25550
8284	26161	4	31	2	0	26198
8285	5	55	1	26279	0	26340
8286	29	1	26079	4	0	26113
8287	2	26257	1	14	0	26274
8288	19	140	3	25132	0	25294
8289	4	25305	0	64	0	25373
8290	26135	3	45	6	0	26189
8291	2	28622	1	10	0	28635
8292	3	28307	0	13	0	28323
8293	7	76	3	28018	0	28104
8294	28187	3	26	11	0	28227
8295	3	65	5	28387	0	28460
8296	28317	2	24	3	0	28346
8297	28362	1	66	8	0	28437
8298	2	28387	0	5	0	28394
8299	27193	1	45	3	0	27242
8300	26550	5	37	5	0	26597
8301	24664	4	96	3	0	24767
8302	25	1	25406	2	0	25434
8303	2	45	2	25440	0	25489
8304	1	33	3	25406	0	25443
8305	39	5	25404	3	0	25451
8306	25423	3	46	8	0	25480
8307	25620	2	68	2	0	25692
8308	25578	2	77	6	0	25663
8309	26333	38	65	4	0	26440
8310	0	26795	0	16	0	26811
8311	26554	1	31	5	0	26591
8312	3	74	2	26522	0	26601
8313	28	2	26304	8	0	26342
8314	26678	1	52	9	0	26740
8315	0	26635	2	36	0	26673
8316	26470	1	45	23	0	26539
8317	4	27103	3	8	0	27118
8318	7	26767	1	18	0	26793
8319	6	26647	1	13	0	26667
8320	2	26923	1	27	0	26953
8321	16	3	26978	3	0	27000
8322	5	97	3	26926	0	27031
8323	15	0	26669	5	0	26689
8324	26996	1	37	5	0	27039
8325	2	27068	0	10	0	27080
8326	4	26917	0	10	0	26931
8327	3	81	4	26642	0	26730
8328	16	71	5	26798	0	26890
8329	16	1	26640	3	0	26660
8330	26	0	26753	9	0	26788
8331	2	59	1	28413	0	28475
8332	34	1	27992	7	0	28034
8333	4	28058	0	11	0	28073
8334	5	114	3	27826	0	27948
8335	4	89	5	28533	0	28631
8336	21	0	29603	1	0	29625
8337	11	37	2	29773	0	29823
8338	30435	1	34	1	0	30471
8339	7	91	4	30142	0	30244
8340	3	77	4	31239	0	31323
8341	12	0	31157	27	0	31196
8342	31706	3	57	12	0	31778
8343	1	31800	0	14	0	31815
8344	8	113	8	31250	0	31379
8345	25	1	31835	4	0	31865
8346	6	78	3	32048	0	32135
8347	31700	1	46	3	0	31750
8348	32	0	31429	1	0	31462
8349	11	73	0	30140	0	30224
8350	33	2	28882	59	0	28976
8351	4	29263	4	23	0	29294
8352	22	0	29251	7	0	29280
8353	3	29245	1	31	0	29280
8354	20	0	29243	2	0	29265
8355	6	93	2	28482	0	28583
8356	4	26871	0	14	0	26889
8357	28677	3	50	7	0	28737
8358	4	42	1	28745	0	28792
8359	29412	0	31	4	0	29447
8360	5	60	1	29279	0	29345
8361	3	48	1	29222	0	29274
8362	28722	0	34	28	0	28784
8363	28633	2	46	1	0	28682
8364	2	50	1	28078	0	28131
8365	19	1	27765	4	0	27789
8366	6	24292	1	34	0	24333
8367	38	2	24198	5	0	24243
8368	3	24282	2	18	0	24305
8369	24217	5	50	15	0	24287
8370	13	1	24435	3	0	24452
8371	43	0	24272	6	0	24321
8372	5	70	4	24541	0	24620
8373	24479	2	44	4	0	24529
8374	30	0	24452	8	0	24490
8375	2	24579	2	17	0	24600
8376	24577	3	68	4	0	24652
8377	25023	1	37	5	0	25066
8378	24427	1	55	0	0	24483
8379	25311	3	56	6	0	25376
8380	25454	4	83	1	0	25542
8381	31	1	25676	2	0	25710
8382	6	89	1	25928	0	26024
8383	5	25722	4	14	0	25745
8384	26551	1	73	3	0	26628
8385	2	25699	2	19	0	25722
8386	25663	6	62	11	0	25742
8387	26350	0	58	4	0	26412
8388	3	26303	1	7	0	26314
8389	26630	2	26	4	0	26662
8390	1	64	3	26544	0	26612
8391	5	29	1	26427	0	26462
8392	44	0	27273	10	0	27327
8393	1	26482	0	13	0	26496
8394	8	103	6	26973	0	27090
8395	2	33	4	27310	0	27349
8396	4	57	9	26830	0	26900
8397	46	1	28033	8	0	28088
8398	28206	5	47	8	0	28266
8399	8	40	5	28560	0	28613
8400	28275	3	40	9	0	28327
8401	6	76	3	27314	0	27399
8402	34	1	27042	3	0	27080
8403	17	3	27368	13	0	27401
8404	27186	1	69	11	0	27267
8405	27844	5	99	7	0	27955
8406	3	26411	0	55	0	26469
8407	40	0	26884	3	0	26927
8408	2	87	2	26798	0	26889
8409	1	27	0	26515	0	26543
8410	26559	1	37	4	0	26601
8411	25907	2	44	5	0	25958
8412	24766	6	99	5	0	24876
8413	19	0	25226	1	0	25246
8414	25166	1	53	4	0	25224
8415	1	82	2	25224	0	25309
8416	3	58	5	23817	0	23883
8417	11	91	1	23442	0	23545
8418	1	22839	1	13	0	22854
8419	22981	1	35	5	0	23022
8420	8	71	3	23112	0	23194
8421	36	3	22938	0	0	22977
8422	6	51	1	22772	0	22830
8423	1	22905	0	10	0	22916
8424	22893	1	39	4	0	22937
8425	7	80	2	22931	0	23020
8426	4	77	1	23572	0	23654
8427	23	0	24062	1	0	24086
8428	8	74	2	24564	0	24648
8429	2	23393	0	13	0	23408
8430	9	64	6	23033	0	23112
8431	17	1	23226	3	0	23247
8432	23243	0	48	7	0	23298
8433	21518	4	62	3	0	21587
8434	0	23477	0	23	0	23500
8435	22923	4	55	3	0	22985
8436	22578	2	38	3	0	22621
8437	1	22828	0	11	0	22840
8438	3	37	1	22777	0	22818
8439	22923	0	43	3	0	22969
8440	2	22864	1	17	0	22884
8441	16	0	22816	4	0	22836
8442	22819	5	43	9	0	22876
8443	22668	2	62	0	0	22732
8444	23370	2	72	2	0	23446
8445	24495	33	68	5	0	24601
8446	3	25752	0	10	0	25765
8447	26063	1	51	2	0	26117
8448	26579	3	39	9	0	26630
8449	26682	2	50	9	0	26743
8450	6	26	4	26693	0	26729
8451	27966	2	30	3	0	28001
8452	4	28056	1	26	0	28087
8453	32	1	27635	1	0	27669
8454	8	43	5	28142	0	28198
8455	26813	2	36	4	0	26855
8456	17	1	27194	3	0	27215
8457	7	56	6	26871	0	26940
8458	42	1	26594	5	0	26642
8459	2	26543	2	15	0	26562
8460	7	82	4	25849	0	25942
8461	33	1	26720	7	0	26761
8462	1	27250	0	14	0	27265
8463	5	52	2	27245	0	27304
8464	27477	1	28	3	0	27509
8465	26798	5	32	6	0	26841
8466	26861	1	46	0	0	26908
8467	27751	1	41	3	0	27796
8468	26698	4	110	3	0	26815
8469	5	0	27082	2	0	27089
8470	26171	1	45	4	0	26221
8471	26103	3	52	2	0	26160
8472	4	29	0	27028	0	27061
8473	25917	0	24	5	0	25946
8474	28048	6	49	2	0	28105
8475	0	28362	0	5	0	28367
8476	6	80	3	27790	0	27879
8477	0	41	1	27861	0	27903
8478	27664	3	37	6	0	27710
8479	5	28457	0	27	0	28489
8480	2	28072	0	28	0	28102
8481	3	117	5	27601	0	27726
8482	4	58	3	27756	0	27821
8483	2	63	4	27608	0	27677
8484	1	17	0	27773	0	27791
8485	28774	1	30	3	0	28808
8486	28715	2	43	6	0	28766
8487	12	0	28926	2	0	28940
8488	2	53	1	28237	0	28293
8489	8	83	4	27622	0	27717
8490	30	2	27885	7	0	27924
8491	28022	1	85	10	0	28118
8492	3	27992	0	14	0	28009
8493	28892	3	59	4	0	28958
8494	1	61	0	28339	0	28401
8495	36	0	29149	3	0	29188
8496	13	67	7	29010	0	29097
8497	22	1	28370	15	0	28408
8498	4	28867	2	26	0	28899
8499	28598	0	54	5	0	28657
8500	28730	4	56	14	0	28804
8501	2	29401	1	11	0	29415
8502	6	60	0	29501	0	29567
8503	30401	1	36	4	0	30442
8504	1	29721	0	11	0	29733
8505	4	42	1	29234	0	29281
8506	29219	0	76	8	0	29303
8507	9	0	29135	6	0	29150
8508	29272	1	101	11	0	29385
8509	3	29212	1	15	0	29231
8510	26873	6	64	9	0	26952
8511	26959	3	66	3	0	27031
8512	10	0	27747	2	0	27759
8513	2	84	4	28379	0	28469
8514	3	76	4	28635	0	28718
8515	21	0	29015	1	0	29037
8516	2	102	3	29342	0	29449
8517	2	46	0	29479	0	29527
8518	29477	1	27	5	0	29510
8519	29549	1	49	3	0	29602
8520	5	72	4	29077	0	29158
8521	23	0	28046	2	0	28071
8522	4	82	2	27308	0	27396
8523	2	66	3	26893	0	26964
8524	24	0	26387	9	0	26420
8525	5	55	3	26714	0	26777
8526	26660	1	38	1	0	26700
8527	25748	2	69	6	0	25825
8528	2	26077	0	18	0	26097
8529	26134	2	63	7	0	26206
8530	26200	3	73	3	0	26279
8531	0	25523	0	16	0	25539
8532	25610	7	68	4	0	25689
8533	25589	3	67	1	0	25660
8534	26271	3	87	11	0	26372
8535	9	2	26509	3	0	26523
8536	26406	5	67	7	0	26485
8537	2	51	0	25853	0	25906
8538	25073	1	44	10	0	25128
8539	36	0	25610	3	0	25649
8540	4	26302	4	58	0	26368
8541	27534	3	57	6	0	27600
8542	4	27998	2	7	0	28011
8543	6	85	6	27073	0	27170
8544	6	22	1	27207	0	27236
8545	26927	1	23	5	0	26956
8546	26667	5	64	7	0	26743
8547	11	0	26876	1	0	26888
8548	22	1	25895	8	0	25926
8549	15	0	26068	3	0	26086
8550	10	62	2	24109	0	24183
8551	15	2	23976	0	0	23993
8552	19	1	24386	1	0	24407
8553	3	20	1	24804	0	24828
8554	24689	0	24	1	0	24714
8555	24012	0	20	3	0	24035
8556	23719	2	30	3	0	23754
8557	23773	1	24	1	0	23799
8558	0	29	1	24080	0	24110
8559	2	49	0	23774	0	23825
8560	18	0	24416	1	0	24435
8561	5	48	1	23970	0	24024
8562	4	24	1	23968	0	23997
8563	24492	2	24	2	0	24520
8564	25207	2	28	5	0	25242
8565	3	16	1	25597	0	25617
8566	24871	3	15	0	0	24889
8567	24746	3	42	3	0	24794
8568	2	41	1	24783	0	24827
8569	5	58	1	24943	0	25007
8570	8	0	25786	1	0	25795
8571	20	1	24946	3	0	24970
8572	5	46	3	25258	0	25312
8573	2	71	1	25118	0	25192
8574	24	2	24963	1	0	24990
8575	26941	2	77	12	0	27032
8576	26845	5	83	4	0	26937
8577	17	1	25234	2	0	25254
8578	2	25107	1	18	0	25128
8579	24299	1	57	4	0	24361
8580	20	0	24636	2	0	24658
8581	8	56	6	24917	0	24987
8582	4	14	4	25361	0	25383
8583	25432	1	15	3	0	25451
8584	27746	1	42	3	0	27792
8585	3	33	3	28197	0	28236
8586	2	19	2	28452	0	28475
8587	28099	0	18	6	0	28123
8588	28138	1	53	1	0	28193
8589	27410	4	84	5	0	27503
8590	20	0	27462	0	0	27482
8591	2	61	2	27132	0	27197
8592	0	44	0	27391	0	27435
8593	27520	0	43	6	0	27569
8594	2	27434	0	16	0	27452
8595	27342	1	74	2	0	27419
8596	1	27459	1	11	0	27472
8597	6	96	4	26803	0	26909
8598	5	58	4	26689	0	26756
8599	22	0	26798	4	0	26824
8600	6	94	3	26586	0	26689
8601	23	1	26672	1	0	26697
8602	8	90	1	26594	0	26693
8603	5	64	3	26337	0	26409
8604	9	26049	4	19	0	26081
8605	1	25514	1	24	0	25540
8606	6	131	3	25484	0	25624
8607	0	95	3	25589	0	25687
8608	4	69	10	25493	0	25576
8609	6	18	5	25668	0	25697
8610	5	58	3	24829	0	24895
8611	28	0	24623	1	0	24652
8612	0	42	1	24976	0	25019
8613	6	57	1	24427	0	24491
8614	25	0	24305	3	0	24333
8615	3	21481	2	13	0	21499
8616	7	67	1	21842	0	21917
8617	20	0	22421	0	0	22441
8618	4	22378	0	13	0	22395
8619	3	48	0	22697	0	22748
8620	23222	2	24	2	0	23250
8621	2	54	3	24249	0	24308
8622	1	27	2	24402	0	24432
8623	1	36	0	24308	0	24345
8624	3	26	1	24130	0	24160
8625	1	24081	1	20	0	24103
8626	4	31	3	24258	0	24296
8627	25330	2	39	3	0	25374
8628	2	44	2	25760	0	25808
8629	2	36	4	25572	0	25614
8630	3	14	2	26862	0	26881
8631	28281	1	15	5	0	28302
8632	28310	2	33	3	0	28348
8633	1	24	2	28451	0	28478
8634	28028	2	35	2	0	28067
8635	28137	4	68	3	0	28212
8636	5	28412	0	59	0	28476
8637	28395	4	75	1	0	28475
8638	11	28610	1	13	0	28635
8639	2	27782	2	19	0	27805
8640	8	59	3	27292	0	27362
8641	38	0	29711	4	0	29753
8642	7	140	1	29859	0	30007
8643	8	95	3	29727	0	29833
8644	5	29797	1	60	0	29863
8645	28855	2	81	7	0	28945
8646	6	83	6	28800	0	28895
8647	47	0	28807	1	0	28855
8648	14	132	1	28777	0	28924
8649	3	28616	1	24	0	28644
8650	26926	6	70	8	0	27010
8651	4	74	1	29149	0	29228
8652	16	0	29929	2	0	29947
8653	10	80	8	30248	0	30346
8654	4	30339	1	15	0	30359
8655	7	68	1	29946	0	30022
8656	30087	1	32	2	0	30122
8657	30875	8	87	8	0	30978
8658	30665	8	66	3	0	30742
8659	0	31607	1	26	0	31634
8660	29440	3	64	5	0	29512
8661	1	38	3	29182	0	29224
8662	29358	2	44	9	0	29413
8663	2	28657	1	16	0	28676
8664	13	67	6	28361	0	28447
8665	14	1	28408	7	0	28430
8666	28391	3	53	9	0	28456
8667	3	28728	0	17	0	28748
8668	3	138	3	28183	0	28327
8669	1	96	7	28678	0	28782
8670	0	48	2	28490	0	28540
8671	6	63	4	28508	0	28581
8672	4	28068	1	13	0	28086
8673	28059	7	71	4	0	28141
8674	27980	5	69	8	0	28062
8675	42	0	28052	4	0	28098
8676	5	46	3	27777	0	27831
8677	17	0	27743	4	0	27764
8678	27797	2	104	7	0	27910
8679	28154	1	71	3	0	28229
8680	28109	6	98	3	0	28216
8681	7	42	4	28510	0	28563
8682	2	28750	0	20	0	28772
8683	29082	0	69	5	0	29156
8684	5	39	1	29270	0	29315
8685	29179	1	65	12	0	29257
8686	5	2	29687	5	0	29699
8687	9	1	29689	4	0	29703
8688	30888	5	124	12	0	31029
8689	4	29	2	31091	0	31126
8690	30827	0	48	7	0	30882
8691	9	30556	0	44	0	30609
8692	30097	0	79	10	0	30186
8693	30094	3	96	8	0	30201
8694	11	1	30578	10	0	30600
8695	30	2	31459	9	0	31500
8696	2	31188	0	26	0	31216
8697	6	42	4	30096	0	30148
8698	31374	2	56	6	0	31438
8699	2	78	2	31437	0	31519
8700	5	64	2	31659	0	31730
8701	21	3	31285	3	0	31312
8702	30508	4	70	11	0	30593
8703	5	56	3	29767	0	29831
8704	33	1	29054	2	0	29090
8705	15	0	29199	8	0	29222
8706	5	51	6	28263	0	28325
8707	17	0	26709	7	0	26733
8708	16	1	29363	9	0	29389
8709	13	80	2	29282	0	29377
8710	11	0	29066	17	0	29094
8711	11	88	3	29092	0	29194
8712	2	28005	0	15	0	28022
8713	28272	5	65	7	0	28349
8714	6	27986	0	9	0	28001
8715	4	81	2	27654	0	27741
8716	0	25697	1	28	0	25726
8717	48	2	25713	0	0	25763
8718	4	64	3	26400	0	26471
8719	33	0	26249	5	0	26287
8720	27328	4	95	7	0	27434
8721	0	27214	1	15	0	27230
8722	28285	4	54	3	0	28346
8723	5	43	2	28222	0	28272
8724	28854	5	50	9	0	28918
8725	28	0	29177	5	0	29210
8726	4	29515	1	26	0	29546
8727	29701	1	71	7	0	29780
8728	6	81	3	29291	0	29381
8729	2	29190	0	11	0	29203
8730	7	51	3	29188	0	29249
8731	29660	1	35	3	0	29699
8732	3	29550	1	18	0	29572
8733	28511	2	99	8	0	28620
8734	14	0	28863	7	0	28884
8735	28114	2	78	10	0	28204
8736	5	30	2	28445	0	28482
8737	28398	1	45	4	0	28448
8738	0	28787	2	24	0	28813
8739	4	69	1	28495	0	28569
8740	2	75	1	28399	0	28477
8741	7	0	28285	3	0	28295
8742	5	54	6	28231	0	28296
8743	4	47	4	27650	0	27705
8744	5	56	3	28113	0	28177
8745	2	46	2	27673	0	27723
8746	33	1	27727	6	0	27767
8747	5	27970	1	26	0	28002
8748	0	35	1	28271	0	28307
8749	28354	4	70	6	0	28434
8750	28485	3	52	8	0	28548
8751	2	28583	1	96	0	28682
8752	28631	4	64	8	0	28707
8753	28742	6	64	4	0	28816
8754	28389	13	111	7	0	28520
8755	2	28238	1	17	0	28258
8756	27987	3	69	8	0	28067
8757	3	47	2	27762	0	27814
8758	40	0	27429	6	0	27475
8759	1	26669	2	20	0	26692
8760	2	59	4	26536	0	26601
8761	30	0	27217	1	0	27248
8762	27145	3	34	7	0	27189
8763	0	56	7	27042	0	27105
8764	1	49	0	25731	0	25781
8765	4	21	3	26305	0	26333
8766	10	42	5	27083	0	27140
8767	3	1	27231	5	0	27240
8768	27630	1	94	9	0	27734
8769	8	26668	0	22	0	26698
8770	26807	3	97	7	0	26914
8771	1	26185	0	24	0	26210
8772	25842	10	73	6	0	25931
8773	4	35	3	27070	0	27112
8774	25	0	27733	4	0	27762
8775	17	1	28438	5	0	28461
8776	2	67	5	28241	0	28315
8777	4	50	3	28145	0	28202
8778	2	45	0	28197	0	28244
8779	28282	2	70	4	0	28358
8780	44	0	28234	5	0	28283
8781	17	27668	1	65	0	27751
8782	9	27458	1	38	0	27506
8783	25069	8	69	12	0	25158
8784	35	0	25307	6	0	25348
8785	3	25759	0	20	0	25782
8786	8	0	25975	0	0	25983
8787	5	50	4	26142	0	26201
8788	23	0	26048	2	0	26073
8789	14	1	27185	2	0	27202
8790	16	38	1	27065	0	27120
8791	32	0	26992	2	0	27026
8792	43	4	27170	3	0	27220
8793	3	39	3	28301	0	28346
8794	28261	5	49	2	0	28317
8795	8	0	28522	1	0	28531
8796	9	63	3	27873	0	27948
8797	3	32	2	27610	0	27647
8798	26679	1	24	8	0	26712
8799	4	39	1	26775	0	26819
8800	26213	0	44	2	0	26259
8801	3	25296	1	35	0	25335
8802	2	30	2	23164	0	23198
8803	22902	0	38	4	0	22944
8804	22674	11	23	2	0	22710
8805	1	36	0	22942	0	22979
8806	7	2	23034	3	0	23046
8807	22470	1	73	6	0	22550
8808	5	22376	2	19	0	22402
8809	22836	2	67	8	0	22913
8810	22570	3	55	3	0	22631
8811	22672	4	93	3	0	22772
8812	25	0	22406	4	0	22435
8813	3	22567	1	11	0	22582
8814	13	32	2	23534	0	23581
8815	7	61	2	23600	0	23670
8816	22	0	23575	5	0	23602
8817	4	23966	4	41	0	24015
8818	10	23880	1	24	0	23915
8819	2	24318	0	25	0	24345
8820	24190	1	64	7	0	24262
8821	2	46	3	24313	0	24364
8822	4	52	2	24041	0	24099
8823	10	2	24202	4	0	24218
8824	24357	7	46	6	0	24416
8825	3	43	1	26292	0	26339
8826	6	50	2	26084	0	26142
8827	41	1	25902	3	0	25947
8828	7	25977	2	21	0	26007
8829	2	57	6	26002	0	26067
8830	34	0	25976	4	0	26014
8831	2	25904	1	39	0	25946
8832	25901	2	92	6	0	26001
8833	18	1	26821	0	0	26840
8834	3	66	3	26440	0	26512
8835	5	26737	0	25	0	26767
8836	26842	0	65	2	0	26909
8837	2	30	2	27145	0	27179
8838	27389	0	50	6	0	27445
8839	27124	1	114	17	0	27256
8840	4	27780	0	15	0	27799
8841	27294	3	76	2	0	27375
8842	26263	1	91	4	0	26359
8843	5	1	26307	5	0	26318
8844	25623	1	102	16	0	25742
8845	25	2	26073	0	0	26100
8846	25375	2	93	5	0	25475
8847	25259	1	136	4	0	25400
8848	10	0	25473	2	0	25485
8849	9	45	5	24403	0	24462
8850	16	0	22979	3	0	22998
8851	28	0	22428	3	0	22459
8852	9	1	22971	5	0	22986
8853	0	61	7	22883	0	22951
8854	7	64	1	22605	0	22677
8855	1	32	10	22154	0	22197
8856	5	38	1	22545	0	22589
8857	31	1	22552	3	0	22587
8858	13	33	2	22835	0	22883
8859	2	22271	0	26	0	22299
8860	15	1	22317	4	0	22337
8861	2	41	0	22819	0	22862
8862	12	0	22303	22	0	22337
8863	3	22218	0	22	0	22243
8864	2	21145	0	11	0	21158
8865	8	31	1	21156	0	21196
8866	16	0	21201	6	0	21223
8867	32	1	21309	3	0	21345
8868	1	35	10	21188	0	21234
8869	0	41	0	19920	0	19961
8870	1	32	2	19360	0	19395
8871	31	0	18978	12	0	19021
8872	6	20241	1	40	0	20288
8873	4	20133	0	11	0	20148
8874	13	37	2	20619	0	20671
8875	15	1	20416	2	0	20434
8876	27	0	20666	5	0	20698
8877	14	20455	1	19	0	20489
8878	20777	4	54	1	0	20836
8879	9	21920	1	41	0	21971
8880	27	0	21908	0	0	21935
8881	23727	3	78	7	0	23815
8882	2	20	3	25368	0	25393
8883	25750	1	28	4	0	25783
8884	10	44	5	27358	0	27417
8885	2	18	0	26723	0	26743
8886	26792	1	63	2	0	26858
8887	2	26426	5	19	0	26452
8888	43	2	26086	1	0	26132
8889	33	25497	2	22	0	25554
8890	24520	2	66	5	0	24593
8891	0	25414	0	28	0	25442
8892	25526	1	59	4	0	25590
8893	26873	2	80	0	0	26955
8894	3	26813	0	6	0	26822
8895	6	35	0	26560	0	26601
8896	26616	0	22	1	0	26639
8897	26467	2	97	1	0	26567
8898	1	22	6	26521	0	26550
8899	31	0	26200	4	0	26235
8900	44	1	27908	2	0	27955
8901	10	59	4	27323	0	27396
8902	11	2	27135	5	0	27153
8903	27213	2	108	5	0	27328
8904	0	27715	0	9	0	27724
8905	4	73	6	27504	0	27587
8906	6	66	6	28106	0	28184
8907	9	56	7	28164	0	28236
8908	6	66	4	28348	0	28424
8909	3	64	3	27640	0	27710
8910	42	9	27575	2	0	27628
8911	2	28695	0	21	0	28718
8912	28731	2	61	2	0	28796
8913	3	84	6	27759	0	27852
8914	3	46	2	27799	0	27850
8915	7	48	2	27957	0	28014
8916	4	27951	1	24	0	27980
8917	9	41	4	27933	0	27987
8918	1	25	3	28475	0	28504
8919	28538	0	57	2	0	28597
8920	9	28285	1	17	0	28312
8921	3	28436	2	22	0	28463
8922	7	40	4	28183	0	28234
8923	27798	1	55	4	0	27858
8924	19	2	28150	3	0	28174
8925	27935	4	90	11	0	28040
8926	12	2	28142	20	0	28176
8927	3	54	19	28036	0	28112
8928	14	49	10	28043	0	28116
8929	3	72	3	28234	0	28312
8930	2	48	4	28536	0	28590
8931	3	33	3	28796	0	28835
8932	28592	8	34	6	0	28640
8933	29	1	28716	1	0	28747
8934	1	61	2	28382	0	28446
8935	17	0	28156	14	0	28187
8936	3	28124	2	27	0	28156
8937	27657	2	75	33	0	27767
8938	9	0	28343	2	0	28354
8939	6	43	24	28680	0	28753
8940	3	42	3	28948	0	28996
8941	57	1	28869	6	0	28933
8942	29	1	28929	9	0	28968
8943	4	37	1	29124	0	29166
8944	29083	2	58	1	0	29144
8945	28912	5	87	14	0	29018
8946	1	29604	0	17	0	29622
8947	28572	7	85	3	0	28667
8948	5	41	4	28384	0	28434
8949	2	28641	0	57	0	28700
8950	9	48	3	28200	0	28260
8951	7	1	29300	0	0	29308
8952	7	49	3	29596	0	29655
8953	1	36	0	29739	0	29776
8954	29741	2	57	3	0	29803
8955	5	28024	1	21	0	28051
8956	27529	3	87	5	0	27624
8957	6	25250	2	8	0	25266
8958	23757	7	79	8	0	23851
8959	8	24002	0	17	0	24027
8960	5	22510	0	41	0	22556
8961	22784	4	37	6	0	22831
8962	7	30	2	22463	0	22502
8963	11	22414	1	21	0	22447
8964	22518	1	37	1	0	22557
8965	22525	3	38	5	0	22571
8966	22855	3	66	3	0	22927
8967	22041	2	80	3	0	22126
8968	1	21696	0	3	0	21700
8969	9	46	5	21024	0	21084
8970	0	24	1	21163	0	21188
8971	22910	1	39	6	0	22956
8972	2	29	2	23169	0	23202
8973	24743	1	36	5	0	24785
8974	7	2	26243	3	0	26255
8975	24261	2	53	2	0	24318
8976	7	0	29311	1	0	29319
8977	1	32	1	28781	0	28815
8978	29488	2	39	5	0	29534
8979	1	29632	4	29	0	29666
8980	30892	3	66	7	0	30968
8981	1	31604	1	22	0	31628
8982	9	31	2	30885	0	30927
8983	13	0	32714	6	0	32733
8984	32795	1	70	3	0	32869
8985	4	35571	0	8	0	35583
8986	9	139	28	34117	0	34293
8987	7	71	3	39395	0	39476
8988	9	90	8	40216	0	40323
8989	16	1	40171	4	0	40192
8990	13	42117	1	42	0	42173
8991	42157	1	104	200	0	42462
8992	43959	4	112	13	0	44088
8993	4	44052	2	29	0	44087
8994	44000	7	94	6	0	44107
8995	7	86	5	44350	0	44448
8996	2	44494	1	20	0	44517
8997	44633	8	112	5	0	44758
8998	47	1	45437	3	0	45488
8999	4	46182	0	18	0	46204
9000	10	155	5	46046	0	46216
9001	13	116	4	46193	0	46326
9002	40	0	47692	2	0	47734
9003	8	116	3	47994	0	48121
9004	19	1	48096	1	0	48117
9005	9	125	17	48555	0	48706
9006	7	112	6	48084	0	48209
9007	10	121	7	48662	0	48800
9008	18	98	8	48916	0	49040
9009	50	1	48408	29	0	48488
9010	54	2	51623	11	0	51690
9011	7	51500	5	44	0	51556
9012	24	115	3	51424	0	51566
9013	43	0	52086	9	0	52138
9014	6	51739	2	23	0	51770
9015	10	132	10	51670	0	51822
9016	38	2	52195	4	0	52239
9017	51913	21	99	11	0	52044
9018	52789	2	130	5	0	52926
9019	8	101	6	53517	0	53632
9020	47	1	54050	3	0	54101
9021	11	72	3	54045	0	54131
9022	53226	2	94	9	0	53331
9023	10	52846	3	27	0	52886
9024	52733	1	153	7	0	52894
9025	52426	6	96	7	0	52535
9026	23	86	2	52119	0	52230
9027	3	126	6	51468	0	51603
9028	6	97	11	51360	0	51474
9029	8	82	8	51496	0	51594
9030	7	60	2	51546	0	51615
9031	51287	4	38	12	0	51341
9032	50960	2	91	5	0	51058
9033	50704	6	180	4	0	50894
9034	16	0	51018	2	0	51036
9035	49900	7	159	10	0	50076
9036	6	87	5	50167	0	50265
9037	39	0	50271	4	0	50314
9038	1	51367	1	40	0	51409
9039	14	164	5	51035	0	51218
9040	30	129	5	51432	0	51596
9041	5	50765	0	24	0	50794
9042	29	86	15	51417	0	51547
9043	51	1	52730	4	0	52786
9044	55	1	52810	12	0	52878
9045	7	66	4	53596	0	53673
9046	53344	4	103	13	0	53464
9047	53026	7	160	26	0	53219
9048	33	17	54354	9	0	54413
9049	15	52619	3	46	0	52683
9050	4	52618	1	31	0	52654
9051	51679	5	98	16	0	51798
9052	29	0	49720	3	0	49752
9053	11	65	5	51723	0	51804
9054	55678	6	104	10	0	55798
9055	20	56593	1	47	0	56661
9056	3	54759	1	57	0	54820
9057	56925	9	74	30	0	57038
9058	6	94	4	57254	0	57358
9059	56399	2	65	4	0	56470
9060	6	87	4	56976	0	57073
9061	5	92	6	54057	0	54160
9062	34	10	55525	4	0	55573
9063	8	123	10	57346	0	57487
9064	5	115	1	57162	0	57283
9065	57358	2	63	9	0	57432
9066	10	104	7	55386	0	55507
9067	41	0	55293	7	0	55341
9068	54529	5	162	25	0	54721
9069	6	91	7	55255	0	55359
9070	55172	5	78	13	0	55268
9071	12	55944	3	59	0	56018
9072	16	55094	0	57	0	55167
9073	57920	7	80	9	0	58016
9074	58789	3	88	4	0	58884
9075	6	163	6	58729	0	58904
9076	45	0	64803	20	0	64868
9077	13	91	5	67522	0	67631
9078	67194	4	87	10	0	67295
9079	5	67753	1	35	0	67794
9080	9	120	5	67039	0	67173
9081	67188	5	115	28	0	67336
9082	39	2	67162	6	0	67209
9083	66521	10	176	27	0	66734
9084	66467	11	188	19	0	66685
9085	24	2	63914	7	0	63947
9086	35	0	65385	16	0	65436
9087	4	153	11	65172	0	65340
9088	17	180	7	64855	0	65059
9089	2	68114	1	25	0	68142
9090	18	139	10	68597	0	68764
9091	41	1	68794	2	0	68838
9092	18	146	5	68656	0	68825
9093	7	112	1	68566	0	68686
9094	63	0	68122	6	0	68191
9095	6	69317	1	36	0	69360
9096	12	194	15	69116	0	69337
9097	8	84	2	69833	0	69927
9098	69984	6	59	5	0	70054
9099	7	167	6	70026	0	70206
9100	37	3	70125	3	0	70168
9101	74245	5	183	37	0	74470
9102	74168	15	157	7	0	74347
9103	73368	15	269	12	0	73664
9104	14	1	74713	5	0	74733
9105	5	118	19	74714	0	74856
9106	10	111	9	74547	0	74677
9107	4	58	19	74940	0	75021
9108	75079	2	114	8	0	75203
9109	2	75378	5	43	0	75428
9110	62	5	75130	3	0	75200
9111	19	75249	3	60	0	75331
9112	22	75129	2	51	0	75204
9113	7	75343	1	38	0	75389
9114	30	202	8	75230	0	75470
9115	81	3	76449	7	0	76540
9116	76528	4	170	30	0	76732
9117	4	76543	0	47	0	76594
9118	76439	3	221	19	0	76682
9119	24	75989	0	44	0	76057
9120	75195	11	277	21	0	75504
9121	13	77873	3	54	0	77943
9122	49	0	78011	2	0	78062
9123	16	164	11	77007	0	77198
9124	2	106	2	74550	0	74660
9125	74570	5	123	9	0	74707
9126	12	154	3	74178	0	74347
9127	99	0	74636	7	0	74742
9128	13	116	8	70576	0	70713
9129	62	5	70404	19	0	70490
9130	9	67343	2	61	0	67415
9131	33	230	5	65856	0	66124
9132	12	64238	1	37	0	64288
9133	64670	5	93	8	0	64776
9134	8	173	5	64362	0	64548
9135	50	2	63423	6	0	63481
9136	37	1	62599	12	0	62649
9137	62038	5	116	17	0	62176
9138	6	129	8	60618	0	60761
9139	39	1	57534	7	0	57581
9140	72	4	58381	17	0	58474
9141	2	58767	0	65	0	58834
9142	28	209	11	57788	0	58036
9143	9	58785	1	33	0	58828
9144	14	80	8	58714	0	58816
9145	59630	3	48	6	0	59687
9146	16	120	8	60191	0	60335
9147	4	83	4	58792	0	58883
9148	58938	3	52	10	0	59003
9149	10	146	1	55640	0	55797
9150	17	112	2	54430	0	54561
9151	2	49313	4	18	0	49337
9152	46386	4	58	4	0	46452
9153	46333	3	43	2	0	46381
9154	5	124	3	44980	0	45112
9155	15	124	4	44150	0	44293
9156	14	96	0	47196	0	47306
9157	6	47306	1	13	0	47326
9158	0	47219	1	11	0	47231
9159	8	86	1	47191	0	47286
9160	47106	2	54	8	0	47170
9161	47011	5	99	10	0	47125
9162	2	46420	1	22	0	46445
9163	45917	5	81	10	0	46013
9164	1	46274	2	23	0	46300
9165	5	42090	0	15	0	42110
9166	7	59	2	41450	0	41518
9167	42848	4	40	7	0	42899
9168	3	43561	3	15	0	43582
9169	1	43197	0	21	0	43219
9170	15	86	6	43001	0	43108
9171	9	82	3	41063	0	41157
9172	12	23	40826	7	0	40868
9173	40195	3	68	15	0	40281
9174	40044	3	175	5	0	40227
9175	14	0	40587	3	0	40604
9176	29	2	36878	9	0	36918
9177	3	115	1	35480	0	35599
9178	9	87	2	34898	0	34996
9179	0	36211	0	13	0	36224
9180	8	60	2	35966	0	36036
9181	45	0	36373	1	0	36419
9182	49	80	2	29237	0	29368
9183	2	39	15	29378	0	29434
9184	29102	2	42	7	0	29153
9185	13	1	29049	3	0	29066
9186	28673	3	70	8	0	28754
9187	17	0	28727	3	0	28747
9188	1	43	4	28270	0	28318
9189	32	0	28340	3	0	28375
9190	21	0	28770	6	0	28797
9191	7	50	2	28967	0	29026
9192	28737	2	39	4	0	28782
9193	28810	9	42	6	0	28867
9194	1	28446	0	11	0	28458
9195	28763	1	61	4	0	28829
9196	28942	3	45	1	0	28991
9197	0	27254	1	8	0	27263
9198	1	114	2	27228	0	27345
9199	8	69	2	27942	0	28021
9200	3	52	0	28248	0	28303
9201	1	49	1	28173	0	28224
9202	13	0	28145	5	0	28163
9203	28258	3	39	10	0	28310
9204	8	79	2	28424	0	28513
9205	2	76	0	29187	0	29265
9206	1	27609	0	16	0	27626
9207	8	62	4	27384	0	27458
9208	21	2	28157	2	0	28182
9209	27943	4	37	12	0	27996
9210	35	0	28870	5	0	28910
9211	2	47	0	30697	0	30746
9212	31802	6	33	5	0	31846
9213	1	32354	1	31	0	32387
9214	3	96	3	32085	0	32187
9215	33	2	32083	10	0	32128
9216	4	53	9	32554	0	32620
9217	32133	1	54	10	0	32198
9218	39	2	32037	4	0	32082
9219	21	2	30868	8	0	30899
9220	9	30462	1	18	0	30490
9221	30136	2	50	5	0	30193
9222	3	31260	3	35	0	31301
9223	39	0	31116	1	0	31156
9224	39	2	31055	3	0	31099
9225	10	31188	3	22	0	31223
9226	31418	3	75	6	0	31502
9227	3	32401	0	7	0	32411
9228	9	123	2	32279	0	32413
9229	3	106	3	32391	0	32503
9230	48	1	32596	1	0	32646
9231	3	74	14	32341	0	32432
9232	18	0	29483	6	0	29507
9233	29286	1	75	9	0	29371
9234	29310	2	54	5	0	29371
9235	29262	2	108	10	0	29382
9236	11	1	29529	2	0	29543
9237	29567	2	66	4	0	29639
9238	5	77	1	29036	0	29119
9239	5	29044	1	17	0	29067
9240	28937	2	65	5	0	29009
9241	5	0	29054	2	0	29061
9242	28881	3	57	15	0	28956
9243	27609	5	86	3	0	27703
9244	40	0	27263	3	0	27306
9245	4	27219	2	20	0	27245
9246	5	68	10	27386	0	27469
9247	36	0	27643	3	0	27682
9248	18	2	28374	2	0	28396
9249	3	95	7	28923	0	29028
9250	23	1	29161	2	0	29187
9251	6	51	8	28877	0	28942
9252	5	82	5	28553	0	28645
9253	8	74	3	28880	0	28965
9254	16	10	29559	2	0	29587
9255	6	111	5	28871	0	28993
9256	20	0	29452	1	0	29473
9257	3	53	2	30010	0	30068
9258	31216	2	36	3	0	31257
9259	5	120	2	30957	0	31084
9260	1	31108	0	8	0	31117
9261	8	54	3	31317	0	31382
9262	32134	2	37	6	0	32179
9263	2	31562	0	13	0	31577
9264	5	79	1	31399	0	31484
9265	31141	2	47	4	0	31194
9266	69	0	32056	3	0	32128
9267	18	67	5	31689	0	31779
9268	71	0	31643	5	0	31719
9269	59	2	32835	5	0	32901
9270	6	58	4	32629	0	32697
9271	32099	6	42	8	0	32155
9272	12	0	32199	2	0	32213
9273	31584	2	82	10	0	31678
9274	6	61	5	31453	0	31525
9275	26	1	30642	2	0	30671
9276	22	1	30767	4	0	30794
9277	33	1	32395	9	0	32438
9278	5	66	2	32116	0	32189
9279	32825	1	37	5	0	32868
9280	19	32589	0	14	0	32622
9281	9	98	3	32083	0	32193
9282	7	45	2	32752	0	32806
9283	32832	0	22	1	0	32855
9284	32472	13	53	5	0	32543
9285	3	31637	0	9	0	31649
9286	30708	3	56	7	0	30774
9287	31693	3	47	2	0	31745
9288	4	56	2	30451	0	30513
9289	9	0	30489	3	0	30501
9290	30412	5	30	6	0	30453
9291	7	28	0	30530	0	30565
9292	1	34	1	30641	0	30677
9293	30463	1	21	1	0	30486
9294	6	61	2	32200	0	32269
9295	0	46	0	32591	0	32637
9296	32578	2	29	4	0	32613
9297	0	32434	0	17	0	32451
9298	30550	5	59	8	0	30622
9299	17	1	30980	2	0	31000
9300	30754	9	45	2	0	30810
9301	9	74	8	31005	0	31096
9302	0	31046	1	5	0	31052
9303	4	145	3	30235	0	30387
9304	2	45	5	30422	0	30474
9305	3	52	1	31496	0	31552
9306	31426	1	36	4	0	31467
9307	5	31335	1	24	0	31365
9308	4	30964	1	38	0	31007
9309	30764	8	35	9	0	30816
9310	51	0	30828	2	0	30881
9311	55	0	31391	7	0	31453
9312	30357	9	78	14	0	30458
9313	9	0	30999	2	0	31010
9314	6	131	34	30540	0	30711
9315	1	73	2	32462	0	32538
9316	3	69	1	32606	0	32679
9317	6	41	1	32591	0	32639
9318	2	32634	0	10	0	32646
9319	15	112	3	32362	0	32492
9320	17	1	32916	5	0	32939
9321	10	94	4	33165	0	33273
9322	27	0	33847	4	0	33878
9323	20	1	35680	5	0	35706
9324	9	119	3	34725	0	34856
9325	45	0	34603	2	0	34650
9326	4	64	1	35288	0	35357
9327	34874	4	66	12	0	34956
9328	26	0	34734	6	0	34766
9329	34168	0	62	11	0	34241
9330	13	94	4	33777	0	33888
9331	20	2	32694	4	0	32720
9332	7	31697	1	12	0	31717
9333	4	113	3	31318	0	31438
9334	16	0	32153	1	0	32170
9335	2	35	1	34405	0	34443
9336	34708	0	98	3	0	34809
9337	34308	6	38	3	0	34355
9338	33763	2	27	3	0	33795
9339	2	18	0	33841	0	33861
9340	3	67	2	33526	0	33598
9341	2	24	2	33262	0	33290
9342	32555	3	20	4	0	32582
9343	1	31755	1	24	0	31781
9344	4	72	3	31085	0	31164
9345	2	18	1	31439	0	31460
9346	32656	2	23	5	0	32686
9347	1	33699	0	15	0	33715
9348	8	63	2	33600	0	33673
9349	35020	1	31	1	0	35053
9350	34983	7	57	4	0	35051
9351	7	45	1	35773	0	35826
9352	35941	2	27	6	0	35976
9353	5	85	1	35304	0	35395
9354	18	0	36833	2	0	36853
9355	11	135	19	35913	0	36078
9356	9	82	2	35457	0	35550
9357	0	50	1	35674	0	35725
9358	35218	4	50	0	0	35272
9359	5	34980	0	26	0	35011
9360	35659	2	72	9	0	35742
9361	6	37022	0	16	0	37044
9362	9	35973	0	20	0	36002
9363	35575	5	42	19	0	35641
9364	2	34401	0	27	0	34430
9365	5	69	3	34458	0	34535
9366	35485	0	44	2	0	35531
9367	35268	0	47	6	0	35321
9368	2	48	1	35499	0	35550
9369	6	72	5	35288	0	35371
9370	2	33504	0	8	0	33514
9371	33081	2	79	1	0	33163
9372	34291	3	48	6	0	34348
9373	6	34440	2	8	0	34456
9374	6	34452	2	19	0	34479
9375	6	51	2	34305	0	34364
9376	34438	2	24	1	0	34465
9377	4	60	2	34243	0	34309
9378	6	66	1	35140	0	35213
9379	58	3	35020	9	0	35090
9380	23	0	35102	8	0	35133
9381	6	68	2	34314	0	34390
9382	30	0	35038	17	0	35085
9383	1	35205	0	19	0	35225
9384	4	110	4	35184	0	35302
9385	7	86	3	35874	0	35970
9386	7	75	2	35886	0	35970
9387	37	1	35772	27	0	35837
9388	42	2	36297	11	0	36352
9389	36069	10	82	7	0	36168
9390	4	35618	1	16	0	35639
9391	34354	4	66	5	0	34429
9392	2	50	1	35336	0	35389
9393	35434	1	64	9	0	35508
9394	16	59	5	35151	0	35231
9395	1	34881	1	23	0	34906
9396	34127	6	77	6	0	34216
9397	52	4	34421	3	0	34480
9398	4	33674	0	15	0	33693
9399	34317	0	40	4	0	34361
9400	11	118	4	34670	0	34803
9401	9	37495	2	19	0	37525
9402	2	75	3	37495	0	37575
9403	38583	1	58	5	0	38647
9404	8	79	4	38952	0	39043
9405	38751	1	36	3	0	38791
9406	13	1	38788	3	0	38805
9407	4	65	1	38115	0	38185
9408	36654	2	59	8	0	36723
9409	34	1	36614	3	0	36652
9410	2	33887	0	25	0	33914
9411	6	66	12	34337	0	34421
9412	17	0	34278	1	0	34296
9413	23	1	34589	4	0	34617
9414	9	77	6	35210	0	35302
9415	45	1	35103	1	0	35150
9416	36	1	36426	6	0	36469
9417	4	55	4	36825	0	36888
9418	37225	1	46	5	0	37277
9419	7	99	5	37906	0	38017
9420	4	99	3	37825	0	37931
9421	26	0	37744	4	0	37774
9422	5	72	4	39129	0	39210
9423	37836	0	59	4	0	37899
9424	29	0	37814	2	0	37845
9425	3	36545	1	18	0	36567
9426	3	74	2	36515	0	36594
9427	37102	2	42	5	0	37151
9428	13	120	4	36860	0	36997
9429	1	34808	0	52	0	34861
9430	44	0	35123	1	0	35168
9431	7	71	7	35580	0	35665
9432	35160	4	46	7	0	35217
9433	71	0	35602	1	0	35674
9434	10	80	0	38006	0	38096
9435	38020	2	66	2	0	38090
9436	37248	1	85	17	0	37351
9437	1	35835	0	21	0	35857
9438	35558	5	83	5	0	35651
9439	5	87	20	35774	0	35886
9440	44	1	35247	11	0	35303
9441	8	34736	5	62	0	34811
9442	2	34624	1	18	0	34645
9443	7	115	7	34449	0	34578
9444	7	83	0	35513	0	35603
9445	17	0	35956	17	0	35990
9446	9	36209	3	30	0	36251
9447	4	35656	0	17	0	35677
9448	9	79	2	35580	0	35670
9449	35622	4	43	7	0	35676
9450	3	35223	2	6	0	35234
9451	7	72	5	36570	0	36654
9452	37618	1	23	1	0	37643
9453	2	117	3	37461	0	37583
9454	3	41	6	36806	0	36856
9455	6	60	4	36862	0	36932
9456	1	19	0	37234	0	37254
9457	36991	2	23	4	0	37020
9458	10	85	3	36824	0	36922
9459	11	2	36743	3	0	36759
9460	35529	4	129	18	0	35680
9461	20	1	35691	2	0	35714
9462	17	1	37057	4	0	37079
9463	2	106	8	37359	0	37475
9464	9	104	8	37414	0	37535
9465	2	28	1	39134	0	39165
9466	38899	2	53	7	0	38961
9467	25	1	38940	0	0	38966
9468	38863	2	79	5	0	38949
9469	38610	4	133	6	0	38753
9470	33	1	38568	6	0	38608
9471	36452	6	128	13	0	36599
9472	47	1	37617	0	0	37665
9473	3	37038	0	43	0	37084
9474	4	212	5	36770	0	36991
9475	6	82	4	38589	0	38681
9476	6	73	6	38718	0	38803
9477	5	69	13	35867	0	35954
9478	31	1	36158	11	0	36201
9479	30	0	35315	9	0	35354
9480	6	68	3	35195	0	35272
9481	30	1	35502	7	0	35540
9482	35288	1	89	29	0	35407
9483	35836	4	130	7	0	35977
9484	2	39	3	36001	0	36045
9485	36006	0	41	3	0	36050
9486	0	36215	1	20	0	36236
9487	35130	3	77	12	0	35222
9488	17	1	37176	4	0	37198
9489	16	132	5	37626	0	37779
9490	2	37064	1	20	0	37087
9491	37250	4	94	7	0	37355
9492	9	78	18	35789	0	35894
9493	20	0	35992	3	0	36015
9494	7	47	1	36630	0	36685
9495	35651	3	73	10	0	35737
9496	22	0	35725	2	0	35749
9497	11	87	3	33978	0	34079
9498	7	97	2	33690	0	33796
9499	29	0	33839	4	0	33872
9500	14	34460	0	27	0	34501
9501	3	34312	0	20	0	34335
9502	3	92	1	34209	0	34305
9503	6	49	0	34310	0	34365
9504	3	42	1	34525	0	34571
9505	34279	2	29	8	0	34318
9506	36017	4	49	5	0	36075
9507	3	41	0	35959	0	36003
9508	35521	6	51	5	0	35583
9509	2	35003	0	15	0	35020
9510	6	143	3	32898	0	33050
9511	9	56	2	34304	0	34371
9512	0	45	0	34662	0	34707
9513	34804	2	28	8	0	34842
9514	2	34805	0	12	0	34819
9515	6	59	5	34131	0	34201
9516	35546	2	32	5	0	35585
9517	4	128	2	35395	0	35529
9518	9	86	2	36887	0	36984
9519	9	37828	1	12	0	37850
9520	1	36001	1	46	0	36049
9521	7	71	14	35930	0	36022
9522	10	55	3	36526	0	36594
9523	36750	2	48	1	0	36801
9524	10	123	4	36877	0	37014
9525	11	17	37602	2	0	37632
9526	17	164	2	36799	0	36982
9527	2	35142	1	16	0	35161
9528	34788	9	102	9	0	34908
9529	5	136	4	34924	0	35069
9530	16	94	6	36162	0	36278
9531	3	36411	1	19	0	36434
9532	36516	7	98	8	0	36629
9533	4	37052	2	16	0	37074
9534	4	140	5	36060	0	36209
9535	36	1	37037	7	0	37081
9536	12	85	0	37917	0	38014
9537	38068	4	67	10	0	38149
9538	1	36990	3	19	0	37013
9539	13	110	7	35584	0	35714
9540	2	36410	2	16	0	36430
9541	6	99	8	34967	0	35080
9542	33	0	36827	3	0	36863
9543	4	127	13	36737	0	36881
9544	9	102	2	36013	0	36126
9545	8	46	4	36781	0	36839
9546	36178	2	24	5	0	36209
9547	36308	10	105	9	0	36432
9548	5	36281	0	19	0	36305
9549	35533	5	101	10	0	35649
9550	4	35672	1	28	0	35705
9551	1	33967	0	31	0	33999
9552	33786	7	71	10	0	33874
9553	13	0	34240	2	0	34255
9554	7	99	10	33734	0	33850
9555	9	76	6	33742	0	33833
9556	1	34	2	34108	0	34145
9557	33778	5	36	8	0	33827
9558	0	33340	0	33	0	33373
9559	10	92	2	33105	0	33209
9560	3	33516	0	19	0	33538
9561	32978	8	87	4	0	33077
9562	3	51	1	34099	0	34154
9563	3	97	1	34083	0	34184
9564	2	32338	0	12	0	32352
9565	11	66	6	32079	0	32162
9566	3	38	2	32404	0	32447
9567	32217	12	38	7	0	32274
9568	3	32973	1	15	0	32992
9569	4	32527	2	25	0	32558
9570	14	62	3	32408	0	32487
9571	37	1	31776	2	0	31816
9572	12	22	33555	12	0	33601
9573	8	83	9	34149	0	34249
9574	14	1	34421	1	0	34437
9575	5	105	9	33743	0	33862
9576	4	57	3	33153	0	33217
9577	6	46	0	32855	0	32907
9578	33599	2	29	5	0	33635
9579	7	113	0	33626	0	33746
9580	6	103	2	33588	0	33699
9581	1	32895	1	47	0	32944
9582	9	87	7	31177	0	31280
9583	37	0	32828	4	0	32869
9584	3	72	3	32926	0	33004
9585	0	42	0	34195	0	34237
9586	34443	4	32	2	0	34481
9587	4	55	5	33259	0	33323
9588	5	76	4	33098	0	33183
9589	4	44	1	34007	0	34056
9590	34334	4	36	5	0	34379
9591	0	34208	0	8	0	34216
9592	13	93	1	32928	0	33035
9593	7	96	3	32820	0	32926
9594	21	0	31514	8	0	31543
9595	6	54	4	31271	0	31335
9596	31283	0	60	3	0	31346
9597	0	31072	0	9	0	31081
9598	12	84	6	32445	0	32547
9599	12	84	21	32663	0	32780
9600	30	1	32408	17	0	32456
9601	31954	4	119	11	0	32088
9602	0	32542	0	13	0	32555
9603	32010	6	74	5	0	32095
9604	3	61	5	31900	0	31969
9605	6	50	2	31779	0	31837
9606	5	22	5	30777	0	30809
9607	3	25	1	30716	0	30745
9608	30543	1	13	3	0	30560
9609	3	59	1	30116	0	30179
9610	4	29244	0	5	0	29253
9611	8	70	3	28390	0	28471
9612	2	23	2	29301	0	29328
9613	29577	1	44	6	0	29628
9614	2	29719	0	15	0	29736
9615	7	46	4	29479	0	29536
9616	29484	6	51	2	0	29543
9617	29175	1	41	2	0	29219
9618	1	65	5	27881	0	27952
9619	26	0	28002	0	0	28028
9620	28366	2	84	6	0	28458
9621	2	50	5	28002	0	28059
9622	12	0	28141	0	0	28153
9623	1	81	7	28105	0	28194
9624	5	98	1	29108	0	29212
9625	4	81	2	29656	0	29743
9626	2	29157	0	4	0	29163
9627	1	153	3	28833	0	28990
9628	1	25	0	29258	0	29284
9629	3	54	2	29327	0	29386
9630	2	19	0	29379	0	29400
9631	8	21	2	29418	0	29449
9632	3	28	3	29499	0	29533
9633	29175	2	45	4	0	29226
9634	23	4	29382	4	0	29413
9635	6	29766	2	26	0	29800
9636	29878	3	111	11	0	30003
9637	1	29531	2	23	0	29557
9638	30247	3	77	6	0	30333
9639	8	46	2	30492	0	30548
9640	31104	5	44	1	0	31154
9641	4	88	0	31038	0	31130
9642	13	48	4	30771	0	30836
9643	4	30725	2	19	0	30750
9644	29685	16	77	4	0	29782
9645	18	1	30411	9	0	30439
9646	10	51	1	29891	0	29953
9647	22	0	29594	5	0	29621
9648	48	0	27986	5	0	28039
9649	27326	1	85	18	0	27430
9650	4	36	4	27990	0	28034
9651	27	0	28024	1	0	28052
9652	22	4	30170	19	0	30215
9653	13	65	4	30550	0	30632
9654	4	43	1	29896	0	29944
9655	30016	3	37	6	0	30062
9656	7	53	1	30011	0	30072
9657	33	3	30499	0	0	30535
9658	8	78	1	30669	0	30756
9659	9	83	6	28939	0	29037
9660	3	28843	0	45	0	28891
9661	27489	4	77	2	0	27572
9662	2	27987	1	18	0	28008
9663	27991	6	90	1	0	28088
9664	4	29469	1	32	0	29506
9665	2	30427	0	11	0	30440
9666	6	112	6	30037	0	30161
9667	10	65	5	30203	0	30283
9668	3	44	1	30371	0	30419
9669	30267	2	28	5	0	30302
9670	26	1	29854	5	0	29886
9671	6	49	2	30139	0	30196
9672	29981	1	48	7	0	30037
9673	6	29763	1	26	0	29796
9674	2	27615	0	18	0	27635
9675	7	93	2	28416	0	28518
9676	1	61	2	29152	0	29216
9677	7	68	1	29497	0	29573
9678	0	29471	0	10	0	29481
9679	19	57	4	29302	0	29382
9680	17	0	29747	1	0	29765
9681	14	0	29954	10	0	29978
9682	29504	1	88	5	0	29598
9683	1	38	2	30005	0	30046
9684	29197	2	45	2	0	29246
9685	29679	4	97	7	0	29787
9686	5	30231	1	16	0	30253
9687	30459	0	61	1	0	30521
9688	30062	3	46	3	0	30114
9689	6	62	5	29300	0	29373
9690	6	30	4	29009	0	29049
9691	19	0	29789	8	0	29816
9692	3	30088	0	49	0	30140
9693	5	63	6	31209	0	31283
9694	5	49	0	31164	0	31218
9695	32146	2	47	3	0	32198
9696	10	49	2	32411	0	32472
9697	32563	1	35	5	0	32604
9698	10	99	1	32433	0	32543
9699	3	32310	3	6	0	32322
9700	30983	1	57	11	0	31052
9701	1	38	4	30641	0	30684
9702	6	73	0	30731	0	30810
9703	10	79	3	31106	0	31198
9704	20	0	31718	1	0	31739
9705	6	40	0	31769	0	31815
9706	31698	2	17	0	0	31717
9707	6	78	0	31546	0	31630
9708	2	88	2	31274	0	31366
9709	7	49	2	31239	0	31297
9710	10	31486	0	20	0	31516
9711	4	31402	0	50	0	31456
9712	31447	5	91	7	0	31550
9713	9	30108	1	18	0	30136
9714	29436	3	78	6	0	29523
9715	29307	3	88	6	0	29404
9716	28496	4	96	3	0	28599
9717	29	1	29123	5	0	29158
9718	1	29612	0	42	0	29655
9719	29190	4	64	1	0	29259
9720	2	62	3	29788	0	29855
9721	5	64	2	29352	0	29423
9722	8	68	4	29490	0	29570
9723	4	29816	0	8	0	29828
9724	3	48	1	29466	0	29518
9725	29473	3	28	4	0	29508
9726	2	44	1	29034	0	29081
9727	7	59	3	29259	0	29328
9728	20	1	27516	6	0	27543
9729	33	0	27610	9	0	27652
9730	4	93	2	27786	0	27885
9731	5	59	1	27570	0	27635
9732	1	27331	0	3	0	27335
9733	5	110	2	26993	0	27110
9734	7	39	4	27443	0	27493
9735	5	34	2	27717	0	27758
9736	27628	1	48	2	0	27679
9737	22	2	27986	2	0	28012
9738	10	31	0	28878	0	28919
9739	28794	4	45	6	0	28849
9740	26580	3	46	3	0	26632
9741	3	44	1	25442	0	25490
9742	4	39	1	26162	0	26206
9743	26739	1	33	4	0	26777
9744	6	27229	0	33	0	27268
9745	5	27228	2	16	0	27251
9746	7	34	1	26877	0	26919
9747	27110	2	40	2	0	27154
9748	26982	8	63	3	0	27056
9749	26763	6	116	6	0	26891
9750	29	0	26929	3	0	26961
9751	25716	2	73	2	0	25793
9752	17	1	25376	2	0	25396
9753	24770	13	124	2	0	24909
9754	4	25102	4	16	0	25126
9755	53	0	25455	2	0	25510
9756	3	66	3	24974	0	25046
9757	10	1	25039	3	0	25053
9758	3	31	2	25125	0	25161
9759	24688	2	63	5	0	24758
9760	23	0	25196	4	0	25223
9761	4	69	1	24848	0	24922
9762	3	25127	1	14	0	25145
9763	1	62	3	24781	0	24847
9764	4	45	1	24627	0	24677
9765	2	33	0	24852	0	24887
9766	26433	3	18	6	0	26460
9767	25455	7	51	1	0	25514
9768	5	38	5	25150	0	25198
9769	19	1	23954	2	0	23976
9770	14	1	24027	5	0	24047
9771	5	56	2	22334	0	22397
9772	17	0	22199	4	0	22220
9773	7	66	20	22327	0	22420
9774	4	54	1	22154	0	22213
9775	5	49	1	21950	0	22005
9776	6	23484	1	7	0	23498
9777	2	23836	0	4	0	23842
9778	4	62	0	23955	0	24021
9779	5	36	3	23529	0	23573
9780	4	28	2	23134	0	23168
9781	22822	2	29	3	0	22856
9782	31	0	22792	0	0	22823
9783	1	34	0	24400	0	24435
9784	24271	3	43	2	0	24319
9785	1	23914	0	10	0	23925
9786	2	136	2	23097	0	23237
9787	1	44	2	23934	0	23981
9788	2	63	4	25519	0	25588
9789	1	56	4	26470	0	26531
9790	11	0	26406	3	0	26420
9791	26570	3	64	9	0	26646
9792	26487	5	109	10	0	26611
9793	33	1	26200	1	0	26235
9794	25749	3	76	3	0	25831
9795	25654	4	105	3	0	25766
9796	10	0	25266	5	0	25281
9797	3	26376	2	19	0	26400
9798	4	47	5	26468	0	26524
9799	16	4	26485	5	0	26510
9800	3	26410	0	33	0	26446
9801	23	0	26462	1	0	26486
9802	5	26529	1	15	0	26550
9803	3	42	3	25801	0	25849
9804	22	1	26315	0	0	26338
9805	8	64	2	28510	0	28584
9806	47	0	28486	1	0	28534
9807	17	32460	1	37	0	32515
9808	34101	4	98	13	0	34216
9809	14	34262	3	24	0	34303
9810	3	34723	0	39	0	34765
9811	9	189	8	34502	0	34708
9812	2	67	4	34956	0	35029
9813	9	87	4	33047	0	33147
9814	7	54	8	33194	0	33263
9815	10	63	4	33681	0	33758
9816	25	1	33726	1	0	33753
9817	3	54	3	34362	0	34422
9818	4	19	2	33235	0	33260
9819	32583	2	46	8	0	32639
9820	31891	2	64	9	0	31966
9821	32233	1	46	1	0	32281
9822	1	20	3	32754	0	32778
9823	32714	0	28	1	0	32743
9824	32745	3	40	3	0	32791
9825	32663	3	86	0	0	32752
9826	22	1	32726	0	0	32749
9827	35000	0	72	5	0	35077
9828	34383	1	101	3	0	34488
9829	34588	3	101	3	0	34695
9830	6	51	2	33819	0	33878
9831	36	1	33781	4	0	33822
9832	5	56	4	33658	0	33723
9833	34524	3	62	4	0	34593
9834	10	90	3	34440	0	34543
9835	4	34115	0	18	0	34137
9836	11	37	1	34953	0	35002
9837	35052	2	33	1	0	35088
9838	34119	5	53	2	0	34179
9839	34080	3	107	6	0	34196
9840	12	0	34158	1	0	34171
9841	6	59	0	33920	0	33985
9842	4	35	5	32625	0	32669
9843	33	2	33239	5	0	33279
9844	9	33404	2	41	0	33456
9845	13	2	33593	2	0	33610
9846	3	44	0	33681	0	33728
9847	33403	5	98	1	0	33507
9848	26	0	34057	2	0	34085
9849	5	60	7	33646	0	33718
9850	31	1	33726	9	0	33767
9851	33642	7	106	10	0	33765
9852	17	41	4	32033	0	32095
9853	29	0	31981	4	0	32014
9854	11	53	3	31891	0	31958
9855	19	0	32526	8	0	32553
9856	3	33133	1	27	0	33164
9857	4	53	0	32265	0	32322
9858	32543	0	55	8	0	32606
9859	1	63	4	32003	0	32071
9860	6	40	0	32807	0	32853
9861	32833	4	51	7	0	32895
9862	8	32526	0	16	0	32550
9863	12	32413	0	12	0	32437
9864	20	88	1	30454	0	30563
9865	3	30350	3	7	0	30363
9866	9	53	14	29992	0	30068
9867	2	33	5	30058	0	30098
9868	30433	1	45	4	0	30483
9869	2	30461	4	18	0	30485
9870	55	0	30212	2	0	30269
9871	34	30734	3	30	0	30801
9872	30056	1	49	3	0	30109
9873	32498	2	90	5	0	32595
9874	2	36	0	32504	0	32542
9875	33450	1	35	3	0	33489
9876	5	35	1	33530	0	33571
9877	33650	1	36	1	0	33688
9878	33563	2	76	3	0	33644
9879	3	23	2	33808	0	33836
9880	30675	1	43	9	0	30728
9881	20	1	30936	3	0	30960
9882	25735	3	70	8	0	25816
9883	5	22	2	26063	0	26092
9884	25223	3	47	5	0	25278
9885	2	25129	0	4	0	25135
9886	6	39	1	24279	0	24325
9887	2	34	1	24248	0	24285
9888	24016	1	30	2	0	24049
9889	13	1	24146	4	0	24164
9890	1	24173	0	16	0	24190
9891	4	73	4	23220	0	23301
9892	5	25085	0	6	0	25096
9893	5	101	2	24290	0	24398
9894	8	40	5	24507	0	24560
9895	3	32	2	24557	0	24594
9896	24719	4	34	6	0	24763
9897	7	31	3	24635	0	24676
9898	24261	1	25	1	0	24288
9899	24309	2	25	6	0	24342
9900	4	12	0	24251	0	24267
9901	22387	0	26	1	0	22414
9902	21953	1	39	1	0	21994
9903	4	0	22957	1	0	22962
9904	1	35	1	22882	0	22919
9905	23069	5	38	8	0	23120
9906	3	23420	5	9	0	23437
9907	23731	0	39	3	0	23773
9908	23965	1	67	8	0	24041
9909	2	1	29682	4	0	29689
9910	3	46	1	30067	0	30117
9911	30696	0	14	3	0	30713
9912	4	48	2	30986	0	31040
9913	5	66	3	30909	0	30983
9914	4	39	9	30948	0	31000
9915	1	26	1	31776	0	31804
9916	31524	1	19	3	0	31547
9917	32	0	31885	4	0	31921
9918	3	52	5	31273	0	31333
9919	19	2	30805	2	0	30828
9920	9	2	32457	17	0	32485
9921	32165	6	98	2	0	32271
9922	39	2	33681	7	0	33729
9923	1	33295	0	43	0	33339
9924	34025	3	57	5	0	34090
9925	34219	9	79	3	0	34310
9926	6	58	7	34324	0	34395
9927	62	3	40056	6	0	40127
9928	41	0	40616	17	0	40674
9929	40373	5	97	18	0	40493
9930	3	60	3	40735	0	40801
9931	40215	3	85	15	0	40318
9932	3	41971	5	34	0	42013
9933	41758	1	131	10	0	41900
9934	43177	5	87	9	0	43278
9935	3	43259	0	23	0	43285
9936	4	80	3	43634	0	43721
9937	44261	0	78	4	0	44343
9938	54	2	44610	20	0	44686
9939	3	46325	1	36	0	46365
9940	1	89	6	46454	0	46550
9941	46983	6	84	8	0	47081
9942	2	47879	0	36	0	47917
9943	47572	4	131	18	0	47725
9944	41	0	47845	14	0	47900
9945	47571	2	125	11	0	47709
9946	26	3	47884	11	0	47924
9947	46752	4	122	13	0	46891
9948	46487	12	139	24	0	46662
9949	31	0	44486	1	0	44518
9950	0	43140	0	32	0	43172
9951	6	99	6	43245	0	43356
9952	50	3	44406	3	0	44462
9953	5	44172	0	26	0	44203
9954	15	123	2	44646	0	44786
9955	9	119	9	44829	0	44966
9956	34	0	45251	4	0	45289
9957	8	126	4	45580	0	45718
9958	10	147	5	45089	0	45251
9959	35	4	44773	2	0	44814
9960	16	130	6	45107	0	45259
9961	4	45302	4	40	0	45350
9962	45932	0	91	3	0	46026
9963	12	179	5	46570	0	46766
9964	2	46561	0	22	0	46585
9965	25	153	6	46597	0	46781
9966	6	47479	1	51	0	47537
9967	138	5	47353	2	0	47498
9968	3	46313	1	36	0	46353
9969	46374	2	85	7	0	46468
9970	46197	3	81	16	0	46297
9971	46144	9	120	9	0	46282
9972	49	2	46594	8	0	46653
9973	70	3	46457	24	0	46554
9974	4	47198	1	32	0	47235
9975	16	199	4	45930	0	46149
9976	4	48320	0	26	0	48350
9977	20	144	5	47531	0	47700
9978	7	48608	2	50	0	48667
9979	48611	2	79	7	0	48699
9980	48653	4	82	4	0	48743
9981	6	97	2	48659	0	48764
9982	33	0	48384	4	0	48421
9983	48158	4	97	11	0	48270
9984	2	42964	1	43	0	43010
9985	11	157	3	42440	0	42611
9986	19	114	8	42542	0	42683
9987	2	41588	1	21	0	41612
9988	41491	7	91	8	0	41597
9989	30	0	41695	6	0	41731
9990	4	88	1	42447	0	42540
9991	42590	2	72	4	0	42668
9992	42724	7	100	15	0	42846
9993	2	42652	1	27	0	42682
9994	15	147	9	41468	0	41639
9995	17	40766	1	12	0	40796
9996	47712	9	64	17	0	47802
9997	19	2	48360	5	0	48386
9998	43	3	48026	15	0	48087
9999	3	122	3	48100	0	48228
10000	11	116	7	47445	0	47579
10001	1	41521	0	18	0	41540
10002	14	92	7	41405	0	41518
10003	34	1	41570	4	0	41609
10004	41578	4	75	13	0	41670
10005	8	70	6	41756	0	41840
10006	26	0	43511	2	0	43539
10007	13	110	7	43774	0	43904
10008	5	126	2	41938	0	42071
10009	1	40959	0	15	0	40975
10010	10	271	7	40788	0	41076
10011	11	79	2	41968	0	42060
10012	4	58	0	41233	0	41295
10013	40828	4	36	5	0	40873
10014	4	38337	0	54	0	38395
10015	6	37891	1	34	0	37932
10016	39125	3	61	24	0	39213
10017	38349	4	64	7	0	38424
10018	1	38557	1	22	0	38581
10019	2	37769	0	35	0	37806
10020	37795	7	62	14	0	37878
10021	3	39299	0	24	0	39326
10022	3	39741	0	28	0	39772
10023	41779	8	53	25	0	41865
10024	1	41675	2	16	0	41694
10025	41355	6	97	6	0	41464
10026	41388	3	94	6	0	41491
10027	41052	10	67	7	0	41136
10028	3	43717	0	23	0	43743
10029	1	43752	2	16	0	43771
10030	15	180	2	44291	0	44488
10031	2	45643	0	11	0	45656
10032	11	59	1	45485	0	45556
10033	49101	5	36	7	0	49149
10034	18	131	2	48905	0	49056
10035	4	49408	0	105	0	49517
10036	48813	14	99	12	0	48938
10037	1	49359	1	33	0	49394
10038	2	52528	0	30	0	52560
10039	25	182	6	51028	0	51241
10040	2	51815	0	33	0	51850
10041	51272	8	102	12	0	51394
10042	37	2	51123	6	0	51168
10043	4	52787	3	29	0	52823
10044	12	108	9	52443	0	52572
10045	74	1	53959	6	0	54040
10046	16	155	61	53517	0	53749
10047	11	115	15	53829	0	53970
10048	20	156	9	54077	0	54262
10049	11	184	2	54213	0	54410
10050	37	5	53514	22	0	53578
10051	4	52467	0	44	0	52515
10052	51841	9	170	24	0	52044
10053	31	0	52175	6	0	52212
10054	49727	12	122	35	0	49896
10055	10	0	51124	4	0	51138
10056	3	95	5	52446	0	52549
10057	41	1	52490	2	0	52534
10058	40	1	55909	10	0	55960
10059	2	163	12	56216	0	56393
10060	10	166	0	55156	0	55332
10061	15	119	5	55325	0	55464
10062	3	41	1	56686	0	56731
10063	55747	5	90	8	0	55850
10064	38	2	55982	3	0	56025
10065	56495	8	157	8	0	56668
10066	56268	4	109	10	0	56391
10067	55022	6	128	19	0	55175
10068	54803	8	140	11	0	54962
10069	54467	6	129	7	0	54609
10070	6	85	5	54622	0	54718
10071	43	0	54445	2	0	54490
10072	53	1	54484	8	0	54546
10073	3	56200	6	65	0	56274
10074	56198	12	93	8	0	56311
10075	6	171	7	56160	0	56344
10076	45	139	14	55584	0	55782
10077	20	56069	2	56	0	56147
10078	19	56331	3	23	0	56376
10079	9	56856	2	40	0	56907
10080	56779	10	81	13	0	56883
10081	26	161	6	56209	0	56402
10082	9	55304	0	39	0	55352
10083	21	96	7	55078	0	55202
10084	37	5	55387	3	0	55432
10085	49	1	56370	9	0	56429
10086	5	93	4	56499	0	56601
10087	56714	0	79	5	0	56798
10088	56265	9	136	6	0	56416
10089	56247	6	259	11	0	56523
10090	25	0	57977	11	0	58013
10091	13	105	13	62777	0	62908
10092	4	156	9	62026	0	62195
10093	38	0	61944	7	0	61989
10094	60672	11	166	20	0	60869
10095	23	1	61674	11	0	61709
10096	58	1	61903	7	0	61969
10097	41	1	61952	11	0	62005
10098	16	151	6	61605	0	61778
10099	9	187	49	67885	0	68130
10100	52	1	70595	1	0	70649
10101	12	107	8	71180	0	71307
10102	72115	0	103	9	0	72227
10103	28	121	7	71998	0	72154
10104	98	1	68111	6	0	68216
10105	50	2	70983	13	0	71048
10106	15	111	6	69444	0	69576
10107	68975	1	117	28	0	69121
10108	17	68720	1	54	0	68792
10109	65048	11	191	17	0	65267
10110	65464	3	192	14	0	65673
10111	35	1	65329	0	0	65365
10112	15	110	2	65323	0	65450
10113	64005	2	44	7	0	64058
10114	59003	12	122	7	0	59144
10115	3	58930	1	18	0	58952
10116	23	118	9	58669	0	58819
10117	16	160	7	58200	0	58383
10118	53	0	58223	7	0	58283
10119	26	155	11	57582	0	57774
10120	73	2	57260	8	0	57343
10121	45	2	58470	15	0	58532
10122	8	93	3	59426	0	59530
10123	59485	1	75	10	0	59571
10124	11	59883	0	40	0	59934
10125	59774	4	152	10	0	59940
10126	60387	4	145	8	0	60544
10127	7	60081	0	21	0	60109
10128	11	129	4	59294	0	59438
10129	60238	5	76	10	0	60329
10130	5	58952	1	33	0	58991
10131	59335	3	120	15	0	59473
10132	5	59256	0	25	0	59286
10133	24	150	4	57336	0	57514
10134	11	68	1	57588	0	57668
10135	56761	4	71	31	0	56867
10136	56556	7	162	9	0	56734
10137	3	56724	3	66	0	56796
10138	55	0	55299	6	0	55360
10139	36	0	56950	8	0	56994
10140	7	170	3	56295	0	56475
10141	9	56269	1	12	0	56291
10142	14	192	7	55971	0	56184
10143	12	106	3	56131	0	56252
10144	23	117	3	56436	0	56579
10145	52	1	56360	7	0	56420
10146	46	5	56235	22	0	56308
10147	6	56310	1	38	0	56355
10148	9	136	6	54075	0	54226
10149	7	118	5	53519	0	53649
10150	31	3	53345	5	0	53384
10151	53424	3	130	2	0	53559
10152	8	140	9	54159	0	54316
10153	69	0	53985	8	0	54062
10154	53871	13	133	22	0	54039
10155	3	54177	2	60	0	54242
10156	99	1	54831	3	0	54934
10157	5	100	5	54838	0	54948
10158	54551	4	89	11	0	54655
10159	46	1	55027	8	0	55082
10160	9	183	50	54004	0	54246
10161	24	133	10	53992	0	54159
10162	6	86	0	54607	0	54699
10163	53839	9	47	9	0	53904
10164	131	51982	0	78	0	52191
10165	5	128	4	48762	0	48899
10166	51	1	52860	3	0	52915
10167	13	161	4	50666	0	50844
10168	10	49902	2	51	0	49965
10169	15	50081	3	66	0	50165
10170	49999	1	70	14	0	50084
10171	40041	9133	88	34	0	49296
10172	13	0	49193	3	0	49209
10173	48719	4	78	14	0	48815
10174	5	49477	0	19	0	49501
10175	40626	8	93	5	0	40732
10176	4	116	6	38377	0	38503
10177	24	2	38189	2	0	38217
10178	12	107	11	37106	0	37236
10179	28	0	36948	15	0	36991
10180	36844	4	71	14	0	36933
10181	6	86	10	34159	0	34261
10182	1	33979	2	19	0	34001
10183	8	115	3	34554	0	34680
10184	45	1	34589	8	0	34643
10185	8	34134	2	15	0	34159
10186	34171	3	72	3	0	34249
10187	5	36358	1	21	0	36385
10188	4	36420	2	21	0	36447
10189	10	153	3	37738	0	37904
10190	2	38316	0	11	0	38329
10191	3	120	1	38146	0	38270
10192	87	2	38255	8	0	38352
10193	40555	5	79	11	0	40650
10194	40335	6	94	6	0	40441
10195	13	0	40401	4	0	40418
10196	39079	3	99	13	0	39194
10197	2	38715	0	17	0	38734
10198	38684	5	84	4	0	38777
10199	10	80	2	39351	0	39443
10200	73	1	39118	16	0	39208
10201	3	38947	0	20	0	38970
10202	6	122	6	38820	0	38954
10203	3	45	1	39631	0	39680
10204	39520	4	29	5	0	39558
10205	39222	3	79	4	0	39308
10206	9	39415	2	13	0	39439
10207	12	38940	1	18	0	38971
10208	4	39383	0	26	0	39413
10209	5	58	3	38128	0	38194
10210	38259	2	44	2	0	38307
10211	38528	7	27	7	0	38569
10212	5	73	1	38813	0	38892
10213	0	40	0	39595	0	39635
10214	39667	4	40	3	0	39714
10215	5	103	2	37397	0	37507
10216	35	0	37393	3	0	37431
10217	38096	5	69	12	0	38182
10218	37829	6	122	6	0	37963
10219	14	0	39201	1	0	39216
10220	39353	5	66	11	0	39435
10221	1	50	3	39626	0	39680
10222	6	118	5	39452	0	39581
10223	5	83	2	39649	0	39739
10224	39702	2	48	8	0	39760
10225	2	39655	0	39	0	39696
10226	27	143	5	39225	0	39400
10227	3	39706	0	54	0	39763
10228	39007	10	38	4	0	39059
10229	4	121	2	40517	0	40644
10230	9	133	5	41402	0	41549
10231	1	40493	0	21	0	40515
10232	35	4	40514	2	0	40555
10233	7	64	3	40767	0	40841
10234	39927	5	43	1	0	39976
10235	39357	9	97	18	0	39481
10236	14	0	40558	3	0	40575
10237	8	152	6	40621	0	40787
10238	6	40373	0	10	0	40389
10239	2	85	3	39712	0	39802
10240	40550	0	54	1	0	40605
10241	40408	6	62	8	0	40484
10242	15	91	5	36891	0	37002
10243	3	37637	0	15	0	37655
10244	37473	1	49	7	0	37530
10245	5	32	0	37209	0	37246
10246	37135	1	30	3	0	37169
10247	36756	8	53	7	0	36824
10248	6	46	1	36480	0	36533
10249	7	65	0	36517	0	36589
10250	5	86	2	38427	0	38520
10251	0	38312	1	12	0	38325
10252	5	83	3	38025	0	38116
10253	6	97	6	38088	0	38197
10254	50	0	38358	6	0	38414
10255	75	1	39223	14	0	39313
10256	4	93	3	40569	0	40669
10257	40484	3	62	7	0	40556
10258	3	40278	0	30	0	40311
10259	39021	6	120	9	0	39156
10260	24	0	41677	5	0	41706
10261	68	2	41959	10	0	42039
10262	8	38646	2	42	0	38698
10263	15	118	5	38319	0	38457
10264	47	1	38370	8	0	38426
10265	28	0	39290	16	0	39334
10266	5	56	3	39723	0	39787
10267	39498	3	68	3	0	39572
10268	39454	7	64	1	0	39526
10269	4	71	1	37087	0	37163
10270	100	3	37884	13	0	38000
10271	3	198	2	40136	0	40339
10272	14	144	5	39983	0	40146
10273	7	39693	0	15	0	39715
10274	37670	1	1620	4	0	39295
10275	39979	2	65	7	0	40053
10276	1	38481	2	20	0	38504
10277	6	100	8	37821	0	37935
10278	2	38140	0	41	0	38183
10279	37199	8	53	16	0	37276
10280	22	0	38612	7	0	38641
10281	39	0	38332	10	0	38381
10282	14	2	38921	12	0	38949
10283	3	106	7	39660	0	39776
10284	4	51	5	39832	0	39892
10285	40165	2	39	3	0	40209
10286	15	132	8	41756	0	41911
10287	9	89	5	41787	0	41890
10288	63	2	41685	12	0	41762
10289	45	1	41010	11	0	41067
10290	40692	8	120	12	0	40832
10291	3	40905	2	27	0	40937
10292	40483	5	74	4	0	40566
10293	3	178	5	40579	0	40765
10294	5	92	3	40363	0	40463
10295	11	39249	1	10	0	39271
10296	9	67	4	38879	0	38959
10297	40477	1	41	6	0	40525
10298	6	114	4	40339	0	40463
10299	54	1	40627	11	0	40693
10300	10	40453	4	35	0	40502
10301	40659	3	66	5	0	40733
10302	40644	7	114	8	0	40773
10303	40638	10	49	4	0	40701
10304	41539	2	89	9	0	41639
10305	4	83	5	40210	0	40302
10306	5	67	7	39924	0	40003
10307	26	2	40225	7	0	40260
10308	9	138	4	40014	0	40165
10309	48	1	40459	5	0	40513
10310	4	64	2	40979	0	41049
10311	41431	3	67	8	0	41509
10312	3	40991	2	8	0	41004
10313	15	111	4	40174	0	40304
10314	7	52	2	40367	0	40428
10315	40310	3	19	5	0	40337
10316	40077	2	69	9	0	40157
10317	64	0	41513	3	0	41580
10318	2	41804	2	17	0	41825
10319	11	105	5	41480	0	41601
10320	4	47	4	41704	0	41759
10321	41624	2	44	8	0	41678
10322	41474	4	231	10	0	41719
10323	9	0	43049	2	0	43060
10324	27	1	42974	6	0	43008
10325	7	100	23	42710	0	42840
10326	7	129	9	40860	0	41005
10327	32	1	41635	3	0	41671
10328	41616	6	111	16	0	41749
10329	28	54	8	41944	0	42034
10330	41388	3	80	8	0	41479
10331	0	40032	0	46	0	40078
10332	38845	5	101	9	0	38960
10333	41	1	39125	4	0	39171
10334	11	39740	4	46	0	39801
10335	10	37341	1	41	0	37393
10336	37387	4	61	11	0	37463
10337	39580	3	72	4	0	39659
10338	13	143	6	42929	0	43091
10339	9	42530	0	27	0	42566
10340	6	41909	0	19	0	41934
10341	6	59	1	42007	0	42073
10342	42066	3	36	2	0	42107
10343	41926	11	94	13	0	42044
10344	13	0	41607	3	0	41623
10345	42511	2	139	9	0	42661
10346	6	41240	0	12	0	41258
10347	39122	3	94	13	0	39232
10348	10	40247	0	15	0	40272
10349	5	39063	1	14	0	39083
10350	7	71	2	39040	0	39120
10351	40954	4	46	2	0	41006
10352	41060	10	64	20	0	41154
10353	69	0	43854	3	0	43926
10354	2	70	6	44303	0	44381
10355	44016	3	46	5	0	44070
10356	6	49	1	43020	0	43076
10357	43748	4	32	2	0	43786
10358	43012	6	83	7	0	43108
10359	18	4	42540	3	0	42565
10360	3	135	9	42118	0	42265
10361	6	129	4	41985	0	42124
10362	8	39	3	40100	0	40150
10363	34	1	40090	0	0	40125
10364	4	121	3	40092	0	40220
10365	35	157	8	39896	0	40096
10366	3	40254	3	42	0	40302
10367	30	5	40150	2	0	40187
10368	3	40259	1	24	0	40287
10369	42663	1	80	8	0	42752
10370	3	114	7	42733	0	42857
10371	13	121	1	42891	0	43026
10372	1	42002	1	28	0	42032
10373	42591	2	84	3	0	42680
10374	42941	2	101	4	0	43048
10375	2	42452	0	57	0	42511
10376	3	42356	2	37	0	42398
10377	41784	5	75	11	0	41875
10378	31	1	42173	4	0	42209
10379	9	2	42274	12	0	42297
10380	41062	4	112	11	0	41189
10381	2	41273	2	28	0	41305
10382	40193	7	100	5	0	40305
10383	29	1	40353	3	0	40386
10384	41214	4	87	10	0	41315
10385	4	40734	0	9	0	40747
10386	2	184	2	40471	0	40659
10387	3	75	9	40530	0	40617
10388	4	121	4	40185	0	40314
10389	3	77	4	40455	0	40539
10390	11	108	2	40646	0	40767
10391	18	39945	3	17	0	39983
10392	39230	4	70	7	0	39311
10393	67	0	39436	2	0	39505
10394	5	118	9	42276	0	42408
10395	24	1	42552	2	0	42579
10396	1	91	4	42345	0	42441
10397	3	71	3	42317	0	42394
10398	42127	6	73	7	0	42213
10399	31	1	41077	17	0	41126
10400	3	41794	0	40	0	41837
10401	7	108	4	41738	0	41857
10402	8	97	6	41471	0	41582
10403	23	2	41656	2	0	41683
10404	7	164	5	44080	0	44256
10405	3	67	0	44249	0	44319
10406	47108	4	74	14	0	47200
10407	17	46485	0	41	0	46543
10408	46220	8	137	10	0	46375
10409	46326	6	114	8	0	46454
10410	6	60	3	46305	0	46374
10411	20	4	46229	3	0	46256
10412	41	0	46536	15	0	46592
10413	7	168	4	45043	0	45222
10414	12	144	5	42114	0	42275
10415	8	41898	1	36	0	41943
10416	42626	1	109	5	0	42741
10417	9	42763	1	20	0	42793
10418	3	43975	2	28	0	44008
10419	44866	5	100	9	0	44980
10420	16	152	3	44500	0	44671
10421	9	43312	15	29	0	43365
10422	19	104	3	43159	0	43285
10423	38	0	43533	3	0	43574
10424	46	0	45014	10	0	45070
10425	8	116	13	44853	0	44990
10426	56	1	45239	13	0	45309
10427	10	159	42	43893	0	44104
10428	16	103	7	43969	0	44095
10429	3	94	1	41747	0	41845
10430	41758	6	66	8	0	41838
10431	6	42805	1	33	0	42845
10432	7	42770	1	30	0	42808
10433	42306	5	71	17	0	42399
10434	42149	4	79	4	0	42236
10435	17	87	7	41477	0	41588
10436	34	1	43594	5	0	43634
10437	8	125	4	43611	0	43748
10438	58	1	43785	6	0	43850
10439	9	44348	1	47	0	44405
10440	10	72	3	43904	0	43989
10441	44059	4	87	12	0	44162
10442	6	71	1	43919	0	43997
10443	20	0	43691	2	0	43713
10444	49438	3	139	18	0	49598
10445	82	0	47156	9	0	47247
10446	38	2	47812	12	0	47864
10447	22	47054	2	34	0	47112
10448	69	45786	7	131	0	45993
10449	7	46813	0	26	0	46846
10450	47182	1	59	5	0	47247
10451	47631	0	46	1	0	47678
10452	39	134	5	47508	0	47686
10453	10	100	2	47793	0	47905
10454	11	131	4	46941	0	47087
10455	2	47055	1	44	0	47102
10456	47175	5	88	11	0	47279
10457	1	49557	0	19	0	49577
10458	7	91	3	49184	0	49285
10459	51851	3	82	4	0	51940
10460	4	93	2	51502	0	51601
10461	6	51	1	51466	0	51524
10462	51160	10	43	7	0	51220
10463	50571	10	101	19	0	50701
10464	35	0	50797	6	0	50838
10465	32	1	50844	22	0	50899
10466	38	3	51417	16	0	51474
10467	8	175	6	50261	0	50450
10468	12	176	10	49139	0	49337
10469	4	48133	1	17	0	48155
10470	48426	3	71	3	0	48503
10471	2	183	6	49941	0	50132
10472	8	125	3	50186	0	50322
10473	20	53324	4	19	0	53367
10474	1	53191	0	23	0	53215
10475	11	168	7	54376	0	54562
10476	12	83	2	55532	0	55629
10477	57094	3	52	12	0	57161
10478	56251	4	130	4	0	56389
10479	11	96	5	55774	0	55886
10480	27	1	53378	2	0	53408
10481	38	0	54030	41	0	54109
10482	3	145	5	51974	0	52127
10483	12	175	1	52078	0	52266
10484	11	51717	5	29	0	51762
10485	52798	7	142	8	0	52955
10486	5	148	4	52931	0	53088
10487	67	0	52842	2	0	52911
10488	28	135	7	52432	0	52602
10489	54	3	52007	5	0	52069
10490	29	3	52271	10	0	52313
10491	11	141	2	52119	0	52273
10492	51351	5	112	12	0	51480
10493	59	3	51841	1	0	51904
10494	7	135	5	50363	0	50510
10495	23	36	49683	1	0	49743
10496	9	128	7	49531	0	49675
10497	12	115	3	49076	0	49206
10498	22	0	49330	18	0	49370
10499	64	0	49674	10	0	49748
10500	8	142	24	48613	0	48787
10501	3	103	5	48513	0	48624
10502	4	56	3	48311	0	48374
10503	11	39	1	48594	0	48645
10504	48159	3	33	8	0	48203
10505	48161	11	117	11	0	48300
10506	5	48428	1	20	0	48454
10507	47411	6	110	6	0	47533
10508	6	48	3	47415	0	47472
10509	46075	6	73	7	0	46161
10510	17	2	54437	24	0	54480
10511	54378	2	97	10	0	54487
10512	12	127	6	55993	0	56138
10513	6	84	1	56124	0	56215
10514	56254	4	72	8	0	56338
10515	10	119	4	56004	0	56137
10516	29	0	56069	5	0	56103
10517	55406	4	210	20	0	55640
10518	3	55770	1	26	0	55800
10519	18	126	7	48162	0	48313
10520	33	0	48818	6	0	48857
10521	24	176	9	48388	0	48597
10522	135	82	48676	4	0	48897
10523	9	152	7	48765	0	48933
10524	4	48701	1	66	0	48772
10525	14	162	4	48199	0	48379
10526	4	49624	1	8	0	49637
10527	12	321	5	49306	0	49644
10528	1	99	3	50234	0	50337
10529	11	130	7	49970	0	50118
10530	4	31	5	50681	0	50721
10531	11	75	7	50212	0	50305
10532	38	0	50546	14	0	50598
10533	15	124	5	48180	0	48324
10534	2	36	3	49426	0	49467
10535	47528	11	82	5	0	47626
10536	4	47601	1	29	0	47635
10537	47812	12	170	8	0	48002
10538	9	181	2	47887	0	48079
10539	70	3	47578	22	0	47673
10540	17	48685	3	74	0	48779
10541	48586	8	128	8	0	48730
10542	13	50926	3	56	0	50998
10543	7	50266	0	53	0	50326
10544	52469	12	111	12	0	52604
10545	8	68	6	52449	0	52531
10546	52086	3	107	12	0	52208
10547	10	87	0	50989	0	51086
10548	25	1	50521	2	0	50549
10549	25	1	48494	14	0	48534
10550	47897	9	109	23	0	48038
10551	46203	5	124	6	0	46338
10552	14	103	3	45853	0	45973
10553	4	58	1	44470	0	44533
10554	44882	1	62	3	0	44948
10555	7	44621	17	23	0	44668
10556	10	44298	0	42	0	44350
10557	44276	4	98	20	0	44398
10558	43864	5	88	2	0	43959
10559	1	42636	1	22	0	42660
10560	15	128	1	42300	0	42444
10561	29	0	42493	0	0	42522
10562	40	0	42661	13	0	42714
10563	41793	4	164	9	0	41970
10564	33	0	42159	4	0	42196
10565	1	139	1	42619	0	42760
10566	5	106	1	42168	0	42280
10567	5	42168	0	25	0	42198
10568	41986	9	111	16	0	42122
10569	3	79	0	43407	0	43489
10570	27	1	43175	58	0	43261
10571	6	42687	4	84	0	42781
10572	20	121	1	42542	0	42684
10573	42	0	42754	11	0	42807
10574	28	6	42655	20	0	42709
10575	11	43262	2	35	0	43310
10576	43194	10	93	9	0	43306
10577	2	43501	1	25	0	43529
10578	42379	3	80	19	0	42481
10579	22	1	45574	5	0	45602
10580	49345	10	138	16	0	49509
10581	6	50465	1	18	0	50490
10582	12	137	5	52029	0	52183
10583	1	39	3	52454	0	52497
10584	52106	3	100	14	0	52223
10585	27	2	52164	2	0	52195
10586	44404	5	152	8	0	44569
10587	44229	8	160	9	0	44406
10588	14	0	41040	2	0	41056
10589	14	1	41391	10	0	41416
10590	9	61	3	41357	0	41430
10591	41120	0	56	1	0	41177
10592	41286	4	98	2	0	41390
10593	1	42092	1	27	0	42121
10594	10	128	1	41818	0	41957
10595	5	34	5	43181	0	43225
10596	3	75	6	44240	0	44324
10597	3	28	1	44193	0	44225
10598	43857	2	49	8	0	43916
10599	14	76	0	43779	0	43869
10600	36	1	43422	4	0	43463
10601	49	1	43400	13	0	43463
10602	42753	6	133	9	0	42901
10603	18	42885	1	34	0	42938
10604	4	42092	0	26	0	42122
10605	8	177	7	42544	0	42736
10606	7	128	8	43834	0	43977
10607	5	99	0	46420	0	46524
10608	2	67	1	46182	0	46252
10609	44	1	46222	7	0	46274
10610	10	115	3	45168	0	45296
10611	13	101	4	44537	0	44655
10612	24	0	43858	28	0	43910
10613	43559	14	158	28	0	43759
10614	4	43393	1	29	0	43427
10615	42435	6	114	12	0	42567
10616	52	1	42078	3	0	42134
10617	92	2	42881	9	0	42984
10618	11	41758	0	43	0	41812
10619	42246	3	98	4	0	42351
10620	42887	4	143	9	0	43043
10621	42941	23	125	3	0	43092
10622	8	43293	0	17	0	43318
10623	43057	5	149	3	0	43214
10624	46	0	43385	1	0	43432
10625	17	42462	0	56	0	42535
10626	43631	5	149	15	0	43800
10627	7	43652	1	19	0	43679
10628	43440	8	124	12	0	43584
10629	43430	6	135	3	0	43574
10630	31	1	43105	5	0	43142
10631	4	43044	0	49	0	43097
10632	42614	3	108	5	0	42730
10633	58	2	42655	6	0	42721
10634	4	42537	2	38	0	42581
10635	12	80	7	42583	0	42682
10636	31	2	43214	6	0	43253
10637	56	1	43919	11	0	43987
10638	4	54	0	44171	0	44229
10639	44041	3	94	10	0	44148
10640	3	43019	1	45	0	43068
10641	49	3	43118	13	0	43183
10642	29	2	43629	5	0	43665
10643	43575	6	117	9	0	43707
10644	19	42617	29	42	0	42707
10645	42025	16	120	9	0	42170
10646	6	44116	1	29	0	44152
10647	44177	2	111	7	0	44297
10648	45177	3	148	5	0	45333
10649	3	47174	1	19	0	47197
10650	11	41	4	46373	0	46429
10651	46256	1	48	6	0	46311
10652	8	103	6	47401	0	47518
10653	3	55	2	47362	0	47422
10654	47124	0	62	7	0	47193
10655	3	43470	0	12	0	43485
10656	40626	0	79	11	0	40716
10657	33	0	40442	0	0	40475
10658	9	82	1	38413	0	38505
10659	4	46	1	38502	0	38553
10660	38206	5	27	7	0	38245
10661	38278	5	48	5	0	38336
10662	2	47	2	38876	0	38927
10663	23	0	40188	3	0	40214
10664	4	205	16	40090	0	40315
10665	7	62	8	40813	0	40890
10666	3	59	10	40757	0	40829
10667	3	41	5	41002	0	41051
10668	40670	4	88	8	0	40770
10669	38	0	40135	20	0	40193
10670	3	38874	1	29	0	38907
10671	15	103	6	38922	0	39046
10672	8	85	4	39806	0	39903
10673	43	2	40276	5	0	40326
10674	19	0	43927	14	0	43960
10675	14	94	5	44063	0	44176
10676	10	126	3	43891	0	44030
10677	42	3	43945	2	0	43992
10678	15	71	2	43864	0	43952
10679	44222	1	95	4	0	44322
10680	4	44008	7	49	0	44068
10681	57	2	43135	4	0	43198
10682	8	42503	1	24	0	42536
10683	3	69	1	40182	0	40255
10684	45	0	41187	7	0	41239
10685	3	41522	1	19	0	41545
10686	9	77	5	42191	0	42282
10687	46	0	44923	6	0	44975
10688	13	104	4	44770	0	44891
10689	2	37	0	45629	0	45668
10690	45456	2	51	7	0	45516
10691	5	25	6	44839	0	44875
10692	45037	0	36	0	0	45073
10693	43934	8	112	6	0	44060
10694	45349	7	126	8	0	45490
10695	6	54	6	45310	0	45376
10696	32	3	42409	2	0	42446
10697	23	0	42226	15	0	42264
10698	40685	6	183	24	0	40898
10699	16	2	41371	4	0	41393
10700	40893	2	183	9	0	41087
10701	3	41260	0	27	0	41290
10702	40342	8	127	9	0	40486
10703	31	0	40469	1	0	40501
10704	23	0	42856	13	0	42892
10705	11	71	5	42782	0	42869
10706	29	2	42222	7	0	42260
10707	14	0	42660	4	0	42678
10708	9	110	10	45773	0	45902
10709	4	121	9	45531	0	45665
10710	13	115	5	45450	0	45583
10711	2	44322	0	8	0	44332
10712	11	111	3	43758	0	43883
10713	3	46012	0	50	0	46065
10714	46255	3	91	12	0	46361
10715	46268	2	125	4	0	46399
10716	9	78	8	46048	0	46143
10717	7	45515	2	36	0	45560
10718	25	1	45559	20	0	45605
10719	47040	6	85	8	0	47139
10720	9	102	13	47217	0	47341
10721	4	75	3	47517	0	47599
10722	4	44	2	46113	0	46163
10723	46148	4	108	8	0	46268
10724	7	43655	1	61	0	43724
10725	9	43483	2	52	0	43546
10726	44053	5	136	39	0	44233
10727	7	44084	1	29	0	44121
10728	42956	8	118	6	0	43088
10729	43521	8	120	15	0	43664
10730	4	43946	1	19	0	43970
10731	10	135	3	43206	0	43354
10732	2	46075	0	17	0	46094
10733	13	98	5	45901	0	46017
10734	8	42	0	46282	0	46332
10735	46236	2	66	8	0	46312
10736	46121	4	98	5	0	46228
10737	7	85	5	45999	0	46096
10738	38	1	46073	6	0	46118
10739	44853	4	125	10	0	44992
10740	3	46157	1	13	0	46174
10741	9	191	8	44592	0	44800
10742	11	97	10	44825	0	44943
10743	12	66	3	45180	0	45261
10744	45349	2	27	5	0	45383
10745	45157	9	132	3	0	45301
10746	8	45734	0	44	0	45786
10747	6	43820	2	24	0	43852
10748	10	95	4	42394	0	42503
10749	7	82	6	41601	0	41696
10750	28	1	39360	5	0	39394
10751	19	65	5	39460	0	39549
10752	23	2	39401	5	0	39431
10753	35	6	39572	7	0	39620
10754	10	40259	0	26	0	40295
10755	11	59	3	39535	0	39608
10756	40053	2	67	0	0	40122
10757	5	78	5	39954	0	40042
10758	18	0	39641	3	0	39662
10759	39782	5	156	17	0	39960
10760	38701	5	146	14	0	38866
10761	22	3	39822	5	0	39852
10762	6	23	4	38930	0	38963
10763	36396	4	69	10	0	36479
10764	7	35970	0	44	0	36021
10765	35738	3	98	14	0	35853
10766	37980	2	79	7	0	38068
10767	10	72	4	38931	0	39017
10768	7	32	3	39546	0	39588
10769	39122	4	34	4	0	39164
10770	11	71	4	38263	0	38349
10771	32	0	38237	4	0	38273
10772	39335	3	137	15	0	39490
10773	39241	2	134	7	0	39384
10774	11	40992	0	46	0	41049
10775	3	40534	0	18	0	40555
10776	12	89	5	40184	0	40290
10777	2	40541	0	10	0	40553
10778	8	55	5	41104	0	41172
10779	41207	3	64	2	0	41276
10780	43096	6	105	10	0	43217
10781	2	42738	1	908	0	43649
10782	43113	3	123	11	0	43250
10783	3	42600	3	52	0	42658
10784	39447	4	89	8	0	39548
10785	39604	6	160	12	0	39782
10786	57	0	39547	7	0	39611
10787	40790	4	158	18	0	40970
10788	4	41053	1	52	0	41110
10789	1	38862	0	39	0	38902
10790	38896	3	94	4	0	38997
10791	11	62	6	39220	0	39299
10792	13	27	39758	1	0	39799
10793	9	80	2	40000	0	40091
10794	17	89	0	39600	0	39706
10795	13	2	38724	11	0	38750
10796	38726	5	124	17	0	38872
10797	0	38561	1	37	0	38599
10798	38213	8	95	4	0	38320
10799	5	50	2	39878	0	39935
10800	40122	1	82	10	0	40215
10801	4	39992	2	83	0	40081
10802	2	58	2	39952	0	40014
10803	39444	3	92	8	0	39547
10804	18	1	39058	7	0	39084
10805	32	0	38817	12	0	38861
10806	37645	6	115	6	0	37772
10807	7	36841	2	24	0	36874
10808	2	35467	1	14	0	35484
10809	10	94	4	35450	0	35558
10810	0	36571	2	10	0	36583
10811	8	106	5	36367	0	36486
10812	5	88	3	36650	0	36746
10813	5	61	4	36832	0	36902
10814	2	35009	0	5	0	35016
10815	8	58	5	34303	0	34374
10816	48	0	34383	6	0	34437
10817	2	34478	0	48	0	34528
10818	6	81	3	34413	0	34503
10819	2	35301	1	9	0	35313
10820	35334	2	58	2	0	35396
10821	35455	3	60	4	0	35522
10822	37403	9	89	4	0	37505
10823	1	37829	0	16	0	37846
10824	7	57	2	37982	0	38048
10825	22	1	37801	5	0	37829
10826	35	1	38015	8	0	38059
10827	45867	9	122	15	0	46013
10828	46048	6	135	5	0	46194
10829	6	67	6	46480	0	46559
10830	12	86	6	45737	0	45841
10831	55	0	45888	8	0	45951
10832	22	46577	3	91	0	46693
10833	4	46715	1	48	0	46768
10834	34	1	47380	2	0	47417
10835	7	102	16	47484	0	47609
10836	2	124	5	47330	0	47461
10837	11	79	11	48439	0	48540
10838	2	42	3	49303	0	49350
10839	49881	4	70	13	0	49968
10840	17	1	50009	0	0	50027
10841	50300	6	192	23	0	50521
10842	11	54	107	48910	0	49082
10843	47826	7	117	8	0	47958
10844	7	108	9	47034	0	47158
10845	72	0	47576	3	0	47651
10846	20	89	5	46714	0	46828
10847	34	1	46847	7	0	46889
10848	14	86	7	45443	0	45550
10849	58	1	45195	4	0	45258
10850	5	42366	0	30	0	42401
10851	13	128	2	42161	0	42304
10852	17	92	8	42265	0	42382
10853	9	42485	2	18	0	42514
10854	42163	3	124	10	0	42300
10855	7	64	13	43265	0	43349
10856	8	47	0	41953	0	42008
10857	41579	1	23	6	0	41609
10858	41332	0	100	11	0	41443
10859	41387	7	30	3	0	41427
10860	41396	3	167	3	0	41569
10861	7	1	41367	3	0	41378
10862	40422	3	123	5	0	40553
10863	40623	2	94	1	0	40720
10864	9	65	3	40904	0	40981
10865	5	48	0	41511	0	41564
10866	41208	2	57	4	0	41271
10867	3	40611	0	11	0	40625
10868	7	74	3	40367	0	40451
10869	132	2	40324	6	0	40464
10870	6	39796	1	23	0	39826
10871	39712	2	99	8	0	39821
10872	39570	6	155	7	0	39738
10873	44132	6	100	9	0	44247
10874	44363	7	159	1	0	44530
10875	4	63	6	43464	0	43537
10876	28	0	42934	0	0	42962
10877	30	0	43270	1	0	43301
10878	5	63	4	43349	0	43421
10879	43580	2	93	4	0	43679
10880	9	82	5	43644	0	43740
10881	40	0	44065	5	0	44110
10882	43604	12	147	10	0	43773
10883	44205	4	156	5	0	44370
10884	11	52	9	44055	0	44127
10885	34	0	43275	3	0	43312
10886	56	19	43586	5	0	43666
10887	43741	3	173	9	0	43926
10888	1	43741	1	54	0	43797
10889	40	1	44470	0	0	44511
10890	2	49	4	45613	0	45668
10891	46229	2	58	11	0	46300
10892	18	46040	0	33	0	46091
10893	11	46063	2	41	0	46117
10894	49985	5	101	12	0	50103
10895	3	52	4	49138	0	49197
10896	50003	2	66	14	0	50085
10897	6	80	6	49391	0	49483
10898	24	55	9	47178	0	47266
10899	54	0	47525	8	0	47587
10900	49	2	47047	10	0	47108
10901	21	1	47249	9	0	47280
10902	11	59	3	46946	0	47019
10903	38678	5	65	14	0	38762
10904	15	1	39272	2	0	39290
10905	6	68	1	38378	0	38453
10906	14	1	39419	1	0	39435
10907	1	40189	0	36	0	40226
10908	7	111	5	39201	0	39324
10909	19	83	5	39735	0	39842
10910	8	40	5	39438	0	39491
10911	39958	3	35	5	0	40001
10912	7	51	4	39905	0	39967
10913	1	42	1	39026	0	39070
10914	38403	0	64	7	0	38474
10915	13	1	37876	2	0	37892
10916	36940	4	76	4	0	37024
10917	36863	1	129	6	0	36999
10918	12	0	36796	3	0	36811
10919	36863	4	90	10	0	36967
10920	3	60	1	36503	0	36567
10921	17	1	36810	14	0	36842
10922	38909	5	115	16	0	39045
10923	40153	4	133	4	0	40294
10924	9	49	4	40046	0	40108
10925	10	95	5	40568	0	40678
10926	2	57	4	40672	0	40735
10927	41394	2	49	6	0	41451
10928	4	41024	3	41	0	41072
10929	41936	10	113	9	0	42068
10930	14	44483	2	15	0	44514
10931	5	43589	2	16	0	43612
10932	12	123	6	44344	0	44485
10933	6	128	7	44453	0	44594
10934	11	88	6	44897	0	45002
10935	9	82	4	45800	0	45895
10936	15	0	46000	1	0	46016
10937	46696	5	106	14	0	46821
10938	2	112	5	47492	0	47611
10939	29	2	47736	3	0	47770
10940	9	103	6	53946	0	54064
10941	21	121	7	53654	0	53803
10942	26	4	55120	3	0	55153
10943	22	107	9	55648	0	55786
10944	11	75	2	55921	0	56009
10945	56064	7	134	7	0	56212
10946	82	0	56421	6	0	56509
10947	56814	5	157	19	0	56995
10948	18	56560	2	28	0	56608
10949	51776	6	133	14	0	51929
10950	53091	4	144	9	0	53248
10951	9	59	2	52303	0	52373
10952	38	1	53265	4	0	53308
10953	7	52449	2	72	0	52530
10954	31	132	7	51650	0	51820
10955	7	52323	0	35	0	52365
10956	52014	10	125	14	0	52163
10957	72	5	52776	7	0	52860
10958	30	1	53787	5	0	53823
10959	18	123	6	52723	0	52870
10960	75	1	52937	7	0	53020
10961	17	101	6	52180	0	52304
10962	6	74	1	51877	0	51958
10963	52150	0	71	5	0	52226
10964	3	50991	0	19	0	51013
10965	14	220	10	50013	0	50257
10966	15	152	6	50141	0	50314
10967	20	126	4	49611	0	49761
10968	10	50516	1	25	0	50552
10969	5	46598	2	32	0	46637
10970	46713	9	104	10	0	46836
10971	46369	8	87	7	0	46471
10972	45131	10	129	9	0	45279
10973	17	4	46201	4	0	46226
10974	10	103	7	46255	0	46375
10975	37	5	45260	5	0	45307
10976	9	45948	1	42	0	46000
10977	45706	3	131	9	0	45849
10978	19	3	46210	3	0	46235
10979	6	108	7	47166	0	47287
10980	38	4	47406	11	0	47459
10981	48595	6	119	21	0	48741
10982	47433	1	189	12	0	47635
10983	47018	13	178	14	0	47223
10984	46880	11	294	18	0	47203
10985	22	3	43079	3845	0	46949
10986	48024	1	113	10	0	48148
10987	50387	7	155	14	0	50563
10988	3	50741	0	43	0	50787
10989	51703	8	137	12	0	51860
10990	52362	6	111	6	0	52485
10991	14	90	1	52325	0	52430
10992	6	53080	0	81	0	53167
10993	53058	12	124	10	0	53204
10994	53420	2	145	12	0	53579
10995	31	0	54370	3	0	54404
10996	47	2	54989	18	0	55056
10997	30	3	55478	14	0	55525
10998	17	89	1	54706	0	54813
10999	54205	2	99	8	0	54314
11000	4	53957	0	75	0	54036
11001	53705	6	165	6	0	53882
11002	5	54198	2	52	0	54257
11003	53560	13	149	8	0	53730
11004	14	54414	0	80	0	54508
11005	4	51533	2	42	0	51581
11006	50917	3	92	23	0	51035
11007	4	50029	1	29	0	50063
11008	20	74	10	49126	0	49230
11009	52	3	49681	4	0	49740
11010	40	2	49715	13	0	49770
11011	8	116	1	48787	0	48912
11012	17	113	5	48500	0	48635
11013	29	0	47283	2	0	47314
11014	12	90	3	46708	0	46813
11015	2	51	1	46664	0	46718
11016	40164	4	64	2	0	40234
11017	1	38591	2	42	0	38636
11018	18	125	4	37405	0	37552
11019	3	37910	1	53	0	37967
11020	37758	11	95	8	0	37872
11021	7	37364	2	15	0	37388
11022	37226	6	82	2	0	37316
11023	37151	4	55	5	0	37215
11024	4	83	3	37118	0	37208
11025	3	92	9	37144	0	37248
11026	7	57	4	36747	0	36815
11027	4	77	2	37304	0	37387
11028	19	1	35735	12	0	35767
11029	36053	4	71	10	0	36138
11030	2	35935	1	17	0	35955
11031	5	132	6	35300	0	35443
11032	17	80	5	35238	0	35340
11033	5	34498	0	11	0	34514
11034	34619	3	84	7	0	34713
11035	0	35478	0	4	0	35482
11036	14	124	9	35252	0	35399
11037	12	91	9	35212	0	35324
11038	7	63	5	35560	0	35635
11039	2	47	0	35930	0	35979
11040	35786	7	33	1	0	35827
11041	15	2	36229	1	0	36247
11042	5	98	7	37390	0	37500
11043	6	88	2	37264	0	37360
11044	12	73	1	37092	0	37178
11045	2	29	0	44275	0	44306
11046	44401	6	50	2	0	44459
11047	32	3	45149	6	0	45190
11048	16	114	5	54012	0	54147
11049	24	54318	2	35	0	54379
11050	9	54163	6	59	0	54237
11051	53474	5	138	38	0	53655
11052	67	2	53866	11	0	53946
11053	56361	6	203	16	0	56586
11054	25	1	58153	0	0	58179
11055	8	61	29	57528	0	57626
11056	55861	3	101	7	0	55972
11057	9	55904	2	22	0	55937
11058	31	157	12	55120	0	55320
11059	37	55013	2	29	0	55081
11060	54433	11	98	16	0	54558
11061	53654	3	154	14	0	53825
11062	10	74	5	53878	0	53967
11063	81	0	50506	3	0	50590
11064	20	2	50629	7	0	50658
11065	17	106	4	48390	0	48517
11066	7	47493	1	20	0	47521
11067	14	173	4	47432	0	47623
11068	6	120	7	47474	0	47607
11069	17	105	10	47644	0	47776
11070	27	4	46908	5	0	46944
11071	7	116	33	46139	0	46295
11072	30	146	6	44855	0	45037
11073	1	43535	0	46	0	43582
11074	10	694	6	38162	0	38872
11075	1	220	1	42804	0	43026
11076	2	91	2	43097	0	43192
11077	1	69	4	42913	0	42987
11078	7	85	4	42329	0	42425
11079	5	43	3	41885	0	41936
11080	10	74	5	40918	0	41007
11081	10	119	45	40871	0	41045
11082	27	2	40884	84	0	40997
11083	12	73	5	41015	0	41105
11084	40899	5	69	10	0	40983
11085	6	85	5	40650	0	40746
11086	46	3	40670	1	0	40720
11087	40659	1	104	11	0	40775
11088	40573	2	92	9	0	40676
11089	40480	10	180	5	0	40675
11090	40807	1	101	5	0	40914
11091	5	80	6	40239	0	40330
11092	21	0	40362	2	0	40385
11093	12	40542	1	58	0	40613
11094	4	40817	2	36	0	40859
11095	8	128	5	40535	0	40676
11096	10	84	8	40611	0	40713
11097	7	100	3	40653	0	40763
11098	18	84	5	40649	0	40756
11099	7	54	5	40555	0	40621
11100	40684	6	74	3	0	40767
11101	12	40683	0	32	0	40727
11102	2	39760	0	21	0	39783
11103	14	116	6	38674	0	38810
11104	9	101	4	38448	0	38562
11105	7	61	4	38726	0	38798
11106	8	67	4	38812	0	38891
11107	68	2	39129	0	0	39199
11108	1	39134	2	59	0	39196
11109	6	45	2	38570	0	38623
11110	38348	4	68	7	0	38427
11111	7	39	4	37561	0	37611
11112	41	0	39172	5	0	39218
11113	21	3	39032	13	0	39069
11114	27	0	40437	4	0	40468
11115	2	25	2	40373	0	40402
11116	38587	0	26	2	0	38615
11117	3	43	2	38950	0	38998
11118	1	12	1	38942	0	38956
11119	38950	2	19	8	0	38979
11120	3	37	5	39064	0	39109
11121	6	46	1	30517	0	30570
11122	21	2	29536	14	0	29573
11123	5	23411	0	19	0	23435
11124	5	25	0	19820	0	19850
11125	19904	0	26	5	0	19935
11126	1	44	1	17086	0	17132
11127	12	0	16897	2	0	16911
11128	7	41	0	16210	0	16258
11129	1	14436	0	10	0	14447
11130	3	31	0	14326	0	14360
11131	3	2	14441	1	0	14447
11132	1	14361	0	6	0	14368
11133	1	88	1	14359	0	14449
11134	3	51	7	14664	0	14725
11135	1	43	0	14577	0	14621
11136	1	37	2	14626	0	14666
11137	20	0	14825	1	0	14846
11138	2	14882	0	11	0	14895
11139	15036	0	33	2	0	15071
11140	14732	4	32	2	0	14770
11141	5	36	2	14504	0	14547
11142	11	0	14686	3	0	14700
11143	15438	1	20	4	0	15463
11144	1	28	0	15976	0	16005
11145	13	0	16008	3	0	16024
11146	7	84	8	15711	0	15810
11147	2	37	1	15794	0	15834
11148	4	45	5	15998	0	16052
11149	25	0	16030	2	0	16057
11150	3	48	1	16020	0	16072
11151	1	15929	1	8	0	15939
11152	15974	3	38	8	0	16023
11153	16696	5	31	1	0	16733
11154	18224	17	32	5	0	18278
11155	0	18666	0	5	0	18671
11156	19658	9	35	2	0	19704
11157	2	20	0	19727	0	19749
11158	19449	1	15	4	0	19469
11159	19546	4	24	12	0	19586
11160	16	0	19645	3	0	19664
11161	2	19374	0	16	0	19392
11162	19434	3	44	7	0	19488
11163	4	49	1	19385	0	19439
11164	21	0	19773	3	0	19797
11165	1	19858	0	14	0	19873
11166	19744	3	29	5	0	19781
11167	2	84	6	20070	0	20162
11168	3	73	1	19808	0	19885
11169	6	63	2	19715	0	19786
11170	1	19706	0	5	0	19712
11171	8	71	2	19528	0	19609
11172	0	19597	0	16	0	19613
11173	5	71	3	19231	0	19310
11174	20	2	19510	0	0	19532
11175	5	62	6	19607	0	19680
11176	2	51	2	19588	0	19643
11177	2	39	1	19570	0	19612
11178	12	0	19544	2	0	19558
11179	4	60	22	19475	0	19561
11180	1	62	2	19583	0	19648
11181	1	71	5	19627	0	19704
11182	0	17	1	20248	0	20266
11183	2	29	1	20667	0	20699
11184	22	1	20658	2	0	20683
11185	3	81	3	20937	0	21024
11186	4	44	1	20893	0	20942
11187	21042	2	33	3	0	21080
11188	2	19266	1	10	0	19279
11189	1	17979	1	7	0	17988
11190	6	56	0	17918	0	17980
11191	6	70	0	18725	0	18801
11192	1	18409	0	14	0	18424
11193	4	78	2	18230	0	18314
11194	0	18597	0	10	0	18607
11195	9	49	4	19081	0	19143
11196	5	57	2	19226	0	19290
11197	21	1	19054	5	0	19081
11198	7	19745	0	45	0	19797
11199	1	19952	1	12	0	19966
11200	19650	1	27	6	0	19684
11201	3	19550	1	6	0	19560
11202	4	60	1	19286	0	19351
11203	16	1	19528	1	0	19546
11204	3	39	0	19982	0	20024
11205	20001	1	26	1	0	20029
11206	11	0	20227	0	0	20238
11207	1	20329	0	11	0	20341
11208	1	49	2	20250	0	20302
11209	0	29	1	21235	0	21265
11210	21902	1	13	0	0	21916
11211	9	26	1	22751	0	22787
11212	0	9	5	22641	0	22655
11213	3	6	1	22507	0	22517
11214	1	4	2	22520	0	22527
11215	22755	0	11	2	0	22768
11216	22729	0	18	1	0	22748
11217	4	36	0	22749	0	22789
11218	22582	2	24	2	0	22610
11219	1	36	3	21906	0	21946
11220	17	0	22368	5	0	22390
11221	31	0	25168	3	0	25202
11222	7	82	5	24999	0	25093
11223	4	26980	0	28	0	27012
11224	5	48	5	27142	0	27200
11225	27350	3	37	3	0	27393
11226	2	45	4	27379	0	27430
11227	27387	0	31	5	0	27423
11228	4	66	5	27277	0	27352
11229	21	0	26518	6	0	26545
11230	6	25067	0	23	0	25096
11231	5	24915	0	6	0	24926
11232	8	61	0	24585	0	24654
11233	18	1	24791	0	0	24810
11234	3	24613	0	23	0	24639
11235	2	67	1	24519	0	24589
11236	24538	5	38	6	0	24587
11237	18	0	24912	2	0	24932
11238	3	61	14	24988	0	25066
11239	14	48	3	24923	0	24988
11240	18	0	24536	8	0	24562
11241	33	4	24465	9	0	24511
11242	21	0	25012	3	0	25036
11243	7	84	1	26231	0	26323
11244	12	1	26272	0	0	26285
11245	26743	3	57	8	0	26811
11246	2	68	4	26764	0	26838
11247	20	0	27048	8	0	27076
11248	6	27661	4	35	0	27706
11249	35	0	28440	2	0	28477
11250	4	60	3	29246	0	29313
11251	29361	4	31	4	0	29400
11252	2	62	2	29578	0	29644
11253	3	49	2	29619	0	29673
11254	29875	3	26	7	0	29911
11255	5	74	1	29825	0	29905
11256	14	2	29700	2	0	29718
11257	30040	2	94	10	0	30146
11258	2	29446	2	15	0	29465
11259	29301	3	65	10	0	29379
11260	4	69	5	29406	0	29484
11261	22	0	29715	2	0	29739
11262	28	0	30312	4	0	30344
11263	9	89	2	30128	0	30228
11264	7	65	3	30091	0	30166
11265	26	1	30589	2	0	30618
11266	34	0	31051	9	0	31094
11267	29969	7	47	15	0	30038
11268	4	46	3	30383	0	30436
11269	30517	2	41	2	0	30562
11270	5	82	4	30144	0	30235
11271	14	1	29977	3	0	29995
11272	25	0	30191	2	0	30218
11273	2	92	1	30253	0	30348
11274	4	67	3	29345	0	29419
11275	30	1	29321	2	0	29354
11276	30561	4	68	13	0	30646
11277	9	56	2	30688	0	30755
11278	30648	3	38	9	0	30698
11279	3	30256	0	21	0	30280
11280	10	74	5	29687	0	29776
11281	29182	5	34	3	0	29224
11282	35	13	29357	3	0	29408
11283	5	85	6	29121	0	29217
11284	6	84	1	29022	0	29113
11285	2	47	5	28692	0	28746
11286	16	5	28084	2	0	28107
11287	14	91	2	27277	0	27384
11288	3	26938	0	15	0	26956
11289	9	61	4	26871	0	26945
11290	26	0	26915	2	0	26943
11291	22	0	27527	1	0	27550
11292	2	109	2	27335	0	27448
11293	3	46	5	27436	0	27490
11294	4	56	2	27576	0	27638
11295	5	11	0	28991	0	29007
11296	28310	2	11	7	0	28330
11297	25751	3	67	1	0	25822
11298	15	2	26313	1	0	26331
11299	3	25166	0	14	0	25183
11300	5	37	3	25144	0	25189
11301	25190	1	48	5	0	25244
11302	25162	3	45	8	0	25218
11303	25084	3	62	8	0	25157
11304	25181	5	110	5	0	25301
11305	7	0	25254	2	0	25263
11306	24853	5	67	8	0	24933
11307	0	24761	2	7	0	24770
11308	4	56	4	24167	0	24231
11309	9	0	26106	0	0	26115
11310	4	93	4	29047	0	29148
11311	14	1	30306	1	0	30322
11312	13	104	13	30329	0	30459
11313	1	53	3	30014	0	30071
11314	31015	2	54	1	0	31072
11315	1	74	3	30925	0	31003
11316	21	0	31416	2	0	31439
11317	13	59	0	30931	0	31003
11318	29825	6	48	4	0	29883
11319	5	74	1	30096	0	30176
11320	46	1	29133	2	0	29182
11321	2	29739	1	35	0	29777
11322	29824	1	48	2	0	29875
11323	6	75	5	28812	0	28898
11324	2	28532	1	16	0	28551
11325	28185	5	66	8	0	28264
11326	42	1	28664	6	0	28713
11327	8	28471	1	19	0	28499
11328	2	93	2	30253	0	30350
11329	19	1	30674	0	0	30694
11330	7	82	3	30869	0	30961
11331	30764	2	56	3	0	30825
11332	21	0	31448	4	0	31473
11333	11	79	8	30833	0	30931
11334	25	0	31213	14	0	31252
11335	8	107	2	30514	0	30631
11336	4	50	4	31181	0	31239
11337	31212	0	50	5	0	31267
11338	3	30639	1	12	0	30655
11339	7	55	4	30668	0	30734
11340	30611	4	30	3	0	30648
11341	29687	11	45	3	0	29746
11342	2	71	0	29801	0	29874
11343	11	30596	1	17	0	30625
11344	0	30255	0	10	0	30265
11345	2	83	2	29869	0	29956
11346	2	52	1	30091	0	30146
11347	29619	1	20	5	0	29645
11348	4	74	7	30199	0	30284
11349	38	0	30190	2	0	30230
11350	29954	5	106	9	0	30074
11351	1	29220	0	17	0	29238
11352	28772	3	83	12	0	28870
11353	32	1	28991	0	0	29024
11354	4	29580	0	11	0	29595
11355	29603	0	46	1	0	29650
11356	29589	2	53	8	0	29652
11357	20	0	29579	1	0	29600
11358	30144	3	70	11	0	30228
11359	30540	2	77	2	0	30621
11360	2	30925	0	16	0	30943
11361	7	50	5	30273	0	30335
11362	51	0	32562	0	0	32613
11363	11	111	6	32137	0	32265
11364	27	18	32786	2	0	32833
11365	9	56	2	32910	0	32977
11366	33031	2	37	3	0	33073
11367	4	75	5	32757	0	32841
11368	21	1	32858	2	0	32882
11369	32681	4	59	9	0	32753
11370	7	71	1	32668	0	32747
11371	44	0	31289	2	0	31335
11372	30700	3	58	14	0	30775
11373	6	72	8	31965	0	32051
11374	41	1	31728	0	0	31770
11375	65	11	33081	12	0	33169
11376	7	69	4	34236	0	34316
11377	41	3	34420	5	0	34469
11378	3	34569	0	24	0	34596
11379	2	57	2	34724	0	34785
11380	34938	2	60	6	0	35006
11381	66	1	34851	3	0	34921
11382	39	3	34733	6	0	34781
11383	34130	1	95	6	0	34232
11384	13	0	34332	3	0	34348
11385	29958	1	83	11	0	30053
11386	21	3	30914	1	0	30939
11387	10	68	1	29687	0	29766
11388	21	0	29827	1	0	29849
11389	9	63	2	30151	0	30225
11390	29	0	29106	3	0	29138
11391	29	0	29125	4	0	29158
11392	28617	7	82	12	0	28718
11393	0	28864	0	23	0	28887
11394	28608	3	60	3	0	28674
11395	2	30052	0	29	0	30083
11396	5	86	5	29459	0	29555
11397	1	40	2	29688	0	29731
11398	29748	0	28	1	0	29777
11399	1	64	4	29880	0	29949
11400	9	1	29605	1	0	29616
11401	29653	1	62	13	0	29729
11402	28368	3	29	1	0	28401
11403	2	81	1	30156	0	30240
11404	21	1	28704	3	0	28729
11405	9	127	1	28311	0	28448
11406	1	27796	1	13	0	27811
11407	10	97	8	27717	0	27832
11408	8	64	7	27712	0	27791
11409	27	0	27467	15	0	27509
11410	27571	0	78	4	0	27653
11411	1	26975	1	10	0	26987
11412	26628	6	62	7	0	26703
11413	2	26540	1	29	0	26572
11414	10	69	6	26321	0	26406
11415	2	27212	0	27	0	27241
11416	13	0	27288	58	0	27359
11417	8	106	10	27599	0	27723
11418	5	67	3	27640	0	27715
11419	2	19	1	27258	0	27280
11420	27179	0	25	4	0	27208
11421	2	40	1	27329	0	27372
11422	27119	0	20	0	0	27139
11423	27040	7	34	5	0	27086
11424	25999	9	63	4	0	26075
11425	25	0	27059	2	0	27086
11426	2	47	7	26722	0	26778
11427	4	18	0	26828	0	26850
11428	1	10	0	26902	0	26913
11429	26803	1	116	3	0	26923
11430	3	25	3	26719	0	26750
11431	4	37	0	26922	0	26963
11432	27029	0	25	4	0	27058
11433	6	46	0	28005	0	28057
11434	27	0	27413	3	0	27443
11435	21	2	27479	9	0	27511
11436	25	56	3	27091	0	27175
11437	26871	5	30	7	0	26913
11438	25765	7	36	1	0	25809
11439	4	46	0	25935	0	25985
11440	17	0	27848	5	0	27870
11441	2	28209	3	18	0	28232
11442	3	128	4	27573	0	27708
11443	6	58	2	27698	0	27764
11444	2	42	0	27766	0	27810
11445	27719	6	42	3	0	27770
11446	22	1	27965	2	0	27990
11447	27946	1	64	2	0	28013
11448	3	85	2	28019	0	28109
11449	22	25767	1	18	0	25808
11450	25000	2	130	4	0	25136
11451	24448	2	76	5	0	24531
11452	34	0	23536	4	0	23574
11453	3	22964	1	13	0	22981
11454	0	23212	1	12	0	23225
11455	23379	3	54	7	0	23443
11456	5	68	3	23288	0	23364
11457	7	101	4	23197	0	23309
11458	10	70	1	23271	0	23352
11459	1	23443	1	14	0	23459
11460	1	22804	1	15	0	22821
11461	22852	0	41	2	0	22895
11462	1	54	2	22245	0	22302
11463	25	0	22103	4	0	22132
11464	8	46	2	22253	0	22309
11465	19	1	21950	6	0	21976
11466	22	0	22103	6	0	22131
11467	28	5	22308	6	0	22347
11468	5	22636	1	11	0	22653
11469	10	94	7	22158	0	22269
11470	2	22805	0	14	0	22821
11471	4	59	0	22812	0	22875
11472	0	21	3	24539	0	24563
11473	24428	1	25	3	0	24457
11474	6	66	1	24477	0	24550
11475	24239	4	17	0	0	24260
11476	24139	0	41	5	0	24185
11477	2	72	3	24015	0	24092
11478	0	23679	0	6	0	23685
11479	7	53	1	21725	0	21786
11480	3	22054	0	6	0	22063
11481	5	44	8	22073	0	22130
11482	8	1	22106	2	0	22117
11483	6	63	1	23453	0	23523
11484	2	31	0	24269	0	24302
11485	24490	0	35	4	0	24529
11486	1	24654	0	6	0	24661
11487	8	70	1	24658	0	24737
11488	3	43	1	24914	0	24961
11489	2	24584	1	8	0	24595
11490	6	40	2	24623	0	24671
11491	24586	3	34	1	0	24624
11492	24501	5	58	16	0	24580
11493	2	24303	0	7	0	24312
11494	1	40	2	24598	0	24641
11495	24579	4	35	6	0	24624
11496	2	24645	0	19	0	24666
11497	13	61	3	24352	0	24429
11498	4	24548	0	15	0	24567
11499	23991	4	57	10	0	24062
11500	10	0	24738	3	0	24751
11501	10	0	24823	5	0	24838
11502	8	78	3	24572	0	24661
11503	28	0	24131	2	0	24161
11504	2	33	0	24767	0	24802
11505	25215	0	49	6	0	25270
11506	25	0	25502	2	0	25529
11507	9	74	2	25409	0	25494
11508	3	29	0	25334	0	25366
11509	24023	2	43	4	0	24072
11510	1	23600	0	10	0	23611
11511	23600	2	50	2	0	23654
11512	23594	2	53	6	0	23655
11513	0	21895	0	14	0	21909
11514	12	68	5	20829	0	20914
11515	12	1	21170	0	0	21183
11516	13	79	3	21913	0	22008
11517	5	21909	2	11	0	21927
11518	22798	1	57	7	0	22863
11519	6	47	1	22816	0	22870
11520	9	0	23009	16	0	23034
11521	5	67	23	23190	0	23285
11522	1	56	4	22926	0	22987
11523	1	43	0	23810	0	23854
11524	3	15	2	23690	0	23710
11525	2	37	4	24862	0	24905
11526	5	0	24809	11	0	24825
11527	31	4	24227	6	0	24268
11528	5	25006	2	30	0	25043
11529	2	24988	0	23	0	25013
11530	24693	9	76	7	0	24785
11531	27	1	24836	2	0	24866
11532	26351	5	86	8	0	26450
11533	16	0	27096	2	0	27114
11534	10	1	27549	3	0	27563
11535	2	88	0	27802	0	27892
11536	27844	1	44	1	0	27890
11537	7	67	3	27812	0	27889
11538	7	50	2	27829	0	27888
11539	10	0	29057	2	0	29069
11540	3	67	14	28819	0	28903
11541	3	72	0	28767	0	28842
11542	2	42	11	28417	0	28472
11543	7	32	1	28174	0	28214
11544	0	21	4	28140	0	28165
11545	27975	1	11	6	0	27993
11546	6	69	2	26113	0	26190
11547	30	0	26180	1	0	26211
11548	8	71	6	24551	0	24636
11549	21	1	25600	4	0	25626
11550	7	84	1	25873	0	25965
11551	27	0	26487	0	0	26514
11552	6	86	0	26471	0	26563
11553	7	52	8	26056	0	26123
11554	20	0	26119	5	0	26144
11555	25746	6	100	13	0	25865
11556	22	1	26249	0	0	26272
11557	7	19	3	26477	0	26506
11558	25121	2	46	7	0	25176
11559	4	61	3	25094	0	25162
11560	7	69	0	24314	0	24390
11561	25	0	24136	35	0	24196
11562	5	24873	1	30	0	24909
11563	8	24422	2	24	0	24456
11564	5	24401	0	13	0	24419
11565	3	39	2	23736	0	23780
11566	24197	1	18	2	0	24218
11567	6	65	1	24142	0	24214
11568	3	42	3	24316	0	24364
11569	1	73	7	24128	0	24209
11570	5	44	4	23587	0	23640
11571	0	24010	0	4	0	24014
11572	1	80	0	23815	0	23896
11573	7	66	0	23898	0	23971
11574	1	23956	0	9	0	23966
11575	23666	7	64	4	0	23741
11576	0	46	0	23194	0	23240
11577	22968	3	41	3	0	23015
11578	23042	0	56	8	0	23106
11579	1	22513	0	8	0	22522
11580	13	45	3	22075	0	22136
11581	14	2	23149	1	0	23166
11582	8	1	23894	7	0	23910
11583	4	36	1	24047	0	24088
11584	23964	1	43	10	0	24018
11585	24899	3	96	12	0	25010
11586	7	40	0	25031	0	25078
11587	25267	3	37	3	0	25310
11588	0	25151	0	29	0	25180
11589	24167	3	72	4	0	24246
11590	2	24732	1	20	0	24755
11591	3	81	0	23598	0	23682
11592	9	48	1	25070	0	25128
11593	2	25094	0	6	0	25102
11594	24135	1	83	22	0	24241
11595	7	0	25052	0	0	25059
11596	11	72	5	24446	0	24534
11597	14	2	26588	1	0	26605
11598	0	35	0	26634	0	26669
11599	25697	1	41	13	0	25752
11600	6	28	0	25781	0	25815
11601	24496	1	30	1	0	24528
11602	24730	2	59	6	0	24797
11603	2	51	0	24884	0	24937
11604	30	0	24094	2	0	24126
11605	4	25272	1	16	0	25293
11606	3	30	1	23251	0	23285
11607	23485	1	35	3	0	23524
11608	21	0	23887	0	0	23908
11609	3	61	2	23399	0	23465
11610	0	56	5	22962	0	23023
11611	1	39	2	22793	0	22835
11612	22652	3	11	1	0	22667
11613	1	40	1	22715	0	22757
11614	5	48	4	22661	0	22718
11615	14	0	21708	5	0	21727
11616	1	94	6	21535	0	21636
11617	1	45	0	22579	0	22625
11618	5	51	0	22654	0	22710
11619	0	22670	1	7	0	22678
11620	1	41	3	22609	0	22654
11621	0	29	1	22674	0	22704
11622	22500	2	46	4	0	22552
11623	24	0	22655	4	0	22683
11624	15	0	22942	12	0	22969
11625	1	22307	1	21	0	22330
11626	1	26	0	22002	0	22029
11627	22660	2	25	1	0	22688
11628	9	28	0	23105	0	23142
11629	2	45	2	23061	0	23110
11630	4	24	0	23135	0	23163
11631	1	39	1	23282	0	23323
11632	1	41	0	22712	0	22754
11633	33	2	22681	3	0	22719
11634	2	40	0	22762	0	22804
11635	22859	6	46	3	0	22914
11636	0	22637	1	30	0	22668
11637	3	41	15	21834	0	21893
11638	7	50	4	21920	0	21981
11639	7	0	21999	3	0	22009
11640	8	34	2	22267	0	22311
11641	1	22	3	22915	0	22941
11642	22652	2	34	0	0	22688
11643	1	22722	1	12	0	22736
11644	4	64	4	22938	0	23010
11645	5	37	2	22906	0	22950
11646	4	58	2	23125	0	23189
11647	17	0	22499	14	0	22530
11648	12	1	22470	29	0	22512
11649	5	22615	0	47	0	22667
11650	2	22659	0	12	0	22673
11651	5	68	0	22980	0	23053
11652	0	24149	1	16	0	24166
11653	6	175	8	24939	0	25128
11654	6	55	1	26154	0	26216
11655	2	51	0	25847	0	25900
11656	4	35	2	25606	0	25647
11657	18	1	24687	4	0	24710
11658	5	69	35	24389	0	24498
11659	3	64	5	24496	0	24568
11660	2	31	1	24821	0	24855
11661	23848	0	35	5	0	23888
11662	0	23570	3	17	0	23590
11663	5	61	2	23782	0	23850
11664	1	23757	0	31	0	23789
11665	23674	6	52	4	0	23736
11666	22838	1	60	6	0	22905
11667	6	22075	4	14	0	22099
11668	2	21964	3	39	0	22008
11669	44	0	22020	2	0	22066
11670	4	21436	0	14	0	21454
11671	1	49	0	21898	0	21948
11672	24160	1	37	4	0	24202
11673	3	22240	0	17	0	22260
11674	3	65	1	22125	0	22194
11675	4	55	3	22118	0	22180
11676	0	28	0	22775	0	22803
11677	22494	3	48	1	0	22546
11678	10	0	22433	2	0	22445
11679	22779	1	60	15	0	22855
11680	1	22380	1	22	0	22404
11681	8	39	3	20651	0	20701
11682	11	2	20876	2	0	20891
11683	20907	2	66	7	0	20982
11684	0	21824	1	6	0	21831
11685	8	67	2	21454	0	21531
11686	2	21829	0	8	0	21839
11687	2	36	0	21718	0	21756
11688	4	40	1	22712	0	22757
11689	13	1	22638	4	0	22656
11690	41	1	23302	5	0	23349
11691	2	44	2	23145	0	23193
11692	12	0	23630	4	0	23646
11693	4	51	11	23361	0	23427
11694	10	48	1	23347	0	23406
11695	3	28	0	23620	0	23651
11696	23685	2	29	1	0	23717
11697	4	45	1	23939	0	23989
11698	23	1	23956	2	0	23982
11699	23706	1	69	4	0	23780
11700	2	51	2	23707	0	23762
11701	2	23	1	23161	0	23187
11702	23286	3	27	4	0	23320
11703	1	22488	1	5	0	22495
11704	11	43	3	22258	0	22315
11705	0	14	0	22382	0	22396
11706	22193	0	27	3	0	22223
11707	6	1	22890	3	0	22900
11708	4	57	4	23423	0	23488
11709	4	86	4	23285	0	23379
11710	10	69	3	23306	0	23388
11711	9	23288	0	10	0	23307
11712	10	54	1	23281	0	23346
11713	23698	0	59	4	0	23761
11714	0	23634	0	32	0	23666
11715	23318	3	79	3	0	23403
11716	2	23383	0	24	0	23409
11717	22539	0	73	8	0	22620
11718	6	1	22954	3	0	22964
11719	25	0	23162	2	0	23189
11720	23572	6	87	9	0	23674
11721	12	0	24532	0	0	24544
11722	2	41	8	24108	0	24159
11723	6	50	2	23897	0	23955
11724	1	21	1	24272	0	24295
11725	24306	2	38	5	0	24351
11726	14	1	24474	4	0	24493
11727	24041	3	72	5	0	24121
11728	0	17	0	23205	0	23222
11729	22559	1	34	5	0	22599
11730	1	21	3	21690	0	21715
11731	21677	2	40	2	0	21721
11732	3	35	1	21658	0	21697
11733	12	0	21583	3	0	21598
11734	21218	3	57	7	0	21285
11735	21141	2	20	2	0	21165
11736	2	61	1	21033	0	21097
11737	7	39	2	20907	0	20955
11738	2	21407	2	11	0	21422
11739	21161	2	58	5	0	21226
11740	0	21133	0	19	0	21152
11741	20911	7	54	7	0	20979
11742	13	0	20960	1	0	20974
11743	25	2	21381	7	0	21415
11744	15	2	22021	7	0	22045
11745	21870	4	72	4	0	21950
11746	1	19971	0	14	0	19986
11747	4	26	1	19786	0	19817
11748	20682	0	50	4	0	20736
11749	2	20691	0	11	0	20704
11750	12	45	3	20538	0	20598
11751	3	20561	2	20	0	20586
11752	7	20054	0	20	0	20081
11753	4	19723	0	17	0	19744
11754	19798	5	47	5	0	19855
11755	2	20249	2	15	0	20268
11756	5	20096	0	16	0	20117
11757	6	20075	0	41	0	20122
11758	20079	2	22	2	0	20105
11759	20046	2	37	4	0	20089
11760	14	0	20070	2	0	20086
11761	20161	1	50	6	0	20218
11762	20252	0	52	0	0	20304
11763	2	24	2	20353	0	20381
11764	19408	2	36	2	0	19448
11765	10	0	20099	0	0	20109
11766	2	21827	0	36	0	21865
11767	22131	0	59	5	0	22195
11768	2	33	0	21742	0	21777
11769	20555	2	34	8	0	20599
11770	10	1	20505	3	0	20519
11771	21073	2	45	2	0	21122
11772	3	46	2	20893	0	20944
11773	13	1	20621	1	0	20636
11774	5	21798	1	24	0	21828
11775	4	22555	0	15	0	22574
11776	3	61	3	22649	0	22716
11777	12	36	0	22673	0	22721
11778	2	22553	0	4	0	22559
11779	22525	1	31	6	0	22563
11780	22571	2	58	0	0	22631
11781	22584	4	84	2	0	22674
11782	2	21851	0	7	0	21860
11783	5	58	2	21028	0	21093
11784	11	21200	0	29	0	21240
11785	21337	1	70	10	0	21418
11786	22320	2	48	4	0	22374
11787	3	22779	1	17	0	22800
11788	22669	1	48	1	0	22719
11789	2	26	3	22385	0	22416
11790	5	10	1	22611	0	22627
11791	22770	1	21	2	0	22794
11792	22582	2	30	4	0	22618
11793	22799	3	54	2	0	22858
11794	3	16	2	22192	0	22213
11795	1	43	3	21685	0	21732
11796	7	1	21613	2	0	21623
11797	4	48	0	21077	0	21129
11798	7	35	2	21089	0	21133
11799	17	1	20999	7	0	21024
11800	44	0	20710	3	0	20757
11801	10	1	21558	3	0	21572
11802	4	51	0	22353	0	22408
11803	14	0	22340	1	0	22355
11804	2	36	5	22348	0	22391
11805	6	26	3	22221	0	22256
11806	12	1	21841	2	0	21856
11807	22	0	22115	2	0	22139
11808	10	50	0	22882	0	22942
11809	17	1	22683	2	0	22703
11810	19	1	22435	4	0	22459
11811	8	22313	0	40	0	22361
11812	22465	1	56	5	0	22527
11813	22756	1	60	5	0	22822
11814	22468	9	49	2	0	22528
11815	5	22588	0	10	0	22603
11816	3	22287	0	6	0	22296
11817	4	47	7	22196	0	22254
11818	5	69	1	22217	0	22292
11819	34	0	22259	1	0	22294
11820	4	27	2	21893	0	21926
11821	22140	0	43	2	0	22185
11822	7	36	4	21894	0	21941
11823	5	21434	0	13	0	21452
11824	21156	0	44	2	0	21202
11825	21247	0	11	2	0	21260
11826	21242	3	79	1	0	21325
11827	29	2	21274	2	0	21307
11828	2	27	0	21132	0	21161
11829	20927	0	33	1	0	20961
11830	15	3	20918	5	0	20941
11831	7	22260	1	29	0	22297
11832	9	22092	1	17	0	22119
11833	22239	5	47	9	0	22300
11834	4	21690	0	13	0	21707
11835	5	67	1	21484	0	21557
11836	13	0	22244	13	0	22270
11837	4	64	5	23880	0	23953
11838	23830	3	44	3	0	23880
11839	1	23587	0	21	0	23609
11840	21282	5	72	5	0	21364
11841	20	0	22187	0	0	22207
11842	8	40	2	22010	0	22060
11843	3	22028	0	12	0	22043
11844	2	31	3	21957	0	21993
11845	21357	1	13	0	0	21371
11846	21219	3	21	1	0	21244
11847	21307	2	19	0	0	21328
11848	21882	3	49	11	0	21945
11849	1	28	1	21783	0	21813
11850	16	2	19903	1	0	19922
11851	7	31	0	19768	0	19806
11852	1	19693	1	11	0	19706
11853	19608	5	62	6	0	19681
11854	12	0	20286	1	0	20299
11855	20407	0	50	1	0	20458
11856	2	43	10	20490	0	20545
11857	16	1	20702	1	0	20720
11858	0	30	0	20688	0	20718
11859	20650	2	23	0	0	20675
11860	20435	3	71	4	0	20513
11861	20329	4	111	4	0	20448
11862	11	0	19952	1	0	19964
11863	7	41	1	19875	0	19924
11864	22	1	19778	2	0	19803
11865	9	19827	1	24	0	19861
11866	20176	3	63	7	0	20249
11867	3	20290	1	20	0	20314
11868	20243	1	61	6	0	20311
11869	3	45	3	21590	0	21641
11870	5	21647	0	4	0	21656
11871	21203	4	41	4	0	21252
11872	8	0	21205	1	0	21214
11873	2	22	1	21674	0	21699
11874	21469	2	37	7	0	21515
11875	24	0	21951	4	0	21979
11876	14	32	3	22708	0	22757
11877	3	22499	0	23	0	22525
11878	6	33	2	21247	0	21288
11879	1	32	1	21440	0	21474
11880	21978	0	25	3	0	22006
11881	2	21643	0	21	0	21666
11882	13	57	0	21549	0	21619
11883	4	21603	0	10	0	21617
11884	6	46	1	20691	0	20744
11885	2	21046	0	9	0	21057
11886	20994	4	37	2	0	21037
11887	23	1	21300	0	0	21324
11888	3	41	1	21588	0	21633
11889	3	30	10	21290	0	21333
11890	18	74	1	21224	0	21317
11891	5	59	8	21146	0	21218
11892	9	0	21106	3	0	21118
11893	0	21824	1	28	0	21853
11894	21786	0	67	3	0	21856
11895	21461	2	68	4	0	21535
11896	2	21430	0	15	0	21447
11897	21315	1	50	3	0	21369
11898	22511	1	51	1	0	22564
11899	0	22198	0	11	0	22209
11900	8	33	2	22031	0	22074
11901	2	22082	0	16	0	22100
11902	21775	7	34	8	0	21824
11903	5	0	22653	1	0	22659
11904	23599	0	78	11	0	23688
11905	74	0	23856	1	0	23931
11906	0	16	3	24081	0	24100
11907	22176	4	57	3	0	22240
11908	12	0	22211	2	0	22225
11909	22464	1	85	5	0	22555
11910	22764	0	61	1	0	22826
11911	6	50	2	22648	0	22706
11912	1	20500	0	4	0	20505
11913	20366	0	52	4	0	20422
11914	7	28	1	20057	0	20093
11915	2	20362	0	18	0	20382
11916	20308	3	44	2	0	20357
11917	4	56	3	19392	0	19455
11918	1	19543	0	20	0	19564
11919	1	22	4	19368	0	19395
11920	19529	1	12	0	0	19542
11921	19456	2	35	2	0	19495
11922	19618	0	13	0	0	19631
11923	1	35	4	19582	0	19622
11924	0	24	7	19020	0	19051
11925	14	0	19028	4	0	19046
11926	9	25	4	18280	0	18318
11927	10	0	18153	2	0	18165
11928	10	1	18320	4	0	18335
11929	15	1	18297	6	0	18319
11930	3	17822	0	10	0	17835
11931	7	33	2	17735	0	17777
11932	8	18023	0	9	0	18040
11933	18202	1	37	6	0	18246
11934	18288	1	39	2	0	18330
11935	4	33	0	18234	0	18271
11936	13	1	18391	0	0	18405
11937	3	27	3	17632	0	17665
11938	16	1	17563	2	0	17582
11939	3	51	3	17842	0	17899
11940	7	17658	0	28	0	17693
11941	2	17811	1	25	0	17839
11942	17565	3	37	3	0	17608
11943	12	0	17438	0	0	17450
11944	5	32	3	17659	0	17699
11945	4	24	4	16137	0	16169
11946	16203	0	24	1	0	16228
11947	2	15737	0	15	0	15754
11948	15619	4	50	4	0	15677
11949	2	15686	0	12	0	15700
11950	14711	0	43	3	0	14757
11951	14517	0	39	2	0	14558
11952	4	26	2	13950	0	13982
11953	17	0	14105	13	0	14135
11954	14426	1	55	1	0	14483
11955	5	14296	0	19	0	14320
11956	13887	1	46	1	0	13935
11957	2	23	2	14032	0	14059
11958	5	31	1	14197	0	14234
11959	0	14597	0	6	0	14603
11960	4	38	3	14244	0	14289
11961	1	14283	0	10	0	14294
11962	7	18	3	13951	0	13979
11963	1	20	0	14522	0	14543
11964	14476	1	30	2	0	14509
11965	6	0	14723	0	0	14729
11966	1	16217	0	10	0	16228
11967	1	24	1	16949	0	16975
11968	16784	1	25	4	0	16814
11969	16715	2	18	2	0	16737
11970	16961	3	77	3	0	17044
11971	24	0	17220	0	0	17244
11972	17229	0	85	4	0	17318
11973	1	30	0	17835	0	17866
11974	16725	4	27	1	0	16757
11975	3	17109	1	13	0	17126
11976	5	24	1	17078	0	17108
11977	17668	4	38	4	0	17714
11978	2	16734	0	5	0	16741
11979	7	27	2	15730	0	15766
11980	5	1	15696	3	0	15705
11981	15374	0	33	8	0	15415
11982	15278	1	66	0	0	15345
11983	7	0	15391	0	0	15398
11984	6	14872	0	12	0	14890
11985	1	14874	0	3	0	14878
11986	4	35	2	14393	0	14434
11987	2	22	0	14596	0	14620
11988	2	19	0	14622	0	14643
11989	8	0	14700	3	0	14711
11990	14802	1	43	2	0	14848
11991	14635	1	27	2	0	14665
11992	14749	0	30	4	0	14783
11993	14148	1	12	1	0	14162
11994	14110	0	34	3	0	14147
11995	14133	2	26	3	0	14164
11996	0	14	0	13996	0	14010
11997	21	0	13997	0	0	14018
11998	13	1	14221	2	0	14237
11999	2	14	3	14297	0	14316
12000	4	44	1	14640	0	14689
12001	7	32	2	14573	0	14614
12002	0	14706	1	19	0	14726
12003	14779	6	35	3	0	14823
12004	0	14567	0	9	0	14576
12005	1	16	0	14853	0	14870
12006	14958	1	22	0	0	14981
12007	1	14630	0	2	0	14633
12008	7	26	3	14451	0	14487
12009	3	47	2	14435	0	14487
12010	6	20	2	14544	0	14572
12011	0	14309	0	5	0	14314
12012	1	19	0	14196	0	14216
12013	3	0	14272	1	0	14276
12014	7	27	4	14209	0	14247
12015	3	30	2	14214	0	14249
12016	7	35	2	15124	0	15168
12017	2	27	1	15536	0	15566
12018	12	0	15436	2	0	15450
12019	2	15518	1	15	0	15536
12020	4	54	1	15374	0	15433
12021	0	49	3	15378	0	15430
12022	6	34	3	15376	0	15419
12023	6	15599	0	13	0	15618
12024	2	16416	0	8	0	16426
12025	16513	4	36	3	0	16556
12026	3	21	2	16588	0	16614
12027	11	0	16441	3	0	16455
12028	0	16228	1	15	0	16244
12029	16031	2	37	4	0	16074
12030	12	0	18194	2	0	18208
12031	12	0	18246	8	0	18266
12032	7	1	24424	5	0	24437
12033	0	21	13	24277	0	24311
12034	16	1	27693	6	0	27716
12035	2	29064	1	18	0	29085
12036	3	53	3	29280	0	29339
12037	22	0	29862	1	0	29885
12038	1	40	0	30440	0	30481
12039	30111	2	39	7	0	30159
12040	17	1	31631	2	0	31651
12041	30363	4	56	14	0	30437
12042	1	30698	0	16	0	30715
12043	29899	10	62	8	0	29979
12044	5	48	4	31525	0	31582
12045	31794	0	38	17	0	31849
12046	31905	3	83	11	0	32002
12047	31942	25	89	7	0	32063
12048	2	32418	0	29	0	32449
12049	31868	4	36	4	0	31912
12050	31881	3	56	2	0	31942
12051	24	0	31817	1	0	31842
12052	2	31786	1	28	0	31817
12053	7	97	3	32062	0	32169
12054	9	86	4	32202	0	32301
12055	3	73	4	32405	0	32485
12056	17	0	32878	7	0	32902
12057	13	91	11	33078	0	33193
12058	21	0	33440	2	0	33463
12059	33573	2	97	10	0	33682
12060	33471	6	111	8	0	33596
12061	14	0	33769	5	0	33788
12062	33743	6	101	12	0	33862
12063	34244	1	125	4	0	34374
12064	35367	1	104	5	0	35477
12065	8	50	3	35780	0	35841
12066	54	1	35853	6	0	35914
12067	4	36636	7	43	0	36690
12068	6	96	3	36638	0	36743
12069	21	2	36959	7	0	36989
12070	81	1	36763	12	0	36857
12071	37011	3	104	19	0	37137
12072	2	37893	1	47	0	37943
12073	37793	0	96	15	0	37904
12074	37891	4	64	7	0	37966
12075	1	37927	1	32	0	37961
12076	37398	7	93	14	0	37512
12077	20	0	37750	25	0	37795
12078	41	2	38201	24	0	38268
12079	34	4	38495	8	0	38541
12080	3	38631	0	39	0	38673
12081	38391	3	99	3	0	38496
12082	40383	5	96	4	0	40488
12083	3	42630	1	61	0	42695
12084	2	44275	0	19	0	44296
12085	13	146	11	45533	0	45703
12086	8	47	3	45659	0	45717
12087	45648	4	68	12	0	45732
12088	0	45532	0	20	0	45552
12089	45459	1	124	8	0	45592
12090	46319	7	130	7	0	46463
12091	46	2	48440	9	0	48497
12092	7	48342	3	58	0	48410
12093	4	92	1	47426	0	47523
12094	47492	3	81	8	0	47584
12095	6	71	0	49024	0	49101
12096	48691	4	99	12	0	48806
12097	39	1	49404	27	0	49471
12098	6	50333	4	30	0	50373
12099	2	50565	3	49	0	50619
12100	16	164	6	49656	0	49842
12101	2	50005	0	30	0	50037
12102	49716	9	130	12	0	49867
12103	30	0	50794	5	0	50829
12104	52342	7	135	18	0	52502
12105	56	1	54805	3	0	54865
12106	8	129	10	51952	0	52099
12107	11	140	11	52022	0	52184
12108	2	59	3	47051	0	47115
12109	46911	5	50	10	0	46976
12110	27	2	43632	7	0	43668
12111	6	150	0	42219	0	42375
12112	14	131	2	42879	0	43026
12113	7	44099	2	31	0	44139
12114	13	43393	1	22	0	43429
12115	6	42746	0	54	0	42806
12116	23	130	7	42773	0	42933
12117	12	132	5	43004	0	43153
12118	6	43632	2	21	0	43661
12119	4	41746	0	22	0	41772
12120	43995	6	96	7	0	44104
12121	6	119	3	43817	0	43945
12122	4	43902	0	20	0	43926
12123	44557	4	93	12	0	44666
12124	3	60	3	44501	0	44567
12125	44648	5	54	6	0	44713
12126	13	102	10	44473	0	44598
12127	55	2	43788	8	0	43853
12128	2	43813	1	53	0	43869
12129	42906	4	117	4	0	43031
12130	55	2	43825	8	0	43890
12131	4	43906	0	25	0	43935
12132	5	243	2	44419	0	44669
12133	9	113	7	44680	0	44809
12134	13	97	0	44692	0	44802
12135	6	103	7	44602	0	44718
12136	82	1	44425	12	0	44520
12137	7	44354	0	48	0	44409
12138	11	82	4	44480	0	44577
12139	43808	5	63	4	0	43880
12140	5	42140	0	25	0	42170
12141	1	104	7	41586	0	41698
12142	54	2	42817	6	0	42879
12143	3	43847	0	20	0	43870
12144	17	203	6	42713	0	42939
12145	8	44516	0	40	0	44564
12146	44625	8	72	6	0	44711
12147	44524	15	108	13	0	44660
12148	34	2	43707	35	0	43778
12149	43777	8	133	42	0	43960
12150	43427	4	118	5	0	43554
12151	13	0	44328	8	0	44349
12152	3	45240	0	55	0	45298
12153	15	124	9	45020	0	45168
12154	3	70	2	45239	0	45314
12155	45633	13	52	6	0	45704
12156	9	80	2	45475	0	45566
12157	49	2	46014	0	0	46065
12158	43635	1	134	24	0	43794
12159	37	0	41742	4	0	41783
12160	4	39841	0	34	0	39879
12161	38592	9	74	9	0	38684
12162	44	0	39943	9	0	39996
12163	23	1	40174	17	0	40215
12164	1	36940	0	22	0	36963
12165	12	90	8	36785	0	36895
12166	87	5	37618	4	0	37714
12167	8	103	13	37602	0	37726
12168	9	96	4	39252	0	39361
12169	49	18	40462	6	0	40535
12170	3	40819	6	27	0	40855
12171	7	92	4	39370	0	39473
12172	39054	5	61	9	0	39129
12173	37649	10	77	8	0	37744
12174	6	56	7	37942	0	38011
12175	29	1	37374	2	0	37406
12176	22	1	37184	3	0	37210
12177	7	81	13	35461	0	35562
12178	45	1	35034	9	0	35089
12179	34743	4	67	12	0	34826
12180	4	131	2	36550	0	36687
12181	7	106	0	35399	0	35512
12182	2	35664	0	25	0	35691
12183	6	102	3	35795	0	35906
12184	15	0	36041	7	0	36063
12185	35225	5	68	37	0	35335
12186	34732	15	121	7	0	34875
12187	26	0	35542	5	0	35573
12188	7	96	3	34234	0	34340
12189	1	98	3	32617	0	32719
12190	46	0	33048	2	0	33096
12191	7	128	4	32407	0	32546
12192	15	126	1	32259	0	32401
12193	0	31663	0	19	0	31682
12194	5	71	7	31518	0	31601
12195	11	18	2	31622	0	31653
12196	29464	1	38	2	0	29505
12197	29217	4	55	11	0	29287
12198	28811	2	74	4	0	28891
12199	27982	5	62	11	0	28060
12200	27788	6	113	9	0	27916
12201	8	0	28377	1	0	28386
12202	1	58	2	28560	0	28621
12203	4	68	1	28607	0	28680
12204	12	1	28814	4	0	28831
12205	28664	2	71	15	0	28752
12206	27592	4	77	11	0	27684
12207	14	2	27355	2	0	27373
12208	26433	4	53	11	0	26501
12209	26488	4	69	1	0	26562
12210	23	2	29111	1	0	29137
12211	14	71	2	28949	0	29036
12212	1	30191	0	22	0	30214
12213	2	124	1	30516	0	30643
12214	8	56	5	30953	0	31022
12215	4	91	3	30916	0	31014
12216	18	0	31028	1	0	31047
12217	30835	4	76	13	0	30928
12218	30188	1	87	6	0	30282
12219	3	73	2	29441	0	29519
12220	17	3	29415	0	0	29435
12221	11	84	8	28805	0	28908
12222	21	1	29460	7	0	29489
12223	39	5	29371	11	0	29426
12224	1	29162	0	46	0	29209
12225	11	52	1	30212	0	30276
12226	30401	3	23	2	0	30429
12227	29195	2	53	12	0	29262
12228	28781	3	52	4	0	28840
12229	2	95	3	28776	0	28876
12230	3	28279	0	16	0	28298
12231	3	72	5	27953	0	28033
12232	13	0	28749	4	0	28766
12233	32718	1	67	10	0	32796
12234	32889	1	56	2	0	32948
12235	2	54	2	32858	0	32916
12236	2	57	5	32768	0	32832
12237	2	40	6	32862	0	32910
12238	15	1	31387	4	0	31407
12239	31486	0	64	10	0	31560
12240	4	31304	4	22	0	31334
12241	4	30276	0	35	0	30315
12242	31	4	30712	3	0	30750
12243	3	87	4	34452	0	34546
12244	44	0	32707	10	0	32761
12245	32066	2	76	14	0	32158
12246	1	48	12	32064	0	32125
12247	38	1	31902	4	0	31945
12248	5	32650	5	45	0	32705
12249	32602	2	101	14	0	32719
12250	40	1	33366	8	0	33415
12251	11	33572	2	19	0	33604
12252	5	33826	0	25	0	33856
12253	34364	0	52	6	0	34422
12254	6	114	2	34480	0	34602
12255	28	2	33448	5	0	33483
12256	10	32088	1	24	0	32123
12257	32132	2	54	6	0	32194
12258	32774	3	70	5	0	32852
12259	3	32014	3	16	0	32036
12260	34	1	32029	4	0	32068
12261	1	46	2	31922	0	31971
12262	32017	3	48	1	0	32069
12263	31980	4	54	4	0	32042
12264	16	0	32508	3	0	32527
12265	8	87	4	32260	0	32359
12266	2	74	4	31829	0	31909
12267	42	0	31898	7	0	31947
12268	20	0	32281	2	0	32303
12269	33039	1	70	7	0	33117
12270	33351	3	105	4	0	33463
12271	33430	7	86	6	0	33529
12272	33201	14	213	4	0	33432
12273	25	0	33398	21	0	33444
12274	33882	2	70	7	0	33961
12275	7	74	5	33729	0	33815
12276	15	0	33570	3	0	33588
12277	58	2	33005	12	0	33077
12278	7	34411	0	12	0	34430
12279	8	98	13	34611	0	34730
12280	59	2	35396	0	0	35457
12281	36260	4	55	9	0	36328
12282	10	109	4	37106	0	37229
12283	6	37224	0	23	0	37253
12284	37235	2	94	12	0	37343
12285	38610	2	109	9	0	38730
12286	29	0	37085	3	0	37117
12287	9	36355	0	22	0	36386
12288	5	80	0	36318	0	36403
12289	35994	0	45	5	0	36044
12290	9	109	2	35614	0	35734
12291	33	17	35708	4	0	35762
12292	37158	4	83	18	0	37263
12293	14	38544	1	16	0	38575
12294	12	37803	2	51	0	37868
12295	15	37419	1	12	0	37447
12296	37461	7	53	10	0	37531
12297	37527	5	73	3	0	37608
12298	38236	3	89	1	0	38329
12299	4	69	4	42317	0	42394
12300	18	1	43831	4	0	43854
12301	3	92	0	42649	0	42744
12302	42572	0	53	3	0	42628
12303	21	48	0	42644	0	42713
12304	42358	3	63	5	0	42429
12305	43237	7	111	18	0	43373
12306	43144	25	100	5	0	43274
12307	2	42715	0	17	0	42734
12308	38466	3	83	3	0	38555
12309	21	0	41628	6	0	41655
12310	54	3	41698	10	0	41765
12311	3	41976	0	28	0	42007
12312	3	85	5	42088	0	42181
12313	42107	6	63	10	0	42186
12314	61	1	42850	3	0	42915
12315	43190	10	110	7	0	43317
12316	13	148	5	43291	0	43457
12317	4	42813	0	26	0	42843
12318	7	95	3	40414	0	40519
12319	38	1	41139	9	0	41187
12320	40989	3	90	15	0	41097
12321	61	4	41037	7	0	41109
12322	20	0	41073	11	0	41104
12323	41267	1	85	15	0	41368
12324	7	41271	0	21	0	41299
12325	40944	1	83	13	0	41041
12326	39716	5	76	12	0	39809
12327	8	1	39806	3	0	39818
12328	39020	6	114	11	0	39151
12329	28	4	39501	4	0	39537
12330	25	0	38966	12	0	39003
12331	56	5	40104	13	0	40178
12332	4	41234	1	21	0	41260
12333	41232	2	82	7	0	41323
12334	40997	1	107	14	0	41119
12335	40979	4	73	5	0	41061
12336	41973	9	109	15	0	42106
12337	10	0	42513	2	0	42525
12338	5	124	4	42590	0	42723
12339	3	76	3	46626	0	46708
12340	46742	2	62	9	0	46815
12341	3	46545	0	16	0	46564
12342	6	79	9	46488	0	46582
12343	46205	2	75	8	0	46290
12344	24	1	48306	5	0	48336
12345	5	134	0	47259	0	47398
12346	76	3	47313	11	0	47403
12347	7	47908	0	34	0	47949
12348	3	86	7	47350	0	47446
12349	50246	2	81	16	0	50345
12350	16	125	8	50465	0	50614
12351	50	2	50276	8	0	50336
12352	2	50551	0	51	0	50604
12353	49088	5	123	25	0	49241
12354	26	2	49540	4	0	49572
12355	49712	6	85	8	0	49811
12356	16	48914	0	38	0	48968
12357	48672	4	96	8	0	48780
12358	48442	5	91	5	0	48543
12359	5	107	1	48533	0	48646
12360	81	0	49933	6	0	50020
12361	6	48295	0	23	0	48324
12362	13	288	6	47782	0	48089
12363	11	220	7	47732	0	47970
12364	14	208	9	48023	0	48254
12365	12	156	3	49710	0	49881
12366	7	49864	1	20	0	49892
12367	49529	11	92	7	0	49639
12368	1	48202	1	23	0	48227
12369	13	93	6	47903	0	48015
12370	48659	4	52	4	0	48719
12371	5	135	3	48960	0	49103
12372	62	12	50676	7	0	50757
12373	1	46378	2	17	0	46398
12374	21	127	4	45925	0	46077
12375	5	55	2	46223	0	46285
12376	45125	3	60	11	0	45199
12377	15	0	45071	8	0	45094
12378	47599	4	110	5	0	47718
12379	47662	12	125	8	0	47807
12380	47080	5	174	4	0	47263
12381	29	1	46598	3	0	46631
12382	11	97	1	46376	0	46485
12383	11	101	6	46555	0	46673
12384	38	1	47075	14	0	47128
12385	52	2	44543	8	0	44605
12386	46840	7	113	14	0	46974
12387	5	74	2	47455	0	47536
12388	47486	3	43	2	0	47534
12389	49110	9	69	7	0	49195
12390	8	115	6	47698	0	47827
12391	28	0	47795	4	0	47827
12392	47019	4	121	24	0	47168
12393	11	94	48	46250	0	46403
12394	74	0	46384	8	0	46466
12395	2	45770	2	29	0	45803
12396	45671	5	140	2	0	45818
12397	5	46724	0	21	0	46750
12398	21	166	8	45705	0	45900
12399	4	47463	2	31	0	47500
12400	47480	1	75	7	0	47563
12401	47862	2	104	9	0	47977
12402	5	47736	2	19	0	47762
12403	49016	1	91	12	0	49120
12404	49848	4	110	8	0	49970
12405	2	50842	0	58	0	50902
12406	51555	8	96	7	0	51666
12407	16	109	6	51435	0	51566
12408	5	63	8	50306	0	50382
12409	50686	3	32	6	0	50727
12410	21	148	9	49724	0	49902
12411	6	49005	1	69	0	49081
12412	49604	6	86	12	0	49708
12413	50180	7	110	10	0	50307
12414	11	48389	0	13	0	48413
12415	46388	2	92	6	0	46488
12416	47917	5	83	7	0	48012
12417	4	93	2	49069	0	49168
12418	93	2	48933	4	0	49032
12419	2	47625	3	31	0	47661
12420	47640	5	96	7	0	47748
12421	47938	3	116	11	0	48068
12422	13	0	47391	2	0	47406
12423	46956	6	166	14	0	47142
12424	22	0	48069	4	0	48095
12425	52830	2	137	14	0	52983
12426	15	116	4	53008	0	53143
12427	55	3	52794	10	0	52862
12428	43	2	54061	20	0	54126
12429	20	147	6	53820	0	53993
12430	10	139	9	52962	0	53120
12431	33	0	53391	2	0	53426
12432	11	156	1	53009	0	53177
12433	73	0	53082	4	0	53159
12434	12	214	5	53540	0	53771
12435	28	178	6	53279	0	53491
12436	19	53562	3	33	0	53617
12437	24	53129	3	25	0	53181
12438	3	54000	0	49	0	54052
12439	5	144	2	53878	0	54029
12440	17	131	3	54356	0	54507
12441	65	0	53256	11	0	53332
12442	53229	15	137	9	0	53390
12443	55369	2	213	6	0	55590
12444	2	56432	1	35	0	56470
12445	55200	7	91	8	0	55306
12446	6	65	5	55831	0	55907
12447	55225	3	54	5	0	55287
12448	53505	5	111	14	0	53635
12449	13	88	4	53715	0	53820
12450	53250	1	101	7	0	53359
12451	13	53394	0	42	0	53449
12452	1	52427	2	33	0	52463
12453	23	259	5	54415	0	54702
12454	6	57295	3	26	0	57330
12455	22	214	13	57044	0	57293
12456	3	84	0	57683	0	57770
12457	57266	4	95	3	0	57368
12458	6	57534	1	58	0	57599
12459	60626	4	130	5	0	60765
12460	59459	3	125	14	0	59601
12461	2	59111	0	28	0	59141
12462	56251	3	122	17	0	56393
12463	129	0	55910	6	0	56045
12464	7	55309	3	36	0	55355
12465	55284	4	158	6	0	55452
12466	65	2	55256	9	0	55332
12467	31	55611	1	57	0	55700
12468	10	55946	2	70	0	56028
12469	56273	10	108	14	0	56405
12470	58243	2	115	12	0	58372
12471	58869	9	116	10	0	59004
12472	6	59287	1	31	0	59325
12473	15	105	5	58939	0	59064
12474	59290	4	65	3	0	59362
12475	57451	8	95	10	0	57564
12476	8	96	7	57628	0	57739
12477	40	2	57394	9	0	57445
12478	44	1	58177	15	0	58237
12479	8	150	7	57645	0	57810
12480	6	190	4	57640	0	57840
12481	52	0	56718	8	0	56778
12482	28	215	7	55223	0	55473
12483	8	55348	3	27	0	55386
12484	56730	7	147	8	0	56892
12485	12	123	2	57504	0	57641
12486	57473	8	75	11	0	57567
12487	11	57240	2	116	0	57369
12488	1	56841	1	43	0	56886
12489	55849	8	105	24	0	55986
12490	56	1	59385	3	0	59445
12491	60202	5	137	17	0	60361
12492	6	63808	0	23	0	63837
12493	5	111	5	62751	0	62872
12494	63086	4	67	16	0	63173
12495	11	119	8	62684	0	62822
12496	62738	4	88	2	0	62832
12497	63684	9	163	8	0	63864
12498	5	63610	0	37	0	63652
12499	60108	4	130	17	0	60259
12500	5	61148	0	30	0	61183
12501	56780	1	129	12	0	56922
12502	3	103	5	58373	0	58484
12503	58189	6	57	8	0	58260
12504	12	38	5	58487	0	58542
12505	58577	2	30	3	0	58612
12506	58352	8	74	18	0	58452
12507	58687	6	46	5	0	58744
12508	58758	3	82	22	0	58865
12509	58463	6	73	12	0	58554
12510	1	46	1	57891	0	57939
12511	58179	1	68	2	0	58250
12512	1	58604	1	38	0	58644
12513	74	0	58831	7	0	58912
12514	14	173	3	58575	0	58765
12515	31	0	58353	16	0	58400
12516	5	154	9	58380	0	58548
12517	44	1	57947	7	0	57999
12518	57876	4	210	30	0	58120
12519	12	112	7	56837	0	56968
12520	90	1	56003	12	0	56106
12521	50	2	59198	32	0	59282
12522	12	139	3	58985	0	59139
12523	58903	5	134	15	0	59057
12524	7	58572	1	52	0	58632
12525	58334	7	134	9	0	58484
12526	62989	7	153	9	0	63158
12527	1	63235	0	147	0	63383
12528	63264	4	104	5	0	63377
12529	8	83	6	60607	0	60704
12530	13	136	7	57868	0	58024
12531	4	28	2	58909	0	58943
12532	58857	2	95	2	0	58956
12533	2	59430	0	15	0	59447
12534	8	149	6	58758	0	58921
12535	5	65	4	56173	0	56247
12536	56600	1	61	6	0	56668
12537	10	138	3	56474	0	56625
12538	45	2	56373	8	0	56428
12539	1	58295	1	58	0	58355
12540	60960	3	126	15	0	61104
12541	22	191	15	60383	0	60611
12542	10	60357	3	35	0	60405
12543	60347	7	138	22	0	60514
12544	39	2	61732	5	0	61778
12545	10	60427	1	40	0	60478
12546	60286	4	92	7	0	60389
12547	2	153	6	59860	0	60021
12548	11	134	2	58494	0	58641
12549	49	0	58708	11	0	58768
12550	16	122	16	59047	0	59201
12551	38	1	58705	50	0	58794
12552	61	4	58586	14	0	58665
12553	132	1	58098	32	0	58263
12554	58736	6	143	18	0	58903
12555	58469	7	124	5	0	58605
12556	58813	5	130	10	0	58958
12557	6	109	2	58714	0	58831
12558	15	59372	0	46	0	59433
12559	7	58605	0	48	0	58660
12560	58922	9	153	11	0	59095
12561	58220	4	124	7	0	58355
12562	3	58045	1	28	0	58077
12563	57956	4	131	12	0	58103
12564	66	1	59797	3	0	59867
12565	34	1	60129	12	0	60176
12566	12	155	4	56253	0	56424
12567	7	115	6	56082	0	56210
12568	56	2	52304	0	0	52362
12569	13	87	5	54431	0	54536
12570	53583	5	91	39	0	53718
12571	64	3	53688	9	0	53764
12572	55196	5	152	15	0	55368
12573	14	96	2	54522	0	54634
12574	56	1	53431	6	0	53494
12575	4	52390	0	55	0	52449
12576	52215	13	144	12	0	52384
12577	62	0	51726	2	0	51790
12578	51913	5	105	16	0	52039
12579	10	106	7	54398	0	54521
12580	53389	2	78	9	0	53478
12581	37	1	54299	7	0	54344
12582	6	50	5	54360	0	54421
12583	53516	0	64	2	0	53582
12584	53499	4	89	11	0	53603
12585	53881	4	101	15	0	54001
12586	54149	4	74	26	0	54253
12587	12	93	1	54659	0	54765
12588	3	91	2	52275	0	52371
12589	92	1	52188	7	0	52288
12590	11	226	4	51562	0	51803
12591	16	137	3	51508	0	51664
12592	7	50832	3	30	0	50872
12593	51623	6	110	10	0	51749
12594	52833	3	85	6	0	52927
12595	7	49484	0	16	0	49507
12596	26	107	4	48930	0	49067
12597	5	113	3	49191	0	49312
12598	49027	4	84	12	0	49127
12599	33	1	49230	3	0	49267
12600	11	119	3	49458	0	49591
12601	29	0	49342	9	0	49380
12602	44943	4	128	21	0	45096
12603	43981	3	144	2	0	44130
12604	43540	5	113	10	0	43668
12605	6	31	3	43595	0	43635
12606	4	42	1	43794	0	43841
12607	47152	2	74	3	0	47231
12608	51	1	47124	3	0	47179
12609	9	75	5	47375	0	47464
12610	47407	3	85	8	0	47503
12611	8	87	6	46835	0	46936
12612	113	1	46516	7	0	46637
12613	56	13	46773	9	0	46851
12614	47157	8	155	18	0	47338
12615	9	45575	1	40	0	45625
12616	43234	2	72	3	0	43311
12617	43429	7	86	8	0	43530
12618	1	81	6	43455	0	43543
12619	16	122	1	44797	0	44936
12620	2	43484	0	40	0	43526
12621	44170	6	108	12	0	44296
12622	9	44467	2	30	0	44508
12623	3	43707	0	23	0	43733
12624	6	48	2	43831	0	43887
12625	45513	2	56	6	0	45577
12626	48123	6	62	12	0	48203
12627	11	61	2	47926	0	48000
12628	6	61	5	47832	0	47904
12629	2	70	3	48253	0	48328
12630	47402	1	65	2	0	47470
12631	33	1	47231	12	0	47277
12632	3	46968	0	52	0	47023
12633	46886	4	137	9	0	47036
12634	11	101	6	46381	0	46499
12635	30	2	45464	10	0	45506
12636	39	4	46706	11	0	46760
12637	17	47071	1	32	0	47121
12638	5	47009	0	22	0	47036
12639	10	236	6	46754	0	47006
12640	1	48445	1	18	0	48465
12641	12	127	7	48441	0	48587
12642	1	62	1	51335	0	51399
12643	51475	2	52	8	0	51537
12644	9	66	6	51426	0	51507
12645	5	102	6	49903	0	50016
12646	54	0	49884	9	0	49947
12647	8	117	4	48590	0	48719
12648	48463	3	67	4	0	48537
12649	47810	9	119	16	0	47954
12650	12	47855	1	30	0	47898
12651	46052	5	125	7	0	46189
12652	26	0	47893	4	0	47923
12653	3	46533	2	25	0	46563
12654	5	148	9	46321	0	46483
12655	6	76	3	46437	0	46522
12656	5	34	2	46577	0	46618
12657	45462	7	29	10	0	45508
12658	45388	4	113	11	0	45516
12659	26	0	45338	8	0	45372
12660	55	2	45269	27	0	45353
12661	105	5	45071	18	0	45199
12662	13	44701	5	35	0	44754
12663	26	45357	1	33	0	45417
12664	45714	3	90	15	0	45822
12665	45966	0	33	2	0	46001
12666	4	109	6	45984	0	46103
12667	12	109	2	48380	0	48503
12668	1	47078	2	10	0	47091
12669	8	106	10	46426	0	46550
12670	24	2	46536	7	0	46569
12671	3	46715	2	49	0	46769
12672	15	169	9	46711	0	46904
12673	21	2	47745	2	0	47770
12674	13	128	3	48188	0	48332
12675	6	48197	1	36	0	48240
12676	48325	4	58	2	0	48389
12677	48427	4	35	10	0	48476
12678	47972	3	100	4	0	48079
12679	5	48	2	48631	0	48686
12680	1	50	2	50910	0	50963
12681	51330	4	79	6	0	51419
12682	0	47346	2	28	0	47376
12683	46440	7	173	9	0	46629
12684	32	2	47048	3	0	47085
12685	47357	8	148	20	0	47533
12686	50763	6	123	5	0	50897
12687	10	34	4	52006	0	52054
12688	50762	3	55	4	0	50824
12689	50838	3	86	3	0	50930
12690	7	74	1	51111	0	51193
12691	43	0	50633	13	0	50689
12692	50006	16	207	23	0	50252
12693	31	0	52023	3	0	52057
12694	1	52393	22	40	0	52456
12695	12	108	8	51339	0	51467
12696	7	53	3	51871	0	51934
12697	50786	2	70	4	0	50862
12698	27	1	52034	3	0	52065
12699	10	156	4	53947	0	54117
12700	13	52323	0	39	0	52375
12701	5	51610	0	24	0	51639
12702	21	123	4	50225	0	50373
12703	71	0	50594	3	0	50668
12704	13	184	4	50874	0	51075
12705	10	132	5	54000	0	54147
12706	46	1	53591	15	0	53653
12707	13	53201	2	70	0	53286
12708	55000	8	130	12	0	55150
12709	5	55389	1	85	0	55480
12710	0	66	0	56091	0	56157
12711	56637	4	95	6	0	56742
12712	1	55287	4	59	0	55351
12713	42	0	55224	5	0	55271
12714	53376	8	159	13	0	53556
12715	4	52541	2	26	0	52573
12716	51092	10	88	8	0	51198
12717	21	4	51631	5	0	51661
12718	51285	7	135	21	0	51448
12719	11	149	6	53460	0	53626
12720	29	1	53736	7	0	53773
12721	10	185	2	53537	0	53734
12722	3	53280	0	20	0	53303
12723	13	150	6	53499	0	53668
12724	15	121	1	53125	0	53262
12725	71	1	53164	11	0	53247
12726	11	88	2	53725	0	53826
12727	35	1	53265	13	0	53314
12728	7	51994	2	49	0	52052
12729	9	110	8	51456	0	51583
12730	58	0	51687	20	0	51765
12731	13	51823	2	54	0	51892
12732	4	51997	2	59	0	52062
12733	132	5	52011	10	0	52158
12734	23	2	55842	16	0	55883
12735	6	89	5	56681	0	56781
12736	55967	4	70	3	0	56044
12737	7	56086	3	26	0	56122
12738	13	78	2	55674	0	55767
12739	58287	8	107	32	0	58434
12740	3	58106	1	77	0	58187
12741	58158	7	203	16	0	58384
12742	2	58726	3	24	0	58755
12743	55907	4	100	5	0	56016
12744	55996	7	140	11	0	56154
12745	55887	11	131	11	0	56040
12746	3	56618	0	28	0	56649
12747	7	82	6	56676	0	56771
12748	45	0	56937	9	0	56991
12749	4	58797	0	34	0	58835
12750	13	152	6	58880	0	59051
12751	10	122	2	59033	0	59167
12752	42	1	59177	4	0	59224
12753	14	59248	0	53	0	59315
12754	60034	4	89	12	0	60139
12755	3	58622	2	27	0	58654
12756	7	142	13	56365	0	56527
12757	39	2	57136	14	0	57191
12758	57420	6	183	21	0	57630
12759	16	131	23	57842	0	58012
12760	41	0	57070	8	0	57119
12761	56685	9	209	26	0	56929
12762	9	53658	1	64	0	53732
12763	52414	6	146	16	0	52582
12764	52353	9	121	6	0	52489
12765	5	81	3	54204	0	54293
12766	43	0	54924	3	0	54970
12767	7	54597	9	61	0	54674
12768	49	2	54525	3	0	54579
12769	10	108	5	52889	0	53012
12770	2	88	4	52914	0	53008
12771	52704	3	80	3	0	52790
12772	84	2	53607	2	0	53695
12773	3	51858	3	49	0	51913
12774	8	130	12	50639	0	50789
12775	8	70	3	52410	0	52491
12776	52492	1	69	8	0	52570
12777	7	52565	0	82	0	52654
12778	5	85	1	52583	0	52674
12779	52565	9	130	10	0	52714
12780	17	52677	1	58	0	52753
12781	49536	8	191	20	0	49755
12782	49990	10	133	8	0	50141
12783	6	49354	1	36	0	49397
12784	47813	6	154	15	0	47988
12785	13	53855	2	47	0	53917
12786	52386	7	166	12	0	52571
12787	52616	3	182	13	0	52814
12788	13	52407	0	29	0	52449
12789	51464	8	117	6	0	51595
12790	51216	11	87	6	0	51320
12791	49870	4	184	14	0	50072
12792	26	0	50505	6	0	50537
12793	14	1	50923	8	0	50946
12794	23	0	50503	6	0	50532
12795	47845	9	199	29	0	48082
12796	71	0	47579	4	0	47654
12797	64	3	47827	8	0	47902
12798	6	72	4	47678	0	47760
12799	47554	2	98	5	0	47659
12800	51	1	48429	1	0	48482
12801	37	1	50842	6	0	50886
12802	8	124	11	50090	0	50233
12803	7	90	5	49730	0	49832
12804	10	113	5	52062	0	52190
12805	57	3	52409	4	0	52473
12806	6	87	1	53261	0	53355
12807	53397	1	57	7	0	53462
12808	2	51260	1	39	0	51302
12809	10	132	9	56457	0	56608
12810	18	147	12	56212	0	56389
12811	37	1	56292	12	0	56342
12812	18	56865	0	62	0	56945
12813	57323	2	98	24	0	57447
12814	2	57534	1	59	0	57596
12815	11	105	5	56057	0	56178
12816	57	1	58012	7	0	58077
12817	9	87	4	57691	0	57791
12818	6	65	5	57387	0	57463
12819	58769	2	81	7	0	58859
12820	24	140	4	58437	0	58605
12821	27	57531	3	46	0	57607
12822	8	57398	7	70	0	57483
12823	24	0	56832	5	0	56861
12824	56358	5	87	14	0	56464
12825	8	113	32	53833	0	53986
12826	17	87	9	53739	0	53852
12827	4	54	4	53979	0	54041
12828	53686	0	96	9	0	53791
12829	4	52942	1	21	0	52968
12830	52678	6	195	11	0	52890
12831	38	0	52896	17	0	52951
12832	35	1	55002	7	0	55045
12833	54201	5	158	11	0	54375
12834	4	96	18	54015	0	54133
12835	7	67	2	54132	0	54208
12836	5	77	2	54010	0	54094
12837	37	2	54091	3	0	54133
12838	53817	5	139	6	0	53967
12839	54398	4	162	6	0	54570
12840	54044	7	295	6	0	54352
12841	2	54	4	52410	0	52470
12842	34	1	51016	3	0	51054
12843	62	0	50872	7	0	50941
12844	64	4	54172	10	0	54250
12845	14	53915	1	59	0	53989
12846	1	86	2	54217	0	54306
12847	54152	6	99	5	0	54262
12848	38	1	53246	4	0	53289
12849	53502	5	137	5	0	53649
12850	6	120	6	53707	0	53839
12851	18	109	10	51514	0	51651
12852	34	52461	1	36	0	52532
12853	19	55412	1	65	0	55497
12854	8	58015	0	49	0	58072
12855	7	71	6	59583	0	59667
12856	59634	6	62	5	0	59707
12857	59000	5	134	13	0	59152
12858	10	0	59101	28	0	59139
12859	57579	11	260	13	0	57863
12860	17	1	58855	50	0	58923
12861	17	75	9	51956	0	52057
12862	53	1	52152	2	0	52208
12863	55962	6	243	36	0	56247
12864	11	127	18	56245	0	56401
12865	40	1	56026	10	0	56077
12866	115	4	56143	6	0	56268
12867	56648	3	213	22	0	56886
12868	56621	4	189	6	0	56820
12869	1	55977	2	41	0	56021
12870	14	69	8	55719	0	55810
12871	65	3	56612	6	0	56686
12872	71	2	57028	12	0	57113
12873	10	90	5	57527	0	57632
12874	57698	3	93	13	0	57807
12875	14	56208	2	23	0	56247
12876	19	69	4	61996	0	62088
12877	64404	4	128	7	0	64543
12878	20	133	8	63737	0	63898
12879	9	63846	1	41	0	63897
12880	27	73	3	61545	0	61648
12881	62214	4	88	7	0	62313
12882	5	61	3	61708	0	61777
12883	61679	5	65	9	0	61758
12884	12	61108	1	23	0	61144
12885	53772	15	139	4	0	53930
12886	18	0	54266	3	0	54287
12887	54725	2	156	13	0	54896
12888	54406	3	219	4	0	54632
12889	3	52212	1	73	0	52289
12890	4	67	6	50277	0	50354
12891	40	3	50326	4	0	50373
12892	40	1	50387	35	0	50463
12893	50568	11	152	18	0	50749
12894	52062	4	209	14	0	52289
12895	30	50552	5	39	0	50626
12896	13	50162	2	46	0	50223
12897	50422	5	133	6	0	50566
12898	22	50953	0	17	0	50992
12899	7	50835	1	29	0	50872
12900	17	116	9	50644	0	50786
12901	17	128	10	50640	0	50795
12902	31	3	50873	1	0	50908
12903	8	82	5	51367	0	51462
12904	51264	3	108	10	0	51385
12905	17	1	51134	5	0	51157
12906	35	1	54429	12	0	54477
12907	9	126	21	52103	0	52259
12908	9	100	4	54096	0	54209
12909	14	99	6	53595	0	53714
12910	43	20	55095	1	0	55159
12911	27	111	13	55241	0	55392
12912	5	51	5	55337	0	55398
12913	55329	2	126	20	0	55477
12914	4	55048	0	33	0	55085
12915	54211	10	185	12	0	54418
12916	29	1	54400	1	0	54431
12917	57462	10	180	16	0	57668
12918	33	56255	2	39	0	56329
12919	53592	5	204	13	0	53814
12920	23	55639	2	41	0	55705
12921	58405	14	211	13	0	58643
12922	23	59565	1	49	0	59638
12923	10	60043	2	47	0	60102
12924	8	87	9	59906	0	60010
12925	59956	6	88	6	0	60056
12926	59829	6	170	14	0	60019
12927	59256	10	216	11	0	59493
12928	31	0	57291	3	0	57325
12929	41	1	56222	8	0	56272
12930	18	114	11	53398	0	53541
12931	10	51594	1	39	0	51644
12932	7	51517	4	17	0	51545
12933	7	67	11	51738	0	51823
12934	51964	1	41	2	0	52008
12935	51990	4	53	6	0	52053
12936	51720	6	169	3	0	51898
12937	16	0	52366	1	0	52383
12938	8	100	10	47497	0	47615
12939	75	1	47671	3	0	47750
12940	48003	3	150	8	0	48164
12941	47883	16	204	12	0	48115
12942	26	1	51013	1	0	51041
12943	3	65	2	50693	0	50763
12944	51136	0	71	4	0	51211
12945	16	109	7	50774	0	50906
12946	12	88	9	50921	0	51030
12947	10	59	5	50203	0	50277
12948	49709	1	32	11	0	49753
12949	4	71	4	50374	0	50453
12950	51114	3	60	5	0	51182
12951	5	47577	0	6	0	47588
12952	16	166	4	40858	0	41044
12953	11	76	7	42007	0	42101
12954	1	37	0	42273	0	42311
12955	42291	1	19	3	0	42314
12956	8	67	6	42344	0	42425
12957	0	40	4	41146	0	41190
12958	41398	1	25	8	0	41432
12959	41531	4	52	4	0	41591
12960	41074	6	111	3	0	41194
12961	29	0	43119	3	0	43151
12962	9	3	41697	10	0	41719
12963	41059	4	145	5	0	41213
12964	3	83	6	41109	0	41201
12965	13	36	1	41443	0	41493
12966	41559	2	81	2	0	41644
12967	42395	1	108	4	0	42508
12968	42415	4	124	2	0	42545
12969	2	42696	1	24	0	42723
12970	40910	8	115	5	0	41038
12971	42399	3	167	6	0	42575
12972	10	45157	1	50	0	45218
12973	3	44358	1	29	0	44391
12974	5	52	3	44129	0	44189
12975	50262	2	87	13	0	50364
12976	49997	5	85	5	0	50092
12977	50463	5	114	6	0	50588
12978	5	42	3	50546	0	50596
12979	50343	37	56	3	0	50439
12980	16	7	52232	3	0	52258
12981	48336	3	198	20	0	48557
12982	57	2	50022	2	0	50083
12983	49	25	55102	9	0	55185
12984	7	47	5	53362	0	53421
12985	54182	6	93	10	0	54291
12986	9	70	5	52786	0	52870
12987	37	2	52668	5	0	52712
12988	83	0	57384	8	0	57475
12989	8	49	4	57779	0	57840
12990	58342	5	101	4	0	58452
12991	2	58115	0	45	0	58162
12992	11	83	7	57039	0	57140
12993	19	115	8	59443	0	59585
12994	59	2	59315	6	0	59382
12995	51	4	60187	10	0	60252
12996	14	82	5	58676	0	58777
12997	55941	1	100	6	0	56048
12998	43	1	54654	2	0	54700
12999	8	127	10	54618	0	54763
13000	9	107	12	54550	0	54678
13001	2	55	6	55096	0	55159
13002	55275	1	96	6	0	55378
13003	61	11	55091	7	0	55170
13004	2	52953	2	56	0	53013
13005	20	103	5	52909	0	53037
13006	65	1	53471	8	0	53545
13007	7	53931	4	71	0	54013
13008	9	53798	1	42	0	53850
13009	54439	3	144	26	0	54612
13010	7	54751	1	35	0	54794
13011	54440	2	113	15	0	54570
13012	26	2	55963	10	0	56001
13013	7	81	3	56258	0	56349
13014	57471	2	87	8	0	57568
13015	6	57085	8	53	0	57152
13016	68	1	58150	3	0	58222
13017	12	156	3	60096	0	60267
13018	8	56574	2	46	0	56630
13019	6	97	2	56702	0	56807
13020	56888	3	109	5	0	57005
13021	3	56685	0	29	0	56717
13022	55790	4	94	5	0	55893
13023	55888	6	169	12	0	56075
13024	36	0	55731	9	0	55776
13025	3	56842	0	49	0	56894
13026	20	100	14	56240	0	56374
13027	59	0	56608	21	0	56688
13028	19	1	56631	29	0	56680
13029	4	69	1	55637	0	55711
13030	55271	2	89	0	0	55362
13031	56347	7	127	2	0	56483
13032	7	102	3	56422	0	56534
13033	57	2	56270	3	0	56332
13034	9	57199	2	83	0	57293
13035	57093	8	147	18	0	57266
13036	57338	9	188	9	0	57544
13037	1	55709	0	32	0	55742
13038	55522	5	113	18	0	55658
13039	29	2	55594	4	0	55629
13040	56036	3	148	13	0	56200
13041	55711	3	216	7	0	55937
13042	25	0	55933	3	0	55961
13043	10	92	3	55347	0	55452
13044	77	3	54600	28	0	54708
13045	16	55474	2	51	0	55543
13046	10	51593	0	35	0	51638
13047	23	126	10	51702	0	51861
13048	57	3	51813	6	0	51879
13049	12	52549	5	42	0	52608
13050	16	47263	1	33	0	47313
13051	47487	2	95	8	0	47592
13052	47746	6	47	4	0	47803
13053	4	100	1	47751	0	47856
13054	15	118	9	48352	0	48494
13055	9	47023	2	28	0	47062
13056	46963	4	86	7	0	47060
13057	47695	1	76	8	0	47780
13058	1	41979	0	18	0	41998
13059	13	94	3	41370	0	41480
13060	38	0	44619	4	0	44661
13061	6	38	2	44519	0	44565
13062	45129	1	57	6	0	45193
13063	12	64	11	45279	0	45366
13064	11	61	1	41911	0	41984
13065	42664	1	24	3	0	42692
13066	16	100	4	41555	0	41675
13067	2	41010	0	9	0	41021
13068	7	119	9	40399	0	40534
13069	4	115	9	38698	0	38826
13070	14	107	4	39936	0	40061
13071	8	38986	2	28	0	39024
13072	21	81	7	39166	0	39275
13073	21	0	39312	5	0	39338
13074	7	73	8	39009	0	39097
13075	37	4	38792	11	0	38844
13076	2	38610	0	19	0	38631
13077	11	163	5	38188	0	38367
13078	9	109	3	41273	0	41394
13079	10	92	10	42039	0	42151
13080	6	101	2	42687	0	42796
13081	47	21	43361	2	0	43431
13082	4	42142	0	40	0	42186
13083	10	119	13	42535	0	42677
13084	57	1	42846	2	0	42906
13085	12	85	2	43042	0	43141
13086	42885	5	94	12	0	42996
13087	27	0	42957	7	0	42991
13088	42938	3	119	8	0	43068
13089	11	67	4	42829	0	42911
13090	43	0	41358	12	0	41413
13091	7	40797	1	27	0	40832
13092	8	110	6	43314	0	43438
13093	47	0	43542	3	0	43592
13094	6	46250	3	40	0	46299
13095	4	61	5	46367	0	46437
13096	46657	1	85	2	0	46745
13097	46515	3	114	7	0	46639
13098	46554	8	182	7	0	46751
13099	19	1	46579	7	0	46606
13100	8	54047	0	43	0	54098
13101	21	116	10	53460	0	53607
13102	4	70	3	54186	0	54263
13103	54340	2	101	13	0	54456
13104	11	55269	0	21	0	55301
13105	57768	4	122	4	0	57898
13106	57771	8	102	15	0	57896
13107	56032	4	142	7	0	56185
13108	46	0	56494	3	0	56543
13109	56197	4	126	10	0	56337
13110	9	91	7	56797	0	56904
13111	10	65	1	57106	0	57182
13112	56864	2	77	5	0	56948
13113	14	179	5	56196	0	56394
13114	5	56591	3	38	0	56637
13115	22	104	8	60079	0	60213
13116	59446	3	123	0	0	59572
13117	55	3	59706	5	0	59769
13118	3	59915	0	120	0	60038
13119	5	127	7	60205	0	60344
13120	59655	2	132	6	0	59795
13121	53	1	60015	3	0	60072
13122	21	89	26	59803	0	59939
13123	44	1	59289	12	0	59346
13124	80	1	61703	21	0	61805
13125	66	3	61118	9	0	61196
13126	46	1	60932	22	0	61001
13127	63	0	61454	9	0	61526
13128	61447	7	223	28	0	61705
13129	14	61464	1	35	0	61514
13130	60889	9	199	18	0	61115
13131	62186	5	145	15	0	62351
13132	45	61295	1	36	0	61377
13133	11	60988	2	63	0	61064
13134	60820	10	119	33	0	60982
13135	61056	5	134	6	0	61201
13136	19	120	19	64340	0	64498
13137	7	66066	0	37	0	66110
13138	66454	5	123	12	0	66594
13139	8	66283	0	22	0	66313
13140	4	67	11	64994	0	65076
13141	65857	3	74	2	0	65936
13142	65567	1	98	2	0	65668
13143	7	117	4	65249	0	65377
13144	14	181	22	64280	0	64497
13145	67	1	65441	2	0	65511
13146	23	173	32	63888	0	64116
13147	24	1	64499	2	0	64526
13148	9	160	4	63751	0	63924
13149	14	68	2	63729	0	63813
13150	64176	3	100	17	0	64296
13151	63692	11	180	18	0	63901
13152	51	0	63714	7	0	63772
13153	63469	13	209	7	0	63698
13154	6	126	7	60206	0	60345
13155	40	0	60618	3	0	60661
13156	17	144	3	60050	0	60214
13157	13	143	12	59643	0	59811
13158	59	1	61183	6	0	61249
13159	8	170	6	60958	0	61142
13160	34	1	61798	7	0	61840
13161	7	88	8	61701	0	61804
13162	61820	10	94	19	0	61943
13163	6	61628	4	74	0	61712
13164	60413	6	219	24	0	60662
13165	10	60439	1	66	0	60516
13166	58248	11	156	14	0	58429
13167	12	60300	2	60	0	60374
13168	58047	9	135	17	0	58208
13169	10	57496	1	40	0	57547
13170	20	84	7	55405	0	55516
13171	68	2	55688	5	0	55763
13172	50	5	56427	17	0	56499
13173	15	81	5	56675	0	56776
13174	56023	0	71	5	0	56099
13175	4	55501	0	46	0	55551
13176	11	76	8	47050	0	47145
13177	30	2	47272	5	0	47309
13178	30	1	46580	5	0	46616
13179	22	95	0	46289	0	46406
13180	7	44944	1	33	0	44985
13181	42592	12	102	12	0	42718
13182	27	2	42970	5	0	43004
13183	41	0	42861	13	0	42915
13184	14	42644	1	29	0	42688
13185	42735	3	87	15	0	42840
13186	41197	4	106	6	0	41313
13187	3	75	1	40972	0	41051
13188	40928	1	43	7	0	40979
13189	40886	6	62	8	0	40962
13190	3	41418	0	19	0	41440
13191	37160	6	85	4	0	37255
13192	8	1	36838	4	0	36851
13193	13	102	5	36461	0	36581
13194	3	75	2	36816	0	36896
13195	36764	4	75	6	0	36849
13196	4	36268	0	22	0	36294
13197	36110	4	96	6	0	36216
13198	9	36104	1	26	0	36140
13199	9	33599	2	21	0	33631
13200	35	4	33190	4	0	33233
13201	22	1	32812	9	0	32844
13202	32481	1	88	14	0	32584
13203	33048	3	100	3	0	33154
13204	17	2	33377	7	0	33403
13205	11	33270	0	9	0	33290
13206	11	32664	0	10	0	32685
13207	32111	5	25	6	0	32147
13208	32103	2	33	6	0	32144
13209	5	27	1	32013	0	32046
13210	31956	5	25	3	0	31989
13211	1	45	2	31963	0	32011
13212	30	14	23521	73	0	23638
13213	17	1	22563	33	0	22614
13214	22014	1	43	9	0	22067
13215	5	50	5	21338	0	21398
13216	0	20771	0	12	0	20783
13217	20129	2	36	7	0	20174
13218	20068	1	54	3	0	20126
13219	10	0	20118	1	0	20129
13220	20105	2	47	6	0	20160
13221	19311	0	39	3	0	19353
13222	5	37	1	19460	0	19503
13223	1	19387	0	3	0	19391
13224	0	19342	0	5	0	19347
13225	2	86	4	19153	0	19245
13226	4	29	1	19204	0	19238
13227	4	44	2	19292	0	19342
13228	8	0	19132	2	0	19142
13229	32	0	19317	12	0	19361
13230	0	50	2	19696	0	19748
13231	16	1	18832	8	0	18857
13232	16	1	18926	9	0	18952
13233	4	59	1	18306	0	18370
13234	30	0	17325	3	0	17358
13235	3	17086	1	16	0	17106
13236	17460	1	30	7	0	17498
13237	4	48	3	17492	0	17547
13238	3	17171	0	12	0	17186
13239	20	0	17593	0	0	17613
13240	6	41	6	18226	0	18279
13241	17	0	18128	1	0	18146
13242	1	57	1	18978	0	19037
13243	1	42	0	16846	0	16889
13244	22	1	17099	6	0	17128
13245	3	40	0	16881	0	16924
13246	1	16571	0	8	0	16580
13247	12	67	1	16468	0	16548
13248	19	3	16982	1	0	17005
13249	2	44	0	17053	0	17099
13250	17164	0	10	3	0	17177
13251	3	16664	1	11	0	16679
13252	2	56	0	16333	0	16391
13253	19	1	16379	6	0	16405
13254	10	17407	0	31	0	17448
13255	0	17350	1	21	0	17372
13256	15	1	17420	0	0	17436
13257	1	29	1	17754	0	17785
13258	3	48	3	17164	0	17218
13259	36	1	17404	2	0	17443
13260	7	17432	3	21	0	17463
13261	6	17572	0	11	0	17589
13262	18106	2	26	8	0	18142
13263	2	18090	0	9	0	18101
13264	18444	5	43	9	0	18501
13265	3	22	0	18494	0	18519
13266	17700	3	14	5	0	17722
13267	25	0	17834	1	0	17860
13268	17830	2	24	4	0	17860
13269	5	49	3	17749	0	17806
13270	3	17530	0	14	0	17547
13271	17508	1	24	0	0	17533
13272	6	52	3	17726	0	17787
13273	5	17944	0	4	0	17953
13274	3	18121	1	6	0	18131
13275	18205	3	35	9	0	18252
13276	18078	3	20	3	0	18104
13277	18036	3	29	4	0	18072
13278	8	36	2	18506	0	18552
13279	4	17875	0	12	0	17891
13280	5	18112	0	10	0	18127
13281	1	27	2	17874	0	17904
13282	18233	2	22	1	0	18258
13283	18034	1	33	5	0	18073
13284	17977	3	62	0	0	18042
13285	6	0	18133	1	0	18140
13286	18	0	18089	3	0	18110
13287	17632	2	14	2	0	17650
13288	1	48	4	17619	0	17672
13289	1	27	5	17279	0	17312
13290	5	28	3	17664	0	17700
13291	0	31	4	17667	0	17702
13292	23	0	17581	2	0	17606
13293	3	51	1	17925	0	17980
13294	13	0	17688	2	0	17703
13295	17799	2	43	5	0	17849
13296	0	17967	0	5	0	17972
13297	0	39	1	17892	0	17932
13298	4	13	0	17980	0	17997
13299	17771	0	13	1	0	17785
13300	17631	1	41	4	0	17677
13301	19113	5	38	2	0	19158
13302	19320	1	86	5	0	19412
13303	11	0	19649	5	0	19665
13304	13	0	20478	1	0	20492
13305	4	26	1	19962	0	19993
13306	20082	0	26	3	0	20111
13307	20507	1	25	3	0	20536
13308	17	0	21629	2	0	21648
13309	4	34	2	21494	0	21534
13310	21876	0	31	1	0	21908
13311	1	60	1	21392	0	21454
13312	16	0	21938	1	0	21955
13313	8	43	0	22125	0	22176
13314	22169	3	34	1	0	22207
13315	2	21866	1	10	0	21879
13316	21179	2	33	7	0	21221
13317	20487	1	36	1	0	20525
13318	20656	2	19	0	0	20677
13319	1	28	3	20189	0	20221
13320	20759	2	22	3	0	20786
13321	6	21052	0	11	0	21069
13322	0	20183	0	10	0	20193
13323	3	30	0	20306	0	20339
13324	20308	0	22	9	0	20339
13325	2	20381	2	20	0	20405
13326	20354	1	29	0	0	20384
13327	20530	3	43	5	0	20581
13328	0	20076	1	13	0	20090
13329	2	86	1	20205	0	20294
13330	2	49	0	19719	0	19770
13331	27	0	20220	2	0	20249
13332	4	48	1	20180	0	20233
13333	22	1	20049	6	0	20078
13334	1	20003	1	12	0	20017
13335	0	47	2	20195	0	20244
13336	20351	2	24	6	0	20383
13337	20547	3	26	2	0	20578
13338	1	40	6	20178	0	20225
13339	9	0	20103	5	0	20117
13340	19875	4	43	5	0	19927
13341	1	20196	0	16	0	20213
13342	1	19769	0	9	0	19779
13343	3	19716	0	6	0	19725
13344	3	58	2	19573	0	19636
13345	20	1	19687	3	0	19711
13346	19	33	2	19868	0	19922
13347	26	0	19823	3	0	19852
13348	21	1	19610	6	0	19638
13349	12	0	19863	9	0	19884
13350	1	71	5	19560	0	19637
13351	2	54	2	19385	0	19443
13352	2	53	5	19384	0	19444
13353	1	16	1	19477	0	19495
13354	19022	0	16	2	0	19040
13355	0	18920	0	8	0	18928
13356	18768	1	36	4	0	18809
13357	0	19387	2	5	0	19394
13358	3	48	4	18957	0	19012
13359	4	6	0	19755	0	19765
13360	19816	0	18	3	0	19837
13361	19916	1	24	1	0	19942
13362	20026	3	37	3	0	20069
13363	20155	2	52	0	0	20209
13364	20234	17	50	2	0	20303
13365	1	20487	0	5	0	20493
13366	20053	3	41	3	0	20100
13367	1	20828	1	11	0	20841
13368	21273	3	23	9	0	21308
13369	18	0	22903	2	0	22923
13370	7	56	3	23091	0	23157
13371	2	22843	1	9	0	22855
13372	6	65	2	22741	0	22814
13373	46	0	23134	2	0	23182
13374	2	48	3	23315	0	23368
13375	23313	0	25	6	0	23344
13376	4	23182	0	18	0	23204
13377	3	21565	1	22	0	21591
13378	21	1	21449	3	0	21474
13379	8	57	4	20919	0	20988
13380	2	20415	0	11	0	20428
13381	1	37	2	20422	0	20462
13382	11	0	20582	4	0	20597
13383	3	19538	0	26	0	19567
13384	21	0	19589	2	0	19612
13385	23	0	19923	7	0	19953
13386	3	39	2	19402	0	19446
13387	19498	1	26	2	0	19527
13388	4	63	0	18616	0	18683
13389	19	0	19225	2	0	19246
13390	6	53	2	19038	0	19099
13391	15	0	18788	3	0	18806
13392	12	0	18863	2	0	18877
13393	18848	2	38	1	0	18889
13394	18399	2	55	3	0	18459
13395	18007	2	61	4	0	18074
13396	28	0	18159	1	0	18188
13397	5	0	17522	6	0	17533
13398	4	34	2	17161	0	17201
13399	3	30	0	17058	0	17091
13400	17063	0	29	2	0	17094
13401	3	26	4	17057	0	17090
13402	12	0	16949	2	0	16963
13403	16	1	17025	19	0	17061
13404	2	16952	0	17	0	16971
13405	4	43	2	16193	0	16242
13406	13	1	16221	4	0	16239
13407	1	35	0	16334	0	16370
13408	16346	0	12	0	0	16358
13409	10	0	16234	1	0	16245
13410	4	48	0	16735	0	16787
13411	2	39	0	16795	0	16836
13412	36	0	16766	2	0	16804
13413	2	43	6	16285	0	16336
13414	27	0	16309	5	0	16341
13415	16319	1	37	3	0	16360
13416	4	52	1	16301	0	16358
13417	0	15897	1	7	0	15905
13418	15608	3	34	3	0	15648
13419	15697	1	26	2	0	15726
13420	0	15707	0	6	0	15713
13421	5	30	0	15308	0	15343
13422	1	15516	0	4	0	15521
13423	0	15407	0	10	0	15417
13424	22	1	15454	0	0	15477
13425	2	20193	1	7	0	20203
13426	21	1	20226	1	0	20249
13427	20464	0	32	6	0	20502
13428	20447	1	47	3	0	20498
13429	4	20764	0	19	0	20787
13430	7	20667	3	17	0	20694
13431	2	20639	0	23	0	20664
13432	20774	2	30	1	0	20807
13433	9	39	2	20346	0	20396
13434	33	0	20390	3	0	20426
13435	2	20252	0	25	0	20279
13436	3	88	2	20056	0	20149
13437	12	74	1	20301	0	20388
13438	0	19975	0	3	0	19978
13439	19925	3	43	1	0	19972
13440	25	0	19880	1	0	19906
13441	7	55	0	20393	0	20455
13442	3	19700	0	8	0	19711
13443	19429	1	45	2	0	19477
13444	13	1	18842	5	0	18861
13445	0	17870	0	19	0	17889
13446	4	48	5	17759	0	17816
13447	13	0	17775	2	0	17790
13448	18883	2	40	8	0	18933
13449	1	50	2	19010	0	19063
13450	27	1	19054	1	0	19083
13451	1	19141	0	14	0	19156
13452	19613	5	43	5	0	19666
13453	1	19396	0	30	0	19427
13454	19030	1	44	6	0	19081
13455	18994	3	45	3	0	19045
13456	1	59	0	18893	0	18953
13457	0	18939	0	5	0	18944
13458	21	0	18944	1	0	18966
13459	1	69	4	19089	0	19163
13460	1	59	2	22015	0	22077
13461	1	18	0	21805	0	21824
13462	0	21	1	22066	0	22088
13463	3	7	0	21982	0	21992
13464	21905	0	10	3	0	21918
13465	21400	5	33	5	0	21443
13466	21557	3	45	4	0	21609
13467	3	21696	4	8	0	21711
13468	16	0	21441	1	0	21458
13469	27	0	21505	4	0	21536
13470	18	0	21764	3	0	21785
13471	4	49	2	21762	0	21817
13472	5	28	3	21343	0	21379
13473	6	38	1	21386	0	21431
13474	13	0	21363	3	0	21379
13475	2	21423	0	23	0	21448
13476	24	0	21415	1	0	21440
13477	29	0	22616	5	0	22650
13478	2	50	4	22345	0	22401
13479	10	1	22325	4	0	22340
13480	1	31	2	22521	0	22555
13481	22675	1	28	0	0	22704
13482	22666	2	52	2	0	22722
13483	26	0	22806	3	0	22835
13484	6	53	1	23073	0	23133
13485	48	3	22608	4	0	22663
13486	4	21973	3	45	0	22025
13487	21544	0	80	4	0	21628
13488	12	0	21533	1	0	21546
13489	9	22179	0	18	0	22206
13490	18	22176	1	17	0	22212
13491	1	22370	2	21	0	22394
13492	20	1	26054	1	0	26076
13493	3	76	5	26030	0	26114
13494	2	26289	0	7	0	26298
13495	12	81	9	26205	0	26307
13496	2	36	2	26494	0	26534
13497	26564	0	49	5	0	26618
13498	1	26318	0	37	0	26356
13499	26246	0	59	3	0	26308
13500	11	26200	1	14	0	26226
13501	4	20798	1	22	0	20825
13502	19	1	21378	0	0	21398
13503	2	54	5	21121	0	21182
13504	22	2	20774	23	0	20821
13505	5	20781	1	32	0	20819
13506	25	0	20820	1	0	20846
13507	35	3	21054	6	0	21098
13508	3	21002	2	17	0	21024
13509	20974	9	56	3	0	21042
13510	1	20956	0	3	0	20960
13511	20349	2	43	8	0	20402
13512	12	0	20679	3	0	20694
13513	14	1	20436	5	0	20456
13514	11	20844	4	9	0	20868
13515	21072	1	42	2	0	21117
13516	1	21354	0	11	0	21366
13517	4	43	0	21230	0	21277
13518	21311	1	32	4	0	21348
13519	20	0	22169	5	0	22194
13520	4	26	1	21931	0	21962
13521	21408	1	42	3	0	21454
13522	2	21634	0	9	0	21645
13523	5	46	6	20449	0	20506
13524	16	1	20443	7	0	20467
13525	19990	1	38	3	0	20032
13526	3	63	17	20104	0	20187
13527	37	2	22031	2	0	22072
13528	3	81	1	21557	0	21642
13529	1	21707	1	16	0	21725
13530	20	0	22023	0	0	22043
13531	0	31	0	22044	0	22075
13532	22407	1	25	1	0	22434
13533	3	22	0	22266	0	22291
13534	22115	2	32	8	0	22157
13535	1	21825	0	21	0	21847
13536	18535	1	44	4	0	18584
13537	14	0	18689	2	0	18705
13538	10	0	18409	7	0	18426
13539	23	0	18599	7	0	18629
13540	0	18664	0	8	0	18672
13541	4	72	4	18364	0	18444
13542	3	54	2	18428	0	18487
13543	2	42	0	18568	0	18612
13544	10	50	3	18622	0	18685
13545	7	0	18312	1	0	18320
13546	18159	1	49	8	0	18217
13547	1	18574	0	16	0	18591
13548	18134	2	38	3	0	18177
13549	2	55	3	18200	0	18260
13550	4	18762	1	9	0	18776
13551	3	39	0	18700	0	18742
13552	18860	1	27	3	0	18891
13553	4	17917	0	8	0	17929
13554	17745	1	39	4	0	17789
13555	18135	2	47	0	0	18184
13556	0	53	2	18155	0	18210
13557	20	0	18480	0	0	18500
13558	18203	2	62	8	0	18275
13559	1	19	1	17868	0	17889
13560	17672	2	25	2	0	17701
13561	17992	4	33	4	0	18033
13562	17836	4	66	3	0	17909
13563	19	0	18141	1	0	18161
13564	2	29	1	18218	0	18250
13565	17508	1	28	2	0	17539
13566	28	0	17412	1	0	17441
13567	1	13866	1	22	0	13890
13568	5	34	1	13872	0	13912
13569	19	0	13943	1	0	13963
13570	11	0	13974	6	0	13991
13571	5	48	7	14541	0	14601
13572	5	39	2	14356	0	14402
13573	2	33	2	14560	0	14597
13574	9	34	2	14549	0	14594
13575	8	1	14639	5	0	14653
13576	0	14222	0	12	0	14234
13577	0	14	0	14284	0	14298
13578	14417	1	15	0	0	14433
13579	14315	1	13	1	0	14330
13580	14343	3	22	2	0	14370
13581	1	27	0	14517	0	14545
13582	2	43	0	14469	0	14514
13583	0	15094	0	10	0	15104
13584	0	15011	0	5	0	15016
13585	3	26	0	15230	0	15259
13586	15416	2	11	1	0	15430
13587	15484	0	15	0	0	15499
13588	15268	0	23	2	0	15293
13589	15517	2	43	3	0	15565
13590	15124	7	20	2	0	15153
13591	0	15018	0	12	0	15030
13592	3	15	0	14863	0	14881
13593	14912	0	21	1	0	14934
13594	14739	2	20	0	0	14761
13595	2	23	1	14086	0	14112
13596	1	38	1	13999	0	14039
13597	12	1	14016	5	0	14034
13598	3	49	1	14289	0	14342
13599	0	34	0	14302	0	14336
13600	23	0	14127	2	0	14152
13601	3	58	1	14520	0	14582
13602	0	12519	1	7	0	12527
13603	20	0	12497	2	0	12519
13604	0	12254	0	3	0	12257
13605	2	41	1	12356	0	12400
13606	2	38	0	12460	0	12500
13607	4	12220	0	10	0	12234
13608	1	12295	0	18	0	12314
13609	12787	0	25	0	0	12812
13610	12763	1	33	2	0	12799
13611	6	0	12929	0	0	12935
13612	12956	1	26	4	0	12987
13613	12754	3	34	1	0	12792
13614	12734	5	49	1	0	12789
13615	12424	0	58	4	0	12486
13616	5	0	12548	2	0	12555
13617	17	0	12770	2	0	12789
13618	12792	2	48	4	0	12846
13619	3	12839	1	17	0	12860
13620	33	1	12828	1	0	12863
13621	12808	1	26	2	0	12837
13622	12756	2	30	3	0	12791
13623	6	0	12665	0	0	12671
13624	12612	0	29	0	0	12641
13625	6	24	1	12498	0	12529
13626	10	1	11914	0	0	11925
13627	12130	2	25	3	0	12160
13628	3	12918	0	9	0	12930
13629	12795	0	28	0	0	12823
13630	13233	0	18	0	0	13251
13631	1	17	1	12706	0	12725
13632	3	12	0	12411	0	12426
13633	3	2	0	12156	0	12161
13634	12168	2	4	4	0	12178
13635	12134	0	10	0	0	12144
13636	5	11	0	12089	0	12105
13637	4	11	1	11632	0	11648
13638	14	0	11994	2	0	12010
13639	12204	0	18	2	0	12224
13640	2	27	0	13558	0	13587
13641	10	66	3	13395	0	13474
13642	1	13642	2	2	0	13647
13643	8	38	4	13532	0	13582
13644	3	15	1	13695	0	13714
13645	14202	0	20	0	0	14222
13646	2	14155	0	8	0	14165
13647	4	30	2	13295	0	13331
13648	3	41	1	13578	0	13623
13649	1	44	2	13438	0	13485
13650	4	0	14046	1	0	14051
13651	3	25	2	14847	0	14877
13652	14871	1	34	24	0	14930
13653	2	0	15287	2	0	15291
13654	6	31	0	15035	0	15072
13655	4	19	1	14993	0	15017
13656	15033	2	7	5	0	15047
13657	14843	3	37	12	0	14895
13658	13	1	15088	1	0	15103
13659	14022	1	40	5	0	14068
13660	9	0	14246	1	0	14256
13661	14469	3	46	4	0	14522
13662	1	14262	0	8	0	14271
13663	14064	2	36	3	0	14105
13664	2	14233	0	21	0	14256
13665	14267	1	28	5	0	14301
13666	7	14327	2	3	0	14339
13667	4	47	2	14040	0	14093
13668	3	43	1	14362	0	14409
13669	10	51	5	14300	0	14366
13670	0	14532	0	6	0	14538
13671	3	63	1	14270	0	14337
13672	1	14640	0	11	0	14652
13673	2	31	2	14195	0	14230
13674	14518	0	13	1	0	14532
13675	14470	1	36	3	0	14510
13676	1	14769	1	3	0	14774
13677	2	26	1	14338	0	14367
13678	14328	0	23	2	0	14353
13679	5	13909	0	21	0	13935
13680	7	13862	0	8	0	13877
13681	14415	0	35	4	0	14454
13682	14401	2	32	4	0	14439
13683	3	14307	0	5	0	14315
13684	14240	0	28	2	0	14270
13685	10	36	0	14138	0	14184
13686	3	7	14075	1	0	14086
13687	14057	1	48	5	0	14111
13688	14016	2	41	3	0	14062
13689	12	0	14141	1	0	14154
13690	14073	0	39	2	0	14114
13691	14203	0	47	1	0	14251
13692	13960	2	53	4	0	14019
13693	1	14216	0	18	0	14235
13694	14170	1	27	2	0	14200
13695	15111	0	20	1	0	15132
13696	1	11	0	14969	0	14981
13697	2	11	2	14980	0	14995
13698	1	9	0	15318	0	15328
13699	15479	0	8	2	0	15489
13700	1	9	1	15480	0	15491
13701	15622	0	7	0	0	15629
13702	15616	1	14	1	0	15632
13703	1	13	1	17119	0	17134
13704	2	22	0	16141	0	16165
13705	1	12	0	16637	0	16650
13706	16879	1	10	1	0	16891
13707	1	18609	0	0	0	18610
13708	1	36	0	19465	0	19502
13709	2	19	4	20208	0	20233
13710	20149	0	12	4	0	20165
13711	20056	3	50	1	0	20110
13712	11	0	20359	1	0	20371
13713	19	0	20432	5	0	20456
13714	20085	3	48	11	0	20147
13715	4	36	6	19642	0	19688
13716	10	33	2	18261	0	18306
13717	8	0	19372	0	0	19380
13718	8	77	2	19405	0	19492
13719	11	19426	0	6	0	19443
13720	4	19196	0	34	0	19234
13721	19005	3	73	8	0	19089
13722	11	0	19006	2	0	19019
13723	1	18435	1	16	0	18453
13724	1	66	3	18397	0	18467
13725	19	0	18543	4	0	18566
13726	6	52	1	18271	0	18330
13727	2	35	3	18352	0	18392
13728	26	9	18323	4	0	18362
13729	3	18187	0	14	0	18204
13730	5	36	1	18693	0	18735
13731	18854	1	33	0	0	18888
13732	19225	2	26	8	0	19261
13733	19378	4	72	3	0	19457
13734	0	19248	0	7	0	19255
13735	19371	3	41	2	0	19417
13736	4	54	2	19154	0	19214
13737	15	0	18977	1	0	18993
13738	19364	2	56	6	0	19428
13739	0	19047	0	12	0	19059
13740	1	59	4	18992	0	19056
13741	4	44	3	19144	0	19195
13742	1	19204	0	9	0	19214
13743	3	53	2	19150	0	19208
13744	5	41	1	19285	0	19332
13745	3	24	0	19307	0	19334
13746	19188	0	12	1	0	19201
13747	19125	1	39	1	0	19166
13748	8	0	19388	0	0	19396
13749	1	63	4	19344	0	19412
13750	2	31	3	19174	0	19210
13751	0	14	0	19284	0	19298
13752	19027	2	31	11	0	19071
13753	3	1	19374	2	0	19380
13754	20036	0	45	4	0	20085
13755	20080	1	65	2	0	20148
13756	1	7	3	20068	0	20079
13757	19440	1	37	2	0	19480
13758	3	1	19606	1	0	19611
13759	19479	2	67	2	0	19550
13760	1	19774	0	16	0	19791
13761	30	1	19480	4	0	19515
13762	12	0	20299	3	0	20314
13763	1	47	16	20138	0	20202
13764	6	0	20250	1	0	20257
13765	20576	2	75	6	0	20659
13766	3	20640	0	31	0	20674
13767	20459	4	63	4	0	20530
13768	5	32	3	20680	0	20720
13769	38	1	20358	2	0	20399
13770	8	1	21796	3	0	21808
13771	1	32	1	21102	0	21136
13772	21264	2	46	1	0	21313
13773	9	21166	1	17	0	21193
13774	9	20983	0	27	0	21019
13775	21864	4	49	10	0	21927
13776	4	22597	0	14	0	22615
13777	22430	2	60	1	0	22493
13778	4	48	0	22523	0	22575
13779	20861	1	27	3	0	20892
13780	6	33	0	22051	0	22090
13781	21826	3	21	8	0	21858
13782	2	54	5	21032	0	21093
13783	2	19560	1	9	0	19572
13784	18696	3	45	7	0	18751
13785	5	18791	1	14	0	18811
13786	29	1	18975	1	0	19006
13787	9	59	0	19094	0	19162
13788	2	18725	0	5	0	18732
13789	18614	0	42	7	0	18663
13790	18892	10	30	1	0	18933
13791	0	18839	0	11	0	18850
13792	14	0	19712	3	0	19729
13793	3	45	2	18565	0	18615
13794	1	19458	1	8	0	19468
13795	7	56	3	19456	0	19522
13796	3	38	1	19632	0	19674
13797	21235	2	43	1	0	21281
13798	2	22016	0	6	0	22024
13799	2	19	0	22069	0	22090
13800	22752	0	40	5	0	22797
13801	22133	3	35	3	0	22174
13802	22691	1	57	2	0	22751
13803	5	29	0	22699	0	22733
13804	22601	2	32	5	0	22640
13805	1	23482	0	18	0	23501
13806	22924	3	83	11	0	23021
13807	1	23255	0	2	0	23258
13808	22678	5	37	4	0	22724
13809	23398	1	85	3	0	23487
13810	4	34	2	23680	0	23720
13811	18	0	23568	1	0	23587
13812	30	2	23859	12	0	23903
13813	1	23943	1	21	0	23966
13814	23548	2	62	4	0	23616
13815	12	0	23731	4	0	23747
13816	24287	2	64	10	0	24363
13817	3	24237	0	17	0	24257
13818	6	23727	0	14	0	23747
13819	8	67	4	24224	0	24303
13820	1	25445	1	16	0	25463
13821	33	0	25667	2	0	25702
13822	1	70	0	25967	0	26038
13823	5	25576	0	8	0	25589
13824	11	35	1	25600	0	25647
13825	25671	1	35	4	0	25711
13826	3	53	3	25544	0	25603
13827	15	2	25938	3	0	25958
13828	3	26285	1	29	0	26318
13829	4	105	5	25575	0	25689
13830	2	35	5	25716	0	25758
13831	1	26	1	25867	0	25895
13832	25900	3	18	4	0	25925
13833	25790	1	38	7	0	25836
13834	23	0	25607	5	0	25635
13835	13	2	25680	5	0	25700
13836	3	25765	1	17	0	25786
13837	25229	2	51	1	0	25283
13838	3	55	5	24930	0	24993
13839	4	52	2	24802	0	24860
13840	3	26	1	24874	0	24904
13841	4	66	0	24611	0	24681
13842	11	0	24674	3	0	24688
13843	24532	1	58	10	0	24601
13844	4	52	3	24350	0	24409
13845	15	1	24374	6	0	24396
13846	22940	7	79	13	0	23039
13847	23775	3	99	4	0	23881
13848	32	0	23915	2	0	23949
13849	30	0	24165	4	0	24199
13850	1	31	3	24100	0	24135
13851	23607	0	31	2	0	23640
13852	22979	3	50	3	0	23035
13853	2	42	0	23351	0	23395
13854	11	47	2	23144	0	23204
13855	14	0	23032	3	0	23049
13856	12	70	1	22032	0	22115
13857	16	1	21934	2	0	21953
13858	22623	1	79	12	0	22715
13859	6	22397	0	17	0	22420
13860	22270	3	86	6	0	22365
13861	0	23210	0	31	0	23241
13862	22936	1	51	2	0	22990
13863	0	39	2	23335	0	23376
13864	6	27	1	23321	0	23355
13865	23406	1	21	10	0	23438
13866	23284	3	50	2	0	23339
13867	23846	2	42	1	0	23891
13868	22996	0	81	0	0	23077
13869	8	0	23175	0	0	23183
13870	22073	5	66	11	0	22155
13871	21983	1	48	4	0	22036
13872	22061	4	64	1	0	22130
13873	2	16	0	20950	0	20968
13874	20362	2	24	4	0	20392
13875	0	20206	0	7	0	20213
13876	3	37	4	20278	0	20322
13877	2	44	1	20267	0	20314
13878	19	0	20371	1	0	20391
13879	8	53	6	20765	0	20832
13880	3	21425	2	11	0	21441
13881	21573	6	56	6	0	21641
13882	0	21785	0	9	0	21794
13883	22550	2	52	6	0	22610
13884	2	28	1	23154	0	23185
13885	22234	5	35	6	0	22280
13886	3	23220	0	15	0	23238
13887	22677	4	48	6	0	22735
13888	22854	7	54	2	0	22917
13889	2	36	3	23113	0	23154
13890	5	36	3	23010	0	23054
13891	14	0	23154	0	0	23168
13892	4	53	2	23229	0	23288
13893	5	61	1	22974	0	23041
13894	15	0	23242	1	0	23258
13895	9	51	5	22321	0	22386
13896	14	1	21659	2	0	21676
13897	21721	8	69	6	0	21804
13898	8	54	2	21563	0	21627
13899	15	1	21732	2	0	21750
13900	21774	2	54	5	0	21835
13901	1	42	6	21967	0	22016
13902	26	1	22394	5	0	22426
13903	22281	4	52	2	0	22339
13904	4	32	2	21571	0	21609
13905	1	21	0	21409	0	21431
13906	21560	0	22	2	0	21584
13907	4	36	1	21555	0	21596
13908	1	33	2	21479	0	21515
13909	7	59	1	21367	0	21434
13910	8	21411	0	10	0	21429
13911	21321	3	34	1	0	21359
13912	21629	2	25	1	0	21657
13913	5	13	0	21615	0	21633
13914	22318	1	18	2	0	22339
13915	22326	1	19	5	0	22351
13916	22254	0	36	2	0	22292
13917	22225	2	57	8	0	22292
13918	22081	4	88	2	0	22175
13919	16	0	22360	3	0	22379
13920	17	0	22704	6	0	22727
13921	22448	1	57	1	0	22507
13922	1	21477	1	20	0	21499
13923	10	52	3	21157	0	21222
13924	17	0	22049	3	0	22069
13925	11	0	22634	4	0	22649
13926	5	24	0	22918	0	22947
13927	22643	0	34	4	0	22681
13928	2	41	2	22412	0	22457
13929	20	0	22045	2	0	22067
13930	23592	1	43	3	0	23639
13931	3	39	1	23494	0	23537
13932	5	39	4	23246	0	23294
13933	2	39	1	23036	0	23078
13934	5	59	1	22725	0	22790
13935	22	8	22990	2	0	23022
13936	3	35	1	23348	0	23387
13937	21805	1	33	0	0	21839
13938	9	0	21720	1	0	21730
13939	21546	1	39	8	0	21594
13940	22250	0	63	0	0	22313
13941	22178	3	54	4	0	22239
13942	22518	8	61	3	0	22590
13943	4	22707	0	27	0	22738
13944	6	22390	1	24	0	22421
13945	2	22615	1	10	0	22628
13946	22538	3	50	14	0	22605
13947	12	3	24217	1	0	24233
13948	25190	3	55	7	0	25255
13949	4	26	2	25484	0	25516
13950	26260	0	41	7	0	26308
13951	5	29	2	26537	0	26573
13952	25908	1	38	5	0	25952
13953	9	47	2	25813	0	25871
13954	0	26	1	24727	0	24754
13955	25011	2	37	2	0	25052
13956	1	23284	0	24	0	23309
13957	24	1	23152	4	0	23181
13958	2	22529	0	19	0	22550
13959	17	1	22814	1	0	22833
13960	2	21	1	22723	0	22747
13961	22655	2	28	1	0	22686
13962	2	28	1	21273	0	21304
13963	21390	1	28	3	0	21422
13964	1	21137	2	33	0	21173
13965	35	0	20925	3	0	20963
13966	11	21067	3	23	0	21104
13967	7	20851	0	26	0	20884
13968	21160	5	46	4	0	21215
13969	22169	2	43	2	0	22216
13970	0	22195	1	7	0	22203
13971	2	47	2	22200	0	22251
13972	1	26	2	22573	0	22602
13973	22533	4	34	9	0	22580
13974	20	2	22688	0	0	22710
13975	12	0	22737	6	0	22755
13976	5	47	1	22657	0	22710
13977	13	0	22193	8	0	22214
13978	22106	3	83	14	0	22206
13979	22463	0	87	1	0	22551
13980	3	22975	0	12	0	22990
13981	14	0	23265	1	0	23280
13982	2	66	3	23824	0	23895
13983	10	0	23773	1	0	23784
13984	6	39	0	24022	0	24067
13985	24107	1	44	7	0	24159
13986	2	24023	2	34	0	24061
13987	29	0	23938	3	0	23970
13988	14	25029	2	28	0	25073
13989	13	24379	0	15	0	24407
13990	24483	5	50	4	0	24542
13991	24454	2	43	6	0	24505
13992	15	0	24644	2	0	24661
13993	4	24648	0	24	0	24676
13994	7	94	7	24427	0	24535
13995	7	59	1	24658	0	24725
13996	8	53	2	24701	0	24764
13997	9	1	25877	2	0	25889
13998	5	50	4	26424	0	26483
13999	8	9	4	26368	0	26389
14000	25543	0	41	2	0	25586
14001	24717	3	40	6	0	24766
14002	25011	0	55	1	0	25067
14003	25154	1	51	2	0	25208
14004	25083	26	114	2	0	25225
14005	1	24917	1	12	0	24931
14006	23694	3	87	5	0	23789
14007	23	1	24695	5	0	24724
14008	4	30	2	25840	0	25876
14009	25995	5	60	3	0	26063
14010	4	26001	0	11	0	26016
14011	25672	1	60	6	0	25739
14012	26666	0	69	5	0	26740
14013	7	68	4	26551	0	26630
14014	13	67	2	26251	0	26333
14015	1	26239	1	6	0	26247
14016	9	63	2	25465	0	25539
14017	16	8	25697	3	0	25724
14018	7	49	3	26337	0	26396
14019	16	1	26189	3	0	26209
14020	26804	1	81	10	0	26896
14021	10	61	3	25795	0	25869
14022	37	2	25825	5	0	25869
14023	7	24251	2	35	0	24295
14024	3	23665	1	18	0	23687
14025	23969	5	63	5	0	24042
14026	3	44	3	23245	0	23295
14027	23	0	22810	7	0	22840
14028	3	22899	4	9	0	22915
14029	24	0	22917	1	0	22942
14030	22921	7	65	6	0	22999
14031	22585	2	32	3	0	22622
14032	22697	4	93	1	0	22795
14033	0	33	2	22907	0	22942
14034	21	1	22511	0	0	22533
14035	3	22953	1	25	0	22982
14036	10	45	3	22623	0	22681
14037	21	0	23059	4	0	23084
14038	20	0	23352	5	0	23377
14039	7	38	2	24037	0	24084
14040	23894	1	22	5	0	23922
14041	6	37	6	23682	0	23731
14042	2	45	3	23399	0	23449
14043	25	0	23925	3	0	23953
14044	9	39	1	23925	0	23974
14045	13	41	2	22996	0	23052
14046	9	0	22557	4	0	22570
14047	20	1	22774	4	0	22799
14048	8	73	1	23091	0	23173
14049	30	1	23340	1	0	23372
14050	2	32	0	23308	0	23342
14051	23457	1	43	1	0	23502
14052	2	23240	0	13	0	23255
14053	9	57	1	23687	0	23754
14054	12	0	24219	8	0	24239
14055	25627	1	47	16	0	25691
14056	1	25148	0	6	0	25155
14057	24838	0	59	6	0	24903
14058	3	61	5	24535	0	24604
14059	2	27	0	24621	0	24650
14060	24699	2	47	3	0	24751
14061	18	1	24777	1	0	24797
14062	24797	3	60	8	0	24868
14063	3	34	0	24243	0	24280
14064	23377	0	32	2	0	23411
14065	23782	1	41	3	0	23827
14066	5	50	5	23627	0	23687
14067	6	24206	0	9	0	24221
14068	24066	2	43	7	0	24118
14069	23670	1	68	3	0	23742
14070	5	0	23750	0	0	23755
14071	24230	0	76	3	0	24309
14072	4	53	2	24739	0	24798
14073	5	23919	0	11	0	23935
14074	16	67	1	23294	0	23378
14075	3	23874	2	17	0	23896
14076	23996	4	55	5	0	24060
14077	24605	3	68	4	0	24680
14078	4	27	8	24516	0	24555
14079	34	0	24495	2	0	24531
14080	9	0	24633	11	0	24653
14081	7	42	3	24986	0	25038
14082	24900	0	44	4	0	24948
14083	24074	0	48	6	0	24128
14084	0	24014	0	21	0	24035
14085	10	47	3	24190	0	24250
14086	16	0	24192	0	0	24208
14087	21	0	24376	5	0	24402
14088	6	33	1	23540	0	23580
14089	23428	2	31	5	0	23466
14090	3	43	6	23574	0	23626
14091	15	1	22964	1	0	22981
14092	24282	2	57	8	0	24349
14093	3	57	6	23521	0	23587
14094	4	71	1	23358	0	23434
14095	10	32	9	23054	0	23105
14096	2	22913	1	9	0	22925
14097	28	1	22862	6	0	22897
14098	9	1	24130	5	0	24145
14099	3	40	1	24445	0	24489
14100	18	0	24413	4	0	24435
14101	24738	7	49	2	0	24796
14102	6	73	1	26887	0	26967
14103	5	53	1	27488	0	27547
14104	16	52	1	27505	0	27574
14105	0	27721	1	12	0	27734
14106	27868	0	61	9	0	27938
14107	8	42	1	28112	0	28163
14108	28924	3	39	7	0	28973
14109	2	28618	0	17	0	28637
14110	27692	2	68	2	0	27764
14111	27759	0	63	6	0	27828
14112	27660	10	62	0	0	27732
14113	1	27346	0	19	0	27366
14114	3	26715	1	22	0	26741
14115	26695	4	68	0	0	26767
14116	0	26500	0	29	0	26529
14117	36	2	26439	1	0	26478
14118	13	25709	2	18	0	25742
14119	1	25639	0	58	0	25698
14120	25725	2	60	14	0	25801
14121	16	0	25883	12	0	25911
14122	21	0	27667	6	0	27694
14123	4	46	2	27590	0	27642
14124	26954	3	31	5	0	26993
14125	28	1	26602	3	0	26634
14126	16	46	3	26627	0	26692
14127	32	0	26310	2	0	26344
14128	7	0	26696	3	0	26706
14129	25286	1	58	8	0	25353
14130	12	0	24890	3	0	24905
14131	0	61	3	23352	0	23416
14132	9	68	1	23125	0	23203
14133	11	23316	1	7	0	23335
14134	2	23818	0	10	0	23830
14135	12	59	1	23720	0	23792
14136	11	2	24189	1	0	24203
14137	2	71	2	24042	0	24117
14138	4	77	5	24429	0	24515
14139	18	1	24585	1	0	24605
14140	6	43	1	25420	0	25470
14141	24711	2	40	3	0	24756
14142	8	0	24887	4	0	24899
14143	24158	2	42	4	0	24206
14144	4	48	5	24449	0	24506
14145	5	51	1	23720	0	23777
14146	1	23694	0	5	0	23700
14147	9	34	2	23907	0	23952
14148	1	22	1	23951	0	23975
14149	24408	1	18	2	0	24429
14150	9	33	1	24748	0	24791
14151	1	29	0	25061	0	25091
14152	25346	4	26	3	0	25379
14153	5	62	2	24602	0	24671
14154	12	65	1	24545	0	24623
14155	5	24618	2	9	0	24634
14156	23303	3	38	1	0	23345
14157	5	39	1	23672	0	23717
14158	1	38	0	23582	0	23621
14159	10	1	24588	0	0	24599
14160	6	63	1	24276	0	24346
14161	3	29	0	25984	0	26016
14162	25607	0	30	3	0	25640
14163	25565	3	42	3	0	25613
14164	5	39	0	26270	0	26314
14165	24	1	26455	0	0	26480
14166	10	26411	0	14	0	26435
14167	3	26874	2	9	0	26888
14168	6	33	5	25681	0	25725
14169	28435	3	40	2	0	28480
14170	2	43	4	28946	0	28995
14171	29241	0	29	0	0	29270
14172	4	65	0	29105	0	29174
14173	3	23	11	27694	0	27731
14174	27648	1	33	3	0	27685
14175	27836	3	63	4	0	27906
14176	5	27834	0	15	0	27854
14177	2	27557	0	17	0	27576
14178	6	62	1	25332	0	25401
14179	1	61	2	24573	0	24637
14180	37	0	24599	5	0	24641
14181	24650	1	71	7	0	24729
14182	7	24901	1	21	0	24930
14183	5	24716	0	30	0	24751
14184	23797	4	40	12	0	23853
14185	13	0	24122	6	0	24141
14186	21	0	24196	14	0	24231
14187	27	0	24682	4	0	24713
14188	3	24826	0	9	0	24838
14189	2	62	1	24600	0	24665
14190	5	48	1	24647	0	24701
14191	3	24	1	24732	0	24760
14192	24734	2	21	1	0	24758
14193	24767	1	46	4	0	24818
14194	1	24796	0	15	0	24812
14195	7	57	4	23408	0	23476
14196	19	1	23310	6	0	23336
14197	5	23019	1	25	0	23050
14198	22918	4	57	3	0	22982
14199	11	0	22969	2	0	22982
14200	23098	3	55	5	0	23161
14201	5	0	23685	5	0	23695
14202	3	66	4	24170	0	24243
14203	3	24019	1	15	0	24038
14204	24229	1	52	11	0	24293
14205	1	24347	0	24	0	24372
14206	24438	1	65	8	0	24512
14207	1	55	3	25042	0	25101
14208	33	0	24790	2	0	24825
14209	2	49	2	25736	0	25789
14210	4	64	3	24609	0	24680
14211	20	1	24635	6	0	24662
14212	24304	2	54	5	0	24365
14213	3	24256	0	11	0	24270
14214	23711	0	66	6	0	23783
14215	1	23495	2	19	0	23517
14216	6	43	5	23510	0	23564
14217	20	2	24160	7	0	24189
14218	24430	8	60	10	0	24508
14219	3	24241	0	9	0	24253
14220	13	69	3	24216	0	24301
14221	7	36	1	24475	0	24519
14222	24200	5	33	2	0	24240
14223	23887	5	56	5	0	23953
14224	5	24101	1	9	0	24116
14225	23606	2	30	3	0	23641
14226	22871	2	49	3	0	22925
14227	22023	2	70	3	0	22098
14228	14	1	22551	1	0	22567
14229	4	23433	6	16	0	23459
14230	4	23296	0	9	0	23309
14231	7	51	9	23271	0	23338
14232	2	28	2	23441	0	23473
14233	23321	0	43	6	0	23370
14234	0	22730	0	17	0	22747
14235	22582	2	56	1	0	22641
14236	2	58	1	22562	0	22623
14237	5	16	2	20378	0	20401
14238	20514	3	26	1	0	20544
14239	20272	2	57	4	0	20335
14240	15	0	19894	2	0	19911
14241	2	38	3	19500	0	19543
14242	12	1	19085	2	0	19100
14243	10	4	18730	4	0	18748
14244	21	0	18851	2	0	18874
14245	16259	1	41	5	0	16306
14246	0	40	5	16365	0	16410
14247	2	22	2	16269	0	16295
14248	2	26	2	16467	0	16497
14249	20	0	16675	2	0	16697
14250	2	32	2	16620	0	16656
14251	4	16	0	16217	0	16237
14252	15971	0	25	3	0	15999
14253	16050	2	33	10	0	16095
14254	16100	0	20	3	0	16123
14255	16174	0	37	1	0	16212
14256	13	19	0	15953	0	15985
14257	16035	2	20	2	0	16059
14258	3	39	5	15534	0	15581
14259	7	0	15501	2	0	15510
14260	15594	2	47	3	0	15646
14261	1	15190	0	8	0	15199
14262	4	43	1	14614	0	14662
14263	9	36	3	14817	0	14865
14264	7	14894	0	7	0	14908
14265	15095	1	46	2	0	15144
14266	2	15416	0	11	0	15429
14267	26	0	15308	0	0	15334
14268	2	1	15563	3	0	15569
14269	15407	2	26	10	0	15445
14270	14805	1	50	4	0	14860
14271	0	0	14872	1	0	14873
14272	14262	1	37	2	0	14302
14273	8	1	14410	0	0	14419
14274	14010	1	49	3	0	14063
14275	13	0	14195	1	0	14209
14276	13	0	14410	10	0	14433
14277	1	36	2	13401	0	13440
14278	3	14	0	13484	0	13501
14279	13416	0	11	0	0	13427
14280	13318	3	29	2	0	13352
14281	13072	0	25	2	0	13099
14282	13079	2	33	0	0	13114
14283	0	12783	0	2	0	12785
14284	5	39	2	11806	0	11852
14285	2	11886	0	11	0	11899
14286	1	41	3	11784	0	11829
14287	1	29	3	11801	0	11834
14288	1	18	1	11772	0	11792
14289	10	0	11668	5	0	11683
14290	11884	2	29	1	0	11916
14291	3	13091	1	7	0	13102
14292	0	11389	0	11	0	11400
14293	7	0	11325	0	0	11332
14294	0	23	0	11115	0	11138
14295	1	15	0	11091	0	11107
14296	11816	0	5	3	0	11824
14297	1	7	0	11620	0	11628
14298	1	21	0	11505	0	11527
14299	2	8	0	11501	0	11511
14300	34	3	0	11258	0	11295
14301	11803	0	3	1	0	11807
14302	11780	0	13	0	0	11793
14303	11842	1	7	2	0	11852
14304	0	6	1	11232	0	11239
14305	10238	2	8	0	0	10248
14306	2	14	0	10105	0	10121
14307	1	13	1	10149	0	10164
14308	12	1	10023	3	0	10039
14309	11	0	10383	3	0	10397
14310	8	0	10177	6	0	10191
14311	10147	0	12	0	0	10159
14312	4	31	1	10032	0	10068
14313	0	10285	0	9	0	10294
14314	10287	0	31	2	0	10320
14315	6	1	10469	1	0	10477
14316	10865	1	25	8	0	10899
14317	1	10919	1	8	0	10929
14318	10507	2	21	5	0	10535
14319	3	8	0	10464	0	10475
14320	11066	0	16	2	0	11084
14321	2	11061	2	13	0	11078
14322	0	11290	0	12	0	11302
14323	11246	1	26	9	0	11282
14324	1	11286	1	14	0	11302
14325	3	11485	0	8	0	11496
14326	0	11513	0	15	0	11528
14327	11693	4	8	2	0	11707
14328	11629	2	20	1	0	11652
14329	11452	1	17	2	0	11472
14330	0	29	3	11503	0	11535
14331	1	23	2	11545	0	11571
14332	9	1	12068	0	0	12078
14333	2	38	5	12051	0	12096
14334	13	1	12031	1	0	12046
14335	3	34	1	12068	0	12106
14336	1	25	1	11933	0	11960
14337	11805	0	13	3	0	11821
14338	11822	2	26	3	0	11853
14339	2	11764	0	2	0	11768
14340	1	26	1	11643	0	11671
14341	2	0	11756	2	0	11760
14342	1	28	2	11376	0	11407
14343	2	17	1	11474	0	11494
14344	1	27	1	11232	0	11261
14345	10	0	11236	1	0	11247
14346	6	0	11232	3	0	11241
14347	11551	0	23	1	0	11575
14348	3	39	1	11374	0	11417
14349	13	0	11410	1	0	11424
14350	11328	0	29	4	0	11361
14351	1	11226	0	8	0	11235
14352	11069	2	31	6	0	11108
14353	20	5	11256	0	0	11281
14354	11382	3	32	3	0	11420
14355	1	22	0	11491	0	11514
14356	12	1	11580	1	0	11594
14357	1	11895	2	12	0	11910
14358	12618	0	27	1	0	12646
14359	1	45	2	12416	0	12464
14360	3	30	3	12189	0	12225
14361	4	12219	0	7	0	12230
14362	7	60	2	12070	0	12139
14363	12	0	12277	0	0	12289
14364	1	12436	1	9	0	12447
14365	12294	0	9	0	0	12303
14366	1	41	2	12200	0	12244
14367	4	20	1	10986	0	11011
14368	18	0	11500	2	0	11520
14369	2	33	3	11644	0	11682
14370	23	1	11555	1	0	11580
14371	2	11123	0	10	0	11135
14372	10974	1	21	5	0	11001
14373	10880	1	35	1	0	10917
14374	11037	8	20	0	0	11065
14375	0	11480	0	5	0	11485
14376	0	39	4	11410	0	11453
14377	1	12	0	10967	0	10980
14378	2	9	0	10960	0	10971
14379	10934	0	14	4	0	10952
14380	10902	0	10	1	0	10913
14381	1	11	1	10908	0	10921
14382	6	0	11266	1	0	11273
14383	1	25	0	11445	0	11471
14384	1	7	1	11144	0	11153
14385	1	24	0	10894	0	10919
14386	0	7	0	10909	0	10916
14387	11548	0	5	1	0	11554
14388	1	26	0	11738	0	11765
14389	2	26	0	12031	0	12059
14390	1	12010	0	6	0	12017
14391	7	32	1	11509	0	11549
14392	2	12113	1	4	0	12120
14393	1	24	2	12107	0	12134
14394	12375	2	26	10	0	12413
14395	3	12333	0	12	0	12348
14396	11715	2	25	0	0	11742
14397	21	0	11881	3	0	11905
14398	1	19	0	11363	0	11383
14399	7	0	11541	1	0	11549
14400	5	30	0	11243	0	11278
14401	7	32	1	10933	0	10973
14402	2	10960	1	11	0	10974
14403	3	10954	0	8	0	10965
14404	0	10956	0	10	0	10966
14405	11187	1	23	2	0	11213
14406	2	11363	0	5	0	11370
14407	0	10784	0	8	0	10792
14408	0	28	1	10645	0	10674
14409	10638	0	16	3	0	10657
14410	2	10848	0	14	0	10864
14411	10811	0	9	1	0	10821
14412	10709	4	25	2	0	10740
14413	8	0	11061	0	0	11069
14414	1	37	3	11369	0	11410
14415	0	27	2	11155	0	11184
14416	2	24	4	11230	0	11260
14417	2	19	3	11103	0	11127
14418	17	1	10947	6	0	10971
14419	14	0	10930	5	0	10949
14420	11329	0	37	2	0	11368
14421	4	11435	0	17	0	11456
14422	2	11430	0	7	0	11439
14423	11505	1	26	3	0	11535
14424	2	11604	1	4	0	11611
14425	1	25	2	11643	0	11671
14426	11655	2	20	0	0	11677
14427	7	8	11507	1	0	11523
14428	1	27	2	11944	0	11974
14429	6	0	11821	2	0	11829
14430	11832	2	45	4	0	11883
14431	5	0	12096	0	0	12101
14432	12217	3	21	3	0	12244
14433	12380	0	10	4	0	12394
14434	11699	2	32	3	0	11736
14435	11695	1	11	0	0	11707
14436	11741	1	17	1	0	11760
14437	1	10	1	12058	0	12070
14438	12065	1	5	0	0	12071
14439	2	18	2	11896	0	11918
14440	1	18	0	11758	0	11777
14441	3	12	0	11852	0	11867
14442	5	0	11963	0	0	11968
14443	4	31	2	11935	0	11972
14444	1	29	0	11633	0	11663
14445	9	0	11639	0	0	11648
14446	11650	0	38	2	0	11690
14447	3	18	1	11720	0	11742
14448	14	0	11658	2	0	11674
14449	13	0	11852	7	0	11872
14450	1	31	4	12335	0	12371
14451	5	1	11987	5	0	11998
14452	2	40	1	12202	0	12245
14453	2	27	1	12235	0	12265
14454	7	12353	0	11	0	12371
14455	2	12464	0	9	0	12475
14456	12490	1	22	1	0	12514
14457	0	35	2	12419	0	12456
14458	3	23	2	11908	0	11936
14459	5	27	0	11936	0	11968
14460	20	0	11842	2	0	11864
14461	4	18	0	13482	0	13504
14462	13397	2	24	0	0	13423
14463	8	0	12879	1	0	12888
14464	5	44	2	12604	0	12655
14465	2	20	0	12030	0	12052
14466	2	30	1	11874	0	11907
14467	3	11469	0	6	0	11478
14468	11527	0	26	1	0	11554
14469	11713	1	23	0	0	11737
14470	0	11301	0	7	0	11308
14471	0	22	2	11234	0	11258
14472	8	0	11345	0	0	11353
14473	8	0	11697	5	0	11710
14474	11717	0	28	1	0	11746
14475	3	18	1	11508	0	11530
14476	11429	1	28	1	0	11459
14477	3	11523	1	8	0	11535
14478	0	11340	0	11	0	11351
14479	11627	3	20	2	0	11652
14480	1	11587	0	5	0	11593
14481	7	38	2	11577	0	11624
14482	5	22	7	11744	0	11778
14483	1	11703	0	5	0	11709
14484	11663	0	32	3	0	11698
14485	2	0	11699	1	0	11702
14486	11505	1	38	4	0	11548
14487	5	1	11811	0	0	11817
14488	11464	5	47	3	0	11519
14489	10	0	11427	3	0	11440
14490	2	11830	0	5	0	11837
14491	1	22	1	11829	0	11853
14492	11852	2	27	2	0	11883
14493	5	0	11890	2	0	11897
14494	17	0	12324	2	0	12343
14495	1	35	0	12256	0	12292
14496	11	0	12103	2	0	12116
14497	5	34	4	12364	0	12407
14498	12	33	2	12033	0	12080
14499	22	2	12572	0	0	12596
14500	3	25	2	12410	0	12440
14501	12511	1	28	1	0	12541
14502	0	12663	0	7	0	12670
14503	12030	1	27	2	0	12060
14504	1	15	1	12183	0	12200
14505	12038	1	12	0	0	12051
14506	12135	1	23	2	0	12161
14507	2	21	0	12344	0	12367
14508	2	12041	0	8	0	12051
14509	11558	2	19	1	0	11580
14510	12	1	11610	2	0	11625
14511	8	0	11724	1	0	11733
14512	11758	1	24	1	0	11784
14513	1	24	1	11487	0	11513
14514	10	0	11564	0	0	11574
14515	1	17	0	11596	0	11614
14516	11608	0	16	1	0	11625
14517	11769	5	39	3	0	11816
14518	11882	6	31	1	0	11920
14519	0	12596	0	4	0	12600
14520	4	37	3	12258	0	12302
14521	0	12	1	12298	0	12311
14522	12343	1	26	2	0	12372
14523	1	12398	0	8	0	12407
14524	12381	3	33	2	0	12419
14525	1	20	0	12348	0	12369
14526	11755	0	17	1	0	11773
14527	9	0	12985	1	0	12995
14528	0	12662	0	7	0	12669
14529	2	35	1	12767	0	12805
14530	4	12961	0	17	0	12982
14531	5	22	2	13052	0	13081
14532	13146	2	21	1	0	13170
14533	4	0	13167	0	0	13171
14534	13290	2	38	4	0	13334
14535	3	13350	0	5	0	13358
14536	5	28	1	11591	0	11625
14537	0	10	0	11707	0	11717
14538	11603	1	25	0	0	11629
14539	4	8	11937	0	0	11949
14540	2	30	8	12266	0	12306
14541	2	29	2	12058	0	12091
14542	0	24	0	12223	0	12247
14543	2	11	0	12277	0	12290
14544	12307	0	4	2	0	12313
14545	12097	2	31	2	0	12132
14546	9	2	12190	1	0	12202
14547	6	0	12475	3	0	12484
14548	11999	0	31	8	0	12038
14549	12150	1	27	0	0	12178
14550	2	10	1	12390	0	12403
14551	0	9	0	12388	0	12397
14552	12514	1	15	1	0	12531
14553	0	12337	0	9	0	12346
14554	4	34	0	12450	0	12488
14555	2	24	1	12728	0	12755
14556	16	0	12717	2	0	12735
14557	3	18	0	12910	0	12931
14558	12	0	12946	0	0	12958
14559	2	18	0	12956	0	12976
14560	12920	1	41	1	0	12963
14561	1	14	1	12915	0	12931
14562	7	0	12747	4	0	12758
14563	4	12703	1	10	0	12718
14564	0	22	2	12371	0	12395
14565	11	0	12377	1	0	12389
14566	0	12518	0	9	0	12527
14567	1	21	0	12463	0	12485
14568	11	1	12472	1	0	12485
14569	12649	1	33	10	0	12693
14570	3	12392	1	30	0	12426
14571	5	12139	1	12	0	12157
14572	0	11578	0	3	0	11581
14573	2	31	1	12020	0	12054
14574	15	0	12714	1	0	12730
14575	3	13165	0	7	0	13175
14576	2	22	0	13159	0	13183
14577	13301	2	29	4	0	13336
14578	2	29	0	13183	0	13214
14579	5	1	13099	3	0	13108
14580	0	12969	0	6	0	12975
14581	12843	0	40	5	0	12888
14582	0	12770	0	14	0	12784
14583	18	0	12347	4	0	12369
14584	0	12166	1	9	0	12176
14585	0	18	3	12155	0	12176
14586	6	1	12575	5	0	12587
14587	2	12516	0	6	0	12524
14588	2	33	0	12500	0	12535
14589	4	33	1	12514	0	12552
14590	1	12348	1	12	0	12362
14591	1	18	0	12314	0	12333
14592	16	0	12417	2	0	12435
14593	11	1	12390	1	0	12403
14594	2	17	2	12347	0	12368
14595	11544	0	27	1	0	11572
14596	11791	1	24	1	0	11817
14597	2	25	0	12032	0	12059
14598	0	12187	0	27	0	12214
14599	4	12	2	12140	0	12158
14600	12292	1	9	0	0	12302
14601	2	15	0	12228	0	12245
14602	0	13	3	12255	0	12271
14603	10949	2	14	1	0	10966
14604	0	10982	1	5	0	10988
14605	0	22	0	10646	0	10668
14606	10617	2	26	2	0	10647
14607	2	0	10830	1	0	10833
14608	10958	1	13	0	0	10972
14609	1	9	0	10980	0	10990
14610	10817	1	10	0	0	10828
14611	10841	0	20	0	0	10861
14612	10916	4	26	1	0	10947
14613	0	10930	0	7	0	10937
14614	6	1	10887	2	0	10896
14615	2	10648	0	17	0	10667
14616	10397	1	14	0	0	10412
14617	1	10497	0	10	0	10508
14618	1	13	0	10354	0	10368
14619	10414	0	20	5	0	10439
14620	2	10382	0	15	0	10399
14621	6	1	10450	1	0	10458
14622	2	22	0	10289	0	10313
14623	6	1	9980	6	0	9993
14624	0	10083	1	35	0	10119
14625	1	40	1	10015	0	10057
14626	1	29	2	10297	0	10329
14627	1	33	2	10917	0	10953
14628	4	13	1	10889	0	10907
14629	1	10771	0	6	0	10778
14630	10557	3	19	8	0	10587
14631	6	0	10339	3	0	10348
14632	5	11	0	10251	0	10267
14633	9884	2	29	0	0	9915
14634	1	0	9720	0	0	9721
14635	0	9761	2	9	0	9772
14636	1	23	1	9764	0	9789
14637	9	0	9830	2	0	9841
14638	0	9472	0	14	0	9486
14639	9515	1	23	5	0	9544
14640	0	9852	0	4	0	9856
14641	1	23	0	9590	0	9614
14642	2	11	0	10368	0	10381
14643	10393	2	14	2	0	10411
14644	0	11500	0	8	0	11508
14645	1	15	0	11496	0	11512
14646	11334	1	21	0	0	11356
14647	11333	2	29	0	0	11364
14648	2	11365	0	3	0	11370
14649	10749	1	25	5	0	10780
14650	10254	0	20	1	0	10275
14651	1	13	0	9803	0	9817
14652	7	0	9855	4	0	9866
14653	2	25	0	9690	0	9717
14654	2	20	2	9609	0	9633
14655	13	0	9541	1	0	9555
14656	1	9961	0	8	0	9970
14657	0	63	0	9865	0	9928
14658	0	20	1	9951	0	9972
14659	1	18	0	9944	0	9963
14660	2	21	1	9952	0	9976
14661	0	9474	0	1	0	9475
14662	9486	0	23	1	0	9510
14663	9500	1	20	0	0	9521
14664	9459	2	30	3	0	9494
14665	0	9387	0	6	0	9393
14666	1	15	2	9305	0	9323
14667	11	0	9460	2	0	9473
14668	5	16	1	9547	0	9569
14669	3	9485	0	6	0	9494
14670	9587	1	24	5	0	9617
14671	9619	0	27	2	0	9648
14672	9371	1	23	0	0	9395
14673	2	8952	3	10	0	8967
14674	2	8855	1	10	0	8868
14675	1	8791	1	13	0	8806
14676	5	1	8682	0	0	8688
14677	2	1	8635	1	0	8639
14678	2	6	1	8639	0	8648
14679	8857	1	4	0	0	8862
14680	8809	0	2	2	0	8813
14681	1	16	0	8881	0	8898
14682	0	23	1	8591	0	8615
14683	4	14	4	8373	0	8395
14684	2	7	1	8255	0	8265
14685	8198	0	4	3	0	8205
14686	8211	1	17	3	0	8232
14687	1	8285	0	9	0	8295
14688	8254	0	12	0	0	8266
14689	8347	0	4	0	0	8351
14690	8223	1	29	0	0	8253
14691	4	0	8184	0	0	8188
14692	8193	0	22	3	0	8218
14693	0	8550	0	2	0	8552
14694	0	37	1	8799	0	8837
14695	4	17	1	8918	0	8940
14696	3	8858	1	4	0	8866
14697	1	10	1	8924	0	8936
14698	8932	0	12	1	0	8945
14699	1	25	1	9163	0	9190
14700	7	0	8876	0	0	8883
14701	8969	0	20	3	0	8992
14702	1	8721	0	4	0	8726
14703	0	25	1	8027	0	8053
14704	2	15	0	9247	0	9264
14705	4	9	1	9210	0	9224
14706	7	2	9212	0	0	9221
14707	1	9211	1	16	0	9229
14708	3	17	0	9225	0	9245
14709	10	0	9352	1	0	9363
14710	4	20	5	9293	0	9322
14711	7	0	10355	1	0	10363
14712	2	20	0	10422	0	10444
14713	1	10328	0	2	0	10331
14714	3	15	0	10390	0	10408
14715	10388	0	7	0	0	10395
14716	10009	1	14	6	0	10030
14717	1	1	10083	3	0	10088
14718	7	0	9525	1	0	9533
14719	8	0	9533	2	0	9543
14720	3	30	3	8132	0	8168
14721	0	25	1	8097	0	8123
14722	4	15	0	8277	0	8296
14723	1	8284	1	3	0	8289
14724	0	22	0	8294	0	8316
14725	1	12	0	8387	0	8400
14726	0	5	0	8431	0	8436
14727	8553	1	15	0	0	8569
14728	8528	1	15	2	0	8546
14729	3	0	8563	2	0	8568
14730	4	0	8670	4	0	8678
14731	8516	1	22	2	0	8541
14732	8238	1	31	2	0	8272
14733	8	0	8190	1	0	8199
14734	3	0	8395	2	0	8400
14735	8672	0	19	2	0	8693
14736	8608	1	17	0	0	8626
14737	7	0	8681	0	0	8688
14738	1	33	2	8738	0	8774
14739	2	18	0	8676	0	8696
14740	0	8619	1	6	0	8626
14741	4	17	2	8853	0	8876
14742	2	0	8886	0	0	8888
14743	1	17	2	9215	0	9235
14744	4	13	1	9136	0	9154
14745	4	0	9223	6	0	9233
14746	9303	0	18	3	0	9324
14747	9416	0	19	0	0	9435
14748	5	15	1	9418	0	9439
14749	1	7	0	9730	0	9738
14750	9772	0	6	4	0	9782
14751	10123	2	19	1	0	10145
14752	10150	1	21	2	0	10174
14753	10274	4	26	1	0	10305
14754	0	10358	0	7	0	10365
14755	10194	1	29	0	0	10224
14756	1	10344	0	10	0	10355
14757	0	20	0	10410	0	10430
14758	4	28	0	10406	0	10438
14759	0	10629	0	3	0	10632
14760	2	27	1	10607	0	10637
14761	5	11	0	11378	0	11394
14762	3	11542	0	3	0	11548
14763	6	41	2	11349	0	11398
14764	5	27	0	11531	0	11563
14765	3	20	1	11390	0	11414
14766	8	0	12167	2	0	12177
14767	1	12112	0	11	0	12124
14768	3	29	1	11971	0	12004
14769	2	12147	0	9	0	12158
14770	11942	3	26	3	0	11974
14771	8	0	13750	1	0	13759
14772	17	1	13770	0	0	13788
14773	13958	0	34	3	0	13995
14774	4	20	8	14986	0	15018
14775	21	0	14942	0	0	14963
14776	18	0	15611	7	0	15636
14777	4	14	4	16029	0	16051
14778	15996	1	23	2	0	16022
14779	16254	3	29	4	0	16290
14780	1	31	0	15040	0	15072
14781	15	3	15149	0	0	15167
14782	0	15269	1	4	0	15274
14783	2	19	1	15026	0	15048
14784	30	0	15249	3	0	15282
14785	2	14199	1	12	0	14214
14786	1	22	3	14235	0	14261
14787	14467	0	18	2	0	14487
14788	2	19	1	14363	0	14385
14789	1	14481	0	7	0	14489
14790	14354	1	36	1	0	14392
14791	6	2	14425	0	0	14433
14792	4	14364	0	28	0	14396
14793	14	0	14450	0	0	14464
14794	14946	3	30	4	0	14983
14795	0	29	3	15064	0	15096
14796	4	12	2	15263	0	15281
14797	15289	1	11	1	0	15302
14798	7	25	3	15407	0	15442
14799	8	0	15413	1	0	15422
14800	15396	4	47	11	0	15458
14801	3	16081	0	7	0	16091
14802	4	19	1	15970	0	15994
14803	15853	1	26	3	0	15883
14804	2	15907	0	8	0	15917
14805	1	18	2	15839	0	15860
14806	16112	0	16	2	0	16130
14807	6	38	2	16212	0	16258
14808	5	16718	0	12	0	16735
14809	13	1	17134	3	0	17151
14810	2	28	2	17031	0	17063
14811	2	12	0	17012	0	17026
14812	17128	1	33	2	0	17164
14813	0	19	2	17101	0	17122
14814	17126	0	24	0	0	17150
14815	17197	1	41	1	0	17240
14816	0	42	5	17633	0	17680
14817	1	17898	1	4	0	17904
14818	3	34	2	17923	0	17962
14819	18088	0	24	2	0	18114
14820	13	17835	1	18	0	17867
14821	6	17735	0	15	0	17756
14822	18047	4	30	3	0	18084
14823	18121	0	37	9	0	18167
14824	1	18328	1	5	0	18335
14825	17885	1	31	4	0	17921
14826	18028	2	49	3	0	18082
14827	6	44	3	17669	0	17722
14828	17	0	18400	1	0	18418
14829	4	29	3	18399	0	18435
14830	15	0	18385	2	0	18402
14831	4	36	15	18388	0	18443
14832	17	0	18276	3	0	18296
14833	19923	1	37	11	0	19972
14834	3	29	2	20149	0	20183
14835	19859	3	30	8	0	19900
14836	4	50	2	19802	0	19858
14837	1	19006	0	12	0	19019
14838	18843	3	55	5	0	18906
14839	17	1	19121	5	0	19144
14840	19256	1	51	8	0	19316
14841	6	18847	0	4	0	18857
14842	18309	0	52	5	0	18366
14843	18603	3	41	2	0	18649
14844	1	18936	0	14	0	18951
14845	7	37	0	18964	0	19008
14846	19141	2	23	2	0	19168
14847	0	17478	0	17	0	17495
14848	4	19	1	17255	0	17279
14849	17291	1	20	4	0	17316
14850	3	34	2	16265	0	16304
14851	3	28	2	16163	0	16196
14852	5	39	4	15550	0	15598
14853	8	1	15180	3	0	15192
14854	2	23	3	15284	0	15312
14855	14947	1	24	1	0	14973
14856	10	2	15059	1	0	15072
14857	2	31	0	15100	0	15133
14858	1	12	1	14954	0	14968
14859	7	0	14904	4	0	14915
14860	14482	1	36	5	0	14524
14861	14485	5	38	0	0	14528
14862	12	0	14636	0	0	14648
14863	2	38	1	15188	0	15229
14864	3	32	0	15099	0	15134
14865	20	0	15355	0	0	15375
14866	3	30	2	15520	0	15555
14867	4	40	0	15396	0	15440
14868	7	0	15739	2	0	15748
14869	15567	0	43	5	0	15615
14870	2	9	2	15257	0	15270
14871	15162	1	28	1	0	15192
14872	14985	2	31	6	0	15024
14873	6	0	15438	3	0	15447
14874	1	23	3	15180	0	15207
14875	15030	1	17	1	0	15049
14876	0	14737	0	9	0	14746
14877	3	41	1	14417	0	14462
14878	1	26	0	14498	0	14525
14879	3	21	2	14381	0	14407
14880	6	0	14319	1	0	14326
14881	14421	0	35	6	0	14462
14882	4	19	2	14206	0	14231
14883	3	27	3	13904	0	13937
14884	8	0	13688	2	0	13698
14885	4	34	1	13579	0	13618
14886	1	26	0	13511	0	13538
14887	13601	1	30	4	0	13636
14888	0	13484	0	7	0	13491
14889	10	0	13427	0	0	13437
14890	13604	2	29	5	0	13640
14891	5	26	2	13509	0	13542
14892	13	0	13113	1	0	13127
14893	6	0	12630	2	0	12638
14894	4	22	1	12525	0	12552
14895	18	0	12344	1	0	12363
14896	4	0	12342	6	0	12352
14897	3	12051	0	16	0	12070
14898	4	37	3	11991	0	12035
14899	11	1	13281	1	0	13294
14900	0	14	2	14861	0	14877
14901	14826	1	15	0	0	14842
14902	2	23	2	14592	0	14619
14903	0	16	3	14465	0	14484
14904	14460	0	18	4	0	14482
14905	16066	0	29	3	0	16098
14906	3	33	0	16026	0	16062
14907	19	0	15929	1	0	15949
14908	2	14893	0	6	0	14901
14909	1	30	0	14001	0	14032
14910	14189	2	31	0	0	14222
14911	15034	0	30	1	0	15065
14912	5	15756	0	6	0	15767
14913	4	15714	0	7	0	15725
14914	15650	1	43	1	0	15695
14915	15428	4	19	0	0	15451
14916	16	2	15504	1	0	15523
14917	8	40	3	15412	0	15463
14918	1	15355	0	17	0	15373
14919	15286	2	26	0	0	15314
14920	3	27	1	14682	0	14713
14921	31	14817	2	17	0	14867
14922	14	1	14984	2	0	15001
14923	3	44	2	15151	0	15200
14924	3	14992	1	12	0	15008
14925	15063	1	34	0	0	15098
14926	15215	1	29	6	0	15251
14927	0	15198	0	14	0	15212
14928	15385	0	33	1	0	15419
14929	16667	2	40	4	0	16713
14930	2	16713	0	12	0	16727
14931	3	17758	0	10	0	17771
14932	1	26	6	17702	0	17735
14933	17736	0	35	2	0	17773
14934	7	0	17715	2	0	17724
14935	17795	0	60	6	0	17861
14936	2	17778	0	12	0	17792
14937	17350	5	34	0	0	17389
14938	17265	2	29	3	0	17299
14939	17223	3	42	5	0	17273
14940	2	24	0	17245	0	17271
14941	1	17044	0	7	0	17052
14942	16794	3	44	2	0	16843
14943	15	0	16907	0	0	16922
14944	4	16538	0	14	0	16556
14945	1	27	2	16480	0	16510
14946	8	0	16563	2	0	16573
14947	3	0	16610	1	0	16614
14948	2	30	27	16521	0	16580
14949	1	49	2	16080	0	16132
14950	2	42	2	16041	0	16087
14951	4	26	1	16104	0	16135
14952	6	16038	0	5	0	16049
14953	0	16076	0	9	0	16085
14954	16130	0	27	0	0	16157
14955	2	28	0	15994	0	16024
14956	6	24	7	15677	0	15714
14957	0	10	1	15941	0	15952
14958	15961	0	10	4	0	15975
14959	15958	0	24	1	0	15983
14960	1	10	1	15771	0	15783
14961	15518	0	14	4	0	15536
14962	15450	1	24	3	0	15478
14963	15454	0	37	2	0	15493
14964	0	29	3	15391	0	15423
14965	14	0	15387	0	0	15401
14966	7	2	15706	2	0	15717
14967	14	1	15642	4	0	15661
14968	14	0	15788	2	0	15804
14969	1	26	3	16121	0	16151
14970	15948	0	21	2	0	15971
14971	15893	0	35	6	0	15934
14972	9	1	16581	0	0	16591
14973	13	0	16440	1	0	16454
14974	2	15224	0	9	0	15235
14975	2	23	2	13999	0	14026
14976	13913	0	21	2	0	13936
14977	3	0	13945	5	0	13953
14978	14174	1	59	4	0	14238
14979	2	14384	0	13	0	14399
14980	2	55	1	13869	0	13927
14981	2	12	0	12460	0	12474
14982	2	13	0	12620	0	12635
14983	12735	0	12	4	0	12751
14984	1	14	2	12833	0	12850
14985	1	18	2	12956	0	12977
14986	12763	1	8	0	0	12772
14987	3	34	0	11815	0	11852
14988	11	0	11115	1	0	11127
14989	11055	0	25	2	0	11082
14990	2	37	1	11101	0	11141
14991	6	30	1	11041	0	11078
14992	3	10962	2	4	0	10971
14993	10991	0	11	0	0	11002
14994	10986	1	9	1	0	10997
14995	0	7	1	10972	0	10980
14996	9	0	11381	0	0	11390
14997	10930	1	32	5	0	10968
14998	7	0	11465	0	0	11472
14999	4	19	2	11363	0	11388
15000	0	15	0	11566	0	11581
15001	11619	1	17	1	0	11638
15002	5	23	1	11510	0	11539
15003	7	0	11466	3	0	11476
15004	11119	0	29	6	0	11154
15005	5	0	9812	1	0	9818
15006	19	0	9403	8	0	9430
15007	8493	2	15	2	0	8512
15008	10	23	4	8409	0	8446
15009	0	8653	0	2	0	8655
15010	8781	0	13	0	0	8794
15011	8777	0	24	2	0	8803
15012	5	0	8744	2	0	8751
15013	8819	0	15	2	0	8836
15014	0	31	0	8657	0	8688
15015	14	1	8486	2	0	8503
15016	2	8505	0	6	0	8513
15017	8568	1	11	2	0	8582
15018	0	8887	0	3	0	8890
15019	1	40	0	8818	0	8859
15020	2	22	0	8912	0	8936
15021	0	17	0	8897	0	8914
15022	1	28	1	8974	0	9004
15023	0	9006	0	7	0	9013
15024	19	0	8985	1	0	9005
15025	1	9204	0	1	0	9206
15026	9237	0	18	3	0	9258
15027	0	21	0	9190	0	9211
15028	9439	0	8	1	0	9448
15029	0	17	1	9515	0	9533
15030	9531	0	4	1	0	9536
15031	0	9597	0	5	0	9602
15032	9488	3	28	4	0	9523
15033	9347	1	21	1	0	9370
15034	9295	1	13	4	0	9313
15035	10006	4	18	2	0	10030
15036	0	10006	0	7	0	10013
15037	10	2	9920	0	0	9932
15038	0	18	3	10099	0	10120
15039	10102	0	3	3	0	10108
15040	10242	1	21	0	0	10264
15041	2	25	1	10257	0	10285
15042	3	1	9704	1	0	9709
15043	3	31	2	9678	0	9714
15044	0	9370	0	6	0	9376
15045	9374	0	17	1	0	9392
15046	5	21	0	9521	0	9547
15047	0	9344	0	4	0	9348
15048	1	9307	0	4	0	9312
15049	0	9418	0	7	0	9425
15050	0	26	0	9771	0	9797
15051	10054	1	15	1	0	10071
15052	0	10269	0	0	0	10269
15053	3	23	2	10306	0	10334
15054	10313	0	14	3	0	10330
15055	4	18	2	9945	0	9969
15056	9627	1	8	0	0	9636
15057	9700	5	20	5	0	9730
15058	0	10191	0	7	0	10198
15059	3	35	4	9994	0	10036
15060	2	10515	0	5	0	10522
15061	10322	1	20	2	0	10345
15062	10339	3	13	3	0	10358
15063	10485	1	16	1	0	10503
15064	2	16	0	10483	0	10501
15065	4	0	10467	0	0	10471
15066	10616	0	17	4	0	10637
15067	10991	0	15	1	0	11007
15068	1	30	1	11066	0	11098
15069	1	11098	0	4	0	11103
15070	1	16	2	11227	0	11246
15071	6	1	0	11328	0	11335
15072	11428	1	12	2	0	11443
15073	11425	1	14	3	0	11443
15074	3	1	11072	0	0	11076
15075	5	19	0	10923	0	10947
15076	10608	0	20	0	0	10628
15077	4	32	1	10666	0	10703
15078	25	0	10644	3	0	10672
15079	6	10792	1	10	0	10809
15080	2	10786	0	3	0	10791
15081	10816	1	29	2	0	10848
15082	0	25	3	10710	0	10738
15083	1	12	0	10712	0	10725
15084	10635	1	14	0	0	10650
15085	8	0	10823	0	0	10831
15086	2	26	2	10708	0	10738
15087	15	0	10725	8	0	10748
15088	3	10690	0	12	0	10705
15089	10771	0	24	2	0	10797
15090	10749	1	22	1	0	10773
15091	10698	0	29	1	0	10728
15092	8	0	11395	0	0	11403
15093	11320	2	15	7	0	11344
15094	11072	2	34	3	0	11111
15095	0	8	0	11150	0	11158
15096	11031	0	15	2	0	11048
15097	5	0	11038	2	0	11045
15098	10864	2	27	4	0	10897
15099	6	0	10965	0	0	10971
15100	0	10931	0	3	0	10934
15101	3	47	0	10651	0	10701
15102	1	10802	0	8	0	10811
15103	4	2	10794	1	0	10801
15104	9	10517	0	5	0	10531
15105	10672	0	16	3	0	10691
15106	5	10819	0	18	0	10842
15107	2	10760	0	9	0	10771
15108	13	0	10815	4	0	10832
15109	0	15	0	11001	0	11016
15110	10894	1	17	1	0	10913
15111	10	1	10235	1	0	10247
15112	1	10261	0	9	0	10271
15113	5	21	1	10099	0	10126
15114	13	1	10082	0	0	10096
15115	7	0	10248	3	0	10258
15116	2	33	0	10390	0	10425
15117	16	0	10659	0	0	10675
15118	2	31	0	10701	0	10734
15119	1	11047	2	1	0	11051
15120	3	39	1	10951	0	10994
15121	1	10480	0	5	0	10486
15122	1	18	0	10448	0	10467
15123	10946	10	8	0	0	10964
15124	2	29	1	10924	0	10956
15125	2	11129	0	5	0	11136
15126	4	27	1	11074	0	11106
15127	15	0	11914	2	0	11931
15128	3	14	2	12042	0	12061
15129	11878	1	19	4	0	11902
15130	11	0	12174	2	0	12187
15131	0	33	0	12533	0	12566
15132	12801	0	10	1	0	12812
15133	0	12671	0	7	0	12678
15134	0	16	1	12051	0	12068
15135	12125	0	19	5	0	12149
15136	7	32	4	11647	0	11690
15137	10	3	11877	3	0	11893
15138	11874	0	31	5	0	11910
15139	0	12248	0	10	0	12258
15140	5	12056	0	10	0	12071
15141	11978	1	21	3	0	12003
15142	11881	1	16	2	0	11900
15143	1	20	0	11524	0	11545
15144	11417	1	18	3	0	11439
15145	13	0	11457	3	0	11473
15146	11218	0	30	1	0	11249
15147	0	11199	0	6	0	11205
15148	10607	1	35	3	0	10646
15149	16	1	10661	1	0	10679
15150	2	21	2	10644	0	10669
15151	3	48	3	10898	0	10952
15152	9	42	2	10904	0	10957
15153	3	10857	0	15	0	10875
15154	10969	1	20	0	0	10990
15155	5	32	2	10743	0	10782
15156	2	10771	0	6	0	10779
15157	10719	2	28	0	0	10749
15158	10713	0	3	1	0	10717
15159	10804	0	8	3	0	10815
15160	10765	3	24	2	0	10794
15161	10713	2	12	5	0	10732
15162	0	5	2	10733	0	10740
15163	1	5	1	10612	0	10619
15164	10684	1	8	1	0	10694
15165	2	12	2	10605	0	10621
15166	3	15	2	10745	0	10765
15167	6	0	10545	12	0	10563
15168	10097	0	22	9	0	10128
15169	10189	2	30	1	0	10222
15170	10197	1	14	2	0	10214
15171	5	25	1	10158	0	10189
15172	4	10228	0	9	0	10241
15173	10323	0	11	0	0	10334
15174	10229	0	16	5	0	10250
15175	3	5	0	10576	0	10584
15176	10576	0	11	2	0	10589
15177	6	0	10559	1	0	10566
15178	1	10515	0	9	0	10525
15179	1	10331	1	7	0	10340
15180	29	1	10354	1	0	10385
15181	1	10380	1	6	0	10388
15182	0	10634	0	7	0	10641
15183	10689	0	20	3	0	10712
15184	1	11121	0	0	0	11122
15185	1	15	0	11474	0	11490
15186	11507	0	13	0	0	11520
15187	7	0	11498	1	0	11506
15188	11427	0	27	2	0	11456
15189	6	0	11527	1	0	11534
15190	5	0	11393	1	0	11399
15191	10930	4	24	3	0	10961
15192	8	0	11146	1	0	11155
15193	2	10677	0	8	0	10687
15194	0	18	2	10830	0	10850
15195	11190	1	7	1	0	11199
15196	0	10792	0	4	0	10796
15197	4	44	0	10896	0	10944
15198	15	0	11364	0	0	11379
15199	1	22	2	11410	0	11435
15200	11351	0	15	0	0	11366
15201	6	0	10510	6	0	10522
15202	5	10	1	10238	0	10254
15203	9591	0	8	1	0	9600
15204	9509	2	15	2	0	9528
15205	1	16	0	9422	0	9439
15206	2	21	1	9158	0	9182
15207	6	1	8827	5	0	8839
15208	16	0	8520	0	0	8536
15209	8612	0	14	1	0	8627
15210	8647	0	28	3	0	8678
15211	3	9656	0	7	0	9666
15212	9623	1	17	2	0	9643
15213	9567	1	21	1	0	9590
15214	7	0	9571	0	0	9578
15215	3	9009	0	13	0	9025
15216	8974	0	20	1	0	8995
15217	9073	3	18	2	0	9096
15218	9728	2	7	5	0	9742
15219	2	10	0	9879	0	9891
15220	2	12	3	9746	0	9763
15221	2	10064	0	2	0	10068
15222	1	13	3	9924	0	9941
15223	10247	1	11	2	0	10261
15224	2	25	1	10240	0	10268
15225	9	0	10246	0	0	10255
15226	9	1	10320	2	0	10332
15227	2	13	1	9929	0	9945
15228	11	0	9969	0	0	9980
15229	12	1	10109	1	0	10123
15230	2	28	4	10501	0	10535
15231	2	20	2	10612	0	10636
15232	12	0	10605	0	0	10617
15233	31	0	10675	1	0	10707
15234	7	10802	0	7	0	10816
15235	10987	0	39	1	0	11027
15236	1	10951	0	15	0	10967
15237	10972	0	19	4	0	10995
15238	11294	1	30	2	0	11327
15239	2	11330	0	8	0	11340
15240	11324	1	23	2	0	11350
15241	3	31	2	11358	0	11394
15242	10	2	11585	0	0	11597
15243	1	19	0	11570	0	11590
15244	3	5	0	11635	0	11643
15245	11582	1	11	1	0	11595
15246	11482	1	17	0	0	11500
15247	11427	2	14	3	0	11446
15248	11329	1	27	1	0	11358
15249	11615	11	31	1	0	11658
15250	0	12165	1	2	0	12168
15251	1	18	0	11807	0	11826
15252	5	0	12541	2	0	12548
15253	3	43	2	12454	0	12502
15254	4	25	2	12553	0	12584
15255	0	13	1	12631	0	12645
15256	12612	0	11	0	0	12623
15257	2	13	2	12443	0	12460
15258	12215	2	12	1	0	12230
15259	10	0	12426	1	0	12437
15260	2	28	1	12275	0	12306
15261	6	0	12030	2	0	12038
15262	11995	0	34	3	0	12032
15263	0	29	3	11917	0	11949
15264	15	0	12369	1	0	12385
15265	1	20	0	12620	0	12641
15266	12599	0	22	1	0	12622
15267	2	1	12556	1	0	12560
15268	12383	1	22	7	0	12413
15269	12090	1	42	2	0	12135
15270	11931	2	24	1	0	11958
15271	11811	5	30	3	0	11849
15272	3	11895	0	6	0	11904
15273	6	11324	0	6	0	11336
15274	0	11205	0	4	0	11209
15275	4	37	3	11037	0	11081
15276	1	11431	0	16	0	11448
15277	11427	1	21	1	0	11450
15278	3	12517	0	5	0	12525
15279	2	12521	0	3	0	12526
15280	0	37	0	12241	0	12278
15281	2	8	1	12233	0	12244
15282	12247	0	13	1	0	12261
15283	4	25	1	12233	0	12263
15284	16	0	12342	0	0	12358
15285	2	2	12557	3	0	12564
15286	10	0	12537	13	0	12560
15287	3	23	3	11372	0	11401
15288	0	26	0	11285	0	11311
15289	4	0	11138	1	0	11143
15290	8	0	11297	2	0	11307
15291	11	0	11406	1	0	11418
15292	11574	2	16	2	0	11594
15293	1	38	1	11450	0	11490
15294	0	28	1	10933	0	10962
15295	11224	0	11	0	0	11235
15296	4	33	1	11906	0	11944
15297	2	11899	0	2	0	11903
15298	2	11864	0	8	0	11874
15299	0	6	0	11619	0	11625
15300	11846	0	14	0	0	11860
15301	11788	1	24	1	0	11814
15302	12024	0	12	1	0	12037
15303	1	29	0	12038	0	12068
15304	2	0	12023	1	0	12026
15305	2	40	1	12242	0	12285
15306	15	0	12335	1	0	12351
15307	12454	2	21	6	0	12483
15308	2	10	0	12545	0	12557
15309	12160	2	12	5	0	12179
15310	12	0	12155	4	0	12171
15311	11959	0	60	2	0	12021
15312	8	0	12188	0	0	12196
15313	3	12050	0	8	0	12061
15314	4	11936	0	11	0	11951
15315	12010	2	32	1	0	12045
15316	3	16	0	12265	0	12284
15317	16	0	12411	7	0	12434
15318	5	12110	0	11	0	12126
15319	0	12178	1	5	0	12184
15320	5	22	2	12203	0	12232
15321	12147	0	10	2	0	12159
15322	12150	4	24	4	0	12182
15323	0	12527	0	3	0	12530
15324	12380	1	26	0	0	12407
15325	0	29	1	12386	0	12416
15326	5	0	12298	1	0	12304
15327	1	11736	1	6	0	11744
15328	3	30	1	12004	0	12038
15329	0	7	0	12090	0	12097
15330	11950	1	9	1	0	11961
15331	7	0	12240	1	0	12248
15332	12284	3	12	4	0	12303
15333	12494	3	21	4	0	12522
15334	0	9	1	12446	0	12456
15335	1	16	1	11748	0	11766
15336	11904	1	13	2	0	11920
15337	5	16	0	11758	0	11779
15338	10	0	11627	4	0	11641
15339	14	0	12702	3	0	12719
15340	3	12307	1	9	0	12320
15341	3	12121	0	12	0	12136
15342	8	43	0	12009	0	12060
15343	1	12392	0	9	0	12402
15344	12519	2	34	3	0	12558
15345	0	12516	0	2	0	12518
15346	1	38	6	12537	0	12582
15347	2	29	1	12523	0	12555
15348	12	0	12436	0	0	12448
15349	2	44	0	12618	0	12664
15350	4	45	0	12629	0	12678
15351	1	13190	0	6	0	13197
15352	5	31	0	12909	0	12945
15353	2	13	3	13135	0	13153
15354	8	1	12047	3	0	12059
15355	1	12171	1	8	0	12181
15356	7	34	1	12175	0	12217
15357	1	12296	0	13	0	12310
15358	13	0	12240	12	0	12265
15359	2	12296	0	5	0	12303
15360	12332	1	26	1	0	12360
15361	12316	1	30	1	0	12348
15362	12397	3	31	3	0	12434
15363	1	12828	0	11	0	12840
15364	12841	0	17	4	0	12862
15365	2	23	1	12895	0	12921
15366	12737	3	12	4	0	12756
15367	0	12712	0	18	0	12730
15368	12355	4	44	2	0	12405
15369	12480	1	32	2	0	12515
15370	0	12165	0	17	0	12182
15371	19	1	12490	0	0	12510
15372	0	25	3	11837	0	11865
15373	15	0	12036	2	0	12053
15374	2	39	1	12089	0	12131
15375	2	32	2	12107	0	12143
15376	12	0	11893	6	0	11911
15377	1	31	0	12105	0	12137
15378	11825	0	22	1	0	11848
15379	8	0	11830	1	0	11839
15380	0	10811	0	6	0	10817
15381	1	33	3	10826	0	10863
15382	1	29	0	10701	0	10731
15383	7	0	10742	1	0	10750
15384	6	46	4	11115	0	11171
15385	1	11078	0	9	0	11088
15386	11181	1	32	0	0	11214
15387	3	11094	0	0	0	11097
15388	11235	3	29	2	0	11269
15389	4	12317	1	2	0	12324
15390	2	12080	0	10	0	12092
15391	21	0	12188	0	0	12209
15392	0	39	7	12144	0	12190
15393	2	39	1	12302	0	12344
15394	6	20	0	12762	0	12788
15395	1	13061	0	13	0	13075
15396	0	21	3	12985	0	13009
15397	13050	0	14	1	0	13065
15398	4	8	1	13038	0	13051
15399	12699	4	29	1	0	12733
15400	6	0	12874	2	0	12882
15401	12456	1	12	1	0	12470
15402	2	16	5	12055	0	12078
15403	1	17	0	12225	0	12243
15404	11924	1	24	0	0	11949
15405	11	2	12858	0	0	12871
15406	2	12741	0	10	0	12753
15407	0	19	8	12758	0	12785
15408	12677	1	25	2	0	12705
15409	12526	1	24	2	0	12553
15410	1	19	1	12541	0	12562
15411	9	0	12627	3	0	12639
15412	12243	1	47	6	0	12297
15413	5	0	12528	0	0	12533
15414	10	32	5	11905	0	11952
15415	9	0	12091	2	0	12102
15416	5	29	0	12018	0	12052
15417	17	1	12108	1	0	12127
15418	2	12192	0	9	0	12203
15419	2	37	1	12159	0	12199
15420	12	12298	0	10	0	12320
15421	12342	1	27	4	0	12374
15422	12490	0	27	4	0	12521
15423	3	0	12785	2	0	12790
15424	1	20	1	12960	0	12982
15425	12950	0	17	1	0	12968
15426	2	30	2	12925	0	12959
15427	2	22	0	12341	0	12365
15428	4	0	12398	5	0	12407
15429	12010	0	42	4	0	12056
15430	8	0	12409	0	0	12417
15431	1	27	2	12220	0	12250
15432	1	0	12116	1	0	12118
15433	12397	1	44	5	0	12447
15434	12666	1	44	3	0	12714
15435	12591	1	63	0	0	12655
15436	2	15	1	12665	0	12683
15437	12	0	12589	0	0	12601
15438	23	0	12646	3	0	12672
15439	7	52	1	13055	0	13115
15440	1	13024	0	14	0	13039
15441	13287	3	46	2	0	13338
15442	2	34	1	13332	0	13369
15443	13	0	13503	0	0	13516
15444	3	33	1	13476	0	13513
15445	7	2	13375	4	0	13388
15446	4	34	0	13229	0	13267
15447	21	0	12688	1	0	12710
15448	19	0	12683	3	0	12705
15449	4	12654	1	19	0	12678
15450	17	0	12647	1	0	12665
15451	10	1	13003	2	0	13016
15452	1	42	0	12961	0	13004
15453	3	19	1	13073	0	13096
15454	5	13025	1	6	0	13037
15455	13194	2	29	2	0	13227
15456	1	13885	0	8	0	13894
15457	1	20	3	13827	0	13851
15458	13904	1	28	2	0	13935
15459	3	16	0	13808	0	13827
15460	14416	1	18	0	0	14435
15461	4	25	2	14611	0	14642
15462	7	0	14583	2	0	14592
15463	2	39	2	14449	0	14492
15464	2	6	0	14266	0	14274
15465	13207	0	18	2	0	13227
15466	13197	2	21	1	0	13221
15467	13073	1	37	0	0	13111
15468	2	12802	1	5	0	12810
15469	0	12240	0	7	0	12247
15470	11900	5	17	3	0	11925
15471	6	0	11753	2	0	11761
15472	8	0	12052	4	0	12064
15473	4	35	1	11989	0	12029
15474	11	0	11912	2	0	11925
15475	11	1	11841	16	0	11869
15476	12212	0	34	5	0	12251
15477	12220	1	47	6	0	12274
15478	4	12151	0	8	0	12163
15479	1	11296	0	7	0	11304
15480	2	29	4	11257	0	11292
15481	3	11948	0	5	0	11956
15482	11963	1	22	2	0	11988
15483	2	32	3	11997	0	12034
15484	3	12007	0	9	0	12019
15485	11918	2	37	2	0	11959
15486	10	0	11976	1	0	11987
15487	11	1	11887	4	0	11903
15488	11407	4	39	2	0	11452
15489	8	0	11556	0	0	11564
15490	11199	0	24	3	0	11226
15491	3	27	1	11688	0	11719
15492	10	16	11715	3	0	11744
15493	5	11806	2	17	0	11830
15494	5	11718	1	14	0	11738
15495	11926	7	26	1	0	11960
15496	0	11826	0	14	0	11840
15497	11806	0	29	4	0	11839
15498	11736	1	31	1	0	11769
15499	0	11585	0	5	0	11590
15500	0	18	1	11310	0	11329
15501	10	1	11669	1	0	11681
15502	0	11439	2	8	0	11449
15503	5	26	0	11464	0	11495
15504	0	19	0	11546	0	11565
15505	11594	0	13	2	0	11609
15506	0	17	3	12008	0	12028
15507	21	1	11996	1	0	12019
15508	1	12121	1	2	0	12125
15509	0	15	2	11930	0	11947
15510	11555	1	19	4	0	11579
15511	11532	2	17	0	0	11551
15512	0	15	1	11611	0	11627
15513	11342	2	19	0	0	11363
15514	10	0	11274	1	0	11285
15515	2	21	2	10357	0	10382
15516	5	0	10486	1	0	10492
15517	0	29	8	10218	0	10255
15518	0	16	0	10420	0	10436
15519	2	17	0	10255	0	10274
15520	2	6	2	10340	0	10350
15521	2	14	1	10341	0	10358
15522	10432	0	5	5	0	10442
15523	10386	2	33	3	0	10424
15524	1	10511	0	4	0	10516
15525	10248	1	19	0	0	10268
15526	0	17	2	10205	0	10224
15527	0	12	0	10051	0	10063
15528	2	23	1	10062	0	10088
15529	7	3	9994	3	0	10007
15530	4	24	1	9897	0	9926
15531	4	8962	1	3	0	8970
15532	9021	0	31	5	0	9057
15533	8993	1	26	0	0	9020
15534	7	0	8976	2	0	8985
15535	0	7939	0	10	0	7949
15536	2	15	1	7900	0	7918
15537	7	0	8166	0	0	8173
15538	2	29	1	8415	0	8447
15539	1	8642	0	4	0	8647
15540	8715	1	19	1	0	8736
15541	0	8714	0	4	0	8718
15542	10	0	8698	2	0	8710
15543	11	0	8787	7	0	8805
15544	6	8895	1	15	0	8917
15545	5	8817	0	5	0	8827
15546	8600	2	19	2	0	8623
15547	8745	1	12	2	0	8760
15548	2	17	0	8881	0	8900
15549	2	0	9101	0	0	9103
15550	0	17	1	9755	0	9773
15551	1	14	0	10738	0	10753
15552	10442	2	15	0	0	10459
15553	10590	1	26	3	0	10620
15554	1	24	0	10539	0	10564
15555	16	0	10349	1	0	10366
15556	1	9771	1	7	0	9780
15557	9581	0	28	3	0	9612
15558	0	10025	0	3	0	10028
15559	1	51	0	9881	0	9933
15560	1	14	0	10885	0	10900
15561	2	22	3	10913	0	10940
15562	3	12	3	11481	0	11499
15563	11697	1	10	3	0	11711
15564	6	25	2	11636	0	11669
15565	3	11772	0	5	0	11780
15566	1	17	2	11732	0	11752
15567	11508	1	19	1	0	11529
15568	1	11614	1	6	0	11622
15569	4	19	2	10992	0	11017
15570	3	0	11076	0	0	11079
15571	11458	1	38	3	0	11500
15572	2	11	1	11465	0	11479
15573	8	0	11420	0	0	11428
15574	7	0	11505	3	0	11515
15575	1	24	0	11528	0	11553
15576	11381	1	14	0	0	11396
15577	11000	2	23	12	0	11037
15578	0	11165	0	14	0	11179
15579	11127	0	27	3	0	11157
15580	11350	1	6	0	0	11357
15581	11249	3	23	2	0	11277
15582	10724	1	23	0	0	10748
15583	0	10	0	10620	0	10630
15584	2	13	0	10702	0	10717
15585	12	0	10731	3	0	10746
15586	6	10753	0	14	0	10773
15587	0	10771	1	16	0	10788
15588	6	0	10804	0	0	10810
15589	10925	0	8	1	0	10934
15590	1	5	0	11235	0	11241
15591	11297	0	11	3	0	11311
15592	11094	0	32	2	0	11128
15593	3	1	11258	0	0	11262
15594	1	6	1	11250	0	11258
15595	11232	0	15	1	0	11248
15596	4	18	0	11140	0	11162
15597	8	0	11191	1	0	11200
15598	3	25	1	11067	0	11096
15599	5	11028	0	11	0	11044
15600	0	10962	1	14	0	10977
15601	12	0	10940	0	0	10952
15602	3	10771	0	6	0	10780
15603	10794	1	8	1	0	10804
15604	11339	0	30	1	0	11370
15605	1	13	1	11282	0	11297
15606	0	23	1	11566	0	11590
15607	1	11	0	11650	0	11662
15608	11656	1	15	5	0	11677
15609	4	11550	0	8	0	11562
15610	11679	1	35	1	0	11716
15611	11862	0	52	0	0	11914
15612	2	11618	0	11	0	11631
15613	11256	2	38	3	0	11299
15614	0	11299	1	8	0	11308
15615	10941	4	28	4	0	10977
15616	0	0	11471	1	0	11472
15617	11456	1	39	1	0	11497
15618	2	12334	0	3	0	12339
15619	2	45	0	12255	0	12302
15620	7	34	3	12360	0	12404
15621	2	15	0	12436	0	12453
15622	12444	0	27	3	0	12474
15623	7	19	0	12191	0	12217
15624	7	0	12107	0	0	12114
15625	10995	0	60	7	0	11062
15626	5	1	11217	0	0	11223
15627	1	29	0	10158	0	10188
15628	8	0	10214	0	0	10222
15629	0	41	1	10556	0	10598
15630	1	10840	0	3	0	10844
15631	5	33	0	10693	0	10731
15632	0	10741	0	5	0	10746
15633	3	13	4	10771	0	10791
15634	11031	2	7	1	0	11041
15635	0	7	1	11060	0	11068
15636	10086	2	17	2	0	10107
15637	1	0	10408	0	0	10409
15638	10525	1	18	4	0	10548
15639	10335	0	23	1	0	10359
15640	10470	0	28	1	0	10499
15641	1	9	0	10110	0	10120
15642	10043	0	12	0	0	10055
15643	12	0	9979	0	0	9991
15644	9704	0	26	3	0	9733
15645	6	0	9912	1	0	9919
15646	10259	1	38	2	0	10300
15647	1	19	0	10257	0	10277
15648	15	0	10260	4	0	10279
15649	3	20	4	10267	0	10294
15650	4	21	0	10183	0	10208
15651	11	0	10470	2	0	10483
15652	10535	0	58	7	0	10600
15653	2	10545	0	5	0	10552
15654	10409	0	42	5	0	10456
15655	1	10439	0	9	0	10449
15656	10130	4	29	2	0	10165
15657	4	0	10385	2	0	10391
15658	10932	1	29	9	0	10971
15659	0	11141	0	2	0	11143
15660	1	30	1	10700	0	10732
15661	3	14	0	10826	0	10843
15662	2	22	1	10931	0	10956
15663	9	0	11001	0	0	11010
15664	3	25	0	10978	0	11006
15665	6	0	10831	1	0	10838
15666	10823	0	37	4	0	10864
15667	10763	1	33	1	0	10798
15668	4	5	0	10669	0	10678
15669	2	0	10553	2	0	10557
15670	10501	0	28	2	0	10531
15671	14	0	10705	0	0	10719
15672	1	24	2	10927	0	10954
15673	0	14	0	10883	0	10897
15674	1	19	1	10893	0	10914
15675	1	25	0	11084	0	11110
15676	11571	0	8	0	0	11579
15677	1	11563	1	12	0	11577
15678	8	3	11548	0	0	11559
15679	2	11418	0	16	0	11436
15680	11242	1	32	2	0	11277
15681	1	15	0	11344	0	11360
15682	11055	2	7	1	0	11065
15683	5	16	3	11036	0	11060
15684	2	22	0	11053	0	11077
15685	3	16	5	11018	0	11042
15686	8	0	11064	1	0	11073
15687	0	11388	1	6	0	11395
15688	10	0	11390	1	0	11401
15689	2	21	2	11418	0	11443
15690	11387	0	13	0	0	11400
15691	11365	2	24	3	0	11394
15692	11001	3	34	0	0	11038
15693	0	10771	0	9	0	10780
15694	10734	0	6	1	0	10741
15695	1	23	0	10769	0	10793
15696	2	20	0	10475	0	10497
15697	4	24	0	10586	0	10614
15698	1	10641	0	4	0	10646
15699	4	20	0	10519	0	10543
15700	3	10829	0	9	0	10841
15701	10890	2	15	1	0	10908
15702	10868	1	18	2	0	10889
15703	0	24	1	10980	0	11005
15704	9	0	11005	1	0	11015
15705	11443	2	28	4	0	11477
15706	4	13	1	11230	0	11248
15707	12	0	11244	3	0	11259
15708	10864	0	43	5	0	10912
15709	3	9	1	11006	0	11019
15710	10864	0	18	0	0	10882
15711	2	10706	0	2	0	10710
15712	3	26	1	10323	0	10353
15713	3	10547	0	5	0	10555
15714	4	32	3	10110	0	10149
15715	1	10585	0	1	0	10587
15716	4	23	4	10511	0	10542
15717	4	1	10551	0	0	10556
15718	10577	0	30	3	0	10610
15719	3	10408	2	7	0	10420
15720	10	0	10101	2	0	10113
15721	10047	1	34	6	0	10088
15722	0	13	0	9698	0	9711
15723	1	0	9592	0	0	9593
15724	4	9242	0	5	0	9251
15725	3	23	0	9818	0	9844
15726	4	0	10013	0	0	10017
15727	5	17	0	10007	0	10029
15728	2	18	1	10060	0	10081
15729	10	1	10111	0	0	10122
15730	1	23	3	9900	0	9927
15731	2	0	10010	1	0	10013
15732	1	20	0	9871	0	9892
15733	6	0	9608	0	0	9614
15734	2	26	3	9729	0	9760
15735	0	17	0	9447	0	9464
15736	3	16	2	9478	0	9499
15737	9	9560	0	1	0	9570
15738	9559	0	22	2	0	9583
15739	9571	0	23	2	0	9596
15740	2	15	3	9560	0	9580
15741	9289	1	13	3	0	9306
15742	5	0	9339	2	0	9346
15743	4	9395	0	4	0	9403
15744	9592	1	28	0	0	9621
15745	1	9560	0	4	0	9565
15746	2	13	5	9594	0	9614
15747	0	7	1	9669	0	9677
15748	9795	0	16	0	0	9811
15749	2	19	3	9758	0	9782
15750	11	0	9745	1	0	9757
15751	2	9477	0	5	0	9484
15752	9075	1	30	1	0	9107
15753	1	28	1	9271	0	9301
15754	0	9157	0	5	0	9162
15755	1	32	2	8926	0	8961
15756	0	9082	0	2	0	9084
15757	9015	1	29	1	0	9046
15758	9010	1	24	1	0	9036
15759	5	0	9048	3	0	9056
15760	4	0	9406	1	0	9411
15761	0	14	3	9419	0	9436
15762	1	8915	0	12	0	8928
15763	2	10	0	8910	0	8922
15764	8944	0	20	0	0	8964
15765	6	0	8969	0	0	8975
15766	2	11	0	9253	0	9266
15767	1	0	9264	0	0	9265
15768	11	0	9135	1	0	9147
15769	1	8489	0	9	0	8499
15770	2	20	0	8443	0	8465
15771	8382	0	15	3	0	8400
15772	4	1	8617	2	0	8624
15773	3	8856	1	8	0	8868
15774	8909	1	22	2	0	8934
15775	1	14	0	8936	0	8951
15776	8679	0	14	1	0	8694
15777	8976	1	12	0	0	8989
15778	8970	1	14	2	0	8987
15779	1	0	8755	1	0	8757
15780	8525	0	17	1	0	8543
15781	7720	2	25	0	0	7747
15782	1	8111	0	13	0	8125
15783	0	19	1	8044	0	8064
15784	2	16	1	8259	0	8278
15785	1	4	0	8309	0	8314
15786	8280	1	6	1	0	8288
15787	8083	1	23	2	0	8109
15788	5	0	8017	0	0	8022
15789	2	25	2	8577	0	8606
15790	4	8537	0	6	0	8547
15791	8112	1	24	4	0	8141
15792	7	0	8380	1	0	8388
15793	0	17	0	8405	0	8422
15794	4	15	1	8360	0	8380
15795	2	8349	0	2	0	8353
15796	0	17	0	8256	0	8273
15797	3	12	0	8332	0	8347
15798	0	4	0	8482	0	8486
15799	8410	0	12	4	0	8426
15800	1	12	1	8457	0	8471
15801	3	12	0	7874	0	7889
15802	7730	0	12	2	0	7744
15803	2	13	1	7699	0	7715
15804	3	7513	0	2	0	7518
15805	7538	0	8	0	0	7546
15806	7564	0	25	3	0	7592
15807	7421	1	14	2	0	7438
15808	7441	1	23	2	0	7467
15809	1	7365	0	9	0	7375
15810	7309	0	10	2	0	7321
15811	7375	0	13	1	0	7389
15812	2	12	1	7361	0	7376
15813	5	0	7385	0	0	7390
15814	0	15	10	7821	0	7846
15815	2	16	1	8094	0	8113
15816	0	14	2	8234	0	8250
15817	2	15	1	8401	0	8419
15818	0	12	0	8326	0	8338
15819	8518	0	4	1	0	8523
15820	0	13	1	8402	0	8416
15821	2	0	8256	1	0	8259
15822	6	22	1	7948	0	7977
15823	1	7907	0	3	0	7911
15824	1	10	2	8046	0	8059
15825	1	1	8061	1	0	8064
15826	8019	2	30	6	0	8057
15827	8056	3	26	0	0	8085
15828	11	0	8067	3	0	8081
15829	0	8693	0	3	0	8696
15830	8743	2	18	2	0	8765
15831	8749	1	16	2	0	8768
15832	8730	0	37	3	0	8770
15833	9858	1	28	0	0	9887
15834	1	12	1	9899	0	9913
15835	8	0	10566	0	0	10574
15836	2	15	2	10199	0	10218
15837	2	14	2	10116	0	10134
15838	34	0	10938	4	0	10976
15839	44	1	16048	5	0	16098
15840	16661	2	38	3	0	16704
15841	0	16740	0	8	0	16748
15842	3	11	3	16408	0	16425
15843	73	0	17989	2	0	18064
15844	20906	2	46	6	0	20960
15845	54	0	21446	1	0	21501
15846	21859	1	37	3	0	21900
15847	0	21571	0	13	0	21584
15848	3	18	3	21516	0	21540
15849	5	1	22797	3	0	22806
15850	23429	2	65	10	0	23506
15851	3	24172	1	18	0	24194
15852	3	24213	0	9	0	24225
15853	7	87	9	24304	0	24407
15854	1	54	1	31292	0	31348
15855	32048	2	45	8	0	32103
15856	2	35090	0	12	0	35104
15857	3	51	0	35013	0	35067
15858	34936	1	67	1	0	35005
15859	35960	2	76	8	0	36046
15860	35666	8	172	8	0	35854
15861	11	2	35916	5	0	35934
15862	25	0	35781	10	0	35816
15863	35266	3	81	8	0	35358
15864	5	36070	2	28	0	36105
15865	3	36040	3	24	0	36070
15866	20	112	1	35877	0	36010
15867	0	36721	0	26	0	36747
15868	36834	3	50	3	0	36890
15869	7	96	6	36776	0	36885
15870	22	1	37057	2	0	37082
15871	36764	5	73	10	0	36852
15872	37049	3	95	3	0	37150
15873	6	105	2	37200	0	37313
15874	5	84	27	37015	0	37131
15875	7	106	1	37247	0	37361
15876	2	65	4	37246	0	37317
15877	27	1	37163	16	0	37207
15878	2	37294	2	39	0	37337
15879	9	137	4	37156	0	37306
15880	2	39564	2	17	0	39585
15881	12	152	3	39275	0	39442
15882	5	42228	2	24	0	42259
15883	42450	4	80	7	0	42541
15884	43692	6	122	15	0	43835
15885	1	44048	0	24	0	44073
15886	45697	3	84	9	0	45793
15887	5	84	3	45896	0	45988
15888	45882	6	63	13	0	45964
15889	2	45983	1	23	0	46009
15890	45216	7	115	12	0	45350
15891	45905	6	111	12	0	46034
15892	8	95	11	45804	0	45918
15893	56	7	45788	7	0	45858
15894	1	45934	1	24	0	45960
15895	9	76	5	47347	0	47437
15896	49855	6	93	7	0	49961
15897	44	0	50564	8	0	50616
15898	8	116	2	50905	0	51031
15899	4	50	3	51274	0	51331
15900	51391	2	79	11	0	51483
15901	51264	4	139	10	0	51417
15902	51402	16	154	17	0	51589
15903	1	51493	1	29	0	51524
15904	50099	6	119	14	0	50238
15905	24	2	52852	12	0	52890
15906	63	2	53611	13	0	53689
15907	39	1	53981	11	0	54032
15908	13	139	11	53636	0	53799
15909	29	0	53790	5	0	53824
15910	53926	7	120	23	0	54076
15911	11	128	7	54311	0	54457
15912	42	0	55509	7	0	55558
15913	56660	7	123	9	0	56799
15914	8	139	10	55965	0	56122
15915	5	65	2	53381	0	53453
15916	54568	5	79	8	0	54660
15917	8	102	4	55019	0	55133
15918	44	0	55657	4	0	55705
15919	18	169	12	54255	0	54454
15920	47	2	52307	18	0	52374
15921	11	108	3	52378	0	52500
15922	52474	6	75	5	0	52560
15923	6	52294	4	50	0	52354
15924	8	51373	1	23	0	51405
15925	12	174	8	51855	0	52049
15926	12	135	0	60844	0	60991
15927	11	63110	1	30	0	63152
15928	5	56378	2	21	0	56406
15929	26	140	11	56435	0	56612
15930	8	73	2	56789	0	56872
15931	59759	10	58	7	0	59834
15932	3	56884	3	62	0	56952
15933	11	56454	4	47	0	56516
15934	4	56594	0	28	0	56626
15935	55471	13	77	27	0	55588
15936	42	1	55824	8	0	55875
15937	55886	7	124	16	0	56033
15938	8	161	10	56361	0	56540
15939	7	56240	0	31	0	56278
15940	2	55983	1	37	0	56023
15941	56689	6	87	10	0	56792
15942	7	130	5	56540	0	56682
15943	9	56087	4	25	0	56125
15944	56325	8	95	12	0	56440
15945	56101	4	111	8	0	56224
15946	41	0	56266	6	0	56313
15947	56946	4	146	13	0	57109
15948	57929	8	132	3	0	58072
15949	17	131	10	58588	0	58746
15950	7	59785	1	56	0	59849
15951	2	59429	2	50	0	59483
15952	8	86	3	60024	0	60121
15953	60000	6	96	13	0	60115
15954	35	0	59806	8	0	59849
15955	73	1	59452	24	0	59550
15956	51	0	57267	37	0	57355
15957	42	5	57261	20	0	57328
15958	4	55700	3	61	0	55768
15959	9	54885	3	86	0	54983
15960	59	9	55046	8	0	55122
15961	46	4	55449	12	0	55511
15962	2	53810	3	33	0	53848
15963	1	149	10	53835	0	53995
15964	31	0	55762	1	0	55794
15965	7	179	20	55322	0	55528
15966	13	139	13	55819	0	55984
15967	25	160	5	55864	0	56054
15968	9	167	2	56005	0	56183
15969	39	1	56665	13	0	56718
15970	4	97	10	57417	0	57528
15971	55689	4	91	12	0	55796
15972	49	1	53400	6	0	53456
15973	52024	5	102	19	0	52150
15974	5	127	6	52544	0	52682
15975	55	1	52311	3	0	52370
15976	51575	22	121	7	0	51725
15977	5	86	7	52406	0	52504
15978	52724	1	55	6	0	52786
15979	18	171	6	52677	0	52872
15980	4	52076	0	29	0	52109
15981	70	0	52332	7	0	52409
15982	6	60	2	52537	0	52605
15983	52094	3	54	4	0	52155
15984	51878	7	110	10	0	52005
15985	51406	3	125	12	0	51546
15986	50932	8	136	16	0	51092
15987	50616	35	111	6	0	50768
15988	0	49455	2	23	0	49480
15989	48359	1	97	7	0	48464
15990	18	0	48683	6	0	48707
15991	48914	4	108	12	0	49038
15992	12	112	3	50166	0	50293
15993	43	0	49715	4	0	49762
15994	53	5	51060	20	0	51138
15995	15	95	4	51439	0	51553
15996	50595	6	64	9	0	50674
15997	6	51999	0	25	0	52030
15998	53790	2	98	11	0	53901
15999	2	55525	1	13	0	55541
16000	26	142	4	54461	0	54633
16001	5	62	6	54511	0	54584
16002	46881	2	46	2	0	46931
16003	9	88	9	45070	0	45176
16004	49	2	45076	7	0	45134
16005	45302	10	87	7	0	45406
16006	7	105	8	45213	0	45333
16007	17	109	1	41861	0	41988
16008	31	3	41430	23	0	41487
16009	41538	3	109	13	0	41663
16010	41952	2	93	7	0	42054
16011	2	41808	1	22	0	41833
16012	41	0	41019	6	0	41066
16013	77	1	43317	16	0	43411
16014	6	130	9	43063	0	43208
16015	20	135	2	43061	0	43218
16016	3	43118	2	52	0	43175
16017	39	5	43242	6	0	43292
16018	13	147	4	43261	0	43425
16019	26	0	43883	5	0	43914
16020	7	191	7	44198	0	44403
16021	1	44351	0	19	0	44371
16022	4	192	8	43397	0	43601
16023	2	79	7	43947	0	44035
16024	6	62	4	43332	0	43404
16025	42857	4	40	3	0	42904
16026	48	0	43186	4	0	43238
16027	3	45723	0	34	0	45760
16028	4	96	5	45675	0	45780
16029	46847	2	44	8	0	46901
16030	5	76	4	48488	0	48573
16031	48030	6	63	15	0	48114
16032	52	3	48334	10	0	48399
16033	50931	6	148	14	0	51099
16034	13	112	3	51362	0	51490
16035	62	3	51031	11	0	51107
16036	8	52068	1	23	0	52100
16037	24	154	7	51782	0	51967
16038	2	96	3	52018	0	52119
16039	52162	2	56	5	0	52225
16040	10	51059	2	11	0	51082
16041	8	50467	2	44	0	50521
16042	8	51255	2	14	0	51279
16043	51145	3	69	18	0	51235
16044	3	53026	2	12	0	53043
16045	13	177	4	52566	0	52760
16046	9	92	3	53443	0	53547
16047	53369	5	34	1	0	53409
16048	4	54082	1	22	0	54109
16049	9	108	6	53636	0	53759
16050	53711	3	55	7	0	53776
16051	53915	8	117	9	0	54049
16052	54092	30	117	9	0	54248
16053	1	54866	0	35	0	54902
16054	54594	3	88	9	0	54694
16055	19	156	12	55156	0	55343
16056	11	54671	2	40	0	54724
16057	10	55037	1	21	0	55069
16058	4	96	4	55179	0	55283
16059	59174	5	57	8	0	59244
16060	58918	3	91	11	0	59023
16061	13	164	4	59408	0	59589
16062	8	59531	1	40	0	59580
16063	58618	10	95	11	0	58734
16064	36	0	60735	8	0	60779
16065	85	1	60983	22	0	61091
16066	58986	5	130	30	0	59151
16067	36	1	59578	6	0	59621
16068	6	101	3	62116	0	62226
16069	63196	6	85	8	0	63295
16070	11	157	3	61104	0	61275
16071	52	0	61368	3	0	61423
16072	10	56984	0	24	0	57018
16073	20	153	17	56036	0	56226
16074	61	0	56147	7	0	56215
16075	57146	2	72	20	0	57240
16076	19	190	11	57161	0	57381
16077	26	2	57610	3	0	57641
16078	14	189	5	58960	0	59168
16079	4	57274	1	23	0	57302
16080	17	246	14	58085	0	58362
16081	10	179	3	57984	0	58176
16082	18	193	5	57759	0	57975
16083	6	60921	3	27	0	60957
16084	60853	6	105	7	0	60971
16085	4	129	5	61359	0	61497
16086	11	154	6	61054	0	61225
16087	16	157	6	61175	0	61354
16088	34	2	61264	11	0	61311
16089	8	114	1	59862	0	59985
16090	61119	4	59	13	0	61195
16091	15	61451	1	22	0	61489
16092	14	189	17	61289	0	61509
16093	6	83	0	62026	0	62115
16094	62169	5	79	13	0	62266
16095	6	61673	0	26	0	61705
16096	61596	1	126	14	0	61737
16097	63982	16	146	13	0	64157
16098	10	118	4	63837	0	63969
16099	67048	2	110	15	0	67175
16100	5	66146	1	38	0	66190
16101	64994	10	122	18	0	65144
16102	11	93	5	65133	0	65242
16103	63617	0	68	16	0	63701
16104	62840	6	138	15	0	62999
16105	19	0	62037	8	0	62064
16106	60775	4	146	17	0	60942
16107	62393	5	116	3	0	62517
16108	59344	5	154	13	0	59516
16109	42	16	59767	4	0	59829
16110	8	58387	2	33	0	58430
16111	9	134	4	57814	0	57961
16112	58281	1	82	15	0	58379
16113	12	58785	4	69	0	58870
16114	60794	4	124	8	0	60930
16115	25	165	13	60543	0	60746
16116	70	0	59856	1	0	59927
16117	60013	5	124	16	0	60158
16118	9	134	9	59217	0	59369
16119	32	0	60064	7	0	60103
16120	57532	7	161	16	0	57716
16121	48	1	58441	7	0	58497
16122	6	166	2	58264	0	58438
16123	10	84	1	58611	0	58706
16124	58018	5	72	6	0	58101
16125	58015	6	142	4	0	58167
16126	6	58103	1	36	0	58146
16127	57369	4	108	29	0	57510
16128	30	2	58144	6	0	58182
16129	57	4	57525	15	0	57601
16130	56756	9	105	22	0	56892
16131	11	55425	0	34	0	55470
16132	55785	12	128	22	0	55947
16133	8	57356	1	39	0	57404
16134	58230	5	101	6	0	58342
16135	7	139	7	56806	0	56959
16136	62	1	56881	4	0	56948
16137	11	152	5	56407	0	56575
16138	3	98	3	56358	0	56462
16139	56096	4	115	15	0	56230
16140	24	2	54125	39	0	54190
16141	59259	3	151	23	0	59436
16142	8	58348	0	35	0	58391
16143	61141	11	106	13	0	61271
16144	8	186	8	60100	0	60302
16145	50	1	61293	2	0	61346
16146	15	136	6	61246	0	61403
16147	62197	8	53	8	0	62266
16148	4	244	5	61823	0	62076
16149	25	212	6	61302	0	61545
16150	1	65148	0	21	0	65170
16151	19	205	11	64243	0	64478
16152	59	1	65528	4	0	65592
16153	19	183	7	66512	0	66721
16154	10	104	5	65185	0	65304
16155	65432	4	119	13	0	65568
16156	14	155	5	64375	0	64549
16157	84	0	65012	10	0	65106
16158	5	65177	0	29	0	65211
16159	24	194	10	63214	0	63442
16160	13	121	8	64883	0	65025
16161	64825	1	94	12	0	64932
16162	5	65765	0	34	0	65804
16163	11	123	7	65729	0	65870
16164	67134	3	81	10	0	67228
16165	66750	7	110	20	0	66887
16166	8	148	26	67522	0	67704
16167	30	0	67318	5	0	67353
16168	66418	10	125	16	0	66569
16169	2	140	3	66791	0	66936
16170	67325	2	105	15	0	67447
16171	66698	8	138	9	0	66853
16172	3	66327	0	61	0	66391
16173	65385	6	95	6	0	65492
16174	1	65590	0	19	0	65610
16175	9	245	10	63838	0	64102
16176	28	105	7	64257	0	64397
16177	5	63865	1	51	0	63922
16178	63761	3	148	14	0	63926
16179	63880	10	122	17	0	64029
16180	30	1	64359	5	0	64395
16181	30	1	67052	21	0	67104
16182	5	103	6	66511	0	66625
16183	65165	8	84	4	0	65261
16184	7	143	7	65847	0	66004
16185	17	137	10	64951	0	65115
16186	73	0	64445	14	0	64532
16187	56	1	64312	18	0	64387
16188	92	3	64257	20	0	64372
16189	63073	11	130	30	0	63244
16190	62000	3	105	7	0	62115
16191	8	61900	0	23	0	61931
16192	3	60239	0	37	0	60279
16193	8	146	12	60043	0	60209
16194	46	2	60829	1	0	60878
16195	60095	10	112	18	0	60235
16196	26	1	60857	3	0	60887
16197	9	183	15	59926	0	60133
16198	4	108	12	59768	0	59892
16199	5	147	6	60831	0	60989
16200	4	39	1	60999	0	61043
16201	61064	2	66	6	0	61138
16202	16	115	1	61037	0	61169
16203	74	0	60744	3	0	60821
16204	59604	6	162	18	0	59790
16205	34	4	60566	7	0	60611
16206	61	8	65140	17	0	65226
16207	12	65810	2	31	0	65855
16208	15	110	8	67385	0	67518
16209	75205	2	94	11	0	75312
16210	17	188	3	77302	0	77510
16211	56	1	76747	7	0	76811
16212	36	129	3	77525	0	77693
16213	77287	5	92	9	0	77393
16214	7	76887	3	76	0	76973
16215	74636	8	166	13	0	74823
16216	8	75082	6	75	0	75171
16217	71981	13	203	11	0	72208
16218	5	74016	1	66	0	74088
16219	4	69033	4	43	0	69084
16220	86	9	69528	17	0	69640
16221	10	67947	0	106	0	68063
16222	68245	2	138	13	0	68398
16223	9	98	1	70336	0	70444
16224	70067	5	67	13	0	70152
16225	5	68136	0	41	0	68182
16226	66316	9	129	12	0	66466
16227	47	3	68672	6	0	68728
16228	16	245	8	70453	0	70722
16229	3	71758	3	38	0	71802
16230	22	204	7	71355	0	71588
16231	7	46	2	71782	0	71837
16232	71733	3	92	9	0	71837
16233	4	70871	3	28	0	70906
16234	69524	8	158	12	0	69702
16235	61	6	69579	6	0	69652
16236	78	6	69895	27	0	70006
16237	6	69548	3	30	0	69587
16238	8	214	7	70782	0	71011
16239	97	1	72897	11	0	73006
16240	10	192	11	73081	0	73294
16241	17	153	19	72876	0	73065
16242	67	0	70436	31	0	70534
16243	55	5	70552	33	0	70645
16244	82	2	70026	29	0	70139
16245	87	11	70428	35	0	70561
16246	8	69918	3	61	0	69990
16247	18	220	7	70235	0	70480
16248	20	191	11	69731	0	69953
16249	56	0	70012	3	0	70071
16250	30	171	25	68131	0	68357
16251	77	1	68527	8	0	68613
16252	9	237	2	68771	0	69019
16253	11	224	2	68281	0	68518
16254	4	67859	0	53	0	67916
16255	21	250	13	67418	0	67702
16256	21	186	8	69247	0	69462
16257	14	220	3	68973	0	69210
16258	50	5	68633	16	0	68704
16259	8	68006	2	45	0	68061
16260	67817	4	89	10	0	67920
16261	68408	9	119	16	0	68552
16262	6	169	4	69009	0	69188
16263	32	211	5	69856	0	70104
16264	4	69728	2	84	0	69818
16265	69668	7	145	12	0	69832
16266	2	69633	1	22	0	69658
16267	69118	7	123	19	0	69267
16268	54	3	69388	6	0	69451
16269	73017	6	154	21	0	73198
16270	2	74908	0	22	0	74932
16271	7	356	5	73889	0	74257
16272	26	184	9	76741	0	76960
16273	5	78154	1	25	0	78185
16274	78930	12	122	34	0	79098
16275	10	133	5	77807	0	77955
16276	14	87	8	78000	0	78109
16277	78576	3	76	14	0	78669
16278	78157	9	175	17	0	78358
16279	57	2	78159	4	0	78222
16280	76783	14	214	20	0	77031
16281	7	190	7	74504	0	74708
16282	88	0	72060	7	0	72155
16283	44	178	7	72187	0	72416
16284	77	2	69717	34	0	69830
16285	76	3	64522	10	0	64611
16286	9	130	6	62812	0	62957
16287	89	1	61143	21	0	61254
16288	5	62494	0	30	0	62529
16289	18	268	8	62586	0	62880
16290	11	102	6	65531	0	65650
16291	71	2	65549	5	0	65627
16292	6	65254	1	80	0	65341
16293	65410	2	138	6	0	65556
16294	10	116	5	65931	0	66062
16295	66759	3	78	11	0	66851
16296	4	66107	1	51	0	66163
16297	68	2	65947	4	0	66021
16298	9	139	4	66220	0	66372
16299	62859	4	88	7	0	62958
16300	36	3	63456	5	0	63500
16301	65098	2	161	20	0	65281
16302	20	63185	4	36	0	63245
16303	7	60643	0	31	0	60681
16304	60733	4	62	18	0	60817
16305	8	133	4	64113	0	64258
16306	9	209	9	64040	0	64267
16307	5	64980	3	30	0	65018
16308	13	178	10	64743	0	64944
16309	5	107	7	64055	0	64174
16310	64684	2	42	6	0	64734
16311	10	206	9	63199	0	63424
16312	61	1	63932	32	0	64026
16313	16	160	10	63859	0	64045
16314	3	110	19	61258	0	61390
16315	26	1	60654	10	0	60691
16316	6	94	2	60752	0	60854
16317	60738	2	57	4	0	60801
16318	60448	9	86	15	0	60558
16319	60741	5	99	6	0	60851
16320	7	129	3	60883	0	61022
16321	54	0	60143	18	0	60215
16322	3	63247	3	36	0	63289
16323	12	143	8	62715	0	62878
16324	29	0	65292	7	0	65328
16325	17	177	6	65244	0	65444
16326	4	91	3	65309	0	65407
16327	65690	7	95	6	0	65798
16328	5	65416	14	52	0	65487
16329	89	2	65288	6	0	65385
16330	66221	5	144	17	0	66387
16331	10	65790	2	24	0	65826
16332	10	64288	1	65	0	64364
16333	62646	1	111	13	0	62771
16334	17	189	11	64522	0	64739
16335	39	1	65889	6	0	65935
16336	26	217	5	66799	0	67047
16337	6	66421	1	39	0	66467
16338	67846	4	187	18	0	68055
16339	8	126	6	68012	0	68152
16340	68069	13	87	11	0	68180
16341	21	243	13	67528	0	67805
16342	4	67615	3	41	0	67663
16343	65288	7	155	14	0	65464
16344	64824	11	125	8	0	64968
16345	3	63245	0	27	0	63275
16346	62304	6	97	9	0	62416
16347	19	207	18	62445	0	62689
16348	7	59507	0	28	0	59542
16349	60483	13	119	15	0	60630
16350	0	60339	0	16	0	60355
16351	59933	3	102	10	0	60048
16352	5	50	6	60945	0	61006
16353	60579	3	44	4	0	60630
16354	63850	10	120	18	0	63998
16355	63329	7	49	15	0	63400
16356	12	99	5	63216	0	63332
16357	4	64	7	63932	0	64007
16358	61871	5	71	12	0	61959
16359	37	0	62226	6	0	62269
16360	17	197	10	63568	0	63792
16361	5	62710	2	35	0	62752
16362	21	171	10	62005	0	62207
16363	14	171	13	60460	0	60658
16364	62	0	60537	12	0	60611
16365	32	147	5	60963	0	61147
16366	3	57393	1	24	0	57421
16367	30	159	12	58688	0	58889
16368	44	1	59354	2	0	59401
16369	13	216	3	60768	0	61000
16370	7	92	2	60689	0	60790
16371	59659	3	69	12	0	59743
16372	60727	6	129	6	0	60868
16373	8	94	4	62286	0	62392
16374	9	62541	2	35	0	62587
16375	12	61516	2	57	0	61587
16376	49	5	62064	5	0	62123
16377	8	95	5	62751	0	62859
16378	62325	1	75	8	0	62409
16379	11	117	6	63076	0	63210
16380	57	0	62382	5	0	62444
16381	22	148	39	59278	0	59487
16382	11	160	11	59425	0	59607
16383	16	172	5	58896	0	59089
16384	101	2	58830	3	0	58936
16385	33	58464	1	73	0	58571
16386	58621	1	72	12	0	58706
16387	58707	13	146	7	0	58873
16388	9	62	0	57072	0	57143
16389	84	0	58225	6	0	58315
16390	10	60274	1	59	0	60344
16391	32	180	8	59732	0	59952
16392	25	60582	2	79	0	60688
16393	5	60696	3	63	0	60767
16394	61030	9	125	11	0	61175
16395	59	3	60933	13	0	61008
16396	48	4	61562	12	0	61626
16397	12	166	6	61817	0	62001
16398	18	161	23	57994	0	58196
16399	33	1	57982	4	0	58020
16400	11	157	11	57629	0	57808
16401	83	1	57834	2	0	57920
16402	58420	5	140	19	0	58584
16403	7	170	7	57812	0	57996
16404	28	2	57479	9	0	57518
16405	33	187	14	58230	0	58464
16406	14	57723	1	65	0	57803
16407	58071	11	142	12	0	58236
16408	3	57897	0	52	0	57952
16409	57615	7	143	13	0	57778
16410	32	14	56319	6	0	56371
16411	58840	5	126	11	0	58982
16412	7	131	9	58728	0	58875
16413	44	0	57960	3	0	58007
16414	14	129	16	56328	0	56487
16415	30	0	55432	16	0	55478
16416	55506	11	107	25	0	55649
16417	11	57345	2	17	0	57375
16418	38	192	9	57100	0	57339
16419	33	57333	1	18	0	57385
16420	58100	7	130	7	0	58244
16421	59638	5	114	13	0	59770
16422	3	60036	0	30	0	60069
16423	5	317	6	59484	0	59812
16424	16	107	5	60125	0	60253
16425	4	53	3	59311	0	59371
16426	59968	7	57	7	0	60039
16427	4	59813	0	20	0	59837
16428	5	122	5	58627	0	58759
16429	7	62	3	58688	0	58760
16430	54690	6	88	10	0	54794
16431	14	1	55114	7	0	55136
16432	29	0	54888	13	0	54930
16433	54594	8	194	29	0	54825
16434	46	3	56177	8	0	56234
16435	34	1	57891	7	0	57933
16436	8	105	10	57175	0	57298
16437	57002	4	88	13	0	57107
16438	11	108	8	56791	0	56918
16439	32	0	56861	9	0	56902
16440	56653	7	190	31	0	56881
16441	45	0	57810	3	0	57858
16442	13	57051	3	44	0	57111
16443	7	72	6	55211	0	55296
16444	56856	2	66	3	0	56927
16445	8	118	5	57236	0	57367
16446	2	210	2	57278	0	57492
16447	58788	4	52	7	0	58851
16448	9	109	2	57145	0	57265
16449	9	128	6	55376	0	55519
16450	44	2	55223	11	0	55280
16451	17	55	2	54507	0	54581
16452	54727	5	46	5	0	54783
16453	54335	5	87	8	0	54435
16454	54188	6	71	6	0	54271
16455	15	144	3	54181	0	54343
16456	7	53942	0	22	0	53971
16457	55255	6	119	9	0	55389
16458	1	55719	1	29	0	55750
16459	57010	6	157	15	0	57188
16460	6	48	5	57164	0	57223
16461	56810	4	83	8	0	56905
16462	56547	7	161	23	0	56738
16463	56966	11	143	8	0	57128
16464	9	55238	2	21	0	55270
16465	4	52752	0	34	0	52790
16466	52578	6	90	10	0	52684
16467	19	54512	4	49	0	54584
16468	34	55112	3	45	0	55194
16469	4	55169	1	46	0	55220
16470	55076	1	56	12	0	55145
16471	13	113	5	54841	0	54972
16472	4	58	3	54776	0	54841
16473	54749	7	84	2	0	54842
16474	24	1	56538	0	0	56563
16475	2	174	85	56392	0	56653
16476	14	171	11	56404	0	56600
16477	4	171	5	56527	0	56707
16478	16	159	2	56463	0	56640
16479	18	56274	1	36	0	56329
16480	6	55028	0	37	0	55071
16481	55401	3	72	4	0	55480
16482	11	162	6	55430	0	55609
16483	4	109	3	54634	0	54750
16484	21	0	55934	15	0	55970
16485	20	116	9	54672	0	54817
16486	47	2	54979	6	0	55034
16487	18	139	7	54511	0	54675
16488	55	7	54423	6	0	54491
16489	5	54870	3	47	0	54925
16490	15	85	2	54642	0	54744
16491	55113	6	95	14	0	55228
16492	55209	8	129	15	0	55361
16493	12	103	7	53521	0	53643
16494	53	2	53628	3	0	53686
16495	26	0	51976	13	0	52015
16496	52298	4	197	19	0	52518
16497	14	51088	2	49	0	51153
16498	50172	9	97	15	0	50293
16499	50838	6	112	9	0	50965
16500	18	0	51730	5	0	51753
16501	7	134	27	52378	0	52546
16502	8	98	10	51078	0	51194
16503	10	167	8	50510	0	50695
16504	14	82	3	51532	0	51631
16505	5	86	6	51563	0	51660
16506	11	0	51919	3	0	51933
16507	29	1	51608	8	0	51646
16508	5	65	8	50117	0	50195
16509	11	87	5	48865	0	48968
16510	7	40	4	48718	0	48769
16511	50419	7	37	0	0	50463
16512	7	51	5	50468	0	50531
16513	50729	2	38	11	0	50780
16514	4	25	2	50930	0	50961
16515	50556	4	33	1	0	50594
16516	49934	3	46	13	0	49996
16517	50972	3	42	5	0	51022
16518	49434	1	62	9	0	49506
16519	50526	6	54	16	0	50602
16520	1	33	2	48308	0	48344
16521	47927	3	87	7	0	48024
16522	5	47930	1	19	0	47955
16523	47737	6	151	5	0	47899
16524	13	111	2	47939	0	48065
16525	20	0	48537	6	0	48563
16526	7	112	5	48146	0	48270
16527	33	0	48175	7	0	48215
16528	21	112	9	47835	0	47977
16529	17	72	10	47553	0	47652
16530	49	2	47662	16	0	47729
16531	41	1	46926	10	0	46978
16532	7	53	0	45898	0	45958
16533	43917	5	92	8	0	44022
16534	28	1	44246	8	0	44283
16535	7	44862	3	70	0	44942
16536	51	3	45128	0	0	45182
16537	44869	3	62	24	0	44958
16538	4	51	1	45489	0	45545
16539	44836	2	56	4	0	44898
16540	48555	5	80	5	0	48645
16541	7	86	5	48886	0	48984
16542	58	1	48991	4	0	49054
16543	7	119	6	47342	0	47474
16544	2	67	2	46307	0	46378
16545	48750	1	82	2	0	48835
16546	4	48498	3	42	0	48547
16547	19	101	2	48156	0	48278
16548	40	1	48247	17	0	48305
16549	47755	7	162	14	0	47938
16550	3	47546	2	46	0	47597
16551	8	154	5	46725	0	46892
16552	6	66	5	46607	0	46684
16553	8	51	0	46947	0	47006
16554	46645	3	32	3	0	46683
16555	46538	3	103	10	0	46654
16556	10	46	0	46984	0	47040
16557	32	0	46272	6	0	46310
16558	11	46309	3	39	0	46362
16559	44499	5	151	18	0	44673
16560	43467	5	129	18	0	43619
16561	10	53	9	44024	0	44096
16562	14	84	1	43686	0	43785
16563	29	4	43399	16	0	43448
16564	6	42876	2	56	0	42940
16565	43146	4	82	7	0	43239
16566	44381	3	147	11	0	44542
16567	4	43690	0	29	0	43723
16568	43974	2	111	5	0	44092
16569	5	78	5	44248	0	44336
16570	40	0	43932	5	0	43977
16571	9	94	8	43964	0	44075
16572	33	9	43873	9	0	43924
16573	43700	3	148	58	0	43909
16574	4	42181	3	24	0	42212
16575	19	79	4	41004	0	41106
16576	33	1	41806	10	0	41850
16577	21	0	42234	24	0	42279
16578	42556	2	126	11	0	42695
16579	6	43144	1	19	0	43170
16580	42409	8	81	5	0	42503
16581	42351	6	78	7	0	42442
16582	42664	8	101	2	0	42775
16583	5	56	4	42679	0	42744
16584	44	2	42525	3	0	42574
16585	4	40482	1	44	0	40531
16586	16	65	7	39561	0	39649
16587	59	2	39883	10	0	39954
16588	50	1	41145	5	0	41201
16589	7	90	10	42146	0	42253
16590	34	0	42066	7	0	42107
16591	41516	5	99	7	0	41627
16592	5	88	5	41775	0	41873
16593	1	40	1	40687	0	40729
16594	40851	1	51	4	0	40907
16595	3	40398	3	39	0	40443
16596	39956	0	72	4	0	40032
16597	9	61	3	39938	0	40011
16598	10	64	2	38758	0	38834
16599	6	59	7	42121	0	42193
16600	4	38	3	41751	0	41796
16601	41292	2	70	2	0	41366
16602	40	1	41430	4	0	41475
16603	2	41329	5	31	0	41367
16604	13	72	4	40794	0	40883
16605	40760	5	54	5	0	40824
16606	40374	4	103	13	0	40494
16607	8	43017	0	25	0	43050
16608	43198	8	107	12	0	43325
16609	18	49793	0	26	0	49837
16610	16	48849	1	25	0	48891
16611	24	118	9	48096	0	48247
16612	42	0	51067	1	0	51110
16613	14	65	6	51326	0	51411
16614	51789	7	61	11	0	51868
16615	2	50063	3	40	0	50108
16616	14	100	5	47415	0	47534
16617	20	2	47713	10	0	47745
16618	50776	4	120	18	0	50918
16619	50592	0	109	3	0	50704
16620	50336	7	228	7	0	50578
16621	52	0	48097	2	0	48151
16622	50991	3	164	13	0	51171
16623	3	51703	1	19	0	51726
16624	17	119	3	50817	0	50956
16625	15	49382	0	35	0	49432
16626	49472	8	135	9	0	49624
16627	49773	4	129	6	0	49912
16628	24	1	49889	5	0	49919
16629	4	51976	0	33	0	52013
16630	4	157	7	51680	0	51848
16631	3	80	4	52133	0	52220
16632	4	80	3	52538	0	52625
16633	16	50	8	52649	0	52723
16634	5	97	7	52165	0	52274
16635	98	5	52157	3	0	52263
16636	6	51950	2	47	0	52005
16637	51627	6	177	8	0	51818
16638	51	0	51163	5	0	51219
16639	5	51273	1	52	0	51331
16640	51245	10	142	7	0	51404
16641	67	4	51453	3	0	51527
16642	51972	7	155	12	0	52146
16643	51719	3	168	10	0	51900
16644	51762	7	166	3	0	51938
16645	1	51504	0	34	0	51539
16646	73	1	51545	7	0	51626
16647	1	51049	0	29	0	51079
16648	15	135	4	50399	0	50553
16649	68	50376	4	38	0	50486
16650	51587	8	134	15	0	51744
16651	52217	6	131	9	0	52363
16652	51192	15	174	4	0	51385
16653	29	1	51177	4	0	51211
16654	7	53309	1	24	0	53341
16655	5	57	3	52999	0	53064
16656	53742	3	87	9	0	53841
16657	3	53138	2	22	0	53165
16658	21	108	10	52918	0	53057
16659	56	0	53329	5	0	53390
16660	51894	8	147	12	0	52061
16661	20	1	52179	3	0	52203
16662	22	1	52147	11	0	52181
16663	50832	9	166	19	0	51026
16664	53	0	51153	5	0	51211
16665	50694	6	182	15	0	50897
16666	7	52632	5	33	0	52677
16667	52665	6	83	8	0	52762
16668	5	66	7	52186	0	52264
16669	10	88	8	52099	0	52205
16670	11	46	2	52240	0	52299
16671	51481	3	45	10	0	51539
16672	50979	6	134	7	0	51126
16673	51039	10	82	6	0	51137
16674	4	50323	1	20	0	50348
16675	9	77	4	46719	0	46809
16676	28	0	53328	2	0	53358
16677	11	153	3	53664	0	53831
16678	8	54263	0	17	0	54288
16679	7	97	4	54322	0	54430
16680	6	46	2	54912	0	54966
16681	57160	3	76	10	0	57249
16682	19	74	6	57208	0	57307
16683	50	1	54745	1	0	54797
16684	50	0	58061	10	0	58121
16685	6	61	7	50251	0	50325
16686	49909	0	95	8	0	50012
16687	3	89	6	51424	0	51522
16688	16	83	4	48866	0	48969
16689	48	1	49075	11	0	49135
16690	8	48928	0	54	0	48990
16691	9	70	2	50161	0	50242
16692	50535	5	105	10	0	50655
16693	4	49951	5	39	0	49999
16694	16	94	5	45913	0	46028
16695	44	6	48601	4	0	48655
16696	14	65	5	46280	0	46364
16697	46668	0	77	2	0	46747
16698	2	46081	2	52	0	46137
16699	51	2	45832	5	0	45890
16700	17	95	9	45769	0	45890
16701	36	1	45349	9	0	45395
16702	45435	3	187	23	0	45648
16703	45433	5	171	15	0	45624
16704	38	0	45669	10	0	45717
16705	7	78	4	44132	0	44221
16706	47	1	43859	15	0	43922
16707	3	43902	3	53	0	43961
16708	27	96	9	43906	0	44038
16709	28	0	44750	11	0	44789
16710	13	85	4	44983	0	45085
16711	3	46426	2	28	0	46459
16712	23	82	5	46470	0	46580
16713	45	6	46130	3	0	46184
16714	46130	10	151	15	0	46306
16715	5	46253	0	19	0	46277
16716	45260	10	161	12	0	45443
16717	27	1	45510	2	0	45540
16718	45279	5	149	10	0	45443
16719	56	2	46885	2	0	46945
16720	47764	7	160	23	0	47954
16721	47980	3	129	9	0	48121
16722	4	77	11	47898	0	47990
16723	2	55	2	48070	0	48129
16724	48251	6	80	9	0	48346
16725	0	48817	2	35	0	48854
16726	48173	11	129	8	0	48321
16727	11	95	6	47584	0	47696
16728	6	45591	2	20	0	45619
16729	24	212	10	45352	0	45598
16730	5	86	3	47613	0	47707
16731	13	90	2	47529	0	47634
16732	5	47195	2	22	0	47224
16733	46999	5	131	9	0	47144
16734	11	75	2	47080	0	47168
16735	35	1	46613	2	0	46651
16736	45	1	47161	16	0	47223
16737	53	1	47192	7	0	47253
16738	46614	10	169	24	0	46817
16739	46511	10	182	6	0	46709
16740	22	2	47113	4	0	47141
16741	9	68	6	48029	0	48112
16742	10	73	1	46224	0	46308
16743	40	2	46623	11	0	46676
16744	29	3	46431	7	0	46470
16745	3	63	3	48689	0	48758
16746	48805	4	91	24	0	48924
16747	49689	6	169	16	0	49880
16748	51546	33	223	18	0	51820
16749	14	55548	1	40	0	55603
16750	4	48914	2	38	0	48958
16751	8	58	5	48880	0	48951
16752	47977	3	83	11	0	48074
16753	53	3	48139	8	0	48203
16754	48906	3	175	15	0	49099
16755	17	48827	4	47	0	48895
16756	14	48017	2	29	0	48062
16757	48378	6	106	18	0	48508
16758	19	48747	2	30	0	48798
16759	7	46418	3	38	0	46466
16760	46697	6	87	16	0	46806
16761	1	44810	0	20	0	44831
16762	15	92	7	43847	0	43961
16763	10	32	4	44204	0	44250
16764	46067	3	54	6	0	46130
16765	45960	1	126	9	0	46096
16766	13	45245	0	53	0	45311
16767	5	43552	1	56	0	43614
16768	63	1	43599	3	0	43666
16769	44075	4	51	11	0	44141
16770	44121	1	81	7	0	44210
16771	42186	4	49	7	0	42246
16772	7	67	11	41690	0	41775
16773	1	46	4	41724	0	41775
16774	41907	2	46	2	0	41957
16775	5	56	7	41780	0	41848
16776	17	0	41964	6	0	41987
16777	10	79	3	42698	0	42790
16778	8	43835	2	11	0	43856
16779	10	241	7	43350	0	43608
16780	25	76	5	45700	0	45806
16781	9	51	3	45953	0	46016
16782	46390	0	41	10	0	46441
16783	6	45717	1	23	0	45747
16784	14	56	7	45214	0	45291
16785	25	0	45759	8	0	45792
16786	24	3	46440	9	0	46476
16787	11	71	9	44998	0	45089
16788	5	63	4	45464	0	45536
16789	45252	2	61	6	0	45321
16790	16	86	9	45034	0	45145
16791	10	45353	0	32	0	45395
16792	34	2	45693	6	0	45735
16793	9	98	4	46263	0	46374
16794	24	1	46089	4	0	46118
16795	11	63	10	44343	0	44427
16796	44696	0	93	11	0	44800
16797	45779	7	123	13	0	45922
16798	3	45685	1	14	0	45703
16799	9	51	2	45297	0	45359
16800	45477	3	21	1	0	45502
16801	44668	0	81	8	0	44757
16802	44713	5	113	4	0	44835
16803	44496	5	123	6	0	44630
16804	44628	33	133	5	0	44799
16805	4	44685	2	31	0	44722
16806	42424	6	135	11	0	42576
16807	15	0	43247	1	0	43263
16808	6	56	3	47067	0	47132
16809	47209	0	90	3	0	47302
16810	47018	7	133	17	0	47175
16811	46385	4	229	16	0	46634
16812	25	0	47821	4	0	47850
16813	7	50	2	47762	0	47821
16814	48042	4	84	8	0	48138
16815	17	47951	0	59	0	48027
16816	49153	8	151	14	0	49326
16817	49145	6	166	10	0	49327
16818	49046	2	146	7	0	49201
16819	7	70	3	48747	0	48827
16820	48084	2	64	5	0	48155
16821	11	1	47031	12	0	47055
16822	18	4	47573	5	0	47600
16823	45938	1	222	22	0	46183
16824	37	0	46089	2	0	46128
16825	41621	4	146	7	0	41778
16826	36	0	42229	1	0	42266
16827	6	49	5	42439	0	42499
16828	42088	3	93	20	0	42204
16829	2	41516	0	65	0	41583
16830	40928	3	140	7	0	41078
16831	21	41523	1	61	0	41606
16832	3	40751	0	22	0	40776
16833	12	114	6	38964	0	39096
16834	4	81	2	39870	0	39957
16835	8	76	3	39215	0	39302
16836	35	0	39215	5	0	39255
16837	39349	5	84	8	0	39446
16838	39577	2	45	4	0	39628
16839	40388	2	157	4	0	40551
16840	38525	3	92	3	0	38623
16841	38382	5	163	3	0	38553
16842	14	0	38630	3	0	38647
16843	21	2	39053	4	0	39080
16844	71	54	39	39350	0	39514
16845	40	1	40259	6	0	40306
16846	40681	1	108	11	0	40801
16847	4	41976	1	31	0	42012
16848	6	46	4	42051	0	42107
16849	43037	3	77	6	0	43123
16850	9	56	8	44520	0	44593
16851	70	1	43962	4	0	44037
16852	36	0	44637	10	0	44683
16853	14	72	6	46432	0	46524
16854	30	1	44536	5	0	44572
16855	50653	2	114	13	0	50782
16856	2	68	4	49218	0	49292
16857	37	3	49097	6	0	49143
16858	9	48203	2	36	0	48250
16859	26	100	2	47663	0	47791
16860	67	2	49375	0	0	49444
16861	12	89	10	51212	0	51323
16862	15	118	5	52012	0	52150
16863	27	1	52474	1	0	52503
16864	9	162	58	51707	0	51936
16865	14	87	8	52059	0	52168
16866	2	54	3	51943	0	52002
16867	53213	1	86	10	0	53310
16868	21	52747	3	81	0	52852
16869	15	51443	3	87	0	51548
16870	48	2	51777	7	0	51834
16871	52237	1	126	29	0	52393
16872	57	2	52919	10	0	52988
16873	48	1	53366	15	0	53430
16874	5	88	0	53661	0	53754
16875	53938	2	98	6	0	54044
16876	3	53994	0	77	0	54074
16877	53844	6	166	25	0	54041
16878	57253	5	161	10	0	57429
16879	5	59885	0	32	0	59922
16880	58228	4	136	8	0	58376
16881	58914	4	133	5	0	59056
16882	7	56857	2	25	0	56891
16883	21	116	2	56752	0	56891
16884	6	63	3	57345	0	57417
16885	57344	2	99	7	0	57452
16886	5	57020	0	51	0	57076
16887	56977	8	100	7	0	57092
16888	57244	4	96	13	0	57357
16889	57429	3	50	4	0	57486
16890	8	71	5	57334	0	57418
16891	9	38	4	56857	0	56908
16892	55284	1	48	10	0	55343
16893	55211	5	63	8	0	55287
16894	55404	6	70	2	0	55482
16895	8	69	3	56277	0	56357
16896	44	0	56544	2	0	56590
16897	8	110	8	54736	0	54862
16898	16	81	11	54576	0	54684
16899	47	2	54566	7	0	54622
16900	36	3	54211	7	0	54257
16901	17	102	7	55014	0	55140
16902	38	3	54737	5	0	54783
16903	55893	5	93	14	0	56005
16904	9	103	9	55987	0	56108
16905	9	75	8	63795	0	63887
16906	65339	3	54	6	0	65402
16907	29	138	14	64558	0	64739
16908	24	147	3	63884	0	64058
16909	11	159	8	64146	0	64324
16910	19	120	7	63805	0	63951
16911	40	9	64139	8	0	64196
16912	11	117	4	64147	0	64279
16913	58	1	63946	10	0	64015
16914	14	64281	3	47	0	64345
16915	19	124	12	63848	0	64003
16916	63	1	64208	12	0	64284
16917	64757	4	154	19	0	64934
16918	19	65012	4	44	0	65079
16919	70489	7	172	7	0	70675
16920	34	172	12	69699	0	69917
16921	24	71265	0	56	0	71345
16922	73384	11	214	23	0	73632
16923	11	72373	2	61	0	72447
16924	73437	7	184	29	0	73657
16925	9	110	4	72593	0	72716
16926	70763	3	101	33	0	70900
16927	12	71298	4	57	0	71371
16928	68570	6	187	24	0	68787
16929	55	1	69195	2	0	69253
16930	8	80	13	69289	0	69390
16931	66295	3	106	7	0	66411
16932	65923	8	123	14	0	66068
16933	14	119	7	66082	0	66222
16934	99	2	66601	3	0	66705
16935	45	67503	8	59	0	67615
16936	11	69094	4	42	0	69151
16937	69350	4	133	8	0	69495
16938	14	148	5	68471	0	68638
16939	9	56	3	68853	0	68921
16940	69286	1	50	10	0	69347
16941	68631	4	150	9	0	68794
16942	54	0	68933	1	0	68988
16943	5	122	6	68731	0	68864
16944	78	10	68136	5	0	68229
16945	32	69344	3	50	0	69429
16946	71087	6	229	13	0	71335
16947	19	70237	8	70	0	70334
16948	12	69293	2	50	0	69357
16949	16	101	2	69431	0	69550
16950	70254	5	122	7	0	70388
16951	9	71334	1	183	0	71527
16952	72991	2	174	17	0	73184
16953	7	72997	1	44	0	73049
16954	6	133	8	69996	0	70143
16955	67428	3	155	8	0	67594
16956	48	0	66876	8	0	66932
16957	18	153	8	65870	0	66049
16958	100	11	65450	10	0	65571
16959	28	65246	4	105	0	65383
16960	13	64822	4	47	0	64886
16961	65497	6	154	45	0	65702
16962	16	65806	0	38	0	65860
16963	65963	5	149	11	0	66128
16964	64442	4	145	17	0	64608
16965	32	2	64129	5	0	64168
16966	62482	11	237	20	0	62750
16967	33	1	63491	6	0	63531
16968	21	62835	2	50	0	62908
16969	63127	3	137	13	0	63280
16970	8	63436	2	43	0	63489
16971	12	75	2	62356	0	62445
16972	66585	4	94	12	0	66695
16973	16	119	8	66312	0	66455
16974	68	3	66131	12	0	66214
16975	26	117	8	65778	0	65929
16976	2	51	5	65204	0	65262
16977	64612	6	97	9	0	64724
16978	31	0	64661	3	0	64695
16979	62938	2	152	18	0	63110
16980	62982	2	118	11	0	63113
16981	10	108	5	54715	0	54838
16982	3	64	4	53739	0	53810
16983	53202	2	55	10	0	53269
16984	4	53037	2	16	0	53059
16985	20	111	3	52688	0	52822
16986	64	0	54170	7	0	54241
16987	63	9	54094	19	0	54185
16988	4	55010	2	34	0	55050
16989	21	127	12	54720	0	54880
16990	6	75	2	54518	0	54601
16991	55164	2	59	5	0	55230
16992	5	95	1	54713	0	54814
16993	55371	4	68	3	0	55446
16994	16	53522	5	68	0	53611
16995	25	47847	4	49	0	47925
16996	82	45992	4	25	0	46103
16997	45401	7	54	8	0	45470
16998	44951	4	109	10	0	45074
16999	2	44341	1	31	0	44375
17000	43689	7	83	6	0	43785
17001	2	42823	1	14	0	42840
17002	12	125	12	40359	0	40508
17003	4	41815	0	15	0	41834
17004	41444	10	63	9	0	41526
17005	41129	5	92	4	0	41230
17006	7	60	1	41667	0	41735
17007	39858	1	42	7	0	39908
17008	13	118	2	39768	0	39901
17009	0	38206	2	20	0	38228
17010	11	152	9	34189	0	34361
17011	2	35419	1	23	0	35445
17012	32103	2	71	4	0	32180
17013	17	0	32027	2	0	32046
17014	31697	3	43	7	0	31750
17015	5	57	8	31326	0	31396
17016	35	0	31014	4	0	31053
17017	28991	3	57	8	0	29059
17018	5	1	29506	5	0	29517
17019	8	93	17	30191	0	30309
17020	0	85	19	29786	0	29890
17021	4	72	0	28794	0	28870
17022	10	95	12	28692	0	28809
17023	3	27473	1	79	0	27556
17024	13	44	1	27623	0	27681
17025	27418	3	54	5	0	27480
17026	64	4	26810	4	0	26882
17027	5	25376	4	28	0	25413
17028	23529	2	43	7	0	23581
17029	23624	1	29	2	0	23656
17030	2	63	3	22858	0	22926
17031	19	1	23087	0	0	23107
17032	7	70	4	23031	0	23112
17033	1	71	1	22614	0	22687
17034	44	1	22364	13	0	22422
17035	0	22365	3	16	0	22384
17036	22324	6	51	3	0	22384
17037	22340	3	37	2	0	22382
17038	21853	3	24	7	0	21887
17039	3	19	3	21991	0	22016
17040	3	35	2	21831	0	21871
17041	22441	4	23	1	0	22469
17042	7	65	4	22432	0	22508
17043	0	22449	0	8	0	22457
17044	22287	1	40	5	0	22333
17045	22337	0	52	1	0	22390
17046	21638	3	49	2	0	21692
17047	21725	5	33	2	0	21765
17048	4	0	18323	0	0	18327
17049	30	0	18502	1	0	18533
17050	2	50	1	18401	0	18454
17051	5	66	4	18299	0	18374
17052	11	1	18348	3	0	18363
17053	12	2	18494	9	0	18517
17054	8	41	1	19269	0	19319
17055	19629	1	39	1	0	19670
17056	2	30	5	19513	0	19550
17057	32	2	19066	0	0	19100
17058	2	19960	1	12	0	19975
17059	20583	1	48	2	0	20634
17060	20835	2	61	2	0	20900
17061	20815	3	34	4	0	20856
17062	19093	4	64	1	0	19162
17063	2	0	19700	0	0	19702
17064	3	24	0	19208	0	19235
17065	20060	1	13	2	0	20076
17066	3	49	2	20056	0	20110
17067	4	37	2	19509	0	19552
17068	5	18976	0	10	0	18991
17069	4	39	3	18904	0	18950
17070	19286	0	16	2	0	19304
17071	0	19324	0	7	0	19331
17072	18927	0	46	0	0	18973
17073	0	20466	0	6	0	20472
17074	2	65	1	19836	0	19904
17075	3	20727	0	13	0	20743
17076	2	19995	0	21	0	20018
17077	19869	3	37	4	0	19913
17078	17	0	19909	1	0	19927
17079	14	0	19102	7	0	19123
17080	34	2	19264	1	0	19301
17081	22721	3	43	5	0	22772
17082	6	23784	0	24	0	23814
17083	2	23669	1	14	0	23686
17084	24928	1	37	5	0	24971
17085	3	25089	1	8	0	25101
17086	5	24911	1	18	0	24935
17087	12	67	2	24888	0	24969
17088	39	0	24955	2	0	24996
17089	47	2	26161	3	0	26213
17090	2	42	3	26543	0	26590
17091	26576	5	27	3	0	26611
17092	1	26122	1	9	0	26133
17093	13	37	4	24974	0	25028
17094	18	1	25506	5	0	25530
17095	20	0	25539	1	0	25560
17096	2	30	0	25896	0	25928
17097	25530	2	22	7	0	25561
17098	24268	5	48	10	0	24331
17099	10	0	24446	4	0	24460
17100	23993	0	78	3	0	24074
17101	16	3	24513	4	0	24536
17102	5	85	2	24359	0	24451
17103	1	24198	1	41	0	24241
17104	24236	1	39	0	0	24276
17105	1	53	6	23968	0	24028
17106	3	46	2	24102	0	24153
17107	4	30	3	23977	0	24014
17108	3	44	2	23845	0	23894
17109	26	0	23903	4	0	23933
17110	0	25519	0	7	0	25526
17111	5	43	1	25570	0	25619
17112	25536	1	26	2	0	25565
17113	2	56	1	25522	0	25581
17114	11	61	2	25641	0	25715
17115	37	0	25500	8	0	25545
17116	25	3	26148	8	0	26184
17117	9	27741	3	21	0	27774
17118	2	27732	0	27	0	27761
17119	4	61	5	29955	0	30025
17120	30034	3	25	6	0	30068
17121	34	0	30528	8	0	30570
17122	3	30923	0	6	0	30932
17123	3	136	14	30455	0	30608
17124	4	31382	0	14	0	31400
17125	4	136	5	30849	0	30994
17126	4	32144	0	13	0	32161
17127	10	59	4	32134	0	32207
17128	32280	3	32	3	0	32318
17129	1	32480	0	20	0	32501
17130	11	69	6	31722	0	31808
17131	31900	4	36	7	0	31947
17132	5	32029	0	15	0	32049
17133	4	31173	0	17	0	31194
17134	1	30931	0	31	0	30963
17135	4	104	9	30175	0	30292
17136	9	102	6	30178	0	30295
17137	2	30065	1	6	0	30074
17138	6	71	3	29717	0	29797
17139	56	0	29837	4	0	29897
17140	2	29080	0	13	0	29095
17141	15	117	1	28496	0	28629
17142	6	29117	2	26	0	29151
17143	65	5	29148	2	0	29220
17144	4	29343	0	17	0	29364
17145	29530	1	39	0	0	29570
17146	8	56	1	29571	0	29636
17147	30329	1	27	10	0	30367
17148	13	1	34539	3	0	34556
17149	17	102	3	32927	0	33049
17150	32	1	34622	2	0	34657
17151	2	73	7	35097	0	35179
17152	35115	1	37	6	0	35159
17153	8	81	3	35106	0	35198
17154	34937	2	40	3	0	34982
17155	1	34887	0	30	0	34918
17156	31347	5	50	3	0	31405
17157	15	0	31181	4	0	31200
17158	0	29458	1	9	0	29468
17159	9	95	1	28730	0	28835
17160	2	68	1	28825	0	28896
17161	13	1	28717	1	0	28732
17162	4	28817	1	17	0	28839
17163	14	115	5	29389	0	29523
17164	2	29801	3	9	0	29815
17165	10	143	3	29438	0	29594
17166	2	29635	2	9	0	29648
17167	29565	1	63	15	0	29644
17168	5	76	2	29786	0	29869
17169	65	1	29643	6	0	29715
17170	8	29412	2	28	0	29450
17171	3	29181	0	27	0	29211
17172	49	3	29230	4	0	29286
17173	4	29252	0	8	0	29264
17174	8	94	3	29389	0	29494
17175	27	3	31035	3	0	31068
17176	2	93	3	31102	0	31200
17177	7	75	4	31030	0	31116
17178	23	0	31060	6	0	31089
17179	31321	4	77	13	0	31415
17180	4	95	2	31511	0	31612
17181	17	2	31563	6	0	31588
17182	4	32399	0	24	0	32427
17183	33314	9	70	13	0	33406
17184	3	35590	0	12	0	35605
17185	11	52	1	34093	0	34157
17186	37249	2	56	6	0	37313
17187	10	83	3	37226	0	37322
17188	31	0	37657	5	0	37693
17189	10	116	12	37419	0	37557
17190	23	0	37374	6	0	37403
17191	36585	5	112	14	0	36716
17192	9	0	36609	5	0	36623
17193	34352	5	91	10	0	34458
17194	34329	6	75	3	0	34413
17195	23	0	31817	7	0	31847
17196	14	2	31994	13	0	32023
17197	1	31554	1	15	0	31571
17198	31471	3	50	1	0	31525
17199	3	33	2	31514	0	31552
17200	5	14	1	30819	0	30839
17201	30862	4	21	2	0	30889
17202	29893	4	43	10	0	29950
17203	30087	2	40	1	0	30130
17204	30315	1	42	5	0	30363
17205	2	14	2	29749	0	29767
17206	29196	0	24	4	0	29224
17207	3	33	5	29069	0	29110
17208	5	49	3	28910	0	28967
17209	6	49	1	28951	0	29007
17210	23	1	28744	8	0	28776
17211	8	28872	1	21	0	28902
17212	1	29266	0	13	0	29280
17213	3	48	4	28861	0	28916
17214	29213	1	45	6	0	29265
17215	2	57	0	29225	0	29284
17216	29448	3	35	4	0	29490
17217	7	1	30642	1	0	30651
17218	30264	4	56	3	0	30327
17219	2	32	1	30188	0	30223
17220	31272	3	24	3	0	31302
17221	30980	4	60	5	0	31049
17222	31780	2	51	5	0	31838
17223	2	39	3	30725	0	30769
17224	5	0	27433	0	0	27438
17225	5	60	4	27839	0	27908
17226	25033	4	37	6	0	25080
17227	22	2	25223	3	0	25250
17228	5	33	1	25723	0	25762
17229	25657	3	36	5	0	25701
17230	9	1	27440	1	0	27451
17231	28357	3	53	8	0	28421
17232	28621	4	43	4	0	28672
17233	2	19	1	28399	0	28421
17234	2	24	3	28731	0	28760
17235	29116	0	29	2	0	29147
17236	4	23	1	30400	0	30428
17237	30536	1	34	6	0	30577
17238	4	30339	1	12	0	30356
17239	4	29453	0	10	0	29467
17240	7	89	0	28196	0	28292
17241	28	2	28745	1	0	28776
17242	3	28785	3	19	0	28810
17243	29037	2	63	6	0	29108
17244	0	29146	0	18	0	29164
17245	55	1	28940	1	0	28997
17246	7	61	1	30294	0	30363
17247	23	3	29932	5	0	29963
17248	9	31357	0	16	0	31382
17249	17	115	7	31013	0	31152
17250	0	30808	1	28	0	30837
17251	31	5	31243	4	0	31283
17252	8	103	3	31465	0	31579
17253	14	0	31611	4	0	31629
17254	4	57	2	31623	0	31686
17255	30997	4	59	2	0	31062
17256	28	0	30933	7	0	30968
17257	29604	5	85	13	0	29707
17258	10	0	30184	1	0	30195
17259	2	74	3	29755	0	29834
17260	17	0	27799	0	0	27816
17261	6	115	12	27524	0	27657
17262	5	93	4	24495	0	24597
17263	4	52	0	24695	0	24751
17264	4	65	2	24413	0	24484
17265	40	0	24351	7	0	24398
17266	24479	1	59	5	0	24544
17267	4	33	2	24690	0	24729
17268	24572	2	35	2	0	24611
17269	24372	5	37	1	0	24415
17270	24674	1	44	2	0	24721
17271	0	43	2	25347	0	25392
17272	6	57	0	25352	0	25415
17273	2	25259	1	5	0	25267
17274	25860	3	38	3	0	25904
17275	25758	3	33	2	0	25796
17276	25811	1	54	4	0	25870
17277	14	0	25847	21	0	25882
17278	4	60	3	25830	0	25897
17279	19	9	25899	0	0	25927
17280	25562	2	55	6	0	25625
17281	25623	1	76	2	0	25702
17282	5	49	1	25797	0	25852
17283	7	52	2	25811	0	25872
17284	10	25771	1	17	0	25799
17285	25894	8	75	2	0	25979
17286	26336	4	76	4	0	26420
17287	1	27504	0	12	0	27517
17288	27323	6	55	1	0	27385
17289	1	51	2	27795	0	27849
17290	8	19	0	27542	0	27569
17291	27427	4	40	5	0	27476
17292	12	0	27301	3	0	27316
17293	26115	5	78	9	0	26207
17294	26254	0	86	6	0	26346
17295	2	26854	0	13	0	26869
17296	25440	2	53	7	0	25502
17297	10	1	26481	2	0	26494
17298	7	32	4	25491	0	25534
17299	25468	2	36	0	0	25506
17300	7	69	8	25121	0	25205
17301	25	0	25156	4	0	25185
17302	11	105	0	25138	0	25254
17303	1	26058	0	15	0	26074
17304	5	92	4	25418	0	25519
17305	6	34	1	25326	0	25367
17306	3	61	2	23378	0	23444
17307	7	46	0	22394	0	22447
17308	9	0	22411	16	0	22436
17309	5	40	2	22575	0	22622
17310	22254	2	20	6	0	22282
17311	1	21744	1	8	0	21754
17312	10	57	0	20646	0	20713
17313	24	2	22418	2	0	22446
17314	6	20	2	22584	0	22612
17315	22590	0	17	0	0	22607
17316	22736	0	48	12	0	22796
17317	22128	3	48	6	0	22185
17318	6	48	2	22367	0	22423
17319	28	1	22400	3	0	22432
17320	1	22117	2	18	0	22138
17321	21796	1	56	3	0	21856
17322	3	35	2	21021	0	21061
17323	8	39	0	20323	0	20370
17324	19	0	20332	18	0	20369
17325	2	19589	1	35	0	19627
17326	2	19346	0	13	0	19361
17327	8	70	3	19618	0	19699
17328	13	0	19669	8	0	19690
17329	19361	4	64	4	0	19433
17330	13	1	19701	0	0	19715
17331	19969	4	55	8	0	20036
17332	0	20119	0	21	0	20140
17333	26	1	19441	4	0	19472
17334	19179	1	50	3	0	19233
17335	2	18927	0	12	0	18941
17336	18839	4	59	5	0	18907
17337	4	3	19297	2	0	19306
17338	2	19851	0	21	0	19874
17339	19741	1	52	5	0	19799
17340	4	1	20500	3	0	20508
17341	21423	3	61	8	0	21495
17342	3	38	3	21563	0	21607
17343	22192	1	26	4	0	22223
17344	2	29	3	22275	0	22309
17345	21989	1	34	6	0	22030
17346	10	1	21896	1	0	21908
17347	8	63	4	22168	0	22243
17348	1	58	0	21661	0	21720
17349	16	0	21653	3	0	21672
17350	5	60	2	22294	0	22361
17351	1	22492	1	5	0	22499
17352	4	75	1	22415	0	22495
17353	2	27	3	22508	0	22540
17354	2	50	0	23977	0	24029
17355	3	0	23778	4	0	23785
17356	25534	2	77	2	0	25615
17357	3	62	0	26632	0	26697
17358	5	0	26524	4	0	26533
17359	26925	3	68	3	0	26999
17360	26806	2	87	5	0	26900
17361	26970	2	57	3	0	27032
17362	5	51	5	26590	0	26651
17363	7	40	1	25442	0	25490
17364	3	51	1	25503	0	25558
17365	4	25197	0	8	0	25209
17366	25182	2	55	2	0	25241
17367	25150	1	50	2	0	25203
17368	8	45	2	24913	0	24968
17369	34	3	24868	4	0	24909
17370	26	2	24848	8	0	24884
17371	7	24394	0	20	0	24421
17372	5	23592	0	24	0	23621
17373	23892	4	56	11	0	23963
17374	4	24083	1	27	0	24115
17375	24729	2	34	1	0	24766
17376	24896	6	43	5	0	24950
17377	25196	2	25	3	0	25226
17378	2	45	7	25254	0	25308
17379	2	29	2	24211	0	24244
17380	24421	2	34	3	0	24460
17381	5	60	2	24226	0	24293
17382	33	0	24380	2	0	24415
17383	26574	1	62	5	0	26642
17384	7	46	4	26311	0	26368
17385	7	40	3	26176	0	26226
17386	4	35	5	26016	0	26060
17387	11	1	25710	1	0	25723
17388	25707	2	51	8	0	25768
17389	10	0	24610	0	0	24620
17390	8	62	4	24907	0	24981
17391	19	1	24866	0	0	24886
17392	6	60	4	24803	0	24873
17393	4	53	2	24777	0	24836
17394	22	0	24842	10	0	24874
17395	8	82	6	25104	0	25200
17396	5	24950	1	17	0	24973
17397	24948	5	67	6	0	25026
17398	25530	2	56	7	0	25595
17399	3	49	2	26695	0	26749
17400	41	0	25521	1	0	25563
17401	11	25990	2	20	0	26023
17402	1	26011	2	40	0	26054
17403	25639	5	68	21	0	25733
17404	33	0	25881	3	0	25917
17405	27321	1	47	2	0	27371
17406	4	61	5	27180	0	27250
17407	1	13	3	27000	0	27017
17408	26987	0	32	1	0	27020
17409	3	26790	0	21	0	26814
17410	19	0	27065	1	0	27085
17411	8	57	3	27292	0	27360
17412	22	2	27873	8	0	27905
17413	3	27135	1	20	0	27159
17414	2	33	1	26838	0	26874
17415	28248	1	54	9	0	28312
17416	27689	6	52	6	0	27753
17417	29	1	27492	1	0	27523
17418	4	27832	0	25	0	27861
17419	27465	1	58	3	0	27527
17420	2	28319	0	8	0	28329
17421	1	27	5	27989	0	28022
17422	29214	2	49	1	0	29266
17423	7	52	0	29459	0	29518
17424	24	1	30659	0	0	30684
17425	17	69	2	29903	0	29991
17426	23	0	29785	0	0	29808
17427	5	42	2	30037	0	30086
17428	30140	3	48	2	0	30193
17429	3	30070	0	22	0	30095
17430	28534	1	63	2	0	28600
17431	7	43	5	28511	0	28566
17432	3	43	2	27986	0	28034
17433	15	0	26840	21	0	26876
17434	24	1	26887	14	0	26926
17435	2	26528	1	57	0	26588
17436	20	0	26497	4	0	26521
17437	26658	3	60	6	0	26727
17438	11	26491	0	17	0	26519
17439	17	26175	0	32	0	26224
17440	2	26582	0	32	0	26616
17441	4	70	4	26743	0	26821
17442	18	0	27162	3	0	27183
17443	3	29770	2	20	0	29795
17444	5	84	3	29443	0	29535
17445	9	30159	0	10	0	30178
17446	30141	2	52	6	0	30201
17447	30349	2	59	4	0	30414
17448	27	60	4	30745	0	30836
17449	1	28	2	33116	0	33147
17450	33329	1	40	2	0	33372
17451	6	32360	0	13	0	32379
17452	7	32279	0	15	0	32301
17453	8	103	6	31736	0	31853
17454	50	4	31616	9	0	31679
17455	17	31595	1	29	0	31642
17456	31903	4	69	6	0	31982
17457	2	31856	1	18	0	31877
17458	2	29460	2	15	0	29479
17459	29533	3	74	10	0	29620
17460	2	30236	0	36	0	30274
17461	37	2	30138	1	0	30178
17462	22	29839	0	15	0	29876
17463	30004	6	62	8	0	30080
17464	1	30202	1	21	0	30225
17465	30223	1	58	3	0	30285
17466	3	61	3	32634	0	32701
17467	1	50	1	32691	0	32743
17468	42	1	32807	4	0	32854
17469	1	32392	0	27	0	32420
17470	10	68	1	32055	0	32134
17471	33091	0	45	3	0	33139
17472	33362	4	68	13	0	33447
17473	1	33248	1	21	0	33271
17474	1	39	3	32750	0	32793
17475	31424	2	38	3	0	31467
17476	30563	10	65	8	0	30646
17477	27	0	30808	4	0	30839
17478	27	4	30476	12	0	30519
17479	18	1	30616	8	0	30643
17480	6	29711	0	21	0	29738
17481	29639	2	77	10	0	29728
17482	2	30731	2	22	0	30757
17483	30649	2	70	3	0	30724
17484	1	30548	0	27	0	30576
17485	3	40	3	30399	0	30445
17486	30060	3	72	8	0	30143
17487	44	1	29985	6	0	30036
17488	29313	4	106	10	0	29433
17489	29598	3	85	5	0	29691
17490	8	29458	0	20	0	29486
17491	6	28035	0	17	0	28058
17492	27549	4	79	7	0	27639
17493	9	0	27273	1	0	27283
17494	27404	7	47	11	0	27469
17495	27409	0	38	2	0	27449
17496	2	31	2	26427	0	26462
17497	25907	1	10	0	0	25918
17498	2	67	4	25779	0	25852
17499	6	53	6	25947	0	26012
17500	10	50	1	24900	0	24961
17501	5	24460	1	5	0	24471
17502	24199	0	40	4	0	24243
17503	24343	1	26	2	0	24372
17504	1	83	2	24264	0	24350
17505	8	47	4	24348	0	24407
17506	2	24283	0	8	0	24293
17507	22875	3	55	9	0	22942
17508	8	0	23747	1	0	23756
17509	7	51	3	23550	0	23611
17510	6	0	25584	1	0	25591
17511	5	51	1	25750	0	25807
17512	17	1	25782	1	0	25801
17513	5	45	3	26263	0	26316
17514	26110	5	79	5	0	26199
17515	15	0	26245	3	0	26263
17516	26218	9	91	6	0	26324
17517	3	25840	0	15	0	25858
17518	8	70	2	25065	0	25145
17519	1	34	3	23698	0	23736
17520	24113	0	27	2	0	24142
17521	6	38	0	23955	0	23999
17522	16	1	23927	3	0	23947
17523	23889	2	68	5	0	23964
17524	23416	2	44	2	0	23464
17525	21158	2	89	1	0	21250
17526	21286	11	58	6	0	21361
17527	1	22587	0	14	0	22602
17528	0	22	1	22634	0	22657
17529	22687	1	47	7	0	22742
17530	3	21	0	22516	0	22540
17531	22309	2	56	5	0	22372
17532	9	0	22556	4	0	22569
17533	21	1	23741	6	0	23769
17534	5	58	2	25387	0	25452
17535	10	25240	1	16	0	25267
17536	2	24576	0	25	0	24603
17537	24770	1	51	13	0	24835
17538	49	1	26973	1	0	27024
17539	27486	1	84	2	0	27573
17540	0	27472	0	20	0	27492
17541	27507	3	49	3	0	27562
17542	19	48	4	25121	0	25192
17543	15	0	25209	7	0	25231
17544	7	59	4	25088	0	25158
17545	5	51	2	24990	0	25048
17546	2	25802	0	40	0	25844
17547	0	25270	1	13	0	25284
17548	4	61	5	26517	0	26587
17549	1	26720	0	24	0	26745
17550	43	0	26732	0	0	26775
17551	18	3	27166	7	0	27194
17552	26864	2	54	17	0	26937
17553	26991	4	63	3	0	27061
17554	2	27205	0	10	0	27217
17555	8	52	2	27015	0	27077
17556	1	40	1	27438	0	27480
17557	33	0	27253	5	0	27291
17558	11	53	1	27893	0	27958
17559	2	27716	1	24	0	27743
17560	31	4	27550	6	0	27591
17561	25	0	27828	4	0	27857
17562	2	27928	3	38	0	27971
17563	13	1	28018	0	0	28032
17564	1	59	2	28444	0	28506
17565	6	84	2	28175	0	28267
17566	13	0	29104	1	0	29118
17567	5	74	3	29140	0	29222
17568	7	29145	1	23	0	29176
17569	5	29228	0	16	0	29249
17570	3	64	3	29080	0	29150
17571	34	1	29407	8	0	29450
17572	6	28267	1	40	0	28314
17573	2	75	4	28856	0	28937
17574	21	0	29016	2	0	29039
17575	28452	2	58	14	0	28526
17576	28592	0	57	8	0	28657
17577	29128	4	63	3	0	29198
17578	0	39	5	29482	0	29526
17579	2	44	2	30384	0	30432
17580	29	0	30858	4	0	30891
17581	3	70	2	31678	0	31753
17582	12	67	5	31539	0	31623
17583	40	3	31324	11	0	31378
17584	30638	2	105	16	0	30761
17585	3	29612	1	13	0	29629
17586	29234	3	80	5	0	29322
17587	1	30324	1	14	0	30340
17588	6	70	15	29783	0	29874
17589	18	1	30589	3	0	30611
17590	11	48	5	31326	0	31390
17591	16	0	31314	11	0	31341
17592	31679	6	95	58	0	31838
17593	18	1	32298	3	0	32320
17594	10	45	1	33187	0	33243
17595	27	1	33560	1	0	33589
17596	2	33398	0	49	0	33449
17597	5	91	5	32900	0	33001
17598	11	77	2	32731	0	32821
17599	2	52	6	33480	0	33540
17600	9	1	35243	8	0	35261
17601	42	0	36285	8	0	36335
17602	8	97	22	36813	0	36940
17603	4	93	6	35896	0	35999
17604	4	42	4	35768	0	35818
17605	36473	1	44	11	0	36529
17606	2	65	0	36630	0	36697
17607	8	1	36872	4	0	36885
17608	37411	2	109	12	0	37534
17609	3	48	1	35628	0	35680
17610	35309	3	69	5	0	35386
17611	35264	4	41	11	0	35320
17612	7	36	3	35413	0	35459
17613	35394	2	47	5	0	35448
17614	32868	7	84	6	0	32965
17615	38	1	35355	8	0	35402
17616	2	35404	0	21	0	35427
17617	10	86	3	35613	0	35712
17618	14	28	1	35658	0	35701
17619	35331	2	25	6	0	35364
17620	35224	4	91	12	0	35331
17621	35162	3	135	8	0	35308
17622	21	3	34174	1	0	34199
17623	40	33323	1	45	0	33409
17624	32780	3	93	9	0	32885
17625	3	35524	1	21	0	35549
17626	35602	2	80	12	0	35696
17627	3	42	1	36535	0	36581
17628	36444	1	43	2	0	36490
17629	36224	4	76	14	0	36318
17630	36745	2	136	6	0	36889
17631	5	1	37068	6	0	37080
17632	36750	3	83	4	0	36840
17633	4	36912	0	21	0	36937
17634	35251	2	93	5	0	35351
17635	36267	3	105	3	0	36378
17636	36275	2	71	5	0	36353
17637	7	50	2	36548	0	36607
17638	1	36642	1	11	0	36655
17639	35933	6	66	7	0	36012
17640	74	1	36879	3	0	36957
17641	1	36847	0	23	0	36871
17642	15	124	8	36842	0	36989
17643	49	37021	1	21	0	37092
17644	37225	2	92	15	0	37334
17645	37421	3	73	3	0	37500
17646	3	92	0	37523	0	37618
17647	28	9	38219	1	0	38257
17648	6	38786	0	21	0	38813
17649	2	101	4	38153	0	38260
17650	5	44	3	38420	0	38472
17651	10	23	0	38528	0	38561
17652	39384	3	45	4	0	39436
17653	38958	2	51	11	0	39022
17654	38651	3	72	3	0	38729
17655	38094	1	89	8	0	38192
17656	4	27	1	36889	0	36921
17657	24	0	39261	1	0	39286
17658	6	78	13	39541	0	39638
17659	3	44	5	39613	0	39665
17660	9	73	6	42597	0	42685
17661	1	26	1	41973	0	42001
17662	42628	2	29	10	0	42669
17663	2	29	1	41467	0	41499
17664	41362	2	45	3	0	41412
17665	40378	8	118	12	0	40516
17666	22	0	40868	4	0	40894
17667	40	2	41351	14	0	41407
17668	57	2	43590	7	0	43656
17669	4	78	32	42257	0	42371
17670	77	0	42844	1	0	42922
17671	8	95	3	43562	0	43668
17672	7	81	2	43514	0	43604
17673	43967	2	62	9	0	44040
17674	20	138	4	43656	0	43818
17675	4	41158	3	41	0	41206
17676	41468	9	77	10	0	41564
17677	2	40457	4	123	0	40586
17678	92	4	40389	9	0	40494
17679	9	40337	4	22	0	40372
17680	40688	3	87	9	0	40787
17681	11	120	2	40762	0	40895
17682	46	0	40692	2	0	40740
17683	41534	4	74	7	0	41619
17684	4	68	10	40725	0	40807
17685	42	0	40558	3	0	40603
17686	11	152	14	40650	0	40827
17687	13	110	0	40641	0	40764
17688	14	90	1	40680	0	40785
17689	5	40593	1	25	0	40624
17690	40248	6	92	5	0	40351
17691	14	82	1	37951	0	38048
17692	9	37920	1	24	0	37954
17693	6	138	4	37360	0	37508
17694	79	2	39366	12	0	39459
17695	11	39384	3	38	0	39436
17696	40496	1	56	9	0	40562
17697	40773	1	82	6	0	40862
17698	6	50	4	40999	0	41059
17699	6	47	2	41213	0	41268
17700	41476	2	48	4	0	41530
17701	38756	2	117	8	0	38883
17702	2	38839	0	31	0	38872
17703	37317	4	90	17	0	37428
17704	23	2	37991	5	0	38021
17705	50	1	38324	13	0	38388
17706	19	37611	4	32	0	37666
17707	9	38091	0	30	0	38130
17708	39413	8	81	16	0	39518
17709	6	40952	1	24	0	40983
17710	42167	2	91	6	0	42266
17711	41219	5	54	7	0	41285
17712	41747	7	98	7	0	41859
17713	4	27	4	41312	0	41347
17714	40932	3	42	6	0	40983
17715	25	2	40761	4	0	40792
17716	26	0	39858	21	0	39905
17717	5	40072	2	63	0	40142
17718	27	1	39463	9	0	39500
17719	9	84	5	40992	0	41090
17720	39	0	41151	7	0	41197
17721	32	2	41437	6	0	41477
17722	2	74	2	42650	0	42728
17723	41341	2	53	7	0	41403
17724	40587	9	100	13	0	40709
17725	31	2	41114	4	0	41151
17726	41413	3	120	18	0	41554
17727	12	1	41685	3	0	41701
17728	41186	1	171	11	0	41369
17729	41359	6	86	3	0	41454
17730	2	84	2	41256	0	41344
17731	14	53	1	41376	0	41444
17732	7	41106	0	12	0	41125
17733	1	40974	1	36	0	41012
17734	15	83	7	41142	0	41247
17735	3	57	0	41273	0	41333
17736	39146	6	72	3	0	39227
17737	1	40290	0	34	0	40325
17738	40985	4	101	2	0	41092
17739	0	41692	0	55	0	41747
17740	35	3	41366	8	0	41412
17741	1	71	2	41673	0	41747
17742	40469	0	66	3	0	40538
17743	40602	1	73	13	0	40689
17744	5	38538	2	25	0	38570
17745	12	37523	3	44	0	37582
17746	3	36950	1	29	0	36983
17747	5	78	3	35827	0	35913
17748	27	0	36588	8	0	36623
17749	2	36573	2	26	0	36603
17750	3	57	3	36644	0	36707
17751	16	92	6	37027	0	37141
17752	29	1	36654	2	0	36686
17753	34	0	36314	10	0	36358
17754	35853	4	96	15	0	35968
17755	15	1	36009	3	0	36028
17756	36317	2	69	8	0	36396
17757	35752	5	70	10	0	35837
17758	35712	5	82	9	0	35808
17759	34416	4	195	5	0	34620
17760	42	0	34377	2	0	34421
17761	3	33858	1	44	0	33906
17762	9	109	5	33331	0	33454
17763	22	2	34940	0	0	34964
17764	6	83	5	35519	0	35613
17765	1	36164	3	23	0	36191
17766	6	109	7	36062	0	36184
17767	6	57	3	37102	0	37168
17768	1	37	3	37402	0	37443
17769	38271	5	32	3	0	38311
17770	8	73	4	36275	0	36360
17771	6	94	7	35992	0	36099
17772	15	96	1	35169	0	35281
17773	2	34975	0	11	0	34988
17774	35382	7	73	7	0	35469
17775	5	36282	2	15	0	36304
17776	0	35847	1	15	0	35863
17777	6	118	3	36198	0	36325
17778	2	44	0	36447	0	36493
17779	38106	6	40	3	0	38155
17780	4	41	2	37602	0	37649
17781	40157	2	26	2	0	40187
17782	39881	6	59	5	0	39951
17783	4	50	0	39484	0	39538
17784	31	107	1	38872	0	39011
17785	6	36843	0	12	0	36861
17786	36582	6	108	10	0	36706
17787	0	36959	0	21	0	36980
17788	36141	7	112	13	0	36273
17789	21	2	36998	6	0	37027
17790	43211	3	91	16	0	43321
17791	44534	3	138	9	0	44684
17792	2	54	2	44975	0	45033
17793	62	1	45557	6	0	45626
17794	0	44388	1	50	0	44439
17795	13	109	5	43981	0	44108
17796	44	2	43826	9	0	43881
17797	5	83	4	45182	0	45274
17798	44188	3	84	5	0	44280
17799	36	0	44303	0	0	44339
17800	8	45277	3	38	0	45326
17801	4	45413	0	30	0	45447
17802	18	143	6	44915	0	45082
17803	10	44933	3	16	0	44962
17804	44922	24	83	3	0	45032
17805	44861	4	35	3	0	44903
17806	44540	9	134	4	0	44687
17807	37	0	44743	3	0	44783
17808	43216	8	70	3	0	43297
17809	2	72	4	43196	0	43274
17810	9	71	2	42815	0	42897
17811	1	77	4	43010	0	43092
17812	11	58	17	42781	0	42867
17813	32	2	40899	14	0	40947
17814	63	0	39792	27	0	39882
17815	36	0	39693	6	0	39735
17816	40847	3	138	9	0	40997
17817	6	40079	2	41	0	40128
17818	10	92	1	40179	0	40282
17819	40480	9	69	5	0	40563
17820	11	40309	6	28	0	40354
17821	17	39983	2	32	0	40034
17822	40723	8	58	12	0	40801
17823	41058	3	87	7	0	41155
17824	1	40709	0	23	0	40733
17825	9	114	2	41011	0	41136
17826	2	41321	0	14	0	41337
17827	40792	7	92	11	0	40902
17828	41185	5	85	2	0	41277
17829	40531	13	107	6	0	40657
17830	3	47092	1	17	0	47113
17831	9	97	5	46278	0	46389
17832	24	0	46546	13	0	46583
17833	3	83	3	48268	0	48357
17834	11	108	10	48097	0	48226
17835	38	2	48251	2	0	48293
17836	48556	6	131	13	0	48706
17837	4	156	7	49567	0	49734
17838	12	120	0	49600	0	49732
17839	9	48463	1	22	0	48495
17840	48655	2	99	2	0	48758
17841	17	129	2	48552	0	48700
17842	4	48004	2	28	0	48038
17843	47947	7	119	20	0	48093
17844	10	47678	1	34	0	47723
17845	46679	5	141	21	0	46846
17846	31	1	46690	0	0	46722
17847	39	0	46230	13	0	46282
17848	40	2	49659	9	0	49710
17849	5	48900	0	26	0	48931
17850	19	102	5	48180	0	48306
17851	3	48550	0	18	0	48571
17852	48494	7	70	6	0	48577
17853	37	0	51088	2	0	51127
17854	51413	5	103	13	0	51534
17855	49966	4	150	4	0	50124
17856	15	54	5	49759	0	49833
17857	46974	6	57	15	0	47052
17858	2	101	3	51232	0	51338
17859	33	2	51288	2	0	51325
17860	51064	6	141	27	0	51238
17861	7	50526	1	17	0	50551
17862	19	57	7	43862	0	43945
17863	45003	1	37	6	0	45047
17864	14	105	5	44598	0	44722
17865	29	0	45629	4	0	45662
17866	16	118	3	45382	0	45519
17867	4	43847	3	26	0	43880
17868	44963	9	137	5	0	45114
17869	6	62	2	44258	0	44328
17870	43942	1	54	4	0	44001
17871	2	136	3	43656	0	43797
17872	21	151	5	42366	0	42543
17873	4	43139	1	22	0	43166
17874	41007	2	105	12	0	41126
17875	7	40759	0	17	0	40783
17876	9	87	5	40363	0	40464
17877	9	41716	2	16	0	41743
17878	41478	6	92	7	0	41583
17879	42309	3	86	4	0	42402
17880	42250	12	95	6	0	42363
17881	9	43055	0	22	0	43086
17882	3	42829	0	45	0	42877
17883	42268	7	96	16	0	42387
17884	6	45320	1	26	0	45353
17885	7	99	7	44810	0	44923
17886	35	20	45236	6	0	45297
17887	45766	4	137	14	0	45921
17888	45963	1	123	8	0	46095
17889	45939	11	156	14	0	46120
17890	4	46052	0	41	0	46097
17891	44268	10	100	11	0	44389
17892	46	3	44740	4	0	44793
17893	3	46355	1	43	0	46402
17894	42	183	6	48319	0	48550
17895	1	49546	0	19	0	49566
17896	51429	6	81	18	0	51534
17897	3	53900	0	11	0	53914
17898	16	173	5	53058	0	53252
17899	11	54902	0	29	0	54942
17900	12	196	6	54710	0	54924
17901	15	193	5	54512	0	54725
17902	85	0	54708	1	0	54794
17903	11	106	20	54749	0	54886
17904	55012	1	56	2	0	55071
17905	54968	3	140	4	0	55115
17906	4	102	1	48771	0	48878
17907	40	0	48977	2	0	49019
17908	8	51	2	47341	0	47402
17909	48318	1	80	8	0	48407
17910	47887	8	134	40	0	48069
17911	48038	58	141	11	0	48248
17912	2	47703	1	17	0	47723
17913	46442	6	115	5	0	46568
17914	12	0	48176	15	0	48203
17915	47455	16	134	7	0	47612
17916	2	65	4	47237	0	47308
17917	11	75	3	46351	0	46440
17918	10	43	2	46698	0	46753
17919	46768	5	37	7	0	46817
17920	46904	2	59	2	0	46967
17921	6	95	3	46771	0	46875
17922	36	2	46626	3	0	46667
17923	13	136	4	44366	0	44519
17924	8	82	7	42944	0	43041
17925	45	15	45471	7	0	45538
17926	11	45637	4	26	0	45678
17927	12	87	5	46036	0	46140
17928	46126	3	71	2	0	46202
17929	12	90	7	42447	0	42556
17930	2	62	1	42896	0	42961
17931	42768	9	61	6	0	42844
17932	12	42324	2	23	0	42361
17933	14	41834	1	30	0	41879
17934	37628	8	85	16	0	37737
17935	18	2	38228	6	0	38254
17936	38016	6	123	13	0	38158
17937	40	1	38321	5	0	38367
17938	5	37865	2	16	0	37888
17939	37516	2	67	4	0	37589
17940	37648	3	99	5	0	37755
17941	35952	3	78	7	0	36040
17942	36028	5	122	6	0	36161
17943	54	0	36706	3	0	36763
17944	3	32	4	35624	0	35663
17945	35034	5	75	4	0	35118
17946	13	1	35114	5	0	35133
17947	33	4	35309	15	0	35361
17948	8	35710	1	24	0	35743
17949	35454	5	55	6	0	35520
17950	2	51	3	35538	0	35594
17951	36137	4	44	1	0	36186
17952	5	36630	0	7	0	36642
17953	5	121	4	35178	0	35308
17954	16	114	3	35617	0	35750
17955	4	76	2	34788	0	34870
17956	30	1	35489	3	0	35523
17957	5	34774	2	40	0	34821
17958	34920	3	33	5	0	34961
17959	1	48	1	34785	0	34835
17960	31752	3	27	6	0	31788
17961	32757	8	63	2	0	32830
17962	1	78	2	32554	0	32635
17963	10	1	34665	1	0	34677
17964	5	79	3	34773	0	34860
17965	3	32731	2	12	0	32748
17966	3	73	6	32361	0	32443
17967	16	0	32840	4	0	32860
17968	33259	4	58	12	0	33333
17969	2	31	0	33562	0	33595
17970	30256	3	49	15	0	30323
17971	4	2	29896	4	0	29906
17972	27559	2	86	13	0	27660
17973	8	0	25059	3	0	25070
17974	25119	4	89	4	0	25216
17975	4	25309	1	22	0	25336
17976	1	25502	1	32	0	25536
17977	4	93	3	25455	0	25555
17978	5	69	6	25612	0	25692
17979	1	29	3	25985	0	26018
17980	25666	3	25	1	0	25695
17981	6	84	6	25386	0	25482
17982	21	1	25185	3	0	25210
17983	25648	1	92	16	0	25757
17984	7	25110	1	21	0	25139
17985	24080	2	69	7	0	24158
17986	24106	1	64	6	0	24177
17987	5	0	24103	4	0	24112
17988	4	56	3	24512	0	24575
17989	2	58	6	24538	0	24604
17990	39	1	22807	4	0	22851
17991	5	23412	4	31	0	23452
17992	25829	0	57	4	0	25890
17993	26656	2	36	5	0	26699
17994	3	45	1	26580	0	26629
17995	3	59	8	26629	0	26699
17996	1	33	1	26632	0	26667
17997	26656	0	29	10	0	26695
17998	4	26651	1	14	0	26670
17999	26932	1	56	3	0	26992
18000	26824	1	75	6	0	26906
18001	19	0	24489	0	0	24508
18002	3	85	3	24354	0	24445
18003	2	25688	0	9	0	25699
18004	4	77	2	25779	0	25862
18005	5	62	4	25894	0	25965
18006	10	0	25444	16	0	25470
18007	25599	4	67	6	0	25676
18008	25978	2	55	3	0	26038
18009	25910	4	70	21	0	26005
18010	11	48	2	26242	0	26303
18011	16	19	1	25587	0	25623
18012	7	25557	0	22	0	25586
18013	7	25302	1	27	0	25337
18014	25914	6	42	8	0	25970
18015	2	26181	2	20	0	26205
18016	16	0	26262	10	0	26288
18017	4	32	0	26386	0	26422
18018	26167	1	29	3	0	26200
18019	21	29	23427	2	0	23479
18020	22	0	23681	5	0	23708
18021	24124	5	64	8	0	24201
18022	24574	1	54	0	0	24629
18023	1	40	3	24218	0	24262
18024	13	0	24277	0	0	24290
18025	18	62	1	24328	0	24409
18026	13	2	23932	0	0	23947
18027	40	5	23216	7	0	23268
18028	5	25063	0	61	0	25129
18029	25107	1	51	6	0	25165
18030	25673	1	45	4	0	25723
18031	3	25226	1	16	0	25246
18032	4	154	3	25184	0	25345
18033	3	71	2	25227	0	25303
18034	1	32	1	25388	0	25422
18035	25486	1	22	2	0	25511
18036	2	24184	0	16	0	24202
18037	24610	0	46	6	0	24662
18038	24564	2	52	5	0	24623
18039	28	1	22250	0	0	22279
18040	4	23135	0	21	0	23160
18041	3	57	0	23535	0	23595
18042	8	0	23649	1	0	23658
18043	24177	2	26	3	0	24208
18044	24183	3	56	2	0	24244
18045	24128	2	59	2	0	24191
18046	24584	2	50	2	0	24638
18047	1	53	3	24625	0	24682
18048	32	1	24681	0	0	24714
18049	6	45	4	26340	0	26395
18050	26272	3	31	4	0	26310
18051	25213	3	62	10	0	25288
18052	6	24752	0	12	0	24770
18053	24434	2	74	4	0	24514
18054	16	1	24360	6	0	24383
18055	52	1	24308	7	0	24368
18056	24952	2	54	5	0	25013
18057	4	25147	0	4	0	25155
18058	17	108	4	24341	0	24470
18059	3	26888	1	6	0	26898
18060	3	102	1	26753	0	26859
18061	6	28	2	26915	0	26951
18062	3	31	0	27105	0	27139
18063	26986	0	26	5	0	27017
18064	26881	1	24	4	0	26910
18065	26842	2	84	5	0	26933
18066	13	0	27066	0	0	27079
18067	26569	1	65	2	0	26637
18068	3	32	6	24374	0	24415
18069	4	36	2	23603	0	23645
18070	26	0	25149	2	0	25177
18071	5	43	2	25038	0	25088
18072	25096	1	39	5	0	25141
18073	11	1	25102	1	0	25115
18074	4	44	4	25115	0	25167
18075	25018	1	28	1	0	25048
18076	24777	3	69	4	0	24853
18077	7	0	25073	2	0	25082
18078	31	1	25037	7	0	25076
18079	3	35	3	24057	0	24098
18080	24012	2	29	1	0	24044
18081	24391	5	38	1	0	24435
18082	1	63	0	24663	0	24727
18083	3	24846	0	28	0	24877
18084	24600	2	45	1	0	24648
18085	5	24639	0	12	0	24656
18086	7	42	6	23917	0	23972
18087	42	1	24406	5	0	24454
18088	29	2	24692	5	0	24728
18089	35	1	25281	6	0	25323
18090	3	74	5	25460	0	25542
18091	0	30	1	25137	0	25168
18092	25438	2	31	3	0	25474
18093	0	25772	0	12	0	25784
18094	26838	2	54	1	0	26895
18095	11	82	2	26568	0	26663
18096	7	26084	0	5	0	26096
18097	2	26386	0	25	0	26413
18098	2	49	1	25976	0	26028
18099	26318	1	45	4	0	26368
18100	2	26433	0	15	0	26450
18101	26174	5	70	7	0	26256
18102	0	26121	1	17	0	26139
18103	23814	3	56	7	0	23880
18104	17	0	24073	6	0	24096
18105	25	2	24258	9	0	24294
18106	11	25356	0	17	0	25384
18107	27681	0	62	7	0	27750
18108	5	28512	0	20	0	28537
18109	7	28823	1	24	0	28855
18110	2	60	3	28885	0	28950
18111	29366	4	35	7	0	29412
18112	2	29588	1	21	0	29612
18113	29477	1	70	6	0	29554
18114	1	29426	0	23	0	29450
18115	27839	5	77	7	0	27928
18116	12	29061	0	31	0	29104
18117	4	28383	0	19	0	28406
18118	13	109	5	28614	0	28741
18119	2	28753	1	8	0	28764
18120	28370	5	40	2	0	28417
18121	30	0	29008	4	0	29042
18122	9	59	2	31454	0	31524
18123	35	0	31387	1	0	31423
18124	7	87	6	32138	0	32238
18125	2	92	9	30277	0	30380
18126	16	0	30128	11	0	30155
18127	30166	6	97	24	0	30293
18128	2	30574	1	11	0	30588
18129	30594	4	90	8	0	30696
18130	5	30548	0	32	0	30585
18131	4	29	4	29973	0	30010
18132	30139	2	38	2	0	30181
18133	30325	1	53	7	0	30386
18134	30615	2	44	4	0	30665
18135	6	60	1	29608	0	29675
18136	8	45	1	29489	0	29543
18137	25	29607	0	6	0	29638
18138	30241	1	54	0	0	30296
18139	30534	3	44	3	0	30584
18140	30469	3	55	7	0	30534
18141	30502	2	118	3	0	30625
18142	1	30416	0	13	0	30430
18143	2	61	4	29877	0	29944
18144	25	1	29984	1	0	30011
18145	30015	1	69	6	0	30091
18146	28659	1	100	4	0	28764
18147	7	1	28893	0	0	28901
18148	10	1	30070	6	0	30087
18149	3	57	4	30063	0	30127
18150	7	53	3	29901	0	29964
18151	0	28	2	29796	0	29826
18152	29884	4	45	2	0	29935
18153	8	80	4	29189	0	29281
18154	21	0	29636	1	0	29658
18155	8	81	6	29231	0	29326
18156	24	1	29368	1	0	29394
18157	7	68	4	29247	0	29326
18158	3	110	1	28604	0	28718
18159	39	3	28773	8	0	28823
18160	29197	4	104	13	0	29318
18161	4	29136	0	70	0	29210
18162	29079	4	91	5	0	29179
18163	4	27	4	28376	0	28411
18164	28449	1	56	3	0	28509
18165	6	27958	0	29	0	27993
18166	1	28279	0	20	0	28300
18167	18	84	7	28175	0	28284
18168	63	0	28190	2	0	28255
18169	27	0	28271	7	0	28305
18170	5	27066	0	33	0	27104
18171	27207	3	57	2	0	27269
18172	3	67	2	27647	0	27719
18173	28157	0	51	4	0	28212
18174	7	30069	0	52	0	30128
18175	10	30086	1	10	0	30107
18176	5	40	1	29929	0	29975
18177	30135	0	33	2	0	30170
18178	29960	5	70	6	0	30041
18179	27	1	30285	4	0	30317
18180	18	0	31186	13	0	31217
18181	31028	4	66	8	0	31106
18182	5	29471	0	18	0	29494
18183	27218	4	61	5	0	27288
18184	1	49	3	26423	0	26476
18185	17	1	26835	2	0	26855
18186	28454	3	84	6	0	28547
18187	6	28889	0	24	0	28919
18188	6	29670	0	18	0	29694
18189	6	62	0	29295	0	29363
18190	31351	2	57	4	0	31414
18191	2	37	4	31427	0	31470
18192	30031	3	47	7	0	30088
18193	13	1	30074	1	0	30089
18194	28873	2	29	7	0	28911
18195	26915	1	86	6	0	27008
18196	6	1	26648	2	0	26657
18197	25744	2	89	7	0	25842
18198	2	25900	0	7	0	25909
18199	5	76	1	24691	0	24773
18200	2	25407	0	15	0	25424
18201	25371	4	50	8	0	25433
18202	14	66	3	26418	0	26501
18203	1	26610	2	6	0	26619
18204	6	93	8	26055	0	26162
18205	3	27830	1	13	0	27847
18206	2	48	2	28439	0	28491
18207	30125	0	29	3	0	30157
18208	8	41	1	30005	0	30055
18209	14	0	29449	2	0	29465
18210	28941	4	103	17	0	29065
18211	7	50	0	27946	0	28003
18212	21	1	27803	1	0	27826
18213	20	1	28100	8	0	28129
18214	11	1	28715	6	0	28733
18215	4	86	10	28622	0	28722
18216	4	52	3	28682	0	28741
18217	1	38	5	28671	0	28715
18218	8	8	0	29160	0	29176
18219	29366	0	25	6	0	29397
18220	29260	1	23	7	0	29291
18221	29172	0	34	3	0	29209
18222	29268	1	67	3	0	29339
18223	3	22	0	28499	0	28524
18224	21	0	28313	4	0	28338
18225	28345	3	51	8	0	28407
18226	28576	1	49	3	0	28629
18227	6	30	3	28571	0	28610
18228	1	41	1	28642	0	28685
18229	29014	0	31	5	0	29050
18230	5	53	2	28457	0	28517
18231	4	28248	2	17	0	28271
18232	28127	2	78	7	0	28214
18233	29737	4	96	2	0	29839
18234	7	0	30188	0	0	30195
18235	5	75	4	29870	0	29954
18236	5	26	6	29780	0	29817
18237	29916	0	27	7	0	29950
18238	29831	1	82	2	0	29916
18239	1	30	2	30180	0	30213
18240	28	0	30060	2	0	30090
18241	16	1	30158	11	0	30186
18242	4	59	5	29220	0	29288
18243	2	50	1	29089	0	29142
18244	29114	4	50	2	0	29170
18245	4	30461	3	19	0	30487
18246	12	30373	2	32	0	30419
18247	3	29543	0	15	0	29561
18248	10	49	5	29262	0	29326
18249	29529	0	39	10	0	29578
18250	27893	1	78	5	0	27977
18251	1	28230	1	12	0	28244
18252	28470	2	53	0	0	28525
18253	3	61	6	28250	0	28320
18254	42	1	28254	1	0	28298
18255	7	108	19	27787	0	27921
18256	8	53	0	27814	0	27875
18257	13	41	4	27874	0	27932
18258	29098	2	21	3	0	29124
18259	6	79	2	29005	0	29092
18260	1	28352	0	5	0	28358
18261	28272	1	90	8	0	28371
18262	7	26672	1	16	0	26696
18263	6	25818	4	37	0	25865
18264	6	25314	2	25	0	25347
18265	21	1	25429	8	0	25459
18266	3	23567	0	27	0	23597
18267	43	0	23589	1	0	23633
18268	23646	1	21	4	0	23672
18269	23447	2	65	4	0	23518
18270	6	0	23712	0	0	23718
18271	23639	1	41	5	0	23686
18272	23631	3	118	10	0	23762
18273	25	0	24539	0	0	24564
18274	4	25512	0	32	0	25548
18275	6	37	2	25566	0	25611
18276	25860	1	37	7	0	25905
18277	0	26	1	25978	0	26005
18278	24869	3	26	2	0	24900
18279	24688	3	76	9	0	24776
18280	8	0	25046	0	0	25054
18281	24704	4	80	2	0	24790
18282	0	23957	0	10	0	23967
18283	22636	4	51	4	0	22695
18284	5	50	1	22684	0	22740
18285	26	0	23033	6	0	23065
18286	3	35	1	23250	0	23289
18287	23612	2	36	2	0	23652
18288	0	23185	1	21	0	23207
18289	25	0	22987	0	0	23012
18290	4	54	2	22340	0	22400
18291	20	2	22202	5	0	22229
18292	7	22130	2	18	0	22157
18293	22369	1	46	4	0	22420
18294	7	49	7	22189	0	22252
18295	26	0	22066	2	0	22094
18296	11	1	22489	3	0	22504
18297	22282	4	27	10	0	22323
18298	9	47	4	22250	0	22310
18299	4	31	0	21969	0	22004
18300	22	0	21581	7	0	21610
18301	8	0	21732	7	0	21747
18302	1	22291	0	15	0	22307
18303	2	52	17	22221	0	22292
18304	2	41	2	22856	0	22901
18305	2	22488	0	16	0	22506
18306	13	1	22586	1	0	22601
18307	22967	3	33	2	0	23005
18308	1	33	3	22926	0	22963
18309	9	0	21506	0	0	21515
18310	5	35	2	21121	0	21163
18311	3	21558	0	23	0	21584
18312	20	1	21655	1	0	21677
18313	22183	6	58	5	0	22252
18314	11	0	22392	2	0	22405
18315	15	1	22269	3	0	22288
18316	30	2	21887	5	0	21924
18317	39	0	22690	4	0	22733
18318	6	62	4	22649	0	22721
18319	5	1	22823	1	0	22830
18320	9	41	5	23009	0	23064
18321	4	21615	1	12	0	21632
18322	21648	3	60	4	0	21715
18323	3	52	10	21751	0	21816
18324	15	0	21635	5	0	21655
18325	3	22560	1	45	0	22609
18326	1	43	1	22204	0	22249
18327	22566	1	30	7	0	22604
18328	2	21595	0	19	0	21616
18329	4	42	1	21648	0	21695
18330	21609	1	41	8	0	21659
18331	23	0	21513	1	0	21537
18332	22376	3	89	3	0	22471
18333	4	0	22724	1	0	22729
18334	21798	3	75	8	0	21884
18335	21627	3	69	2	0	21701
18336	9	0	21649	10	0	21668
18337	2	22322	0	18	0	22342
18338	3	43	1	22792	0	22839
18339	12	0	23119	1	0	23132
18340	2	46	0	23301	0	23349
18341	2	38	1	23322	0	23363
18342	19	0	23080	2	0	23101
18343	22	1	23554	2	0	23579
18344	3	51	1	24410	0	24465
18345	24991	3	50	11	0	25055
18346	6	24970	0	18	0	24994
18347	2	25030	0	13	0	25045
18348	24808	2	38	3	0	24851
18349	24077	1	19	4	0	24101
18350	5	66	1	23000	0	23072
18351	4	44	3	23193	0	23244
18352	2	21	2	23721	0	23746
18353	25001	0	12	1	0	25014
18354	3	25028	1	12	0	25044
18355	7	26033	1	9	0	26050
18356	6	123	3	25410	0	25542
18357	9	36	1	25647	0	25693
18358	1	31	1	25785	0	25818
18359	25602	0	47	5	0	25654
18360	0	25327	0	8	0	25335
18361	25109	2	60	2	0	25173
18362	30	0	25026	0	0	25056
18363	4	24810	0	10	0	24824
18364	1	33	16	24754	0	24804
18365	24856	2	43	4	0	24905
18366	5	0	24482	2	0	24489
18367	13	1	25008	3	0	25025
18368	4	57	11	24940	0	25012
18369	3	56	0	25026	0	25085
18370	3	41	3	25063	0	25110
18371	2	52	2	25425	0	25481
18372	8	52	2	25001	0	25063
18373	0	25358	1	18	0	25377
18374	0	21	0	25351	0	25372
18375	25303	3	39	2	0	25347
18376	2	24987	1	49	0	25039
18377	24135	4	91	1	0	24231
18378	8	0	24624	0	0	24632
18379	43	1	25851	4	0	25899
18380	4	50	2	25411	0	25467
18381	14	0	25441	0	0	25455
18382	7	53	3	26514	0	26577
18383	1	35	0	26300	0	26336
18384	26423	1	38	4	0	26466
18385	26191	4	67	7	0	26269
18386	5	26398	1	26	0	26430
18387	2	25819	1	14	0	25836
18388	4	35	0	25036	0	25075
18389	24684	1	48	7	0	24740
18390	31	0	24757	2	0	24790
18391	4	56	2	24966	0	25028
18392	4	58	1	24878	0	24941
18393	29	0	24327	1	0	24357
18394	0	24190	0	38	0	24228
18395	5	46	0	23858	0	23909
18396	26	0	24071	0	0	24097
18397	3	29	0	24174	0	24206
18398	25379	0	42	6	0	25427
18399	5	25133	2	16	0	25156
18400	4	23794	1	20	0	23819
18401	6	38	1	23887	0	23932
18402	23706	1	39	3	0	23749
18403	1	23265	0	15	0	23281
18404	23132	2	58	2	0	23194
18405	13	0	23782	2	0	23797
18406	15	4	24048	5	0	24072
18407	2	46	2	23019	0	23069
18408	3	30	1	22552	0	22586
18409	22771	1	24	7	0	22803
18410	4	40	0	23001	0	23045
18411	21	0	23345	0	0	23366
18412	3	46	3	23428	0	23480
18413	8	72	2	22394	0	22476
18414	8	1	21830	7	0	21846
18415	22820	2	85	11	0	22918
18416	6	24	0	23139	0	23169
18417	23581	2	40	3	0	23626
18418	2	23483	1	14	0	23500
18419	22932	1	81	5	0	23019
18420	10	24053	1	6	0	24070
18421	4	23056	1	14	0	23075
18422	15	32	1	24184	0	24232
18423	24170	0	14	1	0	24185
18424	24105	0	44	3	0	24152
18425	2	26	0	26210	0	26238
18426	25962	1	36	5	0	26004
18427	25974	0	46	3	0	26023
18428	2	21	11	25399	0	25433
18429	24015	2	34	3	0	24054
18430	0	23744	1	5	0	23750
18431	21849	2	56	7	0	21914
18432	3	0	22030	0	0	22033
18433	22590	2	14	5	0	22611
18434	9	29	4	22533	0	22575
18435	0	64	4	22534	0	22602
18436	6	41	2	22700	0	22749
18437	6	55	0	22900	0	22961
18438	4	56	1	22859	0	22920
18439	4	22934	1	12	0	22951
18440	1	22916	0	13	0	22930
18441	22677	2	73	3	0	22755
18442	22	1	22947	2	0	22972
18443	23312	3	65	8	0	23388
18444	3	0	23872	1	0	23876
18445	2	33	2	24287	0	24324
18446	1	28	1	24131	0	24161
18447	23670	5	48	3	0	23726
18448	35	0	24467	5	0	24507
18449	9	48	1	25439	0	25497
18450	36	1	25399	3	0	25439
18451	4	25516	0	14	0	25534
18452	1	33	0	25508	0	25542
18453	25328	4	65	10	0	25407
18454	24811	3	70	11	0	24895
18455	24384	17	88	2	0	24491
18456	8	24531	1	21	0	24561
18457	5	23711	0	25	0	23741
18458	24013	8	58	6	0	24085
18459	6	24580	0	24	0	24610
18460	5	25895	0	29	0	25929
18461	24	1	25902	1	0	25928
18462	13	25645	1	22	0	25681
18463	4	25674	1	16	0	25695
18464	6	36	0	25623	0	25665
18465	33	1	25566	2	0	25602
18466	12	0	25885	6	0	25903
18467	25554	0	73	6	0	25633
18468	7	0	25834	1	0	25842
18469	25646	2	92	10	0	25750
18470	4	50	3	25853	0	25910
18471	4	25730	1	12	0	25747
18472	25988	1	39	2	0	26030
18473	26507	2	37	0	0	26546
18474	2	30	5	25316	0	25353
18475	6	56	6	25336	0	25404
18476	2	25	2	25655	0	25684
18477	25838	0	14	2	0	25854
18478	25775	0	38	2	0	25815
18479	25824	13	69	7	0	25913
18480	0	25125	1	25	0	25151
18481	24760	4	64	6	0	24834
18482	4	26055	1	13	0	26073
18483	6	25258	1	19	0	25284
18484	7	89	3	25283	0	25382
18485	0	25586	0	11	0	25597
18486	25627	2	76	3	0	25708
18487	4	28	2	25566	0	25600
18488	25405	0	61	5	0	25471
18489	7	25369	2	32	0	25410
18490	3	25352	0	34	0	25389
18491	24382	13	64	7	0	24466
18492	3	43819	0	12	0	43834
18493	5	60	4	43272	0	43341
18494	5	24	2	44076	0	44107
18495	46385	1	31	6	0	46423
18496	5	49	3	45772	0	45829
18497	34	2	56476	4	0	56516
18498	8	46	2	55387	0	55443
18499	57743	4	48	5	0	57800
18500	6	58351	1	99	0	58457
18501	56360	3	66	5	0	56434
18502	57860	3	72	9	0	57944
18503	57570	2	56	3	0	57631
18504	7	2	58504	4	0	58517
18505	16	1	58469	25	0	58511
18506	58029	3	119	7	0	58158
18507	8	59018	0	86	0	59112
18508	7	222	4	58623	0	58856
18509	15	180	6	64770	0	64971
18510	6	69035	1	48	0	69090
18511	2	69971	0	24	0	69997
18512	15	197	12	72500	0	72724
18513	26	240	14	72719	0	72999
18514	101	3	81946	3	0	82053
18515	50	3	83081	26	0	83160
18516	84409	10	195	32	0	84646
18517	85517	11	301	14	0	85843
18518	7	221	8	84804	0	85040
18519	111	1	86496	19	0	86627
18520	15	150	8	86710	0	86883
18521	86293	7	141	8	0	86449
18522	100	1	86367	20	0	86488
18523	31	225	8	86555	0	86819
18524	89	5	85671	106	0	85871
18525	11	88840	8	112	0	88971
18526	128	15	96395	6	0	96544
18527	15	194	7	104228	0	104444
18528	103851	8	129	19	0	104007
18529	9	139	7	104035	0	104190
18530	104398	8	170	5	0	104581
18531	103491	21	200	44	0	103756
18532	104790	19	288	14	0	105111
18533	27	0	106468	9	0	106504
18534	104113	21	188	26	0	104348
18535	13	295	13	105209	0	105530
18536	25	269	10	103822	0	104126
18537	106	3	108926	18	0	109053
18538	14	190	7	110939	0	111150
18539	110585	9	171	28	0	110793
18540	1	110511	1	75	0	110588
18541	110020	13	302	25	0	110360
18542	111386	29	297	25	0	111737
18543	113313	11	230	21	0	113575
18544	10	219	15	116404	0	116648
18545	48	1	117859	19	0	117927
18546	28	332	17	117001	0	117378
18547	21	163	7	117392	0	117583
18548	118073	6	161	15	0	118255
18549	117013	18	229	38	0	117298
18550	62	7	117883	16	0	117968
18551	178	347	38	118957	0	119520
18552	90	17	118298	16	0	118421
18553	118086	8	321	91	0	118506
18554	3	119549	5	74	0	119631
18555	118876	13	262	48	0	119199
18556	2	120822	1	54	0	120879
18557	119690	21	336	22	0	120069
18558	5	126101	1	63	0	126170
18559	23	359	13	125297	0	125692
18560	35	121	4	126580	0	126740
18561	125960	9	91	12	0	126072
18562	125224	21	293	24	0	125562
18563	124542	12	264	18	0	124836
18564	124322	21	344	22	0	124709
18565	124388	21	210	27	0	124646
18566	15	424	6	124786	0	125231
18567	8	109334	1	48	0	109391
18568	23	386	17	106925	0	107351
18569	4	107443	2	42	0	107491
18570	30	338	14	106679	0	107061
18571	6	99581	3	50	0	99640
18572	19	345	22	99638	0	100024
18573	84	14	99778	18	0	99894
18574	99564	10	247	43	0	99864
18575	4	97255	1	68	0	97328
18576	96084	16	265	46	0	96411
18577	31	0	97450	6	0	97487
18578	95532	9	212	37	0	95790
18579	35	1	99259	6	0	99301
18580	43	267	7	98153	0	98470
18581	10	98900	3	65	0	98978
18582	144	3	102397	6	0	102550
18583	18	162	6	102796	0	102982
18584	102275	2	139	14	0	102430
18585	24	234	9	96634	0	96901
18586	17	153	4	94260	0	94434
18587	30	250	8	93179	0	93467
18588	50	0	93627	15	0	93692
18589	14	374	12	97105	0	97505
18590	5	88664	4	26	0	88699
18591	23	239	11	88186	0	88459
18592	3	118	4	90343	0	90468
18593	89297	3	127	8	0	89435
18594	27	128	8	90831	0	90994
18595	93	0	88913	17	0	89023
18596	124	16	88449	53	0	88642
18597	80	17	90791	41	0	90929
18598	34	91342	8	73	0	91457
18599	92987	8	243	26	0	93264
18600	13	93561	1	69	0	93644
18601	94114	9	206	17	0	94346
18602	18	189	11	87751	0	87969
18603	52	1	80636	21	0	80710
18604	65	6	84349	29	0	84449
18605	6	84347	0	61	0	84414
18606	40	359	17	83579	0	83995
18607	9	176	8	84415	0	84608
18608	13	187	11	82908	0	83119
18609	91	2	83374	26	0	83493
18610	82922	5	168	31	0	83126
18611	81	0	83694	11	0	83786
18612	10	233	7	84993	0	85243
18613	22	220	10	78595	0	78847
18614	73	2	78474	23	0	78572
18615	78940	9	232	31	0	79212
18616	5	81184	0	40	0	81229
18617	81553	9	194	18	0	81774
18618	18	244	8	81669	0	81939
18619	9	82030	2	46	0	82087
18620	24	161	6	81588	0	81779
18621	84058	38	128	8	0	84232
18622	14	187	10	84284	0	84495
18623	64	9	85087	13	0	85173
18624	83854	8	235	53	0	84150
18625	82672	9	254	9	0	82944
18626	89	1	83552	9	0	83651
18627	8	113	3	83411	0	83535
18628	82681	5	80	7	0	82773
18629	4	201	3	86147	0	86355
18630	15	137	9	85850	0	86011
18631	21	167	15	86782	0	86985
18632	5	213	4	85688	0	85910
18633	60	0	85699	49	0	85808
18634	7	227	16	80102	0	80352
18635	83	2	79909	8	0	80002
18636	78955	6	219	43	0	79223
18637	81623	11	308	13	0	81955
18638	87249	16	255	30	0	87550
18639	88632	11	153	15	0	88811
18640	5	78	4	89437	0	89524
18641	89232	7	104	0	0	89343
18642	78	12	89388	10	0	89488
18643	77	4	87267	35	0	87383
18644	87669	5	215	38	0	87927
18645	13	86057	2	105	0	86177
18646	6	85515	2	67	0	85590
18647	18	169	16	84866	0	85069
18648	82	10	85590	7	0	85689
18649	83831	12	284	27	0	84154
18650	104	5	85397	18	0	85524
18651	14	85573	14	111	0	85712
18652	135	14	85012	9	0	85170
18653	221	84121	5	58	0	84405
18654	87149	11	169	13	0	87342
18655	17	89207	0	42	0	89266
18656	5	85728	3	42	0	85778
18657	25	253	10	87739	0	88027
18658	58	1	89619	13	0	89691
18659	20	239	11	90254	0	90524
18660	16	272	17	91873	0	92178
18661	62	3	94174	7	0	94246
18662	17	283	12	93098	0	93410
18663	17	91511	1	60	0	91589
18664	28	153	11	88198	0	88390
18665	92940	12	104	21	0	93077
18666	26	266	9	92584	0	92885
18667	89	3	99146	14	0	99252
18668	46	230	12	99052	0	99340
18669	115	3	98389	20	0	98527
18670	96545	8	233	44	0	96830
18671	14	109	6	98413	0	98542
18672	96131	9	129	17	0	96286
18673	106	1	95292	17	0	95416
18674	93773	9	230	24	0	94036
18675	2	93384	2	63	0	93451
18676	162	1	89251	17	0	89431
18677	35	263	29	92851	0	93178
18678	158	4	92384	53	0	92599
18679	24	95074	8	113	0	95219
18680	28	95106	1	85	0	95220
18681	96457	14	182	52	0	96705
18682	5	96066	8	71	0	96150
18683	96402	11	211	24	0	96648
18684	21	278	16	97409	0	97724
18685	106	5	96079	15	0	96205
18686	4	98072	1	162	0	98239
18687	23	633	16	96584	0	97256
18688	29	397	16	102459	0	102901
18689	15	393	13	102698	0	103119
18690	26	257	16	102116	0	102415
18691	17	100795	4	34	0	100850
18692	8	100470	1	88	0	100567
18693	100692	21	176	55	0	100944
18694	4	94324	2	34	0	94364
18695	7	217	7	92070	0	92301
18696	58	2	96285	26	0	96371
18697	7	91533	2	5172	0	96714
18698	6	349	11	97015	0	97381
18699	36	309	11	101610	0	101966
18700	10	101728	1	47	0	101786
18701	101274	13	279	39	0	101605
18702	62	3	100604	14	0	100683
18703	101551	11	278	38	0	101878
18704	7	105290	2	63	0	105362
18705	102254	15	261	29	0	102559
18706	3	107531	4	60	0	107598
18707	21	316	16	106960	0	107313
18708	10	152	10	107584	0	107756
18709	106709	18	116	12	0	106855
18710	11	263	12	106947	0	107233
18711	139	2	106481	15	0	106637
18712	37	108624	2	151	0	108814
18713	8	105132	5	67	0	105212
18714	18	298	27	103925	0	104268
18715	95	3	103447	11	0	103556
18716	42	305	13	104655	0	105015
18717	29	297	10	104604	0	104940
18718	117	3	103364	25	0	103509
18719	124	12	102488	62	0	102686
18720	55	102409	4	103	0	102571
18721	103219	9	167	17	0	103412
18722	15	355	11	102965	0	103346
18723	11	103348	0	51	0	103410
18724	106058	22	188	12	0	106280
18725	14	342	22	106903	0	107281
18726	19	341	13	106654	0	107027
18727	15	110123	1	37	0	110176
18728	23	222	12	109363	0	109620
18729	109139	14	112	11	0	109276
18730	20	265	15	109461	0	109761
18731	24	322	8	105675	0	106029
18732	115	3	106352	36	0	106506
18733	94	6	104122	36	0	104258
18734	101840	23	159	31	0	102053
18735	12	282	12	102726	0	103032
18736	16	248	3	101717	0	101984
18737	15	183	12	98950	0	99160
18738	63	5	100229	14	0	100311
18739	100317	8	143	20	0	100488
18740	15	228	8	101109	0	101360
18741	11	162	2	98224	0	98399
18742	96621	13	168	14	0	96816
18743	4	93872	4	86	0	93966
18744	107	7	94681	5	0	94800
18745	32	409	12	101169	0	101622
18746	24	103096	6	44	0	103170
18747	14	208	11	102893	0	103126
18748	107311	13	118	21	0	107463
18749	14	203	9	107099	0	107325
18750	107086	2	101	8	0	107197
18751	106954	14	164	23	0	107155
18752	13	259	19	102485	0	102776
18753	20	103373	1	46	0	103440
18754	9	97315	2	81	0	97407
18755	104	3	100833	4	0	100944
18756	16	389	30	100352	0	100787
18757	18	324	6	100547	0	100895
18758	14	223	11	107074	0	107322
18759	106582	6	110	6	0	106704
18760	26	264	10	107032	0	107332
18761	53	0	106787	3	0	106843
18762	103364	17	241	38	0	103660
18763	11	214	14	104969	0	105208
18764	27	283	9	98992	0	99311
18765	153	1	98800	11	0	98965
18766	106652	7	286	28	0	106973
18767	24	232	11	107204	0	107471
18768	113	2	107970	8	0	108093
18769	25	458	8	108638	0	109129
18770	53	428	14	107925	0	108420
18771	69	103768	4	62	0	103903
18772	104913	22	269	19	0	105223
18773	108455	10	228	21	0	108714
18774	9	108075	1	52	0	108137
18775	103177	6	237	15	0	103435
18776	103425	14	229	13	0	103681
18777	19	173	19	102102	0	102313
18778	73	1	102218	15	0	102307
18779	61	3	105437	39	0	105540
18780	132	4	101605	31	0	101772
18781	83	1	103375	32	0	103491
18782	13	370	37	98231	0	98651
18783	8	200	11	99140	0	99359
18784	28	315	13	99416	0	99772
18785	6	120	3	99640	0	99769
18786	99017	4	134	14	0	99169
18787	11	99167	3	103	0	99284
18788	95013	5	273	25	0	95316
18789	52	0	96029	10	0	96091
18790	80	4	94606	26	0	94716
18791	12	186	7	93541	0	93746
18792	93326	3	94	2	0	93425
18793	94464	13	226	17	0	94720
18794	38	100254	3	40	0	100335
18795	13	101483	1	64	0	101561
18796	15	280	6	101499	0	101800
18797	102708	5	137	19	0	102869
18798	40	101732	3	43	0	101818
18799	102012	9	252	18	0	102291
18800	98857	7	292	42	0	99198
18801	97840	14	300	20	0	98174
18802	71	14	97859	8	0	97952
18803	10	93888	2	61	0	93961
18804	93180	10	155	19	0	93364
18805	101233	14	188	17	0	101452
18806	23	100735	2	137	0	100897
18807	14	100875	2	70	0	100961
18808	101201	5	164	8	0	101378
18809	16	291	18	100057	0	100382
18810	135	2	102025	10	0	102172
18811	100820	8	296	32	0	101156
18812	27	236	20	101882	0	102165
18813	10	102055	1	59	0	102125
18814	21	309	26	99429	0	99785
18815	107	2	109459	8	0	109576
18816	19	192	10	112815	0	113036
18817	113156	4	119	9	0	113288
18818	18	307	14	113359	0	113698
18819	33	310	16	108235	0	108594
18820	86	1	108650	97	0	108834
18821	34	358	3	103132	0	103527
18822	20	100873	2	71	0	100966
18823	101447	7	186	24	0	101664
18824	97810	17	183	14	0	98024
18825	54	2	103203	13	0	103272
18826	28	342	5	104942	0	105317
18827	22	105652	3	75	0	105752
18828	21	105391	4	80	0	105496
18829	106188	15	237	20	0	106460
18830	45	206	14	107465	0	107730
18831	124	0	104331	9	0	104464
18832	99	2	110664	30	0	110795
18833	12	218	3	111028	0	111261
18834	104934	5	128	12	0	105079
18835	104870	14	392	16	0	105292
18836	21	166	5	105824	0	106016
18837	167	2	105180	25	0	105374
18838	27	105540	4	76	0	105647
18839	105299	10	354	36	0	105699
18840	22	108266	2	106	0	108396
18841	105928	9	241	24	0	106202
18842	25	321	14	103673	0	104033
18843	135	0	104075	68	0	104278
18844	19	257	8	103647	0	103931
18845	104893	7	157	17	0	105074
18846	134	2	104866	6	0	105008
18847	21	106034	13	100	0	106168
18848	10	196	12	106115	0	106333
18849	103768	13	122	21	0	103924
18850	86	0	105822	11	0	105919
18851	21	312	7	116811	0	117151
18852	21	371	12	116043	0	116447
18853	64	1	116696	8	0	116769
18854	25	304	19	114620	0	114968
18855	101	3	112619	26	0	112749
18856	113612	6	301	38	0	113957
18857	12	201	6	112450	0	112669
18858	123	5	111429	19	0	111576
18859	18	121344	0	89	0	121451
18860	123217	8	319	27	0	123571
18861	127631	5	261	12	0	127909
18862	25	362	19	127625	0	128031
18863	18	129324	2	54	0	129398
18864	129835	7	207	11	0	130060
18865	12	299	16	129230	0	129557
18866	171	1	129659	17	0	129848
18867	130074	12	307	35	0	130428
18868	8	125132	3	78	0	125221
18869	22	233	6	124030	0	124291
18870	121753	15	226	27	0	122021
18871	84	4	122373	13	0	122474
18872	77	1	128622	33	0	128733
18873	30	433	20	127978	0	128461
18874	114	3	129436	12	0	129565
18875	34	368	10	129935	0	130347
18876	29	128388	3	72	0	128492
18877	41	293	13	129742	0	130089
18878	129909	5	150	7	0	130071
18879	110	4	129336	12	0	129462
18880	13	128374	3	93	0	128483
18881	18	382	9	123200	0	123609
18882	160	3	126775	7	0	126945
18883	45	402	14	126985	0	127446
18884	28	127002	3	109	0	127142
18885	12	125147	3	80	0	125242
18886	126107	21	246	26	0	126400
18887	16	125496	4	117	0	125633
18888	151	15	125083	9	0	125258
18889	123045	12	296	34	0	123387
18890	95	2	124151	21	0	124269
18891	18	275	13	112398	0	112704
18892	99	4	113222	9	0	113334
18893	10	114265	5	65	0	114345
18894	18	444	22	113976	0	114460
18895	22	250	12	117066	0	117350
18896	18	286	10	115403	0	115717
18897	33	3	116960	38	0	117034
18898	35	388	9	119262	0	119694
18899	12	138	10	118242	0	118402
18900	117672	8	155	39	0	117874
18901	109605	15	245	35	0	109900
18902	253	1	110738	10	0	111002
18903	11	110188	1	104	0	110304
18904	82	6	111166	2	0	111256
18905	18	328	24	111969	0	112339
18906	61	0	111071	21	0	111153
18907	18	310	13	110615	0	110956
18908	14	273	17	105746	0	106050
18909	127	1	106112	16	0	106256
18910	109363	6	249	29	0	109647
18911	11	108127	1	91	0	108230
18912	49	254	11	107061	0	107375
18913	112	0	109177	9	0	109298
18914	149	5	109680	24	0	109858
18915	109753	16	262	87	0	110118
18916	17	110880	0	47	0	110944
18917	16	174	11	110493	0	110694
18918	117052	11	112	14	0	117189
18919	21	328	8	119137	0	119494
18920	21	219	13	119042	0	119295
18921	40	1	116370	37	0	116448
18922	112038	9	242	34	0	112323
18923	112043	10	460	7	0	112520
18924	18	209	8	112183	0	112418
18925	109137	15	160	12	0	109324
18926	26	355	11	116172	0	116564
18927	12	112297	2	35	0	112346
18928	17	114235	4	89	0	114345
18929	16	217	8	115283	0	115524
18930	117328	7	127	20	0	117482
18931	16	187	2	118922	0	119127
18932	117712	14	84	10	0	117820
18933	117713	8	152	20	0	117893
18934	17	164	18	113690	0	113889
18935	18	215	11	105635	0	105879
18936	81	2	102446	115	0	102644
18937	69	1	102002	28	0	102100
18938	25	304	13	101054	0	101396
18939	156	1	99647	14	0	99818
18940	99025	17	287	36	0	99365
18941	19	276	23	99146	0	99464
18942	87	1	98977	10	0	99075
18943	99363	4	273	34	0	99674
18944	100079	2	305	20	0	100406
18945	10	94968	2	119	0	95099
18946	18	228	8	92942	0	93196
18947	52	1	94153	16	0	94222
18948	95022	5	202	30	0	95259
18949	95284	8	366	24	0	95682
18950	60	1	95515	12	0	95588
18951	94189	3	211	21	0	94424
18952	10	153	14	94710	0	94887
18953	14	125	4	94946	0	95089
18954	94212	4	110	24	0	94350
18955	93628	13	191	7	0	93839
18956	10	150	12	93586	0	93758
18957	90	1	92157	54	0	92302
18958	13	88920	12	232	0	89177
18959	125	3	88166	11	0	88305
18960	89	2	88339	30	0	88460
18961	9	88349	2	56	0	88416
18962	36	298	11	89070	0	89415
18963	21	291	11	92257	0	92580
18964	110	3	96438	2	0	96553
18965	19	168	6	96841	0	97034
18966	96079	7	157	23	0	96266
18967	61	3	96060	6	0	96130
18968	94816	12	239	28	0	95095
18969	93969	18	302	16	0	94305
18970	93621	22	310	16	0	93969
18971	63	0	92536	9	0	92608
18972	95	0	94590	18	0	94703
18973	17	368	5	99563	0	99953
18974	39	253	5	99125	0	99422
18975	28	98817	5	62	0	98912
18976	99294	12	246	42	0	99594
18977	101702	11	241	36	0	101990
18978	9	100814	1	52	0	100876
18979	100921	7	269	22	0	101219
18980	9	112055	3	121	0	112188
18981	108569	14	363	38	0	108984
18982	20	225	6	112190	0	112441
18983	95	1	112053	17	0	112166
18984	82	20	112965	25	0	113092
18985	24	284	26	112378	0	112712
18986	21	285	24	111218	0	111548
18987	98	0	112421	4	0	112523
18988	20	307	6	114306	0	114639
18989	23	125	5	111248	0	111401
18990	112558	5	168	19	0	112750
18991	111738	12	230	19	0	111999
18992	107056	20	412	16	0	107504
18993	44	1	106032	10	0	106087
18994	11	99520	0	52	0	99583
18995	25	332	7	98885	0	99249
18996	102	3	100832	12	0	100949
18997	22	100836	0	76	0	100934
18998	102374	1	204	4	0	102583
18999	18	212	9	102202	0	102441
19000	13	110	3	103728	0	103854
19001	100924	8	91	7	0	101030
19002	19	112	6	92464	0	92601
19003	14	170	5	91286	0	91475
19004	89146	13	131	15	0	89305
19005	122	1	86966	96	0	87185
19006	9	89080	0	84	0	89173
19007	87200	22	225	21	0	87468
19008	83	4	87370	13	0	87470
19009	88254	13	289	28	0	88584
19010	9	89374	4	39	0	89426
19011	88965	5	148	12	0	89130
19012	88784	5	207	8	0	89004
19013	87468	6	182	16	0	87672
19014	15	147	12	87637	0	87811
19015	30	186	10	88183	0	88409
19016	32	89315	3	50	0	89400
19017	28	87642	3	129	0	87802
19018	12	88015	2	135	0	88164
19019	87725	6	193	28	0	87952
19020	64	2	87787	2	0	87855
19021	13	299	6	94114	0	94432
19022	32	201	7	93053	0	93293
19023	12	94959	3	17	0	94991
19024	17	331	21	93432	0	93801
19025	19	169	5	93808	0	94001
19026	20	94182	1	42	0	94245
19027	94472	12	311	22	0	94817
19028	12	94935	1	127	0	95075
19029	95	4	94064	7	0	94170
19030	95970	4	271	32	0	96277
19031	5	96387	4	96	0	96492
19032	95512	4	184	13	0	95713
19033	20	171	8	112354	0	112553
19034	49	222	8	113052	0	113331
19035	142	4	112553	28	0	112727
19036	64	3	113452	21	0	113540
19037	13	203	6	113552	0	113774
19038	113148	9	180	8	0	113345
19039	110454	46	281	29	0	110810
19040	50	112347	3	78	0	112478
19041	52	111769	3	90	0	111914
19042	13	113287	0	35	0	113335
19043	12	138	15	112237	0	112402
19044	112064	5	141	4	0	112214
19045	111253	20	164	16	0	111453
19046	111563	20	399	10	0	111992
19047	90	4	116784	4	0	116882
19048	10	116979	2	58	0	117049
19049	10	177	11	111867	0	112065
19050	113679	5	152	15	0	113851
19051	15	257	12	114668	0	114952
19052	21	74	4	115553	0	115652
19053	113171	12	100	28	0	113311
19054	113216	13	225	22	0	113476
19055	76	4	115230	6	0	115316
19056	17	243	8	103062	0	103330
19057	79	2	104988	8	0	105077
19058	45	365	24	101682	0	102116
19059	117	2	101730	7	0	101856
19060	22	178	8	100707	0	100915
19061	101203	4	181	21	0	101409
19062	40	99443	2	68	0	99553
19063	18	98748	2	60	0	98828
19064	37	349	9	99473	0	99868
19065	16	99899	1	42	0	99958
19066	98405	4	279	23	0	98711
19067	98951	9	217	12	0	99189
19068	35	1	99343	7	0	99386
19069	9	103019	0	67	0	103095
19070	20	193	18	101635	0	101866
19071	61	2	101977	10	0	102050
19072	102698	8	317	26	0	103049
19073	18	261	20	102985	0	103284
19074	125	15	103051	3	0	103194
19075	20	157	11	104879	0	105067
19076	102926	14	247	23	0	103210
19077	41	5	103692	11	0	103749
19078	102278	13	321	28	0	102640
19079	102638	16	437	13	0	103104
19080	14	167	11	101874	0	102066
19081	114	2	101023	8	0	101147
19082	79	2	101431	20	0	101532
19083	101079	11	222	19	0	101331
19084	100303	13	353	25	0	100694
19085	40	2	103259	18	0	103319
19086	13	296	7	102490	0	102806
19087	29	278	5	101706	0	102018
19088	22	104101	3	113	0	104239
19089	14	171	7	104850	0	105042
19090	106979	13	146	9	0	107147
19091	21	194	28	105270	0	105513
19092	83	4	105025	7	0	105119
19093	106438	11	413	57	0	106919
19094	12	231	7	101249	0	101499
19095	91	3	101467	8	0	101569
19096	18	100675	3	189	0	100885
19097	100003	22	301	43	0	100369
19098	12	99367	0	77	0	99456
19099	97630	4	269	34	0	97937
19100	84	1	107054	12	0	107151
19101	34	109052	9	106	0	109201
19102	23	108236	3	62	0	108324
19103	31	373	12	108124	0	108540
19104	43	274	13	109194	0	109524
19105	218	4	109581	24	0	109827
19106	26	182	7	110581	0	110796
19107	109363	7	223	11	0	109604
19108	45	2	109418	80	0	109545
19109	25	256	11	92756	0	93048
19110	115	2	91874	19	0	92010
19111	99845	12	317	40	0	100214
19112	22	99686	3	59	0	99770
19113	99506	10	223	11	0	99750
19114	98770	9	114	21	0	98914
19115	98491	14	358	5	0	98868
19116	48	1	94988	8	0	95045
19117	9	95540	1	55	0	95605
19118	25	325	19	95214	0	95583
19119	7	103	6	95388	0	95504
19120	96592	6	123	5	0	96726
19121	23	39	3	96661	0	96726
19122	96242	4	42	3	0	96291
19123	91627	5	145	85	0	91862
19124	88992	8	66	8	0	89074
19125	86281	6	163	16	0	86466
19126	8	33	5	85591	0	85637
19127	83614	5	75	11	0	83705
19128	55	0	83736	10	0	83801
19129	84141	6	152	8	0	84307
19130	83746	1	212	13	0	83972
19131	37	1	84996	9	0	85043
19132	82731	8	160	35	0	82934
19133	82114	4	75	11	0	82204
19134	5	83	12	81312	0	81412
19135	9	66	12	81096	0	81183
19136	95048	11	101	24	0	95184
19137	7	184	9	95066	0	95266
19138	26	225	10	93132	0	93393
19139	5	94773	0	65	0	94843
19140	18	124	9	91773	0	91924
19141	95975	3	63	5	0	96046
19142	12	161	6	96524	0	96703
19143	33	236	9	96059	0	96337
19144	6	97121	2	18	0	97147
19145	19	180	11	90859	0	91069
19146	11	92	2	91695	0	91800
19147	92869	7	129	1	0	93006
19148	21	163	6	91905	0	92095
19149	126	1	92097	10	0	92234
19150	28	91785	16	92	0	91921
19151	8	91817	4	121	0	91950
19152	92025	12	291	87	0	92415
19153	7	91169	1	140	0	91317
19154	91027	12	318	31	0	91388
19155	3	95292	3	59	0	95357
19156	93021	6	198	7	0	93232
19157	9	220	7	92941	0	93177
19158	26	194	6	92182	0	92408
19159	10	90135	0	58	0	90203
19160	31	227	13	89488	0	89759
19161	49	1	89955	8	0	90013
19162	90165	8	329	42	0	90544
19163	19	91463	0	129	0	91611
19164	90436	8	220	19	0	90683
19165	90902	3	145	6	0	91056
19166	89456	8	192	15	0	89671
19167	5	109	1	90585	0	90700
19168	25	202	7	90183	0	90417
19169	11	89692	5	42	0	89750
19170	89476	7	308	14	0	89805
19171	4	90354	1	74	0	90433
19172	89675	13	255	31	0	89974
19173	76	24	90895	10	0	91005
19174	91174	3	305	26	0	91508
19175	33	137	11	90258	0	90439
19176	80	4	80951	6	0	81041
19177	61	5	94314	14	0	94394
19178	25	201	48	92938	0	93212
19179	70	3	93592	5	0	93670
19180	13	108	6	93834	0	93961
19181	93071	7	184	17	0	93279
19182	13	201	13	91615	0	91842
19183	143	5	91711	7	0	91866
19184	50	92800	9	104	0	92963
19185	14	92131	1	64	0	92210
19186	18	106	11	83875	0	84010
19187	85533	7	40	6	0	85586
19188	9	202	7	87049	0	87267
19189	12	151	6	89171	0	89340
19190	20	128	11	88960	0	89119
19191	7	126	19	88131	0	88283
19192	71	3	85060	40	0	85174
19193	35	0	85122	19	0	85176
19194	86278	8	261	29	0	86576
19195	86773	10	247	6	0	87036
19196	11	163	9	87122	0	87305
19197	9	195	5	86926	0	87135
19198	55	2	86559	17	0	86633
19199	18	86004	0	108	0	86130
19200	86225	3	232	10	0	86470
19201	85560	14	236	5	0	85815
19202	15	128	4	85472	0	85619
19203	76	3	91997	3	0	92079
19204	16	224	11	92540	0	92791
19205	12	91839	3	118	0	91972
19206	81	0	91965	13	0	92059
19207	90042	37	264	35	0	90378
19208	14	226	5	93223	0	93468
19209	92900	14	198	18	0	93130
19210	52	2	93518	7	0	93579
19211	95350	13	372	28	0	95763
19212	9	126	4	82832	0	82971
19213	82125	7	155	13	0	82300
19214	29	158	13	81720	0	81920
19215	19	81570	4	59	0	81652
19216	12	78093	4	56	0	78165
19217	14	157	14	77531	0	77716
19218	153	2	79040	7	0	79202
19219	10	79123	3	52	0	79188
19220	8	94	0	79489	0	79591
19221	79227	8	96	10	0	79341
19222	81192	9	91	14	0	81306
19223	11	172	5	78684	0	78872
19224	43	191	7	80822	0	81063
19225	14	80242	0	59	0	80315
19226	14	79114	1	53	0	79182
19227	78060	17	169	8	0	78254
19228	8	146	2	79770	0	79926
19229	7	97	6	80016	0	80126
19230	51	0	82320	16	0	82387
19231	22	162	34	78812	0	79030
19232	15	164	10	79248	0	79437
19233	16	151	3	79784	0	79954
19234	102	2	79738	7	0	79849
19235	4	127	6	81531	0	81668
19236	81340	5	143	13	0	81501
19237	36	2	81293	11	0	81342
19238	81675	7	178	22	0	81882
19239	11	158	14	80678	0	80861
19240	13	100	10	80725	0	80848
19241	11	154	10	81708	0	81883
19242	59	3	80078	54	0	80194
19243	81965	5	284	43	0	82297
19244	7	84033	2	71	0	84113
19245	83598	13	316	30	0	83957
19246	5	86183	4	84	0	86276
19247	16	147	3	85906	0	86072
19248	85872	8	232	22	0	86134
19249	54	1	85146	8	0	85209
19250	85970	11	393	28	0	86402
19251	98	0	88770	7	0	88875
19252	21	113	17	85854	0	86005
19253	72	5	75970	4	0	76051
19254	13	78404	4	67	0	78488
19255	8	122	7	77672	0	77809
19256	81593	7	160	12	0	81772
19257	18	195	16	80686	0	80915
19258	14	80518	0	28	0	80560
19259	16	158	6	81275	0	81455
19260	81020	2	81	5	0	81108
19261	82695	14	208	6	0	82923
19262	13	81951	3	99	0	82066
19263	11	80655	0	94	0	80760
19264	26	178	19	80037	0	80260
19265	17	114	5	79374	0	79510
19266	79367	6	85	7	0	79465
19267	79758	11	201	15	0	79985
19268	4	79939	0	37	0	79980
19269	16	193	10	78556	0	78775
19270	11	120	50	77007	0	77188
19271	67	6	76312	76	0	76461
19272	17	76867	3	105	0	76992
19273	5	77296	2	65	0	77368
19274	22	107	12	77644	0	77785
19275	70	2	78393	6	0	78471
19276	26	2	80903	34	0	80965
19277	9	157	5	81854	0	82025
19278	12	171	6	81498	0	81687
19279	51	0	75420	2	0	75473
19280	18	150	16	74542	0	74726
19281	54	1	74822	7	0	74884
19282	74158	15	271	27	0	74471
19283	17	99	12	73599	0	73727
19284	54	3	70686	10	0	70753
19285	36	0	71092	15	0	71143
19286	37	133	8	70241	0	70419
19287	82	3	69082	28	0	69195
19288	58	6	69113	25	0	69202
19289	35	68888	9	136	0	69068
19290	68833	12	160	2	0	69007
19291	47	0	70700	2	0	70749
19292	7	151	14	71385	0	71557
19293	26	201	12	70849	0	71088
19294	6	166	6	69178	0	69356
19295	61	10	70535	8	0	70614
19296	12	85	4	70215	0	70316
19297	70262	4	96	14	0	70376
19298	13	106	3	68879	0	69001
19299	58	0	69295	3	0	69356
19300	15	66	7	67107	0	67195
19301	68289	6	76	12	0	68383
19302	68268	10	155	12	0	68445
19303	68773	8	59	17	0	68857
19304	4	60	8	68917	0	68989
19305	68590	3	35	5	0	68633
19306	69079	9	134	11	0	69233
19307	69206	23	158	8	0	69395
19308	3	69623	0	30	0	69656
19309	68701	5	150	15	0	68871
19310	11	128	11	69923	0	70073
19311	65	1	70953	9	0	71028
19312	8	72803	7	91	0	72909
19313	72951	9	190	11	0	73161
19314	12	192	11	74650	0	74865
19315	15	155	6	73493	0	73669
19316	29	75006	8	57	0	75100
19317	6	73790	3	55	0	73854
19318	74724	10	201	25	0	74960
19319	8	72442	0	93	0	72543
19320	77922	9	229	18	0	78178
19321	4	77186	1	67	0	77258
19322	76412	12	229	26	0	76679
19323	19	75451	1	135	0	75606
19324	8	74873	2	72	0	74955
19325	72097	15	190	23	0	72325
19326	31	0	72746	8	0	72785
19327	11	72419	2	48	0	72480
19328	7	243	8	71996	0	72254
19329	16	185	5	72351	0	72557
19330	13	155	6	71232	0	71406
19331	21	128	10	71498	0	71657
19332	32	2	68088	8	0	68130
19333	68176	7	211	13	0	68407
19334	10	73	2	68864	0	68949
19335	67738	4	117	8	0	67867
19336	65821	8	126	7	0	65962
19337	63967	6	107	20	0	64100
19338	63581	5	210	11	0	63807
19339	22	1	64454	5	0	64482
19340	6	90	4	64260	0	64360
19341	27	27	63718	5	0	63777
19342	5	64099	4	44	0	64152
19343	12	217	6	65043	0	65278
19344	14	185	6	65086	0	65291
19345	16	130	13	65295	0	65454
19346	22	136	6	65748	0	65912
19347	48	1	65070	4	0	65123
19348	13	132	7	64671	0	64823
19349	18	74	8	67372	0	67472
19350	66632	4	119	4	0	66759
19351	70852	5	87	4	0	70948
19352	5	105	9	68258	0	68377
19353	9	116	8	68940	0	69073
19354	11	81	7	69351	0	69450
19355	80117	0	18	21	0	80156
19356	80024	7	82	17	0	80130
19357	79674	7	108	11	0	79800
19358	80345	32	269	9	0	80655
19359	2	81313	0	22	0	81337
19360	80979	8	201	6	0	81194
19361	81333	8	164	11	0	81516
19362	14	100	4	84914	0	85032
19363	7	113	26	85254	0	85400
19364	85468	4	178	15	0	85665
19365	32	86145	3	64	0	86244
19366	6	84697	2	52	0	84757
19367	84882	3	151	8	0	85044
19368	16	168	5	83644	0	83833
19369	12	163	13	83540	0	83728
19370	27	209	12	87055	0	87303
19371	13	181	8	86526	0	86728
19372	18	195	7	87618	0	87838
19373	10	89228	3	48	0	89289
19374	22	116	4	88493	0	88635
19375	89139	2	92	8	0	89241
19376	18	259	17	88276	0	88570
19377	10	124	1	90933	0	91068
19378	91143	11	151	16	0	91321
19379	5	92075	3	58	0	92141
19380	29	206	30	90137	0	90402
19381	8	91527	2	38	0	91575
19382	33	164	17	88625	0	88839
19383	94	2	89215	10	0	89321
19384	89295	15	320	39	0	89669
19385	11	89685	3	89	0	89788
19386	86142	12	288	30	0	86472
19387	56	7	88810	7	0	88880
19388	42	190	11	92412	0	92655
19389	42	98343	6	73	0	98464
19390	17	96601	5	82	0	96705
19391	97650	7	284	33	0	97974
19392	30	192	15	95882	0	96119
19393	59	0	96525	7	0	96591
19394	49	155	16	95158	0	95378
19395	58	0	95285	26	0	95369
19396	86447	20	386	66	0	86919
19397	89	2	86908	2	0	87001
19398	39	191	11	85731	0	85972
19399	13	87355	2	20	0	87390
19400	56	239	9	84947	0	85251
19401	19	85182	2	63	0	85266
19402	87374	14	216	15	0	87619
19403	21	146	10	87813	0	87990
19404	61	0	87843	7	0	87911
19405	168	3	88249	9	0	88429
19406	87494	2	232	21	0	87749
19407	86889	7	417	11	0	87324
19408	86801	14	303	16	0	87134
19409	86923	127	304	15	0	87369
19410	5	87698	1	50	0	87754
19411	86852	11	207	7	0	87077
19412	86700	15	296	18	0	87029
19413	80	3	86962	6	0	87051
19414	16	83	16	88095	0	88210
19415	86973	2	152	2	0	87129
19416	68	0	87955	7	0	88030
19417	32	208	43	88461	0	88744
19418	78	1	90018	8	0	90105
19419	33	170	18	95709	0	95930
19420	18	96205	3	53	0	96279
19421	95644	17	337	39	0	96037
19422	33	1	100296	2	0	100332
19423	104623	13	372	37	0	105045
19424	14	136	8	105166	0	105324
19425	102844	4	173	11	0	103032
19426	16	91	5	103174	0	103286
19427	97977	6	177	14	0	98174
19428	33	1	99814	8	0	99856
19429	101310	11	175	16	0	101512
19430	12	173	13	100964	0	101162
19431	9	110	11	94966	0	95096
19432	95467	4	150	6	0	95627
19433	16	210	12	95424	0	95662
19434	44	1	95222	6	0	95273
19435	24	155	8	94362	0	94549
19436	95143	5	216	21	0	95385
19437	27	95702	10	87	0	95826
19438	7	92903	3	83	0	92996
19439	93874	15	255	41	0	94185
19440	8	94585	0	25	0	94618
19441	14	106	5	95549	0	95674
19442	97100	3	158	9	0	97270
19443	95994	11	278	24	0	96307
19444	96368	19	349	9	0	96745
19445	47	1	97579	2	0	97629
19446	29	153	9	95231	0	95422
19447	13	94634	1	57	0	94705
19448	47	154	16	93705	0	93922
19449	93	1	94111	6	0	94211
19450	25	94932	7	98	0	95062
19451	61	143	8	95568	0	95780
19452	96441	7	207	19	0	96674
19453	9	92294	5	97	0	92405
19454	71	5	94796	3	0	94875
19455	19	226	12	92812	0	93069
19456	108	0	96055	5	0	96168
19457	16	116	5	95037	0	95174
19458	94525	5	133	15	0	94678
19459	37	145	13	94232	0	94427
19460	100380	9	151	9	0	100549
19461	102442	14	308	22	0	102786
19462	34	98834	0	37	0	98905
19463	93079	16	302	18	0	93415
19464	6	92854	2	54	0	92916
19465	89	0	86131	5	0	86225
19466	10	200	12	87379	0	87601
19467	36	173	6	86901	0	87116
19468	112	2	86667	3	0	86784
19469	14	87774	2	80	0	87870
19470	87877	5	214	3	0	88099
19471	88555	8	182	18	0	88763
19472	15	126	5	88293	0	88439
19473	23	176	17	87288	0	87504
19474	6	114	4	88747	0	88871
19475	87459	4	167	13	0	87643
19476	32	1	87502	9	0	87544
19477	50	1	87378	15	0	87444
19478	21	118	9	85686	0	85834
19479	92	3	84435	4	0	84534
19480	39	0	85917	18	0	85974
19481	12	160	6	85699	0	85877
19482	84	2	85046	9	0	85141
19483	9	83890	2	101	0	84002
19484	23	174	8	86894	0	87099
19485	27	3	88623	4	0	88657
19486	29	148	9	91415	0	91601
19487	9	92439	1	35	0	92484
19488	18	231	8	92004	0	92261
19489	50	2	91587	5	0	91644
19490	18	132	5	91787	0	91942
19491	91094	5	215	7	0	91321
19492	123	2	90127	13	0	90265
19493	90004	5	337	24	0	90370
19494	7	86970	2	41	0	87020
19495	81771	4	149	12	0	81936
19496	33	137	12	77558	0	77740
19497	14	73240	1	42	0	73297
19498	73397	12	214	26	0	73649
19499	15	133	5	73319	0	73472
19500	101	0	73129	5	0	73235
19501	19	73235	1	50	0	73305
19502	17	137	10	73048	0	73212
19503	72082	6	111	4	0	72203
19504	71018	14	126	6	0	71164
19505	5	88	8	69868	0	69969
19506	43	1	69683	4	0	69731
19507	63641	10	248	23	0	63922
19508	41	1	63788	3	0	63833
19509	9	83	7	65546	0	65645
19510	65300	3	89	10	0	65402
19511	7	65101	7	46	0	65161
19512	61911	15	193	11	0	62130
19513	27	0	60752	5	0	60784
19514	62144	13	153	14	0	62324
19515	15	147	7	60879	0	61048
19516	28	200	5	60211	0	60444
19517	53	0	58214	2	0	58269
19518	24	93	3	67647	0	67767
19519	67722	3	94	27	0	67846
19520	22	191	2	66727	0	66942
19521	6	65823	3	41	0	65873
19522	16	135	9	63341	0	63501
19523	11	62832	1	77	0	62921
19524	146	4	62752	2	0	62904
19525	64623	2	92	12	0	64729
19526	6	94	2	65647	0	65749
19527	55	2	65769	19	0	65845
19528	5	64028	6	47	0	64086
19529	15	137	2	63581	0	63735
19530	10	85	4	63875	0	63974
19531	64150	3	53	4	0	64210
19532	11	81	9	60633	0	60734
19533	60479	5	74	3	0	60561
19534	60931	11	174	11	0	61127
19535	8	61432	1	38	0	61479
19536	56644	8	159	16	0	56827
19537	10	106	4	57431	0	57551
19538	21	1	57199	4	0	57225
19539	57766	10	180	15	0	57971
19540	16	116	16	57951	0	58099
19541	54	1	57089	2	0	57146
19542	56166	4	162	9	0	56341
19543	10	143	9	55774	0	55936
19544	8	55766	0	58	0	55832
19545	33	120	8	55074	0	55235
19546	11	55102	0	39	0	55152
19547	54753	14	203	9	0	54979
19548	53	5	54809	2	0	54869
19549	17	60137	4	56	0	60214
19550	19	104	8	59284	0	59415
19551	61	1	59119	4	0	59185
19552	55	6	59103	7	0	59171
19553	8	60361	0	93	0	60462
19554	23	222	11	65228	0	65484
19555	20	113	9	65305	0	65447
19556	13	79	2	65463	0	65557
19557	65072	3	133	4	0	65212
19558	25	35	65312	1	0	65373
19559	8	63811	1	37	0	63857
19560	12	144	39	60842	0	61037
19561	9	155	5	57634	0	57803
19562	84	2	57598	2	0	57686
19563	26	109	10	56646	0	56791
19564	55	1	56398	7	0	56461
19565	42	1	55938	13	0	55994
19566	28	1	56263	4	0	56296
19567	9	137	51	54528	0	54725
19568	14	100	3	54228	0	54345
19569	6	62	6	54523	0	54597
19570	54442	2	85	10	0	54539
19571	6	54462	0	44	0	54512
19572	54098	4	180	11	0	54293
19573	53981	6	172	7	0	54166
19574	52818	13	144	6	0	52981
19575	7	52675	2	22	0	52706
19576	51513	1	71	4	0	51589
19577	51739	2	107	3	0	51851
19578	9	90	4	51403	0	51506
19579	6	89	6	51078	0	51179
19580	14	109	20	50857	0	51000
19581	51	1	50908	1	0	50961
19582	50477	9	126	17	0	50629
19583	10	74	3	50733	0	50820
19584	48758	4	100	10	0	48872
19585	6	49021	1	35	0	49063
19586	24	108	5	45711	0	45848
19587	2	65	2	45918	0	45987
19588	45916	3	32	16	0	45967
19589	7	58	6	45558	0	45629
19590	45365	3	56	21	0	45445
19591	44983	9	157	10	0	45159
19592	18	45232	0	19	0	45269
19593	2	44649	1	25	0	44677
19594	15	72	6	33493	0	33586
19595	8	33723	1	22	0	33754
19596	11	66	2	33496	0	33575
19597	33	0	33374	2	0	33409
19598	20	3	33361	7	0	33391
19599	33458	1	85	5	0	33549
19600	33380	2	133	3	0	33518
19601	1	31195	0	27	0	31223
19602	28598	2	73	2	0	28675
19603	4	28061	0	6	0	28071
19604	6	143	2	27062	0	27213
19605	9	89	3	27126	0	27227
19606	11	98	14	27014	0	27137
19607	3	48	3	26921	0	26975
19608	26869	0	35	5	0	26909
19609	5	26787	2	18	0	26812
19610	25849	0	67	7	0	25923
19611	25203	3	82	8	0	25296
19612	13	0	22521	1	0	22535
19613	18328	0	80	5	0	18413
19614	2	18428	0	7	0	18437
19615	5	77	3	17106	0	17191
19616	9	50	1	17171	0	17231
19617	2	17279	0	5	0	17286
19618	17084	2	11	2	0	17099
19619	4	0	17090	0	0	17094
19620	16166	3	8	0	0	16177
19621	3	0	16293	0	0	16296
19622	1	9	6	12705	0	12721
19623	3	2	1	10679	0	10685
19624	0	4	0	10733	0	10737
19625	10399	0	1	0	0	10400
19626	11	0	10386	0	0	10397
19627	10287	0	5	1	0	10293
19628	9749	0	2	0	0	9751
19629	8677	0	7	1	0	8685
19630	3653	0	6	0	0	3659
19631	0	4	0	2712	0	2716
19632	1	0	2527	0	0	2528
19633	2	2	0	2421	0	2425
19634	0	0	2348	3	0	2351
19635	1	0	2389	1	0	2391
19636	0	2479	0	1	0	2480
19637	0	10	0	2475	0	2485
19638	0	0	0	2522	0	2522
19639	0	6	0	2520	0	2526
19640	0	2	0	2527	0	2529
19641	2504	0	2	1	0	2507
19642	2565	0	4	0	0	2569
19643	0	4	0	2623	0	2627
19644	3	0	2658	0	0	2661
19645	2	7	0	2644	0	2653
19646	0	3	0	2628	0	2631
19647	0	0	2675	1	0	2676
19648	0	2	0	2730	0	2732
19649	2799	0	0	1	0	2800
19650	2823	0	3	1	0	2827
19651	2808	0	3	1	0	2812
19652	0	5	0	2863	0	2868
19653	2693	0	2	0	0	2695
19654	2689	0	3	2	0	2694
19655	3	0	2682	1	0	2686
19656	1	0	2690	0	0	2691
19657	6	0	2696	0	0	2702
19658	2670	1	7	0	0	2678
19659	1	2651	0	1	0	2653
19660	2624	0	1	2	0	2627
19661	0	2409	0	1	0	2410
19662	1	14	1	2478	0	2494
19663	1	3	0	2590	0	2594
19664	0	5	1	2590	0	2596
19665	2	0	2588	0	0	2590
19666	2614	0	7	0	0	2621
19667	0	5	0	2670	0	2675
19668	3	0	2615	1	0	2619
19669	5	0	2741	0	0	2746
19670	2738	0	2	2	0	2742
19671	1	2785	0	0	0	2786
19672	2762	0	5	0	0	2767
19673	2813	1	4	0	0	2818
19674	1	2804	0	1	0	2806
19675	2761	0	4	0	0	2765
19676	2	0	2810	0	0	2812
19677	8	1	2755	1	0	2765
19678	1	0	2844	0	0	2845
19679	0	9	0	2733	0	2742
19680	1	0	2691	0	0	2692
19681	2713	1	11	0	0	2725
19682	2628	0	9	1	0	2638
19683	4	0	2703	0	0	2707
19684	1	2	1	2728	0	2732
19685	2702	0	4	1	0	2707
19686	1	2667	1	1	0	2670
19687	0	2657	1	1	0	2659
19688	2661	0	7	0	0	2668
19689	2	0	2707	0	0	2709
19690	0	4	0	2691	0	2695
19691	0	6	0	2693	0	2699
19692	0	7	0	2671	0	2678
19693	1	2727	0	0	0	2728
19694	1	8	3	2737	0	2749
19695	2805	0	3	0	0	2808
19696	0	6	0	2778	0	2784
19697	0	2733	0	4	0	2737
19698	2756	0	6	2	0	2764
19699	0	3	0	2858	0	2861
19700	0	1	1	3121	0	3123
19701	3148	0	1	0	0	3149
19702	3262	0	6	1	0	3269
19703	0	4	0	3296	0	3300
19704	3267	1	4	0	0	3272
19705	3317	0	2	1	0	3320
19706	0	3308	0	0	0	3308
19707	3240	0	6	2	0	3248
19708	0	3280	0	2	0	3282
19709	0	7	1	3126	0	3134
19710	2	0	3254	0	0	3256
19711	0	7	2	3194	0	3203
19712	0	12	0	3186	0	3198
19713	1	2	0	3262	0	3265
19714	3272	0	5	1	0	3278
19715	1	3287	0	2	0	3290
19716	3268	0	9	3	0	3280
19717	1	3280	0	1	0	3282
19718	3176	0	7	0	0	3183
19719	3146	0	10	0	0	3156
19720	3094	2	7	0	0	3103
19721	3121	0	10	1	0	3132
19722	0	0	3166	0	0	3166
19723	0	4	1	3095	0	3100
19724	0	4	1	3061	0	3066
19725	4	0	3003	0	0	3007
19726	2974	0	7	0	0	2981
19727	0	10	2	2964	0	2976
19728	4	0	2921	0	0	2925
19729	0	0	3049	1	0	3050
19730	0	7	1	3003	0	3011
19731	1	0	3018	0	0	3019
19732	1	8	2	3024	0	3035
19733	3	6	1	3015	0	3025
19734	0	0	3025	2	0	3027
19735	3186	1	8	0	0	3195
19736	0	10	0	3200	0	3210
19737	4	0	3176	0	0	3180
19738	1	8	0	3267	0	3276
19739	3171	0	13	2	0	3186
19740	1	0	3186	3	0	3190
19741	3152	0	12	0	0	3164
19742	3116	0	4	0	0	3120
19743	0	3	0	3125	0	3128
19744	1	5	0	2939	0	2945
19745	4	0	2955	0	0	2959
19746	0	7	0	2954	0	2961
19747	1	8	0	2877	0	2886
19748	1	7	0	2922	0	2930
19749	1	0	2873	1	0	2875
19750	2900	1	3	0	0	2904
19751	2925	0	8	0	0	2933
19752	2874	1	7	0	0	2882
19753	2887	1	3	0	0	2891
19754	0	1	0	2849	0	2850
19755	2839	0	0	0	0	2839
19756	2884	0	7	0	0	2891
19757	2838	1	4	1	0	2844
19758	2905	3	10	2	0	2920
19759	0	2901	0	0	0	2901
19760	2885	0	6	0	0	2891
19761	2962	0	13	0	0	2975
19762	0	2992	0	2	0	2994
19763	2993	0	9	0	0	3002
19764	0	6	0	2992	0	2998
19765	1	2	0	2916	0	2919
19766	2952	0	5	1	0	2958
19767	0	2980	0	3	0	2983
19768	0	2970	0	1	0	2971
19769	3	8	2	2935	0	2948
19770	0	0	3083	0	0	3083
19771	0	5	0	3133	0	3138
19772	0	5	0	3147	0	3152
19773	3161	0	3	0	0	3164
19774	3115	0	3	0	0	3118
19775	1	7	1	2996	0	3005
19776	0	0	2754	0	0	2754
19777	1	2	0	2721	0	2724
19778	2575	0	6	0	0	2581
19779	5	0	2591	0	0	2596
19780	0	2689	0	0	0	2689
19781	2700	0	2	0	0	2702
19782	1	2	0	2687	0	2690
19783	1	8	0	2708	0	2717
19784	0	4	0	2630	0	2634
19785	1	0	2604	0	0	2605
19786	2440	2	6	1	0	2449
19787	3	0	2534	0	0	2537
19788	0	2556	0	4	0	2560
19789	0	6	1	2498	0	2505
19790	1	7	0	2572	0	2580
19791	0	4	2	2559	0	2565
19792	0	0	2515	7	0	2522
19793	4	0	2706	0	0	2710
19794	2	0	2721	0	0	2723
19795	0	2762	0	1	0	2763
19796	0	4	0	2745	0	2749
19797	2795	0	3	1	0	2799
19798	2759	0	9	0	0	2768
19799	2	0	2805	1	0	2808
19800	0	2834	0	1	0	2835
19801	10	0	2806	0	0	2816
19802	6	2739	0	4	0	2749
19803	2828	0	6	0	0	2834
19804	2972	1	6	0	0	2979
19805	1	3011	0	7	0	3019
19806	3031	1	4	0	0	3036
19807	0	7	0	3012	0	3019
19808	0	4	0	2989	0	2993
19809	2994	0	2	0	0	2996
19810	3000	0	1	0	0	3001
19811	2821	2	6	0	0	2829
19812	0	2773	0	2	0	2775
19813	0	2753	0	0	0	2753
19814	2596	0	2	0	0	2598
19815	2	0	2681	0	0	2683
19816	0	5	1	2875	0	2881
19817	2879	0	2	2	0	2883
19818	2	2863	0	2	0	2867
19819	1	2831	1	1	0	2834
19820	2804	0	5	2	0	2811
19821	1	0	2824	0	0	2825
19822	2733	0	7	2	0	2742
19823	3	1	2835	0	0	2839
19824	2	0	2829	2	0	2833
19825	1	2	0	2801	0	2804
19826	2	0	2775	0	0	2777
19827	2931	0	3	0	0	2934
19828	2915	0	9	0	0	2924
19829	2941	0	9	0	0	2950
19830	2922	0	2	0	0	2924
19831	0	3	1	2958	0	2962
19832	2999	0	3	0	0	3002
19833	0	2972	0	2	0	2974
19834	1	13	0	2925	0	2939
19835	1	3108	0	2	0	3111
19836	3100	0	6	0	0	3106
19837	3224	0	4	1	0	3229
19838	1	4	0	3254	0	3259
19839	3323	0	3	1	0	3327
19840	3453	0	0	0	0	3453
19841	0	1	0	3419	0	3420
19842	1	2	2	3375	0	3380
19843	0	2	0	3423	0	3425
19844	6	0	3372	0	0	3378
19845	1	0	3413	0	0	3414
19846	2	0	3441	1	0	3444
19847	1	7	1	3376	0	3385
19848	6	0	3375	0	0	3381
19849	1	4	0	3338	0	3343
19850	1	0	3315	2	0	3318
19851	2	0	3332	1	0	3335
19852	3390	0	8	1	0	3399
19853	1	3402	0	2	0	3405
19854	3314	2	4	0	0	3320
19855	0	5	0	3314	0	3319
19856	0	6	0	3255	0	3261
19857	2	0	3309	1	0	3312
19858	0	3412	0	3	0	3415
19859	1	10	2	3405	0	3418
19860	2	0	3577	0	0	3579
19861	0	3589	0	0	0	3589
19862	0	7	1	3644	0	3652
19863	3651	0	4	0	0	3655
19864	3652	5	3	0	0	3660
19865	0	12	0	3669	0	3681
19866	3618	0	3	1	0	3622
19867	0	3607	0	3	0	3610
19868	1	11	0	3450	0	3462
19869	0	1	3469	1	0	3471
19870	0	8	1	3339	0	3348
19871	2	0	3372	0	0	3374
19872	3407	0	8	0	0	3415
19873	1	5	0	3392	0	3398
19874	1	3385	0	3	0	3389
19875	0	11	0	3393	0	3404
19876	1	0	3380	0	0	3381
19877	1	0	3355	0	0	3356
19878	1	0	3379	0	0	3380
19879	3364	0	5	0	0	3369
19880	0	3170	1	0	0	3171
19881	0	7	0	3124	0	3131
19882	3205	0	6	1	0	3212
19883	0	3210	0	3	0	3213
19884	3226	0	4	1	0	3231
19885	3221	0	6	2	0	3229
19886	3181	0	7	0	0	3188
19887	3166	1	13	1	0	3181
19888	0	0	3178	1	0	3179
19889	2995	0	18	0	0	3013
19890	0	0	3096	0	0	3096
19891	2976	2	10	1	0	2989
19892	0	6	0	2914	0	2920
19893	1	0	2928	0	0	2929
19894	1	3063	0	2	0	3066
19895	1	15	1	3009	0	3026
19896	0	3097	0	2	0	3099
19897	0	3103	0	2	0	3105
19898	3109	0	8	1	0	3118
19899	7	0	3130	0	0	3137
19900	1	3123	1	4	0	3129
19901	3201	0	1	1	0	3203
19902	0	3343	0	5	0	3348
19903	3214	0	8	0	0	3222
19904	0	3	0	3462	0	3465
19905	3465	0	4	1	0	3470
19906	0	3	0	3567	0	3570
19907	3631	1	2	0	0	3634
19908	0	9	0	3495	0	3504
19909	0	3530	0	2	0	3532
19910	1	4	1	3487	0	3493
19911	3467	0	2	1	0	3470
19912	1	3585	0	0	0	3586
19913	0	6	0	3434	0	3440
19914	3482	0	4	0	0	3486
19915	3	6	1	3411	0	3421
19916	2	4	1	3300	0	3307
19917	1	0	3279	1	0	3281
19918	1	0	3363	2	0	3366
19919	0	6	0	3346	0	3352
19920	0	0	3303	0	0	3303
19921	0	12	0	3136	0	3148
19922	2	9	0	3138	0	3149
19923	0	6	1	3128	0	3135
19924	1	0	3183	0	0	3184
19925	0	4	0	3295	0	3299
19926	1	8	1	3274	0	3284
19927	0	3284	0	0	0	3284
19928	1	4	0	3246	0	3251
19929	3300	1	6	0	0	3307
19930	1	18	0	3290	0	3309
19931	0	0	3304	0	0	3304
19932	3362	0	9	5	0	3376
19933	0	3081	0	2	0	3083
19934	1	11	1	3002	0	3015
19935	1	0	3053	0	0	3054
19936	3054	0	1	0	0	3055
19937	0	3021	0	0	0	3021
19938	2996	1	6	0	0	3003
19939	0	6	0	3009	0	3015
19940	2950	0	3	1	0	2954
19941	5	0	2965	1	0	2971
19942	1	3022	0	4	0	3027
19943	1	3015	0	7	0	3023
19944	2991	0	8	1	0	3000
19945	2962	0	7	0	0	2969
19946	1	0	2966	0	0	2967
19947	2996	0	5	2	0	3003
19948	2949	0	8	0	0	2957
19949	2945	0	9	0	0	2954
19950	0	2945	0	2	0	2947
19951	1	3107	0	0	0	3108
19952	3118	0	4	0	0	3122
19953	3130	1	2	1	0	3134
19954	0	3079	0	1	0	3080
19955	2	8	0	3066	0	3076
19956	0	0	3086	0	0	3086
19957	3065	0	4	2	0	3071
19958	2976	0	12	2	0	2990
19959	2976	0	10	0	0	2986
19960	0	2991	0	0	0	2991
19961	3	0	3033	0	0	3036
19962	3060	0	2	0	0	3062
19963	1	0	0	3249	0	3250
19964	0	10	0	3259	0	3269
19965	0	4	1	3270	0	3275
19966	4	0	3300	2	0	3306
19967	0	15	1	3300	0	3316
19968	2	0	3261	1	0	3264
19969	3	3193	0	2	0	3198
19970	3215	0	7	1	0	3223
19971	0	3270	0	0	0	3270
19972	0	3226	0	1	0	3227
19973	3291	1	4	0	0	3296
19974	0	3243	0	2	0	3245
19975	0	11	0	3301	0	3312
19976	0	3314	0	0	0	3314
19977	3315	1	8	2	0	3326
19978	0	2823	0	1	0	2824
19979	1	6	0	2807	0	2814
19980	4	0	2886	0	0	2890
19981	0	13	0	2912	0	2925
19982	0	3051	0	7	0	3058
19983	0	29	0	3001	0	3030
19984	1	4	0	3033	0	3038
19985	0	8	0	2989	0	2997
19986	0	2	0	2988	0	2990
19987	1	3	0	3031	0	3035
19988	1	8	1	2848	0	2858
19989	3	0	2858	1	0	2862
19990	2768	0	11	0	0	2779
19991	0	2	0	2800	0	2802
19992	3	0	2788	0	0	2791
19993	2	0	2850	0	0	2852
19994	1	2	0	3006	0	3009
19995	2974	0	5	1	0	2980
19996	0	0	2994	0	0	2994
19997	2960	0	5	1	0	2966
19998	3	0	3055	0	0	3058
19999	1	7	0	3032	0	3040
20000	0	11	1	2941	0	2953
20001	2	0	2881	0	0	2883
20002	2956	2	10	0	0	2968
20003	0	6	0	2974	0	2980
20004	0	0	2971	0	0	2971
20005	4	0	2957	0	0	2961
20006	1	7	0	2955	0	2963
20007	1	2837	1	1	0	2840
20008	2918	1	7	1	0	2927
20009	2942	0	5	1	0	2948
20010	2	0	2948	0	0	2950
20011	1	0	0	3023	0	3024
20012	2986	0	6	1	0	2993
20013	1	0	3021	0	0	3022
20014	3060	0	3	0	0	3063
20015	0	3041	0	2	0	3043
20016	0	6	0	2968	0	2974
20017	0	0	0	2970	0	2970
20018	3126	0	3	0	0	3129
20019	0	5	1	3164	0	3170
20020	3	4	1	3187	0	3195
20021	0	1	0	3199	0	3200
20022	3125	0	4	1	0	3130
20023	0	1	3129	1	0	3131
20024	3123	0	11	1	0	3135
20025	3124	0	8	1	0	3133
20026	3131	1	6	0	0	3138
20027	0	0	0	2920	0	2920
20028	2	0	2932	0	0	2934
20029	1	3014	0	3	0	3018
20030	1	3049	0	5	0	3055
20031	3	3063	0	7	0	3073
20032	6	0	3105	0	0	3111
20033	1	3	0	3237	0	3241
20034	3330	0	3	1	0	3334
20035	3521	0	7	0	0	3528
20036	4	6	0	3515	0	3525
20037	3	0	3426	0	0	3429
20038	1	0	3455	0	0	3456
20039	1	4	0	3280	0	3285
20040	2	0	3301	0	0	3303
20041	2	3	0	3265	0	3270
20042	0	13	1	3369	0	3383
20043	1	3443	0	1	0	3445
20044	0	4	1	3437	0	3442
20045	0	2	1	3490	0	3493
20046	3513	2	5	0	0	3520
20047	0	4	1	3498	0	3503
20048	2	6	2	3522	0	3532
20049	3581	0	7	0	0	3588
20050	0	3545	0	2	0	3547
20051	3382	0	8	3	0	3393
20052	2	0	3396	0	0	3398
20053	3468	0	7	1	0	3476
20054	3541	0	12	2	0	3555
20055	4	1	3554	3	0	3562
20056	3	0	3428	0	0	3431
20057	1	5	0	3439	0	3445
20058	3284	0	8	0	0	3292
20059	7	0	3433	1	0	3441
20060	1	4	1	3454	0	3460
20061	3	0	3531	0	0	3534
20062	0	2	0	3519	0	3521
20063	1	0	0	3413	0	3414
20064	3416	1	4	3	0	3424
20065	3404	0	9	1	0	3414
20066	3389	0	9	0	0	3398
20067	1	0	3420	1	0	3422
20068	1	0	3638	0	0	3639
20069	0	13	1	3368	0	3382
20070	0	10	0	3377	0	3387
20071	0	0	0	3412	0	3412
20072	3426	0	6	0	0	3432
20073	0	3366	0	3	0	3369
20074	3359	0	7	0	0	3366
20075	3425	0	8	0	0	3433
20076	1	3402	1	4	0	3408
20077	0	3502	0	1	0	3503
20078	3560	1	2	1	0	3564
20079	1	4	0	3556	0	3561
20080	0	3570	0	3	0	3573
20081	1	11	0	3566	0	3578
20082	2	0	3567	0	0	3569
20083	1	3	2	3587	0	3593
20084	3551	0	8	0	0	3559
20085	5	0	3501	0	0	3506
20086	1	0	3488	0	0	3489
20087	0	16	0	3490	0	3506
20088	1	3446	1	1	0	3449
20089	1	3411	0	4	0	3416
20090	1	3415	0	3	0	3419
20091	3473	1	4	0	0	3478
20092	3470	0	1	1	0	3472
20093	3450	1	10	0	0	3461
20094	1	3312	0	0	0	3313
20095	3293	1	5	1	0	3300
20096	3320	0	9	1	0	3330
20097	7	0	3317	2	0	3326
20098	0	3389	0	2	0	3391
20099	0	8	0	3377	0	3385
20100	3417	0	13	1	0	3431
20101	0	0	3609	1	0	3610
20102	1	15	1	3645	0	3662
20103	0	3617	0	2	0	3619
20104	0	6	1	3612	0	3619
20105	0	2	1	3587	0	3590
20106	3569	0	6	0	0	3575
20107	3551	0	6	0	0	3557
20108	1	6	1	3671	0	3679
20109	6	0	3508	1	0	3515
20110	10	0	3426	2	0	3438
20111	3126	1	10	1	0	3138
20112	4	0	3207	1	0	3212
20113	1	9	0	3223	0	3233
20114	2	3175	0	1	0	3178
20115	3250	0	6	2	0	3258
20116	0	3316	1	4	0	3321
20117	3326	0	10	0	0	3336
20118	1	6	0	3145	0	3152
20119	1	3	0	3145	0	3149
20120	3167	0	5	0	0	3172
20121	3113	0	6	1	0	3120
20122	0	5	0	3112	0	3117
20123	2	7	0	3059	0	3068
20124	2	0	3045	0	0	3047
20125	0	0	2880	3	0	2883
20126	2823	0	11	1	0	2835
20127	1	0	2878	0	0	2879
20128	2832	1	5	0	0	2838
20129	2781	0	5	0	0	2786
20130	1	0	2701	0	0	2702
20131	3	2876	0	2	0	2881
20132	1	2881	0	7	0	2889
20133	6	0	2998	0	0	3004
20134	0	3	0	3036	0	3039
20135	2942	0	4	0	0	2946
20136	2910	0	2	0	0	2912
20137	2850	0	3	0	0	2853
20138	2834	0	10	0	0	2844
20139	2831	0	18	0	0	2849
20140	0	3065	0	0	0	3065
20141	3043	1	9	0	0	3053
20142	0	3024	0	0	0	3024
20143	2879	0	7	1	0	2887
20144	0	0	2994	0	0	2994
20145	0	16	0	3003	0	3019
20146	0	6	0	2955	0	2961
20147	1	2997	0	0	0	2998
20148	3004	0	9	0	0	3013
20149	3004	0	0	2	0	3006
20150	0	0	0	3007	0	3007
20151	0	2	0	2956	0	2958
20152	2990	0	3	0	0	2993
20153	0	3	0	2762	0	2765
20154	0	2	0	2747	0	2749
20155	2739	0	0	2	0	2741
20156	0	0	0	2677	0	2677
20157	2739	0	1	0	0	2740
20158	2708	0	9	1	0	2718
20159	0	0	2715	0	0	2715
20160	2742	1	2	0	0	2745
20161	2713	0	1	0	0	2714
20162	2675	0	7	0	0	2682
20163	1	0	2711	0	0	2712
20164	0	3	0	2730	0	2733
20165	0	9	2	2737	0	2748
20166	4	0	2741	0	0	2745
20167	2697	0	9	0	0	2706
20168	0	5	0	2705	0	2710
20169	5	1	2687	1	0	2694
20170	2	0	2751	0	0	2753
20171	1	4	0	2710	0	2715
20172	0	0	2639	0	0	2639
20173	0	6	0	2665	0	2671
20174	2	4	0	2636	0	2642
20175	1	0	2828	2	0	2831
20176	1	4	1	2756	0	2762
20177	1	2526	0	0	0	2527
20178	2	2508	0	2	0	2512
20179	2480	0	4	0	0	2484
20180	2549	0	4	0	0	2553
20181	0	2538	0	1	0	2539
20182	2526	0	5	0	0	2531
20183	2536	0	6	0	0	2542
20184	1	5	0	2360	0	2366
20185	1	3	0	2365	0	2369
20186	2401	0	4	0	0	2405
20187	0	2375	0	0	0	2375
20188	1	2357	0	0	0	2358
20189	0	5	2	2321	0	2328
20190	0	0	2351	0	0	2351
20191	2360	0	9	2	0	2371
20192	2264	1	5	1	0	2271
20193	2289	0	7	0	0	2296
20194	0	2257	0	0	0	2257
20195	0	2	1	2281	0	2284
20196	0	1	0	2298	0	2299
20197	2399	1	2	0	0	2402
20198	0	2389	0	7	0	2396
20199	0	8	0	2358	0	2366
20200	0	5	0	2400	0	2405
20201	1	3	0	2428	0	2432
20202	2490	0	7	0	0	2497
20203	0	2477	0	4	0	2481
20204	0	3	1	2469	0	2473
20205	1	2456	0	0	0	2457
20206	2272	0	5	0	0	2277
20207	1	0	2475	0	0	2476
20208	2524	2	4	1	0	2531
20209	3	0	2458	0	0	2461
20210	0	2	0	2427	0	2429
20211	2385	0	4	0	0	2389
20212	1	0	2388	0	0	2389
20213	2408	1	3	0	0	2412
20214	2445	1	8	0	0	2454
20215	2456	1	4	0	0	2461
20216	3	6	0	2215	0	2224
20217	0	4	1	2213	0	2218
20218	1	2	0	2197	0	2200
20219	2215	0	2	2	0	2219
20220	0	2014	0	0	0	2014
20221	2002	0	6	0	0	2008
20222	2004	1	5	0	0	2010
20223	0	0	2008	0	0	2008
20224	2702	0	8	1	0	2711
20225	2753	0	0	0	0	2753
20226	0	0	1	2764	0	2765
20227	0	1	1	2747	0	2749
20228	0	1	2	2763	0	2766
20229	2771	0	1	2	0	2774
20230	2780	0	2	1	0	2783
20231	2864	0	6	0	0	2870
20232	3	2837	0	2	0	2842
20233	0	2748	0	1	0	2749
20234	1	2732	0	7	0	2740
20235	2741	0	3	0	0	2744
20236	2	0	2730	0	0	2732
20237	0	0	2748	0	0	2748
20238	2733	0	12	0	0	2745
20239	1	0	2776	0	0	2777
20240	0	5	0	2764	0	2769
20241	0	2717	0	2	0	2719
20242	2731	0	2	1	0	2734
20243	2722	0	3	0	0	2725
20244	2859	0	8	0	0	2867
20245	0	5	0	2868	0	2873
20246	1	0	2814	0	0	2815
20247	1	0	2832	0	0	2833
20248	2761	0	3	1	0	2765
20249	2754	0	6	0	0	2760
20250	2819	0	8	0	0	2827
20251	2	0	0	2648	0	2650
20252	0	2	1	2663	0	2666
20253	2	0	2666	1	0	2669
20254	2674	0	8	1	0	2683
20255	0	5	1	2664	0	2670
20256	0	3	0	2607	0	2610
20257	0	6	1	2674	0	2681
20258	0	2695	0	1	0	2696
20259	0	5	1	2714	0	2720
20260	0	2	0	2729	0	2731
20261	2724	0	3	1	0	2728
20262	3	0	2712	0	0	2715
20263	2701	0	11	0	0	2712
20264	2710	0	3	0	0	2713
20265	0	0	0	2709	0	2709
20266	0	1	0	2678	0	2679
20267	2669	0	7	0	0	2676
20268	2	0	2706	0	0	2708
20269	0	2762	0	4	0	2766
20270	2	4	1	2748	0	2755
20271	2729	1	3	0	0	2733
20272	0	7	0	2702	0	2709
20273	4	0	2616	0	0	2620
20274	4	1	2653	0	0	2658
20275	2721	0	11	0	0	2732
20276	2	6	1	2669	0	2678
20277	2	0	2633	0	0	2635
20278	2613	0	8	1	0	2622
20279	2639	0	10	0	0	2649
20280	0	6	1	2598	0	2605
20281	0	4	0	2678	0	2682
20282	0	2561	0	4	0	2565
20283	2531	0	4	0	0	2535
20284	1	4	0	2585	0	2590
20285	1	5	0	2570	0	2576
20286	2	0	2589	0	0	2591
20287	2556	0	9	0	0	2565
20288	2560	1	8	1	0	2570
20289	0	2601	0	1	0	2602
20290	4	0	2540	0	0	2544
20291	3	0	3059	0	0	3062
20292	1	2	0	3249	0	3252
20293	3262	0	5	0	0	3267
20294	1	4	0	3257	0	3262
20295	3305	0	3	1	0	3309
20296	3342	0	10	1	0	3353
20297	3448	1	4	0	0	3453
20298	1	4	0	3495	0	3500
20299	1	4	0	3477	0	3482
20300	2769	1	1	2	0	2773
20301	1	0	2731	0	0	2732
20302	2729	0	7	1	0	2737
20303	2743	0	8	0	0	2751
20304	3	0	2765	0	0	2768
20305	3	0	2742	1	0	2746
20306	0	2777	0	2	0	2779
20307	2	4	0	2686	0	2692
20308	2699	0	8	0	0	2707
20309	0	3	0	2730	0	2733
20310	6	0	2740	0	0	2746
20311	0	2826	1	5	0	2832
20312	0	2813	0	0	0	2813
20313	1	3	0	2771	0	2775
20314	0	2	0	2865	0	2867
20315	0	2858	0	6	0	2864
20316	2	0	2866	2	0	2870
20317	2903	1	5	1	0	2910
20318	2908	0	15	0	0	2923
20319	1	2927	0	2	0	2930
20320	2786	0	5	1	0	2792
20321	1	3	0	2815	0	2819
20322	2851	0	11	0	0	2862
20323	1	6	0	2820	0	2827
20324	0	2895	0	2	0	2897
20325	0	0	2907	1	0	2908
20326	1	6	0	2869	0	2876
20327	3	4	1	2863	0	2871
20328	0	5	0	2841	0	2846
20329	2886	0	1	0	0	2887
20330	0	3	0	2892	0	2895
20331	1	0	2887	0	0	2888
20332	1	0	2875	0	0	2876
20333	2732	0	7	1	0	2740
20334	1	0	2785	0	0	2786
20335	2750	0	7	0	0	2757
20336	2	0	0	2860	0	2862
20337	0	6	1	2877	0	2884
20338	0	5	0	2835	0	2840
20339	0	1	0	2848	0	2849
20340	2843	0	4	0	0	2847
20341	0	1	2861	0	0	2862
20342	1	7	1	2859	0	2868
20343	0	2785	0	2	0	2787
20344	2745	0	9	0	0	2754
20345	0	5	0	2752	0	2757
20346	2748	0	3	1	0	2752
20347	4	0	2751	1	0	2756
20348	2	6	0	2742	0	2750
20349	2	2717	0	1	0	2720
20350	2631	1	10	0	0	2642
20351	0	0	2696	0	0	2696
20352	0	3	0	2781	0	2784
20353	0	2	0	2808	0	2810
20354	2762	0	9	0	0	2771
20355	1	0	2751	0	0	2752
20356	1	0	2751	0	0	2752
20357	1	5	0	2697	0	2703
20358	4	0	2614	0	0	2618
20359	3	0	2685	0	0	2688
20360	1	8	2	3026	0	3037
20361	2	9	0	3020	0	3031
20362	0	4	0	3042	0	3046
20363	3073	1	6	0	0	3080
20364	0	3097	1	4	0	3102
20365	3236	1	6	0	0	3243
20366	0	7	0	3179	0	3186
20367	0	2653	0	0	0	2653
20368	1	5	0	2582	0	2588
20369	2596	0	5	0	0	2601
20370	0	2806	0	4	0	2810
20371	0	5	0	2762	0	2767
20372	0	0	2787	0	0	2787
20373	2672	2	6	0	0	2680
20374	1	2	0	2597	0	2600
20375	0	7	0	2706	0	2713
20376	3	0	2686	0	0	2689
20377	4	0	2696	2	0	2702
20378	2689	0	9	1	0	2699
20379	0	2632	0	2	0	2634
20380	0	6	0	2615	0	2621
20381	2603	0	6	0	0	2609
20382	0	0	2609	0	0	2609
20383	1	2630	0	1	0	2632
20384	0	2	0	2636	0	2638
20385	2603	0	5	0	0	2608
20386	2637	0	7	0	0	2644
20387	2585	1	3	1	0	2590
20388	0	2596	0	5	0	2601
20389	0	0	2630	0	0	2630
20390	1	4	1	2521	0	2527
20391	0	6	0	2524	0	2530
20392	1	3	0	2524	0	2528
20393	0	5	0	2503	0	2508
20394	2505	0	4	0	0	2509
20395	2463	0	7	1	0	2471
20396	2	0	2460	0	0	2462
20397	3	0	2427	0	0	2430
20398	2349	0	8	2	0	2359
20399	2349	0	7	0	0	2356
20400	0	6	0	2330	0	2336
20401	0	2330	0	0	0	2330
20402	2352	0	2	0	0	2354
20403	0	2370	0	1	0	2371
20404	0	2373	0	2	0	2375
20405	1	9	0	2352	0	2362
20406	2	4	0	2345	0	2351
20407	0	7	0	2375	0	2382
20408	0	3	0	2427	0	2430
20409	1	0	2440	1	0	2442
20410	2447	0	8	1	0	2456
20411	2478	0	4	0	0	2482
20412	0	2	0	2382	0	2384
20413	0	0	0	2787	0	2787
20414	2786	1	6	0	0	2793
20415	0	0	2790	0	0	2790
20416	2790	0	6	2	0	2798
20417	2754	4	7	0	0	2765
20418	0	0	2765	0	0	2765
20419	2846	0	6	0	0	2852
20420	0	3	0	2868	0	2871
20421	0	2	0	2850	0	2852
20422	0	6	0	2921	0	2927
20423	0	3	0	2936	0	2939
20424	2959	0	3	0	0	2962
20425	1	4	1	2943	0	2949
20426	0	17	0	2921	0	2938
20427	0	3138	0	1	0	3139
20428	0	3042	0	3	0	3045
20429	2	6	1	2997	0	3006
20430	3057	0	5	0	0	3062
20431	3	5	0	3052	0	3060
20432	3	0	3102	0	0	3105
20433	0	0	3252	2	0	3254
20434	3207	0	10	1	0	3218
20435	0	3171	0	4	0	3175
20436	2733	0	3	4	0	2740
20437	5	0	2827	0	0	2832
20438	0	3	2	2828	0	2833
20439	2817	0	2	2	0	2821
20440	1	2772	1	3	0	2777
20441	2571	0	15	2	0	2588
20442	1	0	2629	0	0	2630
20443	0	3	0	2683	0	2686
20444	1	2	0	2666	0	2669
20445	2669	0	1	0	0	2670
20446	2357	2	1	0	0	2360
20447	2368	0	2	0	0	2370
20448	2332	0	6	2	0	2340
20449	2345	1	9	2	0	2357
20450	0	2373	0	0	0	2373
20451	0	1	0	2255	0	2256
20452	2269	0	5	0	0	2274
20453	0	12	0	2272	0	2284
20454	0	3	0	2310	0	2313
20455	1	0	2	2310	0	2313
20456	1	2265	0	2	0	2268
20457	2254	0	2	1	0	2257
20458	0	3	0	2268	0	2271
20459	2257	0	0	4	0	2261
20460	2246	0	8	0	0	2254
20461	0	2257	0	2	0	2259
20462	2137	0	6	1	0	2144
20463	2	0	2136	0	0	2138
20464	2091	1	8	1	0	2101
20465	0	2	1	2089	0	2092
20466	3	0	2090	0	0	2093
20467	0	2092	0	2	0	2094
20468	0	0	2099	0	0	2099
20469	0	2107	0	3	0	2110
20470	2097	0	4	0	0	2101
20471	2106	0	3	0	0	2109
20472	2105	0	4	0	0	2109
20473	0	2099	0	1	0	2100
20474	2075	0	6	0	0	2081
20475	2	0	2082	3	0	2087
20476	1	0	2150	2	0	2153
20477	1	6	0	2138	0	2145
20478	0	6	0	2126	0	2132
20479	0	2146	0	3	0	2149
20480	2218	2	5	0	0	2225
20481	0	8	0	2235	0	2243
20482	1	2243	0	1	0	2245
20483	2	1	0	2220	0	2223
20484	2226	0	2	0	0	2228
20485	2167	1	8	3	0	2179
20486	0	0	2196	0	0	2196
20487	0	2	1	2150	0	2153
20488	1	0	2171	0	0	2172
20489	0	3	1	1750	0	1754
20490	1	0	1769	0	0	1770
20491	0	6	0	1753	0	1759
20492	1	0	1763	0	0	1764
20493	2	4	0	1864	0	1870
20494	2	0	1878	0	0	1880
20495	0	4	0	1875	0	1879
20496	1	1	1	1840	0	1843
20497	0	1845	0	0	0	1845
20498	1	5	0	1763	0	1769
20499	2	0	1789	0	0	1791
20500	0	6	0	1786	0	1792
20501	0	0	0	1753	0	1753
20502	1770	0	1	1	0	1772
20503	0	2	0	1571	0	1573
20504	0	1	0	1585	0	1586
20505	1	0	1591	0	0	1592
20506	1542	0	3	0	0	1545
20507	0	0	0	1544	0	1544
20508	0	3	0	1331	0	1334
20509	2	1	0	1345	0	1348
20510	1344	0	2	0	0	1346
20511	0	2	0	1353	0	1355
20512	0	3	0	1349	0	1352
20513	1360	0	1	1	0	1362
20514	0	1381	0	0	0	1381
20515	0	0	0	1278	0	1278
20516	0	1	0	1293	0	1294
20517	0	0	1301	0	0	1301
20518	1310	0	1	1	0	1312
20519	0	5	0	1317	0	1322
20520	1	0	1317	0	0	1318
20521	1366	1	7	1	0	1375
20522	0	5	0	1374	0	1379
20523	1	2	0	1422	0	1425
20524	0	0	0	1429	0	1429
20525	0	1	0	1433	0	1434
20526	1	0	1423	0	0	1424
20527	2	0	0	1428	0	1430
20528	0	2	0	1413	0	1415
20529	1	0	1373	0	0	1374
20530	1362	1	5	0	0	1368
20531	1356	0	5	0	0	1361
20532	1367	0	5	0	0	1372
20533	0	4	0	1361	0	1365
20534	1366	0	4	0	0	1370
20535	1415	0	2	0	0	1417
20536	0	0	0	1418	0	1418
20537	1418	0	1	0	0	1419
20538	1406	0	1	0	0	1407
20539	1394	1	0	0	0	1395
20540	1410	0	3	0	0	1413
20541	0	3	1	1380	0	1384
20542	0	1401	0	1	0	1402
20543	0	1391	0	1	0	1392
20544	1	1366	0	0	0	1367
20545	1399	0	3	1	0	1403
20546	1397	1	2	0	0	1400
20547	0	0	1401	0	0	1401
20548	1791	0	4	3	0	1798
20549	0	3	0	1779	0	1782
20550	0	1	1	1737	0	1739
20551	0	10	0	1711	0	1721
20552	1755	0	4	0	0	1759
20553	1	3	0	1749	0	1753
20554	0	1691	0	0	0	1691
20555	1	4	0	1637	0	1642
20556	1	0	1631	0	0	1632
20557	2	1	1	1621	0	1625
20558	1622	0	1	0	0	1623
20559	0	0	1615	0	0	1615
20560	0	1	0	1614	0	1615
20561	0	7	0	1599	0	1606
20562	0	1	0	1598	0	1599
20563	0	1597	0	1	0	1598
20564	0	2	0	1626	0	1628
20565	1641	0	0	0	0	1641
20566	1615	0	4	0	0	1619
20567	2	0	1613	1	0	1616
20568	1	0	1610	0	0	1611
20569	0	3	0	1471	0	1474
20570	0	3	0	1357	0	1360
20571	1	0	1360	1	0	1362
20572	1	3	0	1389	0	1393
20573	0	1385	0	2	0	1387
20574	1388	0	8	0	0	1396
20575	1372	0	0	0	0	1372
20576	1344	0	4	0	0	1348
20577	0	0	1346	0	0	1346
20578	0	2	0	1327	0	1329
20579	1	0	1325	0	0	1326
20580	1320	0	8	1	0	1329
20581	0	1303	0	1	0	1304
20582	0	4	0	1335	0	1339
20583	1343	0	1	0	0	1344
20584	0	4	0	1381	0	1385
20585	0	8	0	1392	0	1400
20586	1	0	1379	0	0	1380
20587	1391	0	2	1	0	1394
20588	0	1379	0	1	0	1380
20589	0	0	0	1299	0	1299
20590	1286	0	4	0	0	1290
20591	0	2	0	1297	0	1299
20592	1266	0	3	0	0	1269
20593	0	1267	0	2	0	1269
20594	1207	0	6	0	0	1213
20595	0	0	1208	0	0	1208
20596	1311	0	2	0	0	1313
20597	1258	0	4	0	0	1262
20598	1288	0	1	0	0	1289
20599	0	1	0	1219	0	1220
20600	0	2	0	1232	0	1234
20601	0	5	0	1254	0	1259
20602	1	1253	0	1	0	1255
20603	1300	0	2	0	0	1302
20604	0	0	0	1284	0	1284
20605	1	3	0	1333	0	1337
20606	1	2	0	1321	0	1324
20607	1323	0	1	0	0	1324
20608	0	1	0	1319	0	1320
20609	3	0	1309	0	0	1312
20610	0	1316	0	0	0	1316
20611	0	5	0	1246	0	1251
20612	0	0	0	1266	0	1266
20613	0	0	1	1255	0	1256
20614	0	0	1249	0	0	1249
20615	1	0	1260	0	0	1261
20616	0	1	0	1251	0	1252
20617	0	0	1247	0	0	1247
20618	1	2	0	1233	0	1236
20619	1212	0	3	0	0	1215
20620	1217	0	2	1	0	1220
20621	1197	0	11	0	0	1208
20622	0	0	1209	0	0	1209
20623	1075	0	2	0	0	1077
20624	0	1	0	787	0	788
20625	0	0	773	0	0	773
20626	0	0	778	0	0	778
20627	0	775	0	0	0	775
20628	0	736	2	0	0	738
20629	737	1	2	2	0	742
20630	0	0	0	726	0	726
20631	0	0	727	0	0	727
20632	0	0	0	724	0	724
20633	721	0	1	0	0	722
20634	1	0	712	0	0	713
20635	663	0	0	0	0	663
20636	655	0	4	0	0	659
20637	663	0	0	0	0	663
20638	0	660	0	0	0	660
20639	635	0	0	0	0	635
20640	1	0	0	607	0	608
20641	0	0	0	577	0	577
20642	0	0	0	577	0	577
20643	0	0	0	578	0	578
20644	576	0	1	0	0	577
20645	0	573	0	0	0	573
20646	0	561	0	2	0	563
20647	1	552	0	0	0	553
20648	532	0	0	0	0	532
20649	532	0	1	0	0	533
20650	529	0	1	0	0	530
20651	533	0	0	0	0	533
20652	0	5	0	522	0	527
20653	0	1	0	526	0	527
20654	524	0	2	0	0	526
20655	0	521	0	0	0	521
20656	506	0	1	0	0	507
20657	505	0	0	0	0	505
20658	0	2	0	457	0	459
20659	0	457	0	1	0	458
20660	0	0	0	408	0	408
20661	371	0	1	0	0	372
20662	0	0	371	0	0	371
20663	0	0	0	367	0	367
20664	0	359	0	0	0	359
20665	354	0	1	0	0	355
20666	322	0	1	0	0	323
20667	0	0	322	0	0	322
20668	0	288	0	0	0	288
20669	274	0	0	0	0	274
20670	0	0	0	212	0	212
20671	0	0	193	0	0	193
20672	0	1	194	0	0	195
20673	0	190	0	2	0	192
20674	161	0	0	0	0	161
20675	144	1	0	0	0	145
20676	0	136	0	0	0	136
20677	0	105	0	0	0	105
20678	98	0	0	0	0	98
20679	0	0	59	0	0	59
20680	0	0	56	0	0	56
20681	0	0	0	5	0	5
20682	0	0	4	0	0	4
20683	0	0	0	1	0	1
20684	0	0	0	1	0	1
20685	0	0	1	0	0	1
20686	0	1	0	0	0	1
20687	0	0	0	0	0
20688	0	0	0	0	0
20689	0	0	0	0	0
20690	0	0	0	0	0
20691	0	0	0	0	0
20692	0	0	0	0	0
20693	0	0	0	0	0
20694	0	0	0	0	0
20695	0	0	0	0	0
20696	0	0	0	0	0
20697	0	0	0	0	0
20698	0	0	0	0	0
20699	0	0	0	0	0
20700	0	0	0	0	0
20701	0	0	0	0	0
20702	0	0	0	0	0
20703	0	0	0	0	0
20704	0	0	0	0	0
20705	0	0	0	0	0
20706	0	0	0	0	0
20707	0	0	0	0	0
20708	0	0	0	0	0
20709	0	0	0	0	0
20710	0	0	0	0	0
20711	0	0	0	0	0
20712	0	0	0	0	0
20713	0	0	0	0	0
20714	0	0	0	0	0
20715	0	0	0	0	0
20716	0	0	0	0	0
20717	0	0	0	0	0
20718	0	0	0	0	0
20719	0	0	0	0	0
20720	0	0	0	0	0
20721	0	0	0	0	0
20722	0	0	0	0	0
20723	0	0	0	0	0
20724	0	0	0	0	0
20725	0	0	0	0	0
20726	0	0	0	0	0
20727	0	0	0	0	0
20728	0	0	0	0	0
20729	0	0	0	0	0
20730	0	0	0	0	0
20731	0	0	0	0	0
20732	0	0	0	0	0
20733	0	0	0	0	0
20734	0	0	0	0	0
20735	0	0	0	0	0
20736	0	0	0	0	0
20737	0	0	0	0	0
20738	0	0	0	0	0
20739	0	0	0	0	0
20740	0	0	0	0	0
20741	0	0	0	0	0
20742	0	0	0	0	0
20743	0	0	0	0	0
20744	0	0	0	0	0
20745	0	0	0	0	0
20746	0	0	0	0	0
20747	0	0	0	0	0
20748	0	0	0	0	0
20749	0	0	0	0	0
20750	0	0	0	0	0
20751	0	0	0	0	0
20752	0	0	0	0	0
20753	0	0	0	0	0
20754	0	0	0	0	0
20755	0	0	0	0	0
20756	0	0	0	0	0
20757	0	0	0	0	0
20758	0	0	0	0	0
20759	0	0	0	0	0
20760	0	0	0	0	0
20761	0	0	0	0	0
20762	0	0	0	0	0
20763	0	0	0	0	0
20764	0	0	0	0	0
20765	0	0	0	0	0
20766	0	0	0	0	0
20767	0	0	0	0	0
20768	0	0	0	0	0
20769	0	0	0	0	0
20770	0	0	0	0	0
20771	0	0	0	0	0
20772	0	0	0	0	0
20773	0	0	0	0	0
20774	0	0	0	0	0
20775	0	0	0	0	0
20776	0	0	0	0	0
20777	0	0	0	0	0
20778	0	0	0	0	0
20779	0	0	0	0	0
20780	0	0	0	0	0
20781	0	0	0	0	0
20782	0	0	0	0	0
20783	0	0	0	0	0
20784	0	0	0	0	0
20785	0	0	0	0	0
20786	0	0	0	0	0
20787	0	0	0	0	0
20788	0	0	0	0	0
20789	0	0	0	0	0
20790	0	0	0	0	0
20791	0	0	0	0	0
20792	0	0	0	0	0
20793	0	0	0	0	0
20794	0	0	0	0	0
20795	0	0	0	0	0
20796	0	0	0	0	0
20797	0	0	0	0	0
20798	0	0	0	0	0
20799	0	0	0	0	0
20800	0	0	0	0	0
20801	0	0	0	0	0
20802	0	0	0	0	0
20803	0	0	0	0	0
20804	0	0	0	0	0
20805	0	0	0	0	0
20806	0	0	0	0	0
20807	0	0	0	0	0
20808	0	0	0	0	0
20809	0	0	0	0	0
20810	0	0	0	0	0
20811	0	0	0	0	0
20812	0	0	0	0	0
20813	0	0	0	0	0
20814	0	0	0	0	0
20815	0	0	0	0	0
20816	0	0	0	0	0
20817	0	0	0	0	0
20818	0	0	0	0	0
20819	0	0	0	0	0
20820	0	0	0	0	0
20821	0	0	0	0	0
20822	0	0	0	0	0
20823	0	0	0	0	0
20824	0	0	0	0	0
20825	0	0	0	0	0
20826	0	0	0	0	0
20827	0	0	0	0	0
20828	0	0	0	0	0
20829	0	0	0	0	0
20830	0	0	0	0	0
20831	0	0	0	0	0
20832	0	0	0	0	0
20833	0	0	0	0	0
20834	0	0	0	0	0
20835	0	0	0	0	0
20836	0	0	0	0	0
20837	0	0	0	0	0
20838	0	0	0	0	0
20839	0	0	0	0	0
20840	0	0	0	0	0
20841	0	0	0	0	0
20842	0	0	0	0	0
20843	0	0	0	0	0
20844	0	0	0	0	0
20845	0	0	0	0	0
20846	0	0	0	0	0
20847	0	0	0	0	0
20848	0	0	0	0	0
20849	0	0	0	0	0
20850	0	0	0	0	0
20851	0	0	0	0	0
20852	0	0	0	0	0
20853	0	0	0	0	0
20854	0	0	0	0	0
20855	0	0	0	0	0
20856	0	0	0	0	0
20857	0	0	0	0	0
20858	0	0	0	0	0
20859	0	0	0	0	0
20860	0	0	0	0	0
20861	0	0	0	0	0
20862	0	0	0	0	0
20863	0	0	0	0	0
20864	0	0	0	0	0
20865	0	0	0	0	0
20866	0	0	0	0	0
20867	0	0	0	0	0
20868	0	0	0	0	0
20869	0	0	0	0	0
20870	0	0	0	0	0
20871	0	0	0	0	0
20872	0	0	0	0	0
20873	0	0	0	0	0
20874	0	0	0	0	0
20875	0	0	0	0	0
20876	0	0	0	0	0
20877	0	0	0	0	0
20878	0	0	0	0	0
20879	0	0	0	0	0
20880	0	0	0	0	0
20881	0	0	0	0	0
20882	0	0	0	0	0
20883	0	0	0	0	0
20884	0	0	0	0	0
20885	0	0	0	0	0
20886	0	0	0	0	0
20887	0	0	0	0	0
20888	0	0	0	0	0
20889	0	0	0	0	0
20890	0	0	0	0	0
20891	0	0	0	0	0
20892	0	0	0	0	0
20893	0	0	0	0	0
20894	0	0	0	0	0
20895	0	0	0	0	0
20896	0	0	0	0	0
20897	0	0	0	0	0
20898	0	0	0	0	0
20899	0	0	0	0	0
20900	0	0	0	0	0
20901	0	0	0	0	0
20902	0	0	0	0	0
20903	0	0	0	0	0
20904	0	0	0	0	0
20905	0	0	0	0	0
20906	0	0	0	0	0
20907	0	0	0	0	0
20908	0	0	0	0	0
20909	0	0	0	0	0
20910	0	0	0	0	0
20911	0	0	0	0	0
20912	0	0	0	0	0
20913	0	0	0	0	0
20914	0	0	0	0	0
20915	0	0	0	0	0
20916	0	0	0	0	0
20917	0	0	0	0	0
20918	0	0	0	0	0
20919	0	0	0	0	0
20920	0	0	0	0	0
20921	0	0	0	0	0
20922	0	0	0	0	0
20923	0	0	0	0	0
20924	0	0	0	0	0
20925	0	0	0	0	0
20926	0	0	0	0	0
20927	0	0	0	0	0
20928	0	0	0	0	0
20929	0	0	0	0	0
20930	0	0	0	0	0
20931	0	0	0	0	0
20932	0	0	0	0	0
20933	0	0	0	0	0
20934	0	0	0	0	0
20935	0	0	0	0	0
20936	0	0	0	0	0
20937	0	0	0	0	0
20938	0	0	0	0	0
20939	0	0	0	0	0
20940	0	0	0	0	0
20941	0	0	0	0	0
20942	0	0	0	0	0
20943	0	0	0	0	0
20944	0	0	0	0	0
20945	0	0	0	0	0
20946	0	0	0	0	0
20947	0	0	0	0	0
20948	0	0	0	0	0
20949	0	0	0	0	0
20950	0	0	0	0	0
20951	0	0	0	0	0
20952	0	0	0	0	0
20953	0	0	0	0	0
20954	0	0	0	0	0
20955	0	0	0	0	0
20956	0	0	0	0	0
20957	0	0	0	0	0
20958	0	0	0	0	0
20959	0	0	0	0	0
20960	0	0	0	0	0
20961	0	0	0	0	0
20962	0	0	0	0	0
20963	0	0	0	0	0
20964	0	0	0	0	0
20965	0	0	0	0	0
20966	0	0	0	0	0
20967	0	0	0	0	0
20968	0	0	0	0	0
20969	0	0	0	0	0
20970	0	0	0	0	0
20971	0	0	0	0	0
20972	0	0	0	0	0
20973	0	0	0	0	0
20974	0	0	0	0	0
20975	0	0	0	0	0
20976	0	0	0	0	0
20977	0	0	0	0	0
20978	0	0	0	0	0
20979	0	0	0	0	0
20980	0	0	0	0	0
20981	0	0	0	0	0
20982	0	0	0	0	0
20983	0	0	0	0	0
20984	0	0	0	0	0
20985	0	0	0	0	0
20986	0	0	0	0	0
20987	0	0	0	0	0
20988	0	0	0	0	0
20989	0	0	0	0	0
20990	0	0	0	0	0
20991	0	0	0	0	0
20992	0	0	0	0	0
20993	0	0	0	0	0
20994	0	0	0	0	0
20995	0	0	0	0	0
20996	0	0	0	0	0
20997	0	0	0	0	0
20998	0	0	0	0	0
20999	0	0	0	0	0
21000	0	0	0	0	0
21001	0	0	0	0	0
21002	0	0	0	0	0
21003	0	0	0	0	0
21004	0	0	0	0	0
21005	0	0	0	0	0
21006	0	0	0	0	0
21007	0	0	0	0	0
21008	0	0	0	0	0
21009	0	0	0	0	0
21010	0	0	0	0	0
21011	0	0	0	0	0
21012	0	0	0	0	0
21013	0	0	0	0	0
21014	0	0	0	0	0
21015	0	0	0	0	0
21016	0	0	0	0	0
21017	0	0	0	0	0
21018	0	0	0	0	0
21019	0	0	0	0	0
21020	0	0	0	0	0
21021	0	0	0	0	0
21022	0	0	0	0	0
21023	0	0	0	0	0
21024	0	0	0	0	0
21025	0	0	0	0	0
21026	0	0	0	0	0
21027	0	0	0	0	0
21028	0	0	0	0	0
21029	0	0	0	0	0
21030	0	0	0	0	0
21031	0	0	0	0	0
21032	0	0	0	0	0
21033	0	0	0	0	0
21034	0	0	0	0	0
21035	0	0	0	0	0
21036	0	0	0	0	0
21037	0	0	0	0	0
21038	0	0	0	0	0
21039	0	0	0	0	0
21040	0	0	0	0	0
21041	0	0	0	0	0
21042	0	0	0	0	0
21043	0	0	0	0	0
21044	0	0	0	0	0
21045	0	0	0	0	0
21046	0	0	0	0	0
21047	0	0	0	0	0
21048	0	0	0	0	0
21049	0	0	0	0	0
21050	0	0	0	0	0
21051	0	0	0	0	0
21052	0	0	0	0	0
21053	0	0	0	0	0
21054	0	0	0	0	0
21055	0	0	0	0	0
21056	0	0	0	0	0
21057	0	0	0	0	0
21058	0	0	0	0	0
21059	0	0	0	0	0
21060	0	0	0	0	0
21061	0	0	0	0	0
21062	0	0	0	0	0
21063	0	0	0	0	0
21064	0	0	0	0	0
21065	0	0	0	0	0
21066	0	0	0	0	0
21067	0	0	0	0	0
21068	0	0	0	0	0
21069	0	0	0	0	0
21070	0	0	0	0	0
21071	0	0	0	0	0
21072	0	0	0	0	0
21073	0	0	0	0	0
21074	0	0	0	0	0
21075	0	0	0	0	0
21076	0	0	0	0	0
21077	0	0	0	0	0
21078	0	0	0	0	0
21079	0	0	0	0	0
21080	0	0	0	0	0
21081	0	0	0	0	0
21082	0	0	0	0	0
21083	0	0	0	0	0
21084	0	0	0	0	0
21085	0	0	0	0	0
21086	0	0	0	0	0
21087	0	0	0	0	0
21088	0	0	0	0	0
21089	0	0	0	0	0
21090	0	0	0	0	0
21091	0	0	0	0	0
21092	0	0	0	0	0
21093	0	0	0	0	0
21094	0	0	0	0	0
21095	0	0	0	0	0
21096	0	0	0	0	0
21097	0	0	0	0	0
21098	0	0	0	0	0
21099	0	0	0	0	0
21100	0	0	0	0	0
21101	0	0	0	0	0
21102	0	0	0	0	0
21103	0	0	0	0	0
21104	0	0	0	0	0
21105	0	0	0	0	0
21106	0	0	0	0	0
21107	0	0	0	0	0
21108	0	0	0	0	0
21109	0	0	0	0	0
21110	0	0	0	0	0
21111	0	0	0	0	0
21112	0	0	0	0	0
21113	0	0	0	0	0
21114	0	0	0	0	0
21115	0	0	0	0	0
21116	0	0	0	0	0
21117	0	0	0	0	0
21118	0	0	0	0	0
21119	0	0	0	0	0
21120	0	0	0	0	0
21121	0	0	0	0	0
21122	0	0	0	0	0
21123	0	0	0	0	0
21124	0	0	0	0	0
21125	0	0	0	0	0
21126	0	0	0	0	0
21127	0	0	0	0	0
21128	0	0	0	0	0
21129	0	0	0	0	0
21130	0	0	0	0	0
21131	0	0	0	0	0
21132	0	0	0	0	0
21133	0	0	0	0	0
21134	0	0	0	0	0
21135	0	0	0	0	0
21136	0	0	0	0	0
21137	0	0	0	0	0
21138	0	0	0	0	0
21139	0	0	0	0	0
21140	0	0	0	0	0
21141	0	0	0	0	0
21142	0	0	0	0	0
21143	0	0	0	0	0
21144	0	0	0	0	0
21145	0	0	0	0	0
21146	0	0	0	0	0
21147	0	0	0	0	0
21148	0	0	0	0	0
21149	0	0	0	0	0
21150	0	0	0	0	0
21151	0	0	0	0	0
21152	0	0	0	0	0
21153	0	0	0	0	0
21154	0	0	0	0	0
21155	0	0	0	0	0
21156	0	0	0	0	0
21157	0	0	0	0	0
21158	0	0	0	0	0
21159	0	0	0	0	0
21160	0	0	0	0	0
21161	0	0	0	0	0
21162	0	0	0	0	0
21163	0	0	0	0	0
21164	0	0	0	0	0
21165	0	0	0	0	0
21166	0	0	0	0	0
21167	0	0	0	0	0
21168	0	0	0	0	0
21169	0	0	0	0	0
21170	0	0	0	0	0
21171	0	0	0	0	0
21172	0	0	0	0	0
21173	0	0	0	0	0
21174	0	0	0	0	0
21175	0	0	0	0	0
21176	0	0	0	0	0
21177	0	0	0	0	0
21178	0	0	0	0	0
21179	0	0	0	0	0
21180	0	0	0	0	0
21181	0	0	0	0	0
21182	0	0	0	0	0
21183	0	0	0	0	0
21184	0	0	0	0	0
21185	0	0	0	0	0
21186	0	0	0	0	0
21187	0	0	0	0	0
21188	0	0	0	0	0
21189	0	0	0	0	0
21190	0	0	0	0	0
21191	0	0	0	0	0
21192	0	0	0	0	0
21193	0	0	0	0	0
21194	0	0	0	0	0
21195	0	0	0	0	0
21196	0	0	0	0	0
21197	0	0	0	0	0
21198	0	0	0	0	0
21199	0	0	0	0	0
21200	0	0	0	0	0
21201	0	0	0	0	0
21202	0	0	0	0	0
21203	0	0	0	0	0
21204	0	0	0	0	0
21205	0	0	0	0	0
21206	0	0	0	0	0
21207	0	0	0	0	0
21208	0	0	0	0	0
21209	0	0	0	0	0
21210	0	0	0	0	0
21211	0	0	0	0	0
21212	0	0	0	0	0
21213	0	0	0	0	0
21214	0	0	0	0	0
21215	0	0	0	0	0
21216	0	0	0	0	0
21217	0	0	0	0	0
21218	0	0	0	0	0
21219	0	0	0	0	0
21220	0	0	0	0	0
21221	0	0	0	0	0
21222	0	0	0	0	0
21223	0	0	0	0	0
21224	0	0	0	0	0
21225	0	0	0	0	0
21226	0	0	0	0	0
21227	0	0	0	0	0
21228	0	0	0	0	0
21229	0	0	0	0	0
21230	0	0	0	0	0
21231	0	0	0	0	0
21232	0	0	0	0	0
21233	0	0	0	0	0
21234	0	0	0	0	0
21235	0	0	0	0	0
21236	0	0	0	0	0
21237	0	0	0	0	0
21238	0	0	0	0	0
21239	0	0	0	0	0
21240	0	0	0	0	0
21241	0	0	0	0	0
21242	0	0	0	0	0
21243	0	0	0	0	0
21244	0	0	0	0	0
21245	0	0	0	0	0
21246	0	0	0	0	0
21247	0	0	0	0	0
21248	0	0	0	0	0
21249	0	0	0	0	0
21250	0	0	0	0	0
21251	0	0	0	0	0
21252	0	0	0	0	0
21253	0	0	0	0	0
21254	0	0	0	0	0
21255	0	0	0	0	0
21256	0	0	0	0	0
21257	0	0	0	0	0
21258	0	0	0	0	0
21259	0	0	0	0	0
21260	0	0	0	0	0
21261	0	0	0	0	0
21262	0	0	0	0	0
21263	0	0	0	0	0
21264	0	0	0	0	0
21265	0	0	0	0	0
21266	0	0	0	0	0
21267	0	0	0	0	0
21268	0	0	0	0	0
21269	0	0	0	0	0
21270	0	0	0	0	0
21271	0	0	0	0	0
21272	0	0	0	0	0
21273	0	0	0	0	0
21274	0	0	0	0	0
21275	0	0	0	0	0
21276	0	0	0	0	0
21277	0	0	0	0	0
21278	0	0	0	0	0
21279	0	0	0	0	0
21280	0	0	0	0	0
21281	0	0	0	0	0
21282	0	0	0	0	0
21283	0	0	0	0	0
21284	0	0	0	0	0
21285	0	0	0	0	0
21286	0	0	0	0	0
21287	0	0	0	0	0
21288	0	0	0	0	0
21289	0	0	0	0	0
21290	0	0	0	0	0
21291	0	0	0	0	0
21292	0	0	0	0	0
21293	0	0	0	0	0
21294	0	0	0	0	0
21295	0	0	0	0	0
21296	0	0	0	0	0
21297	0	0	0	0	0
21298	0	0	0	0	0
21299	0	0	0	0	0
21300	0	0	0	0	0
21301	0	0	0	0	0
21302	0	0	0	0	0
21303	0	0	0	0	0
21304	0	0	0	0	0
21305	0	0	0	0	0
21306	0	0	0	0	0
21307	0	0	0	0	0
21308	0	0	0	0	0
21309	0	0	0	0	0
21310	0	0	0	0	0
21311	0	0	0	0	0
21312	0	0	0	0	0
21313	0	0	0	0	0
21314	0	0	0	0	0
21315	0	0	0	0	0
21316	0	0	0	0	0
21317	0	0	0	0	0
21318	0	0	0	0	0
21319	0	0	0	0	0
21320	0	0	0	0	0
21321	0	0	0	0	0
21322	0	0	0	0	0
21323	0	0	0	0	0
21324	0	0	0	0	0
21325	0	0	0	0	0
21326	0	0	0	0	0
21327	0	0	0	0	0
21328	0	0	0	0	0
21329	0	0	0	0	0
21330	0	1	0	0	0	1
21331	3	0	0	0	0	3
21332	0	0	0	3	0	3
21333	0	0	4	0	0	4
21334	0	4	0	0	0	4
21335	9	0	0	0	0	9
21336	16	0	0	0	0	16
21337	57	0	0	0	0	57
21338	0	0	0	151	0	151
21339	0	0	0	158	0	158
21340	303	0	0	0	0	303
21341	0	344	0	2	0	346
21342	384	0	0	0	0	384
21343	0	0	0	415	0	415
21344	679	0	0	1	0	680
21345	5	1	0	1167	0	1173
21346	0	0	0	1182	0	1182
21347	0	0	0	1187	0	1187
21348	0	0	1	1194	0	1195
21349	0	0	1266	0	0	1266
21350	0	0	1513	0	0	1513
21351	1480	0	11	4	0	1495
21352	0	0	1552	0	0	1552
21353	3	0	1634	0	0	1637
21354	1628	0	7	2	0	1637
21355	2340	0	0	0	0	2340
21356	1	4	0	2498	0	2503
21357	2501	0	2	0	0	2503
21358	0	2514	0	1	0	2515
21359	2508	3	6	1	0	2518
21360	2530	1	8	1	0	2540
21361	2879	1	4	0	0	2884
21362	0	5	1	2915	0	2921
21363	1	2906	1	2	0	2910
21364	0	3029	0	2	0	3031
21365	3044	0	4	0	0	3048
21366	3266	1	2	1	0	3270
21367	0	3	2	3269	0	3274
21368	1	8	0	3269	0	3278
21369	1	3336	0	1	0	3338
21370	3341	0	5	0	0	3346
21371	3	0	3534	0	0	3537
21372	1	5	0	3545	0	3551
21373	1	16	0	3529	0	3546
21374	6	0	3684	0	0	3690
21375	4	19	2	3692	0	3717
21376	0	3867	1	4	0	3872
21377	0	10	1	4227	0	4238
21378	1	22	0	4280	0	4303
21379	0	4323	0	6	0	4329
21380	1	4321	0	1	0	4323
21381	0	13	1	4348	0	4362
21382	4473	0	1	1	0	4475
21383	0	20	1	4536	0	4557
21384	0	21	0	4570	0	4591
21385	0	4638	0	3	0	4641
21386	2	15	2	4615	0	4634
21387	0	13	1	4760	0	4774
21388	0	3	0	4867	0	4870
21389	4877	1	1	0	0	4879
21390	0	17	0	4913	0	4930
21391	4	10	0	4922	0	4936
21392	3	13	1	4919	0	4936
21393	4	0	4896	1	0	4901
21394	4916	2	13	2	0	4933
21395	0	4956	1	1	0	4958
21396	4964	1	11	1	0	4977
21397	0	6	1	4976	0	4983
21398	5	1	5238	2	0	5246
21399	5243	1	10	2	0	5256
21400	5	0	5383	2	0	5390
21401	4	10	0	5486	0	5500
21402	5490	1	30	2	0	5523
21403	5514	2	10	4	0	5530
21404	5531	2	16	0	0	5549
21405	0	3	0	5615	0	5618
21406	2	5	0	5594	0	5601
21407	0	6	1	5595	0	5602
21408	0	5586	1	3	0	5590
21409	1	5566	0	3	0	5570
21410	4	5693	0	2	0	5699
21411	0	5728	0	1	0	5729
21412	1	5	1	5766	0	5773
21413	5	2	1	5762	0	5770
21414	6081	0	6	0	0	6087
21415	6200	2	12	1	0	6215
21416	6258	0	15	6	0	6279
21417	0	2	0	6318	0	6320
21418	1	3	1	6261	0	6266
21419	6314	1	8	3	0	6326
21420	6032	1	17	1	0	6051
21421	1	0	5661	0	0	5662
21422	3	0	5867	2	0	5872
21423	14	0	5870	4	0	5888
21424	8	0	6360	1	0	6369
21425	3	13	0	6330	0	6346
21426	6150	0	11	1	0	6162
21427	0	6286	1	1	0	6288
21428	0	9	2	6477	0	6488
21429	12	0	7072	2	0	7086
21430	0	6388	0	2	0	6390
21431	2	16	0	6392	0	6410
21432	17	0	6594	1	0	6612
21433	1	21	2	6611	0	6635
21434	1	7	0	6604	0	6612
21435	6605	0	8	0	0	6613
21436	4	21	0	6577	0	6602
21437	0	0	6389	0	0	6389
21438	1	26	0	6402	0	6429
21439	0	6676	0	0	0	6676
21440	1	25	0	6699	0	6725
21441	1	14	0	6724	0	6739
21442	3	12	3	6577	0	6595
21443	6617	0	7	2	0	6626
21444	6595	1	16	0	0	6612
21445	6610	0	12	0	0	6622
21446	6565	0	25	2	0	6592
21447	2	0	6430	2	0	6434
21448	6326	2	14	9	0	6351
21449	6370	1	14	1	0	6386
21450	1	0	6512	3	0	6516
21451	4	1	6517	2	0	6524
21452	1	10	0	6470	0	6481
21453	2	6052	0	0	0	6054
21454	6065	0	16	3	0	6084
21455	6263	0	12	3	0	6278
21456	6249	1	20	0	0	6270
21457	1	29	0	6265	0	6295
21458	0	6218	0	3	0	6221
21459	6144	0	14	2	0	6160
21460	6213	0	14	1	0	6228
21461	2	8	0	6238	0	6248
21462	4	1	6354	0	0	6359
21463	6315	0	16	2	0	6333
21464	2	13	1	6261	0	6277
21465	6272	0	7	3	0	6282
21466	0	18	4	6291	0	6313
21467	3	0	6637	2	0	6642
21468	6815	1	13	0	0	6829
21469	0	19	1	6904	0	6924
21470	0	30	1	6929	0	6960
21471	0	11	2	6958	0	6971
21472	0	5	0	7188	0	7193
21473	7186	1	2	2	0	7191
21474	2	13	1	6903	0	6919
21475	0	6770	0	18	0	6788
21476	4	57	0	6627	0	6688
21477	0	7197	1	1	0	7199
21478	1	36	0	7173	0	7210
21479	1	12	0	7430	0	7443
21480	0	7447	0	1	0	7448
21481	1	15	1	7453	0	7470
21482	0	15	0	7860	0	7875
21483	8010	1	13	0	0	8024
21484	4	0	8128	1	0	8133
21485	0	5	0	8157	0	8162
21486	8022	0	12	5	0	8039
21487	8113	1	20	4	0	8138
21488	8332	3	39	1	0	8375
21489	6	0	8499	1	0	8506
21490	7	0	8139	3	0	8149
21491	0	18	0	8002	0	8020
21492	7774	0	14	7	0	7795
21493	14	0	7993	0	0	8007
21494	7996	0	10	2	0	8008
21495	0	8667	0	4	0	8671
21496	2	18	2	8629	0	8651
21497	1	10	2	8669	0	8682
21498	8550	0	8	0	0	8558
21499	0	8	1	8739	0	8748
21500	8320	0	13	1	0	8334
21501	8326	1	13	1	0	8341
21502	0	14	1	8294	0	8309
21503	1	9	0	8028	0	8038
21504	7907	0	9	2	0	7918
21505	0	0	7314	1	0	7315
21506	7163	1	18	1	0	7183
21507	8	0	7375	1	0	7384
21508	7163	0	16	2	0	7181
21509	7371	2	15	0	0	7388
21510	7399	0	22	4	0	7425
21511	7467	21	16	2	0	7506
21512	0	7693	0	3	0	7696
21513	7668	0	19	1	0	7688
21514	7760	0	15	1	0	7776
21515	1	7345	0	5	0	7351
21516	7301	1	14	1	0	7317
21517	3	0	7561	0	0	7564
21518	7142	0	311	2	0	7455
21519	12	0	7710	2	0	7724
21520	2	22	1	7746	0	7771
21521	0	20	0	7690	0	7710
21522	3	0	7976	0	0	7979
21523	2	22	1	7970	0	7995
21524	0	13	0	8167	0	8180
21525	8221	1	10	0	0	8232
21526	1	9	0	8720	0	8730
21527	0	32	0	9002	0	9034
21528	3	24	2	8963	0	8992
21529	1	9011	0	2	0	9014
21530	3	19	1	8992	0	9015
21531	8981	1	16	1	0	8999
21532	2	0	9157	2	0	9161
21533	1	28	1	9147	0	9177
21534	6	1	9113	2	0	9122
21535	9156	3	21	1	0	9181
21536	0	20	1	9224	0	9245
21537	16	0	9253	1	0	9270
21538	1	32	1	9503	0	9537
21539	4	23	1	9391	0	9419
21540	1	9560	0	5	0	9566
21541	3	24	0	9535	0	9562
21542	2	29	2	9570	0	9603
21543	10	0	9478	5	0	9493
21544	2	22	0	9262	0	9286
21545	3	24	1	9225	0	9253
21546	9296	0	7	4	0	9307
21547	9280	1	29	4	0	9314
21548	0	9319	0	2	0	9321
21549	9253	1	17	1	0	9272
21550	9307	0	18	1	0	9326
21551	0	8935	0	3	0	8938
21552	3	14	1	8909	0	8927
21553	8922	0	25	0	0	8947
21554	8908	1	20	7	0	8936
21555	8753	1	21	2	0	8777
21556	0	8883	0	4	0	8887
21557	17	0	8849	0	0	8866
21558	8419	0	17	5	0	8441
21559	8344	0	32	2	0	8378
21560	0	8279	1	2	0	8282
21561	8455	1	8	3	0	8467
21562	8679	2	13	1	0	8695
21563	0	12	0	8639	0	8651
21564	6	0	8439	0	0	8445
21565	1	19	2	8262	0	8284
21566	2	22	2	8211	0	8237
21567	1	31	0	8236	0	8268
21568	2	0	8301	0	0	8303
21569	1	21	2	8249	0	8273
21570	0	12	0	8235	0	8247
21571	2	20	0	7526	0	7548
21572	0	7	0	7790	0	7797
21573	1	19	0	8034	0	8054
21574	1	7811	0	26	0	7838
21575	1	18	0	7839	0	7858
21576	1	21	0	7835	0	7857
21577	0	0	8026	1	0	8027
21578	1	17	2	8309	0	8329
21579	1	13	0	8302	0	8316
21580	1	10	0	8265	0	8276
21581	0	5	0	8297	0	8302
21582	8309	0	6	3	0	8318
21583	0	5	0	8173	0	8178
21584	3	18	0	8229	0	8250
21585	9	0	7912	2	0	7923
21586	1	8193	3	4	0	8201
21587	1	7970	0	12	0	7983
21588	8030	0	9	1	0	8040
21589	0	8026	0	3	0	8029
21590	0	18	1	8020	0	8039
21591	8464	3	12	0	0	8479
21592	3	0	8694	0	0	8697
21593	4	31	0	10497	0	10532
21594	0	10413	0	13	0	10426
21595	1	34	1	10282	0	10318
21596	0	10322	0	7	0	10329
21597	2	17	3	10381	0	10403
21598	10495	2	15	0	0	10512
21599	7	0	10518	3	0	10528
21600	6	25	0	11160	0	11191
21601	0	11052	1	5	0	11058
21602	10256	1	22	1	0	10280
21603	1	0	10453	2	0	10456
21604	6	34	2	10777	0	10819
21605	21	0	11253	2	0	11276
21606	3	32	0	11211	0	11246
21607	10	0	11218	2	0	11230
21608	2	30	0	11062	0	11094
21609	0	7	0	11069	0	11076
21610	11015	3	17	3	0	11038
21611	10947	1	25	2	0	10975
21612	1	45	1	11080	0	11127
21613	1	11068	0	7	0	11076
21614	1	33	2	10856	0	10892
21615	1	14	0	10929	0	10944
21616	10713	3	12	0	0	10728
21617	1	10745	0	6	0	10752
21618	10940	0	28	3	0	10971
21619	10631	0	168	5	0	10804
21620	3	10771	1	10	0	10785
21621	4	10715	0	9	0	10728
21622	10661	0	9	2	0	10672
21623	8	0	10812	2	0	10822
21624	10530	2	26	2	0	10560
21625	10627	1	19	0	0	10647
21626	2	10581	0	13	0	10596
21627	0	27	3	10518	0	10548
21628	1	11122	0	4	0	11127
21629	11136	0	12	3	0	11151
21630	11224	1	19	2	0	11246
21631	2	17	1	11297	0	11317
21632	3	10	1	11181	0	11195
21633	11391	0	5	1	0	11397
21634	3	11521	0	4	0	11528
21635	2	11464	0	29	0	11495
21636	1	11443	0	26	0	11470
21637	1	11013	0	7	0	11021
21638	1	11315	1	16	0	11333
21639	3	36	1	11325	0	11365
21640	23	0	11810	0	0	11833
21641	2	11912	1	7	0	11922
21642	11871	2	18	0	0	11891
21643	2	19	1	11904	0	11926
21644	11710	2	10	5	0	11727
21645	3	12559	1	6	0	12569
21646	12465	0	27	1	0	12493
21647	1	12540	1	1	0	12543
21648	3	23	0	12217	0	12243
21649	11917	1	13	0	0	11931
21650	11904	0	12	1	0	11917
21651	1	31	0	12234	0	12266
21652	5	37	0	12236	0	12278
21653	0	12253	1	3	0	12257
21654	2	53	0	11927	0	11982
21655	1	19	2	11969	0	11991
21656	3	44	0	12335	0	12382
21657	0	12400	1	15	0	12416
21658	12323	0	26	1	0	12350
21659	1	12361	0	3	0	12365
21660	11886	0	28	3	0	11917
21661	0	11788	0	15	0	11803
21662	13	0	11666	0	0	11679
21663	6	18	2	11698	0	11724
21664	6	1	11570	3	0	11580
21665	8	0	12154	5	0	12167
21666	2	29	4	12132	0	12167
21667	13	0	12306	1	0	12320
21668	2	35	11	12007	0	12055
21669	2	20	1	10835	0	10858
21670	0	11	1	10841	0	10853
21671	10819	1	7	2	0	10829
21672	5	21	1	10662	0	10689
21673	2	31	1	10605	0	10639
21674	10108	0	13	3	0	10124
21675	1	10061	0	14	0	10076
21676	1	9593	0	17	0	9611
21677	0	9295	0	7	0	9302
21678	4	27	0	9011	0	9042
21679	14	0	9029	1	0	9044
21680	9012	2	19	5	0	9038
21681	0	8746	0	2	0	8748
21682	8729	0	15	1	0	8745
21683	8631	1	9	3	0	8644
21684	8542	1	20	1	0	8564
21685	6	0	8779	1	0	8786
21686	1	31	5	9136	0	9173
21687	0	29	1	9142	0	9172
21688	2	25	0	9020	0	9047
21689	2	34	0	8853	0	8889
21690	1	8858	0	3	0	8862
21691	8824	2	14	34	0	8874
21692	17	0	8872	1	0	8890
21693	9737	0	19	2	0	9758
21694	3	27	1	10006	0	10037
21695	0	9961	0	8	0	9969
21696	1	10221	0	0	0	10222
21697	3	20	2	10168	0	10193
21698	0	10160	0	4	0	10164
21699	10061	1	17	1	0	10080
21700	8	0	10429	0	0	10437
21701	1	38	1	10430	0	10470
21702	1	26	2	10401	0	10430
21703	4	36	2	10436	0	10478
21704	2	16	0	10219	0	10237
21705	10379	0	10	2	0	10391
21706	0	10297	1	4	0	10302
21707	10309	0	20	0	0	10329
21708	1	21	0	10344	0	10366
21709	2	24	1	10086	0	10113
21710	0	10060	1	4	0	10065
21711	10005	3	12	1	0	10021
21712	10328	2	20	4	0	10354
21713	1	10305	0	0	0	10306
21714	2	26	2	10081	0	10111
21715	1	9735	0	6	0	9742
21716	9671	1	27	0	0	9699
21717	9	0	9726	0	0	9735
21718	5	1	9973	1	0	9980
21719	10427	4	16	3	0	10450
21720	2	10169	0	1	0	10172
21721	3	28	0	9761	0	9792
21722	1	15	0	9779	0	9795
21723	11	0	10089	1	0	10101
21724	3	38	1	10030	0	10072
21725	3	21	0	9996	0	10020
21726	1	9962	0	4	0	9967
21727	0	23	0	9860	0	9883
21728	2	17	2	9919	0	9940
21729	9873	1	7	1	0	9882
21730	2	9844	0	4	0	9850
21731	3	9962	0	9	0	9974
21732	2	42	0	9495	0	9539
21733	0	19	0	9561	0	9580
21734	2	53	0	9528	0	9583
21735	1	9534	0	3	0	9538
21736	2	50	1	9656	0	9709
21737	1	27	0	9807	0	9835
21738	0	22	0	9817	0	9839
21739	2	27	2	9749	0	9780
21740	40	8895	1	3	0	8939
21741	0	9381	0	7	0	9388
21742	9386	0	17	4	0	9407
21743	9036	3	12	1	0	9052
21744	0	14	0	9151	0	9165
21745	14	0	8794	0	0	8808
21746	1	28	7	8785	0	8821
21747	1	20	2	8801	0	8824
21748	9241	2	10	3	0	9256
21749	1	9622	1	5	0	9629
21750	1	23	1	9577	0	9602
21751	2	25	1	9617	0	9645
21752	4	0	9498	1	0	9503
21753	14	1	9985	4	0	10004
21754	2	43	2	10022	0	10069
21755	1	22	1	9965	0	9989
21756	1	9980	1	1	0	9983
21757	0	9867	0	11	0	9878
21758	10544	0	13	1	0	10558
21759	4	26	1	10670	0	10701
21760	15	0	10745	2	0	10762
21761	0	11467	0	1	0	11468
21762	1	20	1	11045	0	11067
21763	11445	1	26	3	0	11475
21764	0	17	1	11517	0	11535
21765	11581	1	18	0	0	11600
21766	1	11653	0	13	0	11667
21767	10741	3	16	1	0	10761
21768	0	30	3	10742	0	10775
21769	5	0	10610	3	0	10618
21770	3	40	1	10285	0	10329
21771	1	10577	0	7	0	10585
21772	3	41	3	10268	0	10315
21773	1	10091	1	5	0	10098
21774	2	26	3	10003	0	10034
21775	14	0	10015	3	0	10032
21776	28	0	10180	5	0	10213
21777	11	1	10331	2	0	10345
21778	10369	3	41	0	0	10413
21779	0	10354	0	7	0	10361
21780	5	10192	0	3	0	10200
21781	10276	1	8	1	0	10286
21782	10372	1	20	0	0	10393
21783	4	18	0	10376	0	10398
21784	16	0	10353	3	0	10372
21785	10	0	10862	3	0	10875
21786	2	15	1	11479	0	11497
21787	11562	0	21	0	0	11583
21788	0	11254	0	5	0	11259
21789	1	14	0	11091	0	11106
21790	11121	0	9	1	0	11131
21791	10889	3	13	1	0	10906
21792	11	0	10913	0	0	10924
21793	11231	2	25	3	0	11261
21794	3	0	10779	0	0	10782
21795	7	0	11037	5	0	11049
21796	1	39	4	10975	0	11019
21797	1	24	0	11091	0	11116
21798	3	28	1	11334	0	11366
21799	0	0	11100	13	0	11113
21800	11120	0	16	7	0	11143
21801	0	17	0	11207	0	11224
21802	11119	1	21	0	0	11141
21803	11257	1	30	0	0	11288
21804	6	11205	0	9	0	11220
21805	5	11032	1	5	0	11043
21806	2	11095	0	1	0	11098
21807	5	30	0	10897	0	10932
21808	8	0	11403	1	0	11412
21809	4	32	0	11435	0	11471
21810	8	11393	2	13	0	11416
21811	1	11396	0	6	0	11403
21812	3	23	1	11262	0	11289
21813	11339	0	12	3	0	11354
21814	7	11358	0	8	0	11373
21815	0	11406	0	3	0	11409
21816	11561	0	20	2	0	11583
21817	1	24	1	11099	0	11125
21818	1	17	0	11075	0	11093
21819	1	2	0	11331	0	11334
21820	11360	0	3	3	0	11366
21821	11264	0	10	1	0	11275
21822	1	24	2	11159	0	11186
21823	8	0	11123	0	0	11131
21824	10546	2	15	6	0	10569
21825	2	29	1	10219	0	10251
21826	17	0	10279	1	0	10297
21827	6	0	10505	4	0	10515
21828	0	31	6	10463	0	10500
21829	3	0	10212	2	0	10217
21830	3	31	5	10162	0	10201
21831	2	24	2	10171	0	10199
21832	1	11	0	10162	0	10174
21833	10239	0	7	3	0	10249
21834	7	30	2	9833	0	9872
21835	2	22	3	9682	0	9709
21836	1	23	1	9488	0	9513
21837	1	11	0	8887	0	8899
21838	21	0	8818	2	0	8841
21839	0	9004	0	11	0	9015
21840	3	28	2	9167	0	9200
21841	10	39	3	9281	0	9333
21842	0	9529	0	27	0	9556
21843	2	9493	0	6	0	9501
21844	9851	1	12	5	0	9869
21845	0	9700	0	13	0	9713
21846	0	13	1	9649	0	9663
21847	22	0	9697	0	0	9719
21848	9616	1	36	8	0	9661
21849	10	0	9708	1	0	9719
21850	9773	2	33	2	0	9810
21851	9539	2	37	0	0	9578
21852	1	0	10051	1	0	10053
21853	4	27	4	10117	0	10152
21854	1	10141	0	5	0	10147
21855	4	16	2	10130	0	10152
21856	10134	0	14	0	0	10148
21857	10159	3	16	2	0	10180
21858	0	10475	0	8	0	10483
21859	10455	1	29	0	0	10485
21860	2	18	0	10964	0	10984
21861	9675	0	5	0	0	9680
21862	10524	1	10	2	0	10537
21863	0	7	2	10609	0	10618
21864	10571	0	9	1	0	10581
21865	10469	1	15	2	0	10487
21866	1	0	10457	0	0	10458
21867	9953	2	22	5	0	9982
21868	6	0	10049	0	0	10055
21869	9	0	9773	3	0	9785
21870	1	9638	0	6	0	9645
21871	2	24	0	9565	0	9591
21872	8	1	9606	0	0	9615
21873	13	1	9656	2	0	9672
21874	9950	3	5	0	0	9958
21875	2	17	0	9904	0	9923
21876	3	15	0	10234	0	10252
21877	3	25	1	10222	0	10251
21878	2	2	1	10283	0	10288
21879	0	15	4	10093	0	10112
21880	7	0	10006	4	0	10017
21881	15	0	10010	1	0	10026
21882	2	12	1	10116	0	10131
21883	10048	0	18	4	0	10070
21884	1	9673	0	6	0	9680
21885	1	12	0	9648	0	9661
21886	10070	1	12	0	0	10083
21887	1	10063	0	10	0	10074
21888	0	40	1	9955	0	9996
21889	2	18	0	10018	0	10038
21890	0	3	0	9923	0	9926
21891	9800	2	18	0	0	9820
21892	5	0	9655	1	0	9661
21893	9514	1	25	1	0	9541
21894	0	24	1	9603	0	9628
21895	3	9	1	9265	0	9278
21896	0	9345	1	5	0	9351
21897	9	0	9283	1	0	9293
21898	9315	0	9	0	0	9324
21899	9278	0	28	0	0	9306
21900	11	0	9317	2	0	9330
21901	9507	0	26	1	0	9534
21902	1	9290	1	13	0	9305
21903	7	9132	0	12	0	9151
21904	0	9152	0	6	0	9158
21905	9223	0	23	3	0	9249
21906	6	0	9655	0	0	9661
21907	7	21	0	9705	0	9733
21908	4	9828	3	8	0	9843
21909	1	9752	0	9	0	9762
21910	0	9641	0	10	0	9651
21911	1	18	0	10271	0	10290
21912	10559	1	17	0	0	10577
21913	0	10555	0	4	0	10559
21914	1	25	2	10209	0	10237
21915	1	11	1	9890	0	9903
21916	9747	0	7	0	0	9754
21917	2	16	1	9632	0	9651
21918	4	16	0	9473	0	9493
21919	5	0	9824	0	0	9829
21920	1	22	0	9548	0	9571
21921	1	11	0	9821	0	9833
21922	9809	0	14	1	0	9824
21923	9749	0	9	1	0	9759
21924	1	10	0	9831	0	9842
21925	9608	0	14	1	0	9623
21926	9632	2	28	3	0	9665
21927	1	9297	1	6	0	9305
21928	12	0	9066	0	0	9078
21929	2	9784	0	5	0	9791
21930	1	25	1	9762	0	9789
21931	9992	1	21	1	0	10015
21932	0	9682	0	6	0	9688
21933	12	23	0	9644	0	9679
21934	9616	1	13	0	0	9630
21935	9541	0	9	0	0	9550
21936	1	19	1	9059	0	9080
21937	10	0	9119	0	0	9129
21938	1	27	0	8263	0	8291
21939	6	25	0	8098	0	8129
21940	2	0	8430	1	0	8433
21941	6	21	0	8511	0	8538
21942	1	15	1	8544	0	8561
21943	8826	1	15	2	0	8844
21944	1	16	0	8830	0	8847
21945	3	8	0	8838	0	8849
21946	8779	3	7	1	0	8790
21947	8672	2	14	2	0	8690
21948	8622	0	23	1	0	8646
21949	8	0	8757	4	0	8769
21950	3	28	0	8175	0	8206
21951	0	8102	0	4	0	8106
21952	1	32	4	7772	0	7809
21953	10	0	7878	0	0	7888
21954	3	27	1	7919	0	7950
21955	7	1	7960	0	0	7968
21956	7933	3	29	3	0	7968
21957	7894	2	6	0	0	7902
21958	0	22	1	7870	0	7893
21959	0	10	0	7867	0	7877
21960	0	21	0	7816	0	7837
21961	0	7484	1	2	0	7487
21962	7590	0	15	0	0	7605
21963	7578	1	9	0	0	7588
21964	0	9	0	7638	0	7647
21965	0	8	1	7568	0	7577
21966	4	4	0	7588	0	7596
21967	0	15	0	7669	0	7684
21968	8	0	7717	0	0	7725
21969	3	17	0	8633	0	8653
21970	8514	1	16	1	0	8532
21971	8640	1	19	0	0	8660
21972	2	14	1	8432	0	8449
21973	2	0	8488	2	0	8492
21974	8673	0	20	2	0	8695
21975	1	18	1	8706	0	8726
21976	5	8567	1	6	0	8579
21977	2	8529	0	6	0	8537
21978	9062	1	13	1	0	9077
21979	0	21	0	9078	0	9099
21980	1	15	0	9103	0	9119
21981	1	7	0	9046	0	9054
21982	2	11	1	8563	0	8577
21983	0	7	3	8562	0	8572
21984	6	0	8348	6	0	8360
21985	3	0	8333	6	0	8342
21986	4	1	8401	3	0	8409
21987	2	23	1	7962	0	7988
21988	2	0	8001	0	0	8003
21989	0	26	2	7945	0	7973
21990	1	13	3	7940	0	7957
21991	3	3	1	8010	0	8017
21992	7894	0	8	0	0	7902
21993	2	13	1	7868	0	7884
21994	0	13	0	8190	0	8203
21995	7816	2	20	0	0	7838
21996	1	7851	0	17	0	7869
21997	3	7463	0	13	0	7479
21998	7520	2	10	4	0	7536
21999	0	7603	0	2	0	7605
22000	7564	0	15	0	0	7579
22001	7619	0	12	0	0	7631
22002	7541	1	7	4	0	7553
22003	7444	0	20	0	0	7464
22004	7449	8	19	1	0	7477
22005	1	6748	0	5	0	6754
22006	6718	0	27	0	0	6745
22007	6740	4	20	0	0	6764
22008	1	6629	0	8	0	6638
22009	6619	3	10	3	0	6635
22010	6603	1	11	0	0	6615
22011	6536	1	15	0	0	6552
22012	6540	1	19	0	0	6560
22013	5	1	6583	0	0	6589
22014	0	15	1	6869	0	6885
22015	0	6	1	6890	0	6897
22016	3	0	6580	0	0	6583
22017	7	1	6346	2	0	6356
22018	6489	0	13	5	0	6507
22019	1	8	2	6220	0	6231
22020	4	0	6168	0	0	6172
22021	5	0	6861	2	0	6868
22022	6852	1	22	1	0	6876
22023	6843	1	14	2	0	6860
22024	6817	0	18	1	0	6836
22025	4	0	6811	0	0	6815
22026	0	21	2	6734	0	6757
22027	9	0	6727	0	0	6736
22028	6678	0	25	3	0	6706
22029	22	0	6766	0	0	6788
22030	2	21	0	6975	0	6998
22031	2	17	0	6920	0	6939
22032	1	6914	1	4	0	6920
22033	6881	2	26	5	0	6914
22034	5	0	6967	0	0	6972
22035	7132	0	25	1	0	7158
22036	7	0	7513	0	0	7520
22037	3	23	0	7542	0	7568
22038	0	12	1	7642	0	7655
22039	0	5	0	7584	0	7589
22040	7815	0	7	2	0	7824
22041	0	8	0	7794	0	7802
22042	3	36	2	7737	0	7778
22043	1	7719	0	5	0	7725
22044	1	17	0	7501	0	7519
22045	6790	0	16	0	0	6806
22046	2	0	6818	0	0	6820
22047	1	12	0	6646	0	6659
22048	4	0	6617	2	0	6623
22049	1	6299	0	6	0	6306
22050	5	0	6355	0	0	6360
22051	6377	1	16	2	0	6396
22052	6373	0	6	0	0	6379
22053	0	4	1	6440	0	6445
22054	6008	1	7	0	0	6016
22055	5934	3	13	0	0	5950
22056	1	8	0	5930	0	5939
22057	0	13	0	6160	0	6173
22058	5	1	6150	0	0	6156
22059	0	6119	1	9	0	6129
22060	6141	1	15	0	0	6157
22061	0	6230	0	8	0	6238
22062	0	17	1	6083	0	6101
22063	0	7	0	6251	0	6258
22064	1	6	0	6012	0	6019
22065	0	5	0	6109	0	6114
22066	8	1	6152	0	0	6161
22067	6124	0	21	7	0	6152
22068	6199	0	5	0	0	6204
22069	4	9	0	6207	0	6220
22070	5889	0	3	2	0	5894
22071	0	6	0	6147	0	6153
22072	2	0	5932	0	0	5934
22073	1	20	0	6005	0	6026
22074	1	6108	0	2	0	6111
22075	1	16	2	5944	0	5963
22076	1	6099	0	3	0	6103
22077	3	19	1	5995	0	6018
22078	0	6058	0	2	0	6060
22079	6010	0	16	0	0	6026
22080	6	0	6114	0	0	6120
22081	1	6565	0	7	0	6573
22082	1	6607	0	6	0	6614
22083	0	43	0	6453	0	6496
22084	1	29	2	6490	0	6522
22085	1	12	1	6619	0	6633
22086	2	13	1	6636	0	6652
22087	0	6978	0	5	0	6983
22088	0	19	0	6951	0	6970
22089	2	10	1	6692	0	6705
22090	6688	1	9	0	0	6698
22091	1	15	1	6641	0	6658
22092	7	0	6596	2	0	6605
22093	2	0	6555	1	0	6558
22094	6588	0	32	1	0	6621
22095	2	6700	0	5	0	6707
22096	1	6017	0	5	0	6023
22097	2	19	5	5989	0	6015
22098	0	10	0	6052	0	6062
22099	0	1	6125	0	0	6126
22100	6427	1	18	5	0	6451
22101	6406	0	22	0	0	6428
22102	2	2	6401	3	0	6408
22103	2	1	6435	0	0	6438
22104	6148	0	18	4	0	6170
22105	6514	1	33	1	0	6549
22106	6574	2	19	4	0	6599
22107	6595	5	22	1	0	6623
22108	0	6633	0	2	0	6635
22109	6369	1	11	3	0	6384
22110	9	0	6296	0	0	6305
22111	8	0	6298	2	0	6308
22112	5	0	6033	0	0	6038
22113	0	10	1	6186	0	6197
22114	5944	1	9	0	0	5954
22115	5968	0	10	0	0	5978
22116	2	10	2	5758	0	5772
22117	4	11	0	5887	0	5902
22118	1	10	0	5913	0	5924
22119	3	6449	0	2	0	6454
22120	6530	1	6	0	0	6537
22121	7064	0	5	4	0	7073
22122	7036	0	9	2	0	7047
22123	7244	1	9	0	0	7254
22124	7373	0	5	2	0	7380
22125	2	20	1	7463	0	7486
22126	0	7533	0	3	0	7536
22127	2	18	0	7484	0	7504
22128	0	3	1	7532	0	7536
22129	7404	0	21	1	0	7426
22130	6	1	7417	0	0	7424
22131	7	0	7383	3	0	7393
22132	8	0	7539	1	0	7548
22133	7264	1	17	4	0	7286
22134	7270	0	18	1	0	7289
22135	2	10	2	7225	0	7239
22136	1	15	1	7279	0	7296
22137	2	14	1	7161	0	7178
22138	2	0	7379	0	0	7381
22139	1	14	2	7273	0	7290
22140	2	0	7330	0	0	7332
22141	2	22	2	7181	0	7207
22142	0	14	1	7244	0	7259
22143	0	2	1	7401	0	7404
22144	7387	0	5	1	0	7393
22145	7383	1	20	1	0	7405
22146	3	0	7534	0	0	7537
22147	7185	0	23	4	0	7212
22148	7329	2	17	1	0	7349
22149	1	5	0	7294	0	7300
22150	7275	0	10	0	0	7285
22151	3	11	0	7273	0	7287
22152	1	16	0	7173	0	7190
22153	2	0	7187	1	0	7190
22154	7069	0	31	1	0	7101
22155	2	9	0	6760	0	6771
22156	1	0	6698	0	0	6699
22157	12	0	6575	1	0	6588
22158	2	13	0	6507	0	6522
22159	1	5	1	6596	0	6603
22160	6622	2	9	0	0	6633
22161	0	10	0	6633	0	6643
22162	0	20	0	6564	0	6584
22163	0	9	0	6254	0	6263
22164	0	0	1	6276	0	6277
22165	6275	0	4	1	0	6280
22166	6306	0	5	1	0	6312
22167	6601	0	6	1	0	6608
22168	6804	0	9	0	0	6813
22169	2	8	1	6814	0	6825
22170	6811	0	4	1	0	6816
22171	0	3	0	6678	0	6681
22172	7481	1	1	0	0	7483
22173	2	10	0	7528	0	7540
22174	2	17	0	7565	0	7584
22175	0	7517	0	1	0	7518
22176	0	9	0	7249	0	7258
22177	7293	0	3	0	0	7296
22178	7222	0	20	3	0	7245
22179	10	0	7438	0	0	7448
22180	0	7409	0	7	0	7416
22181	7051	1	10	3	0	7065
22182	0	7028	0	4	0	7032
22183	6980	0	23	4	0	7007
22184	1	7161	0	5	0	7167
22185	11	2	7143	1	0	7157
22186	2	7901	0	2	0	7905
22187	0	7936	0	3	0	7939
22188	2	18	0	8685	0	8705
22189	9406	1	9	2	0	9418
22190	3	9	0	9581	0	9593
22191	1	5	0	9608	0	9614
22192	9769	0	6	2	0	9777
22193	9700	1	1	0	0	9702
22194	1	14	0	9693	0	9708
22195	1	7	0	8982	0	8990
22196	1	5	0	9122	0	9128
22197	8553	0	3	0	0	8556
22198	2	0	8631	0	0	8633
22199	2	18	0	8542	0	8562
22200	3	0	8366	3	0	8372
22201	0	8230	0	11	0	8241
22202	27	0	8258	0	0	8285
22203	2	16	0	8283	0	8301
22204	1	0	8250	3	0	8254
22205	8500	0	14	0	0	8514
22206	1	22	0	8501	0	8524
22207	0	8377	0	3	0	8380
22208	3	24	0	8230	0	8257
22209	2	8533	0	0	0	8535
22210	0	8562	1	4	0	8567
22211	0	8646	0	2	0	8648
22212	2	13	2	8570	0	8587
22213	2	8454	0	9	0	8465
22214	8355	0	20	4	0	8379
22215	7	0	8393	0	0	8400
22216	3	0	8428	3	0	8434
22217	7	0	8461	2	0	8470
22218	1	23	5	8215	0	8244
22219	0	9	0	8152	0	8161
22220	0	10	0	8185	0	8195
22221	0	11	0	8507	0	8518
22222	1	7	0	8298	0	8306
22223	3	8195	0	6	0	8204
22224	9	1	8159	1	0	8170
22225	4	0	8146	4	0	8154
22226	1	8464	0	14	0	8479
22227	2	32	0	8395	0	8429
22228	2	21	2	8498	0	8523
22229	0	8	1	8518	0	8527
22230	8533	0	5	0	0	8538
22231	1	0	8480	1	0	8482
22232	8596	0	25	8	0	8629
22233	8681	1	32	2	0	8716
22234	0	8751	1	7	0	8759
22235	0	8655	0	4	0	8659
22236	8658	1	24	4	0	8687
22237	1	14	0	8742	0	8757
22238	7	11	1	8779	0	8798
22239	3	0	8719	5	0	8727
22240	5	0	8779	0	0	8784
22241	1	11	0	8780	0	8792
22242	8672	0	15	1	0	8688
22243	4	0	8442	0	0	8446
22244	8198	0	27	6	0	8231
22245	2	13	2	8258	0	8275
22246	6	5	1	8155	0	8167
22247	1	14	1	8171	0	8187
22248	8	0	7401	3	0	7412
22249	2	7343	0	5	0	7350
22250	1	7353	0	6	0	7360
22251	7336	1	18	2	0	7357
22252	7321	1	8	1	0	7331
22253	0	7	1	7432	0	7440
22254	7414	2	23	3	0	7442
22255	6	0	7509	0	0	7515
22256	3	2	8064	0	0	8069
22257	0	10	0	8046	0	8056
22258	8059	0	10	2	0	8071
22259	2	4	1	8039	0	8046
22260	2	5	0	7930	0	7937
22261	7921	0	7	1	0	7929
22262	7341	1	6	3	0	7351
22263	0	6896	0	6	0	6902
22264	6435	2	20	6	0	6463
22265	0	16	0	6263	0	6279
22266	0	6087	0	5	0	6092
22267	6094	0	8	4	0	6106
22268	0	5936	0	2	0	5938
22269	0	4	3	5894	0	5901
22270	5837	1	17	1	0	5856
22271	5	0	5855	1	0	5861
22272	2	0	5986	1	0	5989
22273	4	15	2	5961	0	5982
22274	1	50	0	5797	0	5848
22275	1	9	1	5811	0	5822
22276	2	5931	0	2	0	5935
22277	5958	0	8	2	0	5968
22278	5939	1	7	0	0	5947
22279	5945	2	21	0	0	5968
22280	0	5928	0	1	0	5929
22281	1	16	0	5763	0	5780
22282	2	9	1	5830	0	5842
22283	0	6	0	6108	0	6114
22284	6164	0	12	1	0	6177
22285	0	6333	0	5	0	6338
22286	1	17	0	6453	0	6471
22287	0	14	2	6432	0	6448
22288	2	0	6670	0	0	6672
22289	1	6867	0	1	0	6869
22290	0	39	2	6792	0	6833
22291	3	19	1	6854	0	6877
22292	0	12	0	6885	0	6897
22293	7193	0	16	3	0	7212
22294	0	7239	0	5	0	7244
22295	7349	1	14	3	0	7367
22296	0	7	0	7423	0	7430
22297	7022	2	7	1	0	7032
22298	0	1	7139	0	0	7140
22299	7139	0	20	2	0	7161
22300	7164	1	25	0	0	7190
22301	14	0	7139	0	0	7153
22302	3	16	2	7472	0	7493
22303	0	9	0	7423	0	7432
22304	7511	0	10	1	0	7522
22305	1	7	1	7524	0	7533
22306	4	17	0	7507	0	7528
22307	2	17	3	8148	0	8170
22308	9	0	8123	5	0	8137
22309	8056	1	20	0	0	8077
22310	0	7984	0	6	0	7990
22311	0	18	0	7829	0	7847
22312	3	7814	0	4	0	7821
22313	3	7713	0	7	0	7723
22314	4	12	0	7726	0	7742
22315	4	2	7732	2	0	7740
22316	6	0	7794	1	0	7801
22317	1	8	0	7781	0	7790
22318	5	0	7766	1	0	7772
22319	7595	0	26	1	0	7622
22320	2	24	0	7708	0	7734
22321	2	16	1	7673	0	7692
22322	0	7629	0	7	0	7636
22323	2	21	0	7695	0	7718
22324	0	7	0	7721	0	7728
22325	1	7708	0	2	0	7711
22326	1	26	0	7678	0	7705
22327	3	8	1	7715	0	7727
22328	0	7735	2	7	0	7744
22329	7644	2	18	1	0	7665
22330	2	1	7625	0	0	7628
22331	8	0	7396	2	0	7406
22332	1	9	0	6870	0	6880
22333	5	16	1	6790	0	6812
22334	12	0	6733	0	0	6745
22335	4	0	6761	0	0	6765
22336	6729	0	17	1	0	6747
22337	0	6718	0	4	0	6722
22338	6510	0	15	2	0	6527
22339	5	0	6447	0	0	6452
22340	0	6472	0	5	0	6477
22341	0	17	0	6438	0	6455
22342	9	1	6420	3	0	6433
22343	4	0	6476	1	0	6481
22344	1	15	3	6639	0	6658
22345	16	0	6576	2	0	6594
22346	0	7024	0	14	0	7038
22347	0	9	1	7117	0	7127
22348	2	0	7073	0	0	7075
22349	3	7124	0	6	0	7133
22350	7129	3	11	2	0	7145
22351	10	0	7207	0	0	7217
22352	0	7078	0	3	0	7081
22353	0	10	0	7110	0	7120
22354	1	7	0	7365	0	7373
22355	7368	0	4	0	0	7372
22356	2	27	1	10410	0	10440
22357	0	12	0	10410	0	10422
22358	10429	0	14	1	0	10444
22359	3	17	0	10161	0	10181
22360	3	0	10092	0	0	10095
22361	7	11	1	9698	0	9717
22362	14	0	9523	0	0	9537
22363	11	1	9528	0	0	9540
22364	1	1	9395	0	0	9397
22365	2	19	0	9246	0	9267
22366	3	8	0	9306	0	9317
22367	9340	0	8	1	0	9349
22368	3	25	0	9351	0	9379
22369	3	9198	1	1	0	9203
22370	1	28	4	9141	0	9174
22371	0	29	0	9036	0	9065
22372	2	9057	0	3	0	9062
22373	8942	0	29	0	0	8971
22374	9029	0	29	2	0	9060
22375	3	8994	0	7	0	9004
22376	1	8502	0	17	0	8520
22377	1	3	1	9264	0	9269
22378	9134	0	17	2	0	9153
22379	3	0	9109	1	0	9113
22380	13	0	9067	1	0	9081
22381	9231	1	23	1	0	9256
22382	1	9387	0	5	0	9393
22383	0	41	2	8459	0	8502
22384	0	21	3	8524	0	8548
22385	3	21	3	8520	0	8547
22386	5	14	0	8651	0	8670
22387	2	8710	0	6	0	8718
22388	2	11	0	8650	0	8663
22389	8720	0	12	0	0	8732
22390	2	10	2	8645	0	8659
22391	3	11	3	8686	0	8703
22392	8720	0	2	0	0	8722
22393	8712	1	4	0	0	8717
22394	8849	1	5	2	0	8857
22395	8961	0	10	1	0	8972
22396	0	10	1	8822	0	8833
22397	8874	0	5	3	0	8882
22398	2	11	0	8781	0	8794
22399	8658	0	18	0	0	8676
22400	8704	0	14	0	0	8718
22401	0	10	0	8747	0	8757
22402	4	0	8786	0	0	8790
22403	8731	0	8	1	0	8740
22404	8663	0	9	0	0	8672
22405	8633	0	8	2	0	8643
22406	8931	0	13	1	0	8945
22407	1	7	0	8887	0	8895
22408	2	0	8876	0	0	8878
22409	9	0	8949	0	0	8958
22410	9001	0	30	1	0	9032
22411	8993	0	30	2	0	9025
22412	5	9071	1	5	0	9082
22413	0	8944	0	2	0	8946
22414	9171	1	21	2	0	9195
22415	1	15	1	9123	0	9140
22416	0	10	0	9367	0	9377
22417	9401	0	13	3	0	9417
22418	1	9308	0	6	0	9315
22419	9047	1	33	1	0	9082
22420	6	1	9093	2	0	9102
22421	8817	0	26	1	0	8844
22422	3	14	0	8588	0	8605
22423	7	0	8520	0	0	8527
22424	1	8294	0	5	0	8300
22425	0	15	1	8241	0	8257
22426	13	0	8235	1	0	8249
22427	0	6	0	8283	0	8289
22428	8255	0	11	0	0	8266
22429	3	0	8200	1	0	8204
22430	8047	0	40	1	0	8088
22431	0	7981	0	5	0	7986
22432	2	11	1	4257	0	4271
22433	2	0	4322	0	0	4324
22434	0	8	0	4304	0	4312
22435	7	1	4266	0	0	4274
22436	0	5451	1	8	0	5460
22437	7453	1	13	2	0	7469
22438	4	16299	0	1	0	16304
22439	53	7	0	16233	0	16293
22440	7	11	4	17203	0	17225
22441	6	2	21697	9	0	21714
22442	24715	1	21	4	0	24741
22443	4	28843	1	13	0	28861
22444	3	28960	0	6	0	28969
22445	1	31957	0	5	0	31963
22446	5	45	2	36393	0	36445
22447	0	46873	0	4	0	46877
22448	3	29	1	46645	0	46678
22449	1	79598	1	32	0	79632
22450	47	551	7	78382	0	78987
22451	3	86348	1	102	0	86454
22452	86191	23	209	32	0	86455
22453	107	4	106946	22	0	107079
22454	106950	15	463	96	0	107524
22455	111206	15	536	37	0	111794
22456	112529	80	398	33	0	113040
22457	1	115700	1	108	0	115810
22458	118023	15	222	14	0	118274
22459	119435	15	456	25	0	119931
22460	120645	43	369	47	0	121104
22461	79	5	132142	15	0	132241
22462	74	460	13	132434	0	132981
22463	207	44	134093	13	0	134357
22464	16	260	10	135269	0	135555
22465	136484	5	251	25	0	136765
22466	5	139423	12	122	0	139562
22467	236	8	144123	7	0	144374
22468	35	492	22	156096	0	156645
22469	11	434	8	156273	0	156726
22470	188	2	158261	51	0	158502
22471	158780	23	486	90	0	159379
22472	160409	17	607	40	0	161073
22473	176149	23	472	21	0	176665
22474	25	628	11	177966	0	178630
22475	8	180946	1	75	0	181030
22476	11	182605	5	178	0	182799
22477	51	1040	22	182614	0	183727
22478	106	811	29	185283	0	186229
22479	13	186182	4	163	0	186362
22480	186445	49	353	55	0	186902
22481	14	200223	5	71	0	200313
22482	56	753	27	199081	0	199917
22483	378	5	222919	32	0	223334
22484	53	546	17	223138	0	223754
22485	229888	21	408	61	0	230378
22486	147	7	230869	47	0	231070
22487	230010	34	658	172	0	230874
22488	233211	51	780	81	0	234123
22489	236151	45	805	49	0	237050
22490	235530	57	727	53	0	236367
22491	235118	56	1021	32	0	236227
22492	79	4	236991	22	0	237096
22493	158	15	236991	110	0	237274
22494	233483	29	550	139	0	234201
22495	236190	36	716	39	0	236981
22496	53	811	34	237398	0	238296
22497	13	250744	4	122	0	250883
22498	74	575	27	250191	0	250867
22499	254232	23	328	45	0	254628
22500	155	881	27	253228	0	254291
22501	12	254242	5	131	0	254390
22502	253958	67	502	64	0	254591
22503	253842	34	542	36	0	254454
22504	257202	58	550	27	0	257837
22505	6	268028	3	101	0	268138
22506	26	1061	21	267025	0	268133
22507	36	710	19	268740	0	269505
22508	10	271064	1	224	0	271299
22509	55	677	30	271023	0	271785
22510	271750	21	320	17	0	272108
22511	277178	44	421	40	0	277683
22512	1	281298	4	173	0	281476
22513	47	1430	37	279338	0	280852
22514	84	802	41	280896	0	281823
22515	15	524	11	283524	0	284074
22516	282411	28	427	58	0	282924
22517	362	5	276891	63	0	277321
22518	274349	32	737	134	0	275252
22519	276	116	276029	40	0	276461
22520	61	873	14	276787	0	277735
22521	26	271615	9	217	0	271867
22522	50	261806	9	198	0	262063
22523	271603	37	700	101	0	272441
22524	272661	28	446	290	0	273425
22525	16	242600	11	256	0	242883
22526	18	243532	2	243	0	243795
22527	245221	26	342	66	0	245655
22528	251523	28	568	76	0	252195
22529	5	232822	5	166	0	232998
22530	232260	30	541	133	0	232964
22531	301	7	234065	11	0	234384
22532	240368	30	510	125	0	241033
22533	242060	34	601	47	0	242742
22534	38	806	39	239935	0	240818
22535	3	235353	3	95	0	235454
22536	56	542	31	233425	0	234054
22537	244828	16	274	26	0	245144
22538	47	744	20	248454	0	249265
22539	72	731	22	246719	0	247544
22540	150	9	251305	23	0	251487
22541	73	794	32	253598	0	254497
22542	22	551	10	255242	0	255825
22543	251112	19	374	61	0	251566
22544	132	7	240930	28	0	241097
22545	239839	21	482	32	0	240374
22546	23	809	21	241005	0	241858
22547	39	710	14	239108	0	239871
22548	57	725	10	265093	0	265885
22549	6	251112	5	81	0	251204
22550	12	246299	4	156	0	246471
22551	33	478	11	247430	0	247952
22552	248290	22	348	24	0	248684
22553	253265	33	416	60	0	253774
22554	20	285	9	257621	0	257935
22555	277343	39	296	42	0	277720
22556	43	710	26	304070	0	304849
22557	31	245	10	292825	0	293111
22558	298599	20	373	57	0	299049
22559	24	276648	11	239	0	276922
22560	275992	46	876	80	0	276994
22561	271796	45	657	61	0	272559
22562	272324	97	565	53	0	273039
22563	29	281664	2	136	0	281831
22564	47	1031	34	281156	0	282268
22565	59	719	84	280253	0	281115
22566	776	9	279755	56	0	280596
22567	85	918	30	283013	0	284046
22568	315	12	278132	133	0	278592
22569	36	280606	19	296	0	280957
22570	38	281130	6	149	0	281323
22571	14	278637	6	120	0	278777
22572	33	957	32	275432	0	276454
22573	42	1109	35	276104	0	277290
22574	29	664	24	281670	0	282387
22575	52	641	75	279056	0	279824
22576	234	4	280125	60	0	280423
22577	549	8	282719	82	0	283358
22578	38	969	40	282599	0	283646
22579	201	6	281187	72	0	281466
22580	277329	34	752	187	0	278302
22581	268869	37	704	45	0	269655
22582	85	1	279544	19	0	279649
22583	31	969	204	283713	0	284917
22584	16	644	31	284659	0	285350
22585	23	834	21	285221	0	286099
22586	37	250	19	286976	0	287282
22587	84	309	4	283142	0	283539
22588	275404	8	254	48	0	275714
22589	274769	25	600	51	0	275445
22590	8	273744	6	231	0	273989
22591	361	14	270944	65	0	271384
22592	49	273040	21	120	0	273230
22593	33	308489	7	226	0	308755
22594	311099	36	496	93	0	311724
22595	38	308996	6	148	0	309188
22596	19	305425	1	179	0	305624
22597	306388	75	686	89	0	307238
22598	322	3	312368	28	0	312721
22599	326988	71	697	97	0	327853
22600	31	546	29	329400	0	330006
22601	92	919	117	330253	0	331381
22602	52	935	19	322795	0	323801
22603	358	22	319562	193	0	320135
22604	41	316085	6	315	0	316447
22605	315797	35	490	61	0	316383
22606	102	1042	43	315526	0	316713
22607	12	298387	1	101	0	298501
22608	59	835	52	301556	0	302502
22609	191	4	329242	24	0	329461
22610	34	1237	107	327999	0	329377
22611	109	1011	50	328762	0	329932
22612	70	796	24	329632	0	330522
22613	322039	34	417	39	0	322529
22614	54	920	18	319201	0	320193
22615	288	11	323393	29	0	323721
22616	21	319541	11	208	0	319781
22617	62	757	36	314900	0	315755
22618	135	920	71	310768	0	311894
22619	300	14	309844	48	0	310206
22620	347	19	314379	135	0	314880
22621	318965	20	571	83	0	319639
22622	317119	35	944	70	0	318168
22623	12	296951	6	486	0	297455
22624	294052	73	663	78	0	294866
22625	469	17	298173	38	0	298697
22626	274	17	305202	66	0	305559
22627	302224	33	727	144	0	303128
22628	302187	26	879	96	0	303188
22629	121	36	299717	31	0	299905
22630	301672	93	823	103	0	302691
22631	214	15	292490	172	0	292891
22632	289223	38	767	98	0	290126
22633	295402	52	785	54	0	296293
22634	96	599	38	290032	0	290765
22635	16	294618	5	156	0	294795
22636	293786	33	689	59	0	294567
22637	517	9	291602	31	0	292159
22638	41	287204	8	228	0	287481
22639	286317	30	511	50	0	286908
22640	298875	29	543	61	0	299508
22641	18	301439	4	179	0	301640
22642	120	789	53	300291	0	301253
22643	300	11	308838	7	0	309156
22644	67	947	40	306904	0	307958
22645	261	87	308990	15	0	309353
22646	90	1024	32	313684	0	314830
22647	64	921	24	306752	0	307761
22648	392	9	309836	63	0	310300
22649	23	308756	4	185	0	308968
22650	67	831	67	314702	0	315667
22651	232	7	328037	30	0	328306
22652	327914	47	527	72	0	328560
22653	41	1007	56	329842	0	330946
22654	29	455	17	332034	0	332535
22655	344993	101	307	30	0	345431
22656	33	963	13	344480	0	345489
22657	91	1026	27	339472	0	340616
22658	13	333545	9	122	0	333689
22659	128	1026	44	329157	0	330355
22660	251	11	388852	1061	0	390175
22661	82	1330	46	390415	0	391873
22662	44	391988	10	263	0	392305
22663	58	407328	17	201	0	407604
22664	120	903	39	410804	0	411866
22665	455955	29	560	74	0	456618
22666	65	856	26	462941	0	463888
22667	463967	36	503	85	0	464591
22668	62	678	25	462679	0	463444
22669	426980	30	512	36	0	427558
22670	427233	64	751	60	0	428108
22671	52	1244	34	437322	0	438652
22672	176	933	30	424400	0	425539
22673	46	419549	11	171	0	419777
22674	51	403784	14	436	0	404285
22675	625	54	404704	213	0	405596
22676	126	424731	7	233	0	425097
22677	426258	38	847	94	0	427237
22678	127	1674	56	428315	0	430172
22679	16	429887	5	171	0	430079
22680	432403	53	501	30	0	432987
22681	31	906	89	437011	0	438037
22682	47	1345	34	435784	0	437210
22683	72	1065	35	433105	0	434277
22684	155	919	40	427568	0	428682
22685	57	402095	12	244	0	402408
22686	15	403590	10	205	0	403820
22687	404460	57	819	82	0	405418
22688	8	417149	9	130	0	417296
22689	69	1928	38	411585	0	413620
22690	49	409	38	424091	0	424587
22691	47	957	36	419706	0	420746
22692	54	215	35	423073	0	423377
22693	420783	54	256	85	0	421178
22694	417918	78	893	102	0	418991
22695	190	2	444988	36	0	445216
22696	351	1183	82	436685	0	438301
22697	406	5	490304	33	0	490748
22698	118	1473	70	494922	0	496583
22699	77	961	36	494046	0	495120
22700	496348	60	815	123	0	497346
22701	213	1394	53	491312	0	492972
22702	420	22	491142	54	0	491638
22703	637	17	496611	152	0	497417
22704	472728	93	1290	371	0	474482
22705	346	19	482883	80	0	483328
22706	107	1415	58	464348	0	465928
22707	326	5	481365	36	0	481732
22708	171	1856	39	483869	0	485935
22709	41	481935	9	270	0	482255
22710	239	1939	60	474965	0	477203
22711	84	482382	10	521	0	482997
22712	44	485460	13	227	0	485744
22713	78	1015	38	488696	0	489827
22714	490333	15	563	73	0	490984
22715	22	486562	15	385	0	486984
22716	49	785	31	474546	0	475411
22717	482990	35	456	39	0	483520
22718	478232	63	926	98	0	479319
22719	479071	35	668	49	0	479823
22720	48	610	31	481768	0	482457
22721	46	270	8	480022	0	480346
22722	479805	22	344	69	0	480240
22723	476793	40	767	76	0	477676
22724	472161	57	816	50	0	473084
22725	80	1096	37	474101	0	475314
22726	440	5	471334	71	0	471850
22727	468402	30	1054	121	0	469607
22728	76	1484	26	470577	0	472163
22729	34	457249	6	222	0	457511
22730	220	1618	87	450632	0	452557
22731	26	478353	5	178	0	478562
22732	79	1350	44	478115	0	479588
22733	361	10	494158	78	0	494607
22734	24	438631	9	261	0	438925
22735	112	3179	92	434392	0	437775
22736	146	1424	61	459883	0	461514
22737	56	829	22	465055	0	465962
22738	502770	49	562	78	0	503459
22739	16	452602	8	188	0	452814
22740	69	1100	40	442972	0	444181
22741	440724	46	612	39	0	441421
22742	433634	68	866	99	0	434667
22743	57	906	46	476961	0	477970
22744	480	10	482430	44	0	482964
22745	113	1628	43	479751	0	481535
22746	47	480469	11	222	0	480749
22747	140	996	82	467467	0	468685
22748	478111	43	807	93	0	479054
22749	110	1481	40	480532	0	482163
22750	501	26	480806	63	0	481396
22751	34	480221	18	301	0	480574
22752	456381	48	1229	108	0	457766
22753	554	11	461177	60	0	461802
22754	475978	52	692	111	0	476833
22755	52	1229	31	478567	0	479879
22756	74	1415	22	474153	0	475664
22757	23	482533	12	157	0	482725
22758	484219	39	621	53	0	484932
22759	37	1032	43	491428	0	492540
22760	99	1433	41	491694	0	493267
22761	79	1204	25	493907	0	495215
22762	173	9	496000	75	0	496257
22763	79	765	51	502734	0	503629
22764	507246	35	585	36	0	507902
22765	506901	91	817	116	0	507925
22766	50	762	42	497908	0	498762
22767	43	411	19	499893	0	500366
22768	497045	30	598	51	0	497724
22769	420	9	498796	65	0	499290
22770	491409	45	1253	159	0	492866
22771	463	12	478420	37	0	478932
22772	301	6	484889	118	0	485314
22773	85	1105	61	423940	0	425191
22774	441	10	426650	60	0	427161
22775	428263	61	1107	200	0	429631
22776	97	1083	45	429030	0	430255
22777	280	8	429079	43	0	429410
22778	446246	59	1069	166	0	447540
22779	443382	60	1493	99	0	445034
22780	263	7	444914	44	0	445228
22781	203	1160	49	441961	0	443373
22782	28	424356	14	240	0	424638
22783	422101	62	1369	113	0	423645
22784	384	14	423091	38	0	423527
22785	420318	49	1084	255	0	421706
22786	41	420678	6	234	0	420959
22787	426296	28	792	62	0	427178
22788	419573	37	750	73	0	420433
22789	453869	55	829	59	0	454812
22790	90	811	25	458547	0	459473
22791	43	459946	15	515	0	460519
22792	495	15	458646	64	0	459220
22793	42	451494	4	215	0	451755
22794	138	1649	60	445018	0	446865
22795	154	449777	22	388	0	450341
22796	56	449143	11	292	0	449502
22797	448465	59	1025	100	0	449649
22798	293	17	448649	134	0	449093
22799	340	11	449738	209	0	450298
22800	857	26	450790	161	0	451834
22801	45	444318	11	368	0	444742
22802	436772	29	842	59	0	437702
22803	438959	56	908	74	0	439997
22804	439899	195	953	106	0	441153
22805	26	431504	4	608	0	432142
22806	101	897	83	430136	0	431217
22807	593	15	429206	33	0	429847
22808	605	16	430151	96	0	430868
22809	415023	44	1158	138	0	416363
22810	415235	34	1014	57	0	416340
22811	413128	49	2199	111	0	415487
22812	490	4	395532	16	0	396042
22813	392071	30	755	90	0	392946
22814	41	847	65	357786	0	358739
22815	68	1038	30	353695	0	354831
22816	324	8	356490	21	0	356843
22817	34	310104	6	262	0	310406
22818	43	626	41	309670	0	310380
22819	111	8	322574	24	0	322717
22820	344965	16	480	50	0	345511
22821	46	415	32	345784	0	346277
22822	8	155	23	346050	0	346236
22823	345978	8	266	44	0	346296
22824	39	167	5	342724	0	342935
22825	340574	11	262	26	0	340873
22826	349656	34	384	48	0	350122
22827	53	315	32	352801	0	353201
22828	178	227	18	336788	0	337211
22829	337983	18	209	38	0	338248
22830	43	199	15	336443	0	336700
22831	338178	6	351	22	0	338557
22832	338856	33	492	97	0	339478
22833	333143	21	386	58	0	333608
22834	46	467	26	331670	0	332209
22835	28	422	12	331944	0	332406
22836	336355	10	344	42	0	336751
22837	82	333354	3	167	0	333606
22838	17	330132	10	169	0	330328
22839	324447	39	635	163	0	325284
22840	267	9	310264	27	0	310567
22841	342812	29	873	77	0	343791
22842	48	625	28	348680	0	349381
22843	157	5	349783	11	0	349956
22844	378374	40	738	65	0	379217
22845	110	1015	43	397623	0	398791
22846	70	674	31	400441	0	401216
22847	124	944	38	421151	0	422257
22848	16	313	137	419001	0	419467
22849	418325	18	432	48	0	418823
22850	27	413235	3	274	0	413539
22851	404761	64	1172	83	0	406080
22852	450	10	407833	52	0	408345
22853	421	27	428056	106	0	428610
22854	59	426129	14	241	0	426443
22855	68	1183	59	423809	0	425119
22856	538	9	461118	42	0	461707
22857	65	465106	25	746	0	465942
22858	420	97	469086	20	0	469623
22859	106	1313	68	482972	0	484459
22860	49	760	32	487824	0	488665
22861	485146	21	731	70	0	485968
22862	99	827	33	485655	0	486614
22863	476649	42	814	101	0	477606
22864	522	13	477815	43	0	478393
22865	48	440469	7	283	0	440807
22866	107	1092	98	431437	0	432734
22867	73	1126	35	436273	0	437507
22868	294	14	433958	53	0	434319
22869	337	16	437796	98	0	438247
22870	438178	26	616	99	0	438919
22871	440297	30	1126	44	0	441497
22872	30	975	84	439142	0	440231
22873	113	1395	40	439416	0	440964
22874	35	444851	14	176	0	445076
22875	93	921	38	447545	0	448597
22876	446063	30	534	13	0	446640
22877	446451	58	983	123	0	447615
22878	21	444213	5	362	0	444601
22879	435932	48	927	65	0	436972
22880	437271	45	724	165	0	438205
22881	94	1230	37	441583	0	442944
22882	44	445644	6	279	0	445973
22883	84	1202	34	446206	0	447526
22884	74	965	68	446885	0	447992
22885	361	8	448224	70	0	448663
22886	467335	165	1065	101	0	468666
22887	51	1282	43	477071	0	478447
22888	100	1238	27	473090	0	474455
22889	43	472163	14	143	0	472363
22890	85	788	40	468954	0	469867
22891	474454	25	512	45	0	475036
22892	469616	85	1166	192	0	471059
22893	176	10	476798	39	0	477023
22894	576	3	481542	73	0	482194
22895	74	877	47	453460	0	454458
22896	64	846	56	446600	0	447566
22897	737	8	441848	60	0	442653
22898	327	12	446963	127	0	447429
22899	134	844	57	449374	0	450409
22900	527	5	443732	63	0	444327
22901	501	11	445229	55	0	445796
22902	59	479	14	444223	0	444775
22903	441928	23	605	49	0	442605
22904	443140	40	490	76	0	443746
22905	83	602	45	451100	0	451830
22906	32	430	32	452343	0	452837
22907	484322	21	326	65	0	484734
22908	70	324	19	483732	0	484145
22909	482104	18	364	30	0	482516
22910	485943	31	511	64	0	486549
22911	70	599	27	480165	0	480861
22912	36	472	18	498885	0	499411
22913	497284	18	509	44	0	497855
22914	104	508824	12	160	0	509100
22915	38	501774	12	170	0	501994
22916	138	1334	56	482069	0	483597
22917	387	17	530897	54	0	531355
22918	92	713	95	531193	0	532093
22919	536769	24	637	65	0	537495
22920	89	716	33	506506	0	507344
22921	483763	33	722	112	0	484630
22922	515	12	480177	61	0	480765
22923	475538	28	923	110	0	476599
22924	54	983	40	479325	0	480402
22925	43	616	29	466578	0	467266
22926	291	6	471127	26	0	471450
22927	73	1260	307	463396	0	465036
22928	105	1031	62	461919	0	463117
22929	41	962	28	509814	0	510845
22930	503194	59	1099	88	0	504440
22931	282	12	502496	48	0	502838
22932	285	8	488982	140	0	489415
22933	486217	39	1313	177	0	487746
22934	480451	47	1747	72	0	482317
22935	295	12	491231	44	0	491582
22936	81	1146	37	485382	0	486646
22937	67	483738	5	166	0	483976
22938	79	856	26	486310	0	487271
22939	495698	24	631	36	0	496389
22940	497628	57	969	71	0	498725
22941	117	1281	66	505567	0	507031
22942	25	509726	9	227	0	509987
22943	159	1538	61	500533	0	502291
22944	65	491436	12	227	0	491740
22945	491609	60	1151	84	0	492904
22946	491930	47	1296	122	0	493395
22947	496245	173	1443	75	0	497936
22948	71	509386	5	198	0	509660
22949	25	506556	5	245	0	506831
22950	114	2596	66	501569	0	504345
22951	59	1219	50	503344	0	504672
22952	70	1036	29	505360	0	506495
22953	93	750	38	509177	0	510058
22954	294	14	509781	57	0	510146
22955	504394	62	1856	149	0	506461
22956	152	8	503994	47	0	504201
22957	481409	73	1858	169	0	483509
22958	772	15	490234	43	0	491064
22959	489110	48	1853	198	0	491209
22960	384	6	494554	84	0	495028
22961	495753	53	1584	143	0	497533
22962	48	498	21	481327	0	481894
22963	477605	28	816	46	0	478495
22964	61	1240	41	477603	0	478945
22965	64	1032	36	489139	0	490271
22966	119	1390	47	492798	0	494354
22967	49	489419	15	337	0	489820
22968	486426	52	1291	66	0	487835
22969	485786	39	1032	47	0	486904
22970	20	482576	9	290	0	482895
22971	55	817	47	485107	0	486026
22972	311	7	487794	27	0	488139
22973	511424	26	1170	116	0	512736
22974	508997	36	775	59	0	509867
22975	511751	72	1564	64	0	513451
22976	68	1379	52	509287	0	510786
22977	41	511877	11	180	0	512109
22978	78	722	54	511449	0	512303
22979	511903	39	864	87	0	512893
22980	168	855	36	506340	0	507399
22981	32	497156	14	306	0	497508
22982	491872	87	1397	231	0	493587
22983	746	6	465289	43	0	466084
22984	437	14	476664	164	0	477279
22985	156	476382	21	414	0	476973
22986	85	471759	45	453	0	472342
22987	515	84	474778	203	0	475580
22988	302	13	467811	73	0	468199
22989	78	628	26	475743	0	476475
22990	454118	25	906	49	0	455098
22991	419	16	452707	33	0	453175
22992	78	422767	9	731	0	423585
22993	432725	46	1021	87	0	433879
22994	47	431891	6	483	0	432427
22995	429509	56	1293	109	0	430967
22996	114	461398	12	267	0	461791
22997	51	443720	3	201	0	443975
22998	108	1336	50	460422	0	461916
22999	47	1004	71	469135	0	470257
23000	443	8	472714	27	0	473192
23001	98	616	40	473786	0	474540
23002	454198	20	443	45	0	454706
23003	451211	59	1255	93	0	452618
23004	86	663	53	450006	0	450808
23005	268	11	401991	79	0	402349
23006	309	4	425199	63	0	425575
23007	87	933	40	403296	0	404356
23008	245	10	405630	41	0	405926
23009	56	947	21	402367	0	403391
23010	67	899	35	426853	0	427854
23011	416	12	410616	38	0	411082
23012	436239	36	1192	145	0	437612
23013	435493	34	1640	66	0	437233
23014	304	0	439767	24	0	440095
23015	197	2	443799	31	0	444029
23016	62	1069	167	455455	0	456753
23017	40	626	28	451343	0	452037
23018	77	901	39	451681	0	452698
23019	73	287	19	454841	0	455220
23020	485346	28	263	92	0	485729
23021	485078	28	673	63	0	485842
23022	54	644	33	489942	0	490673
23023	92	1020	46	505398	0	506556
23024	376	11	499555	40	0	499982
23025	161	1113	59	501990	0	503323
23026	47	529	19	498501	0	499096
23027	498441	55	874	76	0	499446
23028	23	501494	9	314	0	501840
23029	142	1951	64	494764	0	496921
23030	76	1395	72	501039	0	502582
23031	130	1125	38	500636	0	501929
23032	108	518646	12	204	0	518970
23033	37	513609	10	191	0	513847
23034	124	2614	69	506522	0	509329
23035	160	1242	68	517123	0	518593
23036	34	682	19	519997	0	520732
23037	518261	36	1161	97	0	519555
23038	29	518504	11	300	0	518844
23039	512097	37	1337	89	0	513560
23040	539612	123	1435	92	0	541262
23041	118	1045	47	526305	0	527515
23042	55	529040	15	449	0	529559
23043	546986	63	1364	123	0	548536
23044	104	747	46	549097	0	549994
23045	550634	49	1025	114	0	551822
23046	147	868	53	552250	0	553318
23047	320	9	545327	44	0	545700
23048	277	10	555359	135	0	555781
23049	91	1406	421	529971	0	531889
23050	83	1448	52	530695	0	532278
23051	98	1116	23	528508	0	529745
23052	150	520289	25	311	0	520775
23053	67	522527	16	590	0	523200
23054	528001	42	1451	86	0	529580
23055	530274	48	1398	118	0	531838
23056	119	540171	14	343	0	540647
23057	189	529666	18	382	0	530255
23058	98	538693	8	457	0	539256
23059	542532	65	1220	125	0	543942
23060	41	549161	15	530	0	549747
23061	78	639	54	549665	0	550436
23062	552773	48	973	43	0	553837
23063	552538	78	1219	90	0	553925
23064	108	723	50	544195	0	545076
23065	529	7	538302	55	0	538893
23066	507	15	545993	388	0	546903
23067	122	1032	55	524165	0	525374
23068	409	9	522669	132	0	523219
23069	169	910	43	519107	0	520229
23070	116	748	51	517000	0	517915
23071	265	11	519517	78	0	519871
23072	570	8	496496	243	0	497317
23073	137	898	49	507850	0	508934
23074	61	640	25	492260	0	492986
23075	483752	60	1066	76	0	484954
23076	127	480316	15	393	0	480851
23077	84	483737	19	439	0	484279
23078	486515	71	1198	177	0	487961
23079	509956	60	1140	107	0	511263
23080	107	513200	15	419	0	513741
23081	47	500372	9	442	0	500870
23082	516520	86	1250	188	0	518044
23083	57	954	20	525100	0	526131
23084	524407	48	902	76	0	525433
23085	30	523961	22	525	0	524538
23086	493669	99	1642	160	0	495570
23087	271	12	520691	55	0	521029
23088	489432	75	1494	199	0	491200
23089	317	6	507954	28	0	508305
23090	82	597	78	509994	0	510751
23091	479622	46	991	104	0	480763
23092	348	13	483570	38	0	483969
23093	116	807	42	481610	0	482575
23094	479420	46	1056	174	0	480696
23095	228	53	482287	91	0	482659
23096	49	482	28	454615	0	455174
23097	454270	25	692	78	0	455065
23098	29	445731	19	152	0	445931
23099	117	1286	41	430979	0	432423
23100	51	976	22	430294	0	431343
23101	68	1046	28	421865	0	423007
23102	34	430314	4	79	0	430431
23103	67	2167	36	427915	0	430185
23104	34	737	26	426503	0	427300
23105	44	948	33	426182	0	427207
23106	74	806	47	420683	0	421610
23107	254	11	419315	106	0	419686
23108	404093	36	1390	111	0	405630
23109	408738	45	1487	65	0	410335
23110	16	419828	9	321	0	420174
23111	85	1151	56	409771	0	411063
23112	130	881	37	415832	0	416880
23113	49	417657	6	234	0	417946
23114	153	607	23	419929	0	420712
23115	421580	29	944	86	0	422639
23116	21	392142	11	337	0	392511
23117	391240	41	1332	120	0	392733
23118	111	877	36	387730	0	388754
23119	471	17	365629	167	0	366284
23120	153	373604	27	421	0	374205
23121	372723	51	1395	99	0	374268
23122	85	373782	40	289	0	374196
23123	34	362165	8	345	0	362552
23124	361158	79	996	235	0	362468
23125	491	12	361394	35	0	361932
23126	127	365754	11	470	0	366362
23127	376063	27	748	74	0	376912
23128	384107	31	1127	79	0	385344
23129	23	377813	7	397	0	378240
23130	101	696	36	373309	0	374142
23131	195	6	378863	17	0	379081
23132	80	898	164	375696	0	376838
23133	52	873	30	376347	0	377302
23134	69	782	33	360862	0	361746
23135	223	3	357752	33	0	358011
23136	131	642	24	360107	0	360904
23137	222	14	356357	50	0	356643
23138	350	10	362879	157	0	363396
23139	358831	58	1263	114	0	360266
23140	116	370838	15	297	0	371266
23141	52	361306	5	208	0	361571
23142	103	567	30	372863	0	373563
23143	372953	7	321	16	0	373297
23144	397076	33	500	44	0	397653
23145	398971	40	669	37	0	399717
23146	431811	45	842	47	0	432745
23147	419450	52	1510	44	0	421056
23148	135	9	423132	31	0	423307
23149	103	1039	35	411744	0	412921
23150	64	413496	9	214	0	413783
23151	139	595	29	414814	0	415577
23152	415853	28	884	117	0	416882
23153	34	385527	8	240	0	385809
23154	76	563	31	389287	0	389957
23155	391174	15	374	33	0	391596
23156	407029	15	428	48	0	407520
23157	57	697	21	392604	0	393379
23158	104	690	45	374740	0	375579
23159	91	509	37	368768	0	369405
23160	267	11	366913	48	0	367239
23161	271	6	374588	56	0	374921
23162	65	734	53	375908	0	376760
23163	74	319	12	351303	0	351708
23164	348856	12	306	74	0	349248
23165	329918	34	683	34	0	330669
23166	328589	36	637	23	0	329285
23167	327640	53	1107	35	0	328835
23168	329422	407	1169	67	0	331065
23169	13	331534	4	163	0	331714
23170	323905	34	921	61	0	324921
23171	321233	32	1018	73	0	322356
23172	321670	44	886	36	0	322636
23173	54	554	34	319374	0	320016
23174	294	4	321557	19	0	321874
23175	122	768	43	309493	0	310426
23176	249	5	310654	18	0	310926
23177	156	788	28	312883	0	313855
23178	60	307177	18	171	0	307426
23179	308807	28	1013	38	0	309886
23180	311269	9	364	24	0	311666
23181	60	815	46	310052	0	310973
23182	70	854	48	309221	0	310193
23183	184	744	35	308148	0	309111
23184	38	314719	4	118	0	314879
23185	311820	30	707	19	0	312576
23186	305273	32	819	38	0	306162
23187	15	301501	4	167	0	301687
23188	48	831	54	297161	0	298094
23189	122	672	31	295070	0	295895
23190	184	301404	8	254	0	301850
23191	305431	43	992	136	0	306602
23192	306172	28	873	50	0	307123
23193	79	387	39	305941	0	306446
23194	174	5	309327	16	0	309522
23195	322	6	313901	45	0	314274
23196	38	749	109	310706	0	311602
23197	70	644	44	313154	0	313912
23198	90	445	25	310555	0	311115
23199	314574	20	557	50	0	315201
23200	313789	49	959	52	0	314849
23201	24	313379	5	265	0	313673
23202	304528	59	1116	186	0	305889
23203	229	11	297383	28	0	297651
23204	218	17	302578	72	0	302885
23205	130	302961	11	287	0	303389
23206	306303	34	1042	112	0	307491
23207	52	303477	7	293	0	303829
23208	298583	43	971	130	0	299727
23209	251	4	300448	37	0	300740
23210	294	3	346694	20	0	347011
23211	81	734	43	358278	0	359136
23212	390	4	356783	20	0	357197
23213	72	1106	38	360484	0	361700
23214	186	857	31	357840	0	358914
23215	30	353215	9	163	0	353417
23216	231	799	50	343524	0	344604
23217	50	426	21	347589	0	348086
23218	337876	29	448	55	0	338408
23219	32	336428	13	249	0	336722
23220	87	550	40	314423	0	315100
23221	355	5	311918	41	0	312319
23222	279498	32	972	116	0	280618
23223	105	0	287736	15	0	287856
23224	83	600	28	282559	0	283270
23225	33	277262	12	97	0	277404
23226	100	361	28	277177	0	277666
23227	287227	6	396	6	0	287635
23228	293020	36	887	65	0	294008
23229	26	297419	2	197	0	297644
23230	295084	49	886	44	0	296063
23231	295271	23	415	41	0	295750
23232	269084	39	1126	43	0	270292
23233	271008	36	717	32	0	271793
23234	271941	29	1163	30	0	273163
23235	285	0	273859	7	0	274151
23236	24	601	46	287943	0	288614
23237	41	782	27	285341	0	286191
23238	94	529	17	293811	0	294451
23239	31	293827	6	164	0	294028
23240	153	622	38	293375	0	294188
23241	207	8	293526	13	0	293754
23242	146	293588	24	291	0	294049
23243	26	293903	4	161	0	294094
23244	129	1105	26	298499	0	299759
23245	55	810	37	300055	0	300957
23246	103	750	23	302954	0	303830
23247	84	307008	8	456	0	307556
23248	59	306180	10	458	0	306707
23249	308641	47	938	66	0	309692
23250	308885	33	914	68	0	309900
23251	74	357558	7	291	0	357930
23252	358442	43	1003	49	0	359537
23253	360583	40	777	21	0	361421
23254	44	591	74	358109	0	358818
23255	100	532	86	358116	0	358834
23256	233	671	64	365286	0	366254
23257	385	9	365944	29	0	366367
23258	391	32	367800	58	0	368281
23259	31	377663	15	451	0	378160
23260	369429	52	1398	151	0	371030
23261	273	4	370332	30	0	370639
23262	383202	39	1660	160	0	385061
23263	507	12	388028	17	0	388564
23264	407971	71	1592	107	0	409741
23265	46	411717	6	274	0	412043
23266	415839	18	1115	35	0	417007
23267	57	938	23	423503	0	424521
23268	102	545	21	424487	0	425155
23269	438	3	423759	27	0	424227
23270	48	415277	20	525	0	415870
23271	108	943	69	413908	0	415028
23272	414	13	414235	28	0	414690
23273	412478	43	1513	221	0	414255
23274	128	409309	14	433	0	409884
23275	439849	72	1353	147	0	441421
23276	67	450150	6	963	0	451186
23277	53	804	29	448971	0	449857
23278	446300	46	788	71	0	447205
23279	33	450129	10	771	0	450943
23280	162	741	52	442988	0	443943
23281	483	16	442697	34	0	443230
23282	503446	74	1518	235	0	505273
23283	100	815	61	490511	0	491487
23284	296	6	490523	39	0	490864
23285	58	450353	24	531	0	450966
23286	114	1054	50	431820	0	433038
23287	266	10	432227	152	0	432655
23288	172	853	39	425041	0	426105
23289	229	425179	12	306	0	425726
23290	69	424880	15	501	0	425465
23291	288	8	425202	8	0	425506
23292	104	863	59	422923	0	423949
23293	241	228	420273	26	0	420768
23294	412380	79	1800	201	0	414460
23295	86	769	54	418010	0	418919
23296	212	410015	25	442	0	410694
23297	63	406303	16	355	0	406737
23298	405415	119	1150	154	0	406838
23299	25	402493	5	239	0	402762
23300	384415	112	1957	283	0	386767
23301	258	9	398802	29	0	399098
23302	395320	34	1409	103	0	396866
23303	45	386671	8	248	0	386972
23304	379656	61	1243	70	0	381030
23305	42	375348	6	247	0	375643
23306	92	916	56	370226	0	371290
23307	107	750	77	369734	0	370668
23308	210	7	371437	37	0	371691
23309	358924	54	2017	134	0	361129
23310	111	28	370731	23	0	370893
23311	366966	20	1376	40	0	368402
23312	43	900	30	346681	0	347654
23313	112	756	26	343469	0	344363
23314	53	336590	4	113	0	336760
23315	120	824	30	332999	0	333973
23316	84	798	55	331252	0	332189
23317	188	4	333430	27	0	333649
23318	333248	35	1216	63	0	334562
23319	41	333051	9	241	0	333342
23320	320583	39	1026	56	0	321704
23321	52	626	45	317585	0	318308
23322	25	484	130	317534	0	318173
23323	315087	26	642	38	0	315793
23324	52	313374	8	478	0	313912
23325	309354	77	1069	85	0	310585
23326	61	311519	8	337	0	311925
23327	35	258920	6	361	0	259322
23328	251122	49	775	50	0	251996
23329	39	515	25	249598	0	250177
23330	123	4	248534	127	0	248788
23331	23	690	32	247671	0	248416
23332	84	590	17	239381	0	240072
23333	25	239262	11	156	0	239454
23334	54	1100	25	230533	0	231712
23335	65	888	36	227949	0	228938
23336	90	497	22	227888	0	228497
23337	184	359	107	207394	0	208044
23338	260	9	206082	61	0	206412
23339	220	29	199582	12	0	199843
23340	48	274	18	186823	0	187163
23341	145	2	180202	34	0	180383
23342	225	2	168168	10	0	168405
23343	25	288	46	157388	0	157747
23344	18	2	157163	4	0	157187
23345	21	10	5	155926	0	155962
23346	69	154576	3	24	0	154672
23347	149705	1	33	13	0	149752
23348	10	3	148772	3	0	148788
23349	16	22	6	147010	0	147054
23350	23	3	143962	8	0	143996
23351	10	10	10	111811	0	111841
23352	4	14	5	93666	0	93689
23353	90833	2	25	11	0	90871
23354	9	9	1	90093	0	90112
23355	80365	4	17	3	0	80389
23356	79031	152	29	11	0	79223
23357	8	55857	1	4	0	55870
23358	3102	5	3	7	0	3117
23359	0	2792	0	0	0	2792
23360	0	1752	0	0	0	1752
23361	1742	0	0	0	0	1742
23362	2	0	1692	0	0	1694
23363	0	0	1675	0	0	1675
23364	1682	1	1	0	0	1684
23365	1677	1	7	0	0	1685
23366	0	1667	0	0	0	1667
23367	1674	0	1	0	0	1675
23368	1547	0	4	0	0	1551
23369	1548	0	3	0	0	1551
23370	0	0	0	1536	0	1536
23371	1511	0	0	0	0	1511
23372	0	1573	0	2	0	1575
23373	0	4	0	1578	0	1582
23374	0	2	0	1588	0	1590
23375	0	1586	0	1	0	1587
23376	0	1	0	1588	0	1589
23377	1610	1	2	0	0	1613
23378	1623	0	4	0	0	1627
23379	0	1570	0	2	0	1572
23380	0	1539	0	2	0	1541
23381	1497	1	0	0	0	1498
23382	0	0	1511	0	0	1511
23383	1	0	1527	0	0	1528
23384	0	0	0	1571	0	1571
23385	0	1	0	1561	0	1562
23386	2	1	1568	0	0	1571
23387	0	1542	0	2	0	1544
23388	0	1	0	1542	0	1543
23389	2	0	1591	0	0	1593
23390	0	9	0	1578	0	1587
23391	0	2	0	1594	0	1596
23392	0	1493	0	0	0	1493
23393	0	5	0	1485	0	1490
23394	1	2	1	1510	0	1514
23395	0	0	0	1482	0	1482
23396	1516	0	0	0	0	1516
23397	0	3	0	1495	0	1498
23398	0	1480	0	1	0	1481
23399	1449	0	2	0	0	1451
23400	0	0	1517	1	0	1518
23401	0	0	1543	0	0	1543
23402	1531	1	10	1	0	1543
23403	0	2	0	1548	0	1550
23404	1	0	1528	0	0	1529
23405	0	1	0	1538	0	1539
23406	0	2	0	1527	0	1529
23407	1509	0	5	0	0	1514
23408	1507	0	3	0	0	1510
23409	0	1473	0	0	0	1473
23410	0	7	0	1464	0	1471
23411	4	0	1535	0	0	1539
23412	0	1551	0	1	0	1552
23413	1546	0	3	1	0	1550
23414	0	1557	0	0	0	1557
23415	1545	0	3	0	0	1548
23416	0	2	1575	0	0	1577
23417	1559	0	3	0	0	1562
23418	1504	1	5	0	0	1510
23419	0	0	1499	0	0	1499
23420	0	8	1	1485	0	1494
23421	0	1502	0	1	0	1503
23422	1	1486	1	3	0	1491
23423	0	1213	0	0	0	1213
23424	0	1	0	1218	0	1219
23425	3	0	1245	0	0	1248
23426	0	5	0	1255	0	1260
23427	1	6	0	1241	0	1248
23428	0	0	1237	0	0	1237
23429	0	1268	0	1	0	1269
23430	0	1	0	1305	0	1306
23431	1332	0	1	0	0	1333
23432	0	5	0	1324	0	1329
23433	0	2	0	1297	0	1299
23434	2	1256	0	1	0	1259
23435	1258	0	9	0	0	1267
23436	0	0	1	1276	0	1277
23437	0	0	1258	0	0	1258
23438	0	1219	0	1	0	1220
23439	1197	0	5	0	0	1202
23440	1	0	1234	0	0	1235
23441	1463	0	2	0	0	1465
23442	0	1	2	1454	0	1457
23443	0	1437	0	0	0	1437
23444	1467	0	5	0	0	1472
23445	1530	0	1	0	0	1531
23446	0	1447	0	2	0	1449
23447	0	1	0	1441	0	1442
23448	0	1	0	1478	0	1479
23449	1506	0	0	1	0	1507
23450	0	1576	0	0	0	1576
23451	0	5	0	1554	0	1559
23452	1	1574	0	1	0	1576
23453	0	1559	0	2	0	1561
23454	0	7	0	1585	0	1592
23455	1591	0	5	1	0	1597
23456	0	1574	0	0	0	1574
23457	0	0	0	1587	0	1587
23458	0	10	0	1575	0	1585
23459	3	0	1537	1	0	1541
23460	3	0	1553	0	0	1556
23461	0	1576	0	1	0	1577
23462	0	0	1583	0	0	1583
23463	0	6	0	1588	0	1594
23464	6	1	1601	1	0	1609
23465	1	10	2	1559	0	1572
23466	1	2	0	1608	0	1611
23467	0	2	0	1740	0	1742
23468	1753	0	2	0	0	1755
23469	1	5	0	1809	0	1815
23470	0	3	0	1790	0	1793
23471	0	1803	0	1	0	1804
23472	1	3	0	1766	0	1770
23473	1772	0	3	0	0	1775
23474	0	1765	0	1	0	1766
23475	1731	0	6	0	0	1737
23476	1	0	1702	0	0	1703
23477	2	0	1764	0	0	1766
23478	0	11	0	1800	0	1811
23479	0	10	0	1809	0	1819
23480	0	1790	0	1	0	1791
23481	0	4	0	1857	0	1861
23482	1869	0	0	0	0	1869
23483	1865	0	1	0	0	1866
23484	0	1	0	1882	0	1883
23485	0	0	1868	0	0	1868
23486	0	1	3	1834	0	1838
23487	0	5	0	1754	0	1759
23488	0	9	1	1781	0	1791
23489	0	2	0	1815	0	1817
23490	0	3	0	1797	0	1800
23491	0	1773	0	1	0	1774
23492	1771	1	6	0	0	1778
23493	1783	0	7	0	0	1790
23494	1921	4	4	1	0	1930
23495	0	1932	0	0	0	1932
23496	1938	0	1	0	0	1939
23497	0	1956	0	2	0	1958
23498	0	0	1966	0	0	1966
23499	0	2	1	2019	0	2022
23500	1	0	1996	0	0	1997
23501	0	1969	0	19	0	1988
23502	1989	0	5	1	0	1995
23503	2	0	1992	1	0	1995
23504	1	0	1997	0	0	1998
23505	2	1977	0	0	0	1979
23506	0	5	0	1948	0	1953
23507	1	0	2132	1	0	2134
23508	0	3	0	2144	0	2147
23509	0	1	0	2155	0	2156
23510	0	1	0	2166	0	2167
23511	2195	0	1	0	0	2196
23512	2170	0	2	0	0	2172
23513	0	1	0	2200	0	2201
23514	2101	0	5	3	0	2109
23515	0	0	2104	0	0	2104
23516	3	0	1955	0	0	1958
23517	3	0	1960	0	0	1963
23518	3	0	1953	0	0	1956
23519	3	1900	3	0	0	1906
23520	3	3	0	1909	0	1915
23521	5	0	1931	0	0	1936
23522	1943	0	5	0	0	1948
23523	1939	0	12	1	0	1952
23524	0	1917	0	22	0	1939
23525	1932	0	2	0	0	1934
23526	0	6	0	1876	0	1882
23527	1	0	1887	0	0	1888
23528	2	3	0	1877	0	1882
23529	0	1849	0	0	0	1849
23530	1840	1	4	1	0	1846
23531	1852	0	0	0	0	1852
23532	0	1853	0	3	0	1856
23533	1825	0	0	1	0	1826
23534	1960	0	3	0	0	1963
23535	0	1957	0	0	0	1957
23536	1	8	0	1939	0	1948
23537	0	1967	0	3	0	1970
23538	1992	0	4	0	0	1996
23539	1	1	0	1968	0	1970
23540	1963	0	6	0	0	1969
23541	0	1	1	1961	0	1963
23542	0	0	1972	0	0	1972
23543	1820	0	4	2	0	1826
23544	1	0	1835	0	0	1836
23545	2	3	1	1850	0	1856
23546	5	0	1863	1	0	1869
23547	2	6	0	1871	0	1879
23548	1	0	1942	0	0	1943
23549	2027	0	3	0	0	2030
23550	0	2068	0	0	0	2068
23551	2058	0	3	0	0	2061
23552	0	1	0	2051	0	2052
23553	2025	0	6	0	0	2031
23554	0	2028	0	0	0	2028
23555	1	1982	2	3	0	1988
23556	0	2032	0	0	0	2032
23557	1969	0	3	0	0	1972
23558	0	1	0	1960	0	1961
23559	0	5	0	1972	0	1977
23560	3	0	1972	0	0	1975
23561	2	0	2055	3	0	2060
23562	2	9	0	2029	0	2040
23563	1	0	1980	0	0	1981
23564	0	1994	0	3	0	1997
23565	1965	0	8	1	0	1974
23566	1	0	2073	0	0	2074
23567	5	0	2144	0	0	2149
23568	1	1	0	2183	0	2185
23569	2188	0	2	0	0	2190
23570	0	3	0	2017	0	2020
23571	2025	0	1	0	0	2026
23572	0	2	0	2019	0	2021
23573	1	0	1921	3	0	1925
23574	0	2143	0	4	0	2147
23575	4	0	2105	0	0	2109
23576	0	2134	0	4	0	2138
23577	0	6	0	2135	0	2141
23578	2191	0	1	0	0	2192
23579	2	0	2190	0	0	2192
23580	1	2	1	2259	0	2263
23581	0	8	0	2264	0	2272
23582	2286	0	1	0	0	2287
23583	0	3	1	2173	0	2177
23584	1	2175	0	0	0	2176
23585	2158	0	1	4	0	2163
23586	0	0	2186	0	0	2186
23587	2167	0	4	0	0	2171
23588	0	2167	0	2	0	2169
23589	1	11	0	2113	0	2125
23590	0	2132	0	3	0	2135
23591	2121	0	2	0	0	2123
23592	1	0	2107	0	0	2108
23593	2127	0	2	0	0	2129
23594	0	2142	0	1	0	2143
23595	1	2	0	2130	0	2133
23596	2118	0	1	0	0	2119
23597	2103	2	4	2	0	2111
23598	0	3	0	2107	0	2110
23599	0	3	2	2085	0	2090
23600	0	2074	0	1	0	2075
23601	0	7	0	2002	0	2009
23602	0	2039	0	1	0	2040
23603	0	2038	0	0	0	2038
23604	0	5	0	2006	0	2011
23605	0	2033	0	2	0	2035
23606	2	0	2027	0	0	2029
23607	4	0	2013	1	0	2018
23608	0	2019	0	4	0	2023
23609	4	0	1994	0	0	1998
23610	1	0	1912	4	0	1917
23611	4	1	1917	0	0	1922
23612	1	1909	0	0	0	1910
23613	1931	0	7	2	0	1940
23614	0	1921	0	6	0	1927
23615	2	0	1950	1	0	1953
23616	0	1	2	2087	0	2090
23617	2097	0	1	0	0	2098
23618	3	0	2096	0	0	2099
23619	0	4	0	2120	0	2124
23620	0	0	2108	0	0	2108
23621	1	4	0	2117	0	2122
23622	2063	0	3	0	0	2066
23623	2	0	2038	0	0	2040
23624	0	2020	0	3	0	2023
23625	0	0	0	2017	0	2017
23626	1980	0	3	1	0	1984
23627	0	0	1952	0	0	1952
23628	0	9	0	1961	0	1970
23629	0	1911	0	1	0	1912
23630	1892	0	4	0	0	1896
23631	1951	1	3	0	0	1955
23632	0	6	0	1908	0	1914
23633	0	1923	0	3	0	1926
23634	2	1928	0	2	0	1932
23635	1957	0	3	0	0	1960
23636	1	6	0	1944	0	1951
23637	0	1911	0	4	0	1915
23638	1910	0	2	0	0	1912
23639	0	5	0	1947	0	1952
23640	0	2	1	1983	0	1986
23641	1	0	2010	5	0	2016
23642	1	1920	0	4	0	1925
23643	1	1920	0	2	0	1923
23644	0	5	0	1927	0	1932
23645	1998	0	5	0	0	2003
23646	0	2011	0	1	0	2012
23647	2008	0	5	0	0	2013
23648	0	2054	0	1	0	2055
23649	0	2	0	1853	0	1855
23650	1908	0	5	0	0	1913
23651	0	6	0	1903	0	1909
23652	4	0	1891	0	0	1895
23653	0	7	0	1894	0	1901
23654	0	1783	0	0	0	1783
23655	1773	0	5	0	0	1778
23656	0	1746	0	0	0	1746
23657	0	2	0	1721	0	1723
23658	0	3	0	1730	0	1733
23659	4	0	1647	0	0	1651
23660	3	0	1672	0	0	1675
23661	0	2	0	1679	0	1681
23662	2	0	1641	0	0	1643
23663	0	1654	0	3	0	1657
23664	1649	0	6	0	0	1655
23665	0	0	1655	0	0	1655
23666	1667	0	2	0	0	1669
23667	1682	0	4	0	0	1686
23668	1650	0	3	0	0	1653
23669	1660	0	3	0	0	1663
23670	0	1	0	1645	0	1646
23671	3	7	0	1683	0	1693
23672	0	1668	0	2	0	1670
23673	1663	0	4	1	0	1668
23674	3	0	1672	0	0	1675
23675	0	1	0	1699	0	1700
23676	0	3	0	1689	0	1692
23677	0	0	1701	0	0	1701
23678	0	1687	0	0	0	1687
23679	0	2	0	1712	0	1714
23680	2	3	0	1713	0	1718
23681	1878	0	1	1	0	1880
23682	0	1948	0	1	0	1949
23683	1	7	1	1910	0	1919
23684	0	1998	0	2	0	2000
23685	0	2	0	1956	0	1958
23686	1954	0	0	0	0	1954
23687	1980	0	1	1	0	1982
23688	0	3	1	1993	0	1997
23689	1973	1	6	0	0	1980
23690	1983	0	6	0	0	1989
23691	0	1929	0	0	0	1929
23692	0	10	0	1859	0	1869
23693	0	1876	0	4	0	1880
23694	0	4	0	1824	0	1828
23695	1893	0	1	0	0	1894
23696	0	4	0	1885	0	1889
23697	0	5	0	1946	0	1951
23698	2	1	1966	1	0	1970
23699	2	1961	0	3	0	1966
23700	0	1908	1	2	0	1911
23701	1890	1	5	0	0	1896
23702	2	2	0	1954	0	1958
23703	1959	0	2	0	0	1961
23704	1	2029	0	1	0	2031
23705	0	1997	0	0	0	1997
23706	0	1987	0	0	0	1987
23707	2015	1	6	1	0	2023
23708	0	2016	0	2	0	2018
23709	2027	0	2	0	0	2029
23710	2033	0	4	0	0	2037
23711	2016	0	0	1	0	2017
23712	1	0	0	2106	0	2107
23713	0	3	0	2061	0	2064
23714	0	0	0	2129	0	2129
23715	0	0	0	2102	0	2102
23716	2031	0	1	0	0	2032
23717	0	2058	0	1	0	2059
23718	0	2	0	2049	0	2051
23719	2066	0	1	1	0	2068
23720	1	2	1	2029	0	2033
23721	0	3	1	1976	0	1980
23722	1966	0	4	0	0	1970
23723	0	0	1994	0	0	1994
23724	0	3	0	1957	0	1960
23725	1	0	1955	0	0	1956
23726	0	1	0	1848	0	1849
23727	0	4	0	1851	0	1855
23728	1876	0	3	0	0	1879
23729	2	1859	2	3	0	1866
23730	0	1853	0	1	0	1854
23731	1851	0	2	1	0	1854
23732	0	1858	0	1	0	1859
23733	1818	0	4	0	0	1822
23734	1	0	1815	1	0	1817
23735	1844	1	6	0	0	1851
23736	1848	0	6	0	0	1854
23737	1855	1	3	1	0	1860
23738	0	1	0	1874	0	1875
23739	0	3	0	1870	0	1873
23740	0	1878	0	2	0	1880
23741	1	5	0	1880	0	1886
23742	1894	0	3	1	0	1898
23743	1	1877	0	4	0	1882
23744	1	1882	0	0	0	1883
23745	1817	2	4	1	0	1824
23746	1	1	1844	0	0	1846
23747	0	5	0	1809	0	1814
23748	0	0	1983	0	0	1983
23749	1	5	0	1977	0	1983
23750	0	1962	0	0	0	1962
23751	0	2	0	1958	0	1960
23752	1969	0	3	0	0	1972
23753	1	5	0	1960	0	1966
23754	4	0	1976	0	0	1980
23755	1973	1	4	0	0	1978
23756	1	1949	0	2	0	1952
23757	0	1742	0	4	0	1746
23758	1749	1	3	1	0	1754
23759	1744	1	8	0	0	1753
23760	1	0	1702	0	0	1703
23761	1707	0	11	1	0	1719
23762	0	1723	0	1	0	1724
23763	1697	1	2	0	0	1700
23764	1	5	1	1771	0	1778
23765	0	1772	0	2	0	1774
23766	1765	0	5	1	0	1771
23767	1	0	1705	0	0	1706
23768	0	1	0	1745	0	1746
23769	1756	0	2	3	0	1761
23770	3	0	1753	0	0	1756
23771	1745	0	5	0	0	1750
23772	0	2	0	1749	0	1751
23773	0	2	0	1658	0	1660
23774	2	0	1683	0	0	1685
23775	0	4	0	1684	0	1688
23776	1679	0	1	0	0	1680
23777	0	1679	0	0	0	1679
23778	1724	0	7	1	0	1732
23779	1839	0	2	1	0	1842
23780	0	3	0	1766	0	1769
23781	1	0	1832	0	0	1833
23782	0	2	0	1833	0	1835
23783	1777	0	1	0	0	1778
23784	0	1804	0	1	0	1805
23785	1794	0	2	0	0	1796
23786	0	0	0	1786	0	1786
23787	0	3	0	1764	0	1767
23788	0	3	0	1655	0	1658
23789	0	0	1670	0	0	1670
23790	0	7	0	1638	0	1645
23791	2	0	1619	0	0	1621
23792	4	0	1629	0	0	1633
23793	1	4	0	1530	0	1535
23794	2	0	1529	0	0	1531
23795	1557	1	7	0	0	1565
23796	0	6	0	1569	0	1575
23797	0	4	0	1575	0	1579
23798	0	1561	0	0	0	1561
23799	1563	0	0	0	0	1563
23800	1596	0	2	0	0	1598
23801	0	1593	0	3	0	1596
23802	1	0	0	1580	0	1581
23803	1	0	1594	0	0	1595
23804	1550	0	5	1	0	1556
23805	1554	0	5	0	0	1559
23806	0	2	0	1631	0	1633
23807	1	0	1601	0	0	1602
23808	1	1593	0	1	0	1595
23809	1584	0	9	0	0	1593
23810	2	0	1579	0	0	1581
23811	0	1580	0	0	0	1580
23812	1567	0	8	0	0	1575
23813	1573	1	2	0	0	1576
23814	0	4	0	1538	0	1542
23815	0	1562	0	0	0	1562
23816	0	6	0	1560	0	1566
23817	1	3	0	1593	0	1597
23818	0	2	0	1593	0	1595
23819	0	1	0	1595	0	1596
23820	1	0	1594	0	0	1595
23821	0	5	0	1609	0	1614
23822	0	8	0	1569	0	1577
23823	2	0	1562	0	0	1564
23824	0	1424	0	2	0	1426
23825	1445	0	0	0	0	1445
23826	1460	0	2	0	0	1462
23827	1	0	0	1464	0	1465
23828	1466	0	1	0	0	1467
23829	1	2	0	1465	0	1468
23830	1	0	1437	0	0	1438
23831	1	1	1418	1	0	1421
23832	0	1434	0	0	0	1434
23833	1406	0	5	0	0	1411
23834	1	0	1430	0	0	1431
23835	0	0	0	1438	0	1438
23836	0	3	0	1443	0	1446
23837	0	1	0	1489	0	1490
23838	1	0	1	1456	0	1458
23839	0	0	0	1471	0	1471
23840	4	0	1372	0	0	1376
23841	0	1	0	1374	0	1375
23842	1374	0	3	0	0	1377
23843	1	1344	0	5	0	1350
23844	1313	0	5	0	0	1318
23845	1	1388	1	0	0	1390
23846	1418	0	1	0	0	1419
23847	1444	0	0	0	0	1444
23848	0	2	0	1448	0	1450
23849	0	0	0	1455	0	1455
23850	1397	1	1	0	0	1399
23851	1399	0	6	0	0	1405
23852	1391	0	3	0	0	1394
23853	0	1405	0	3	0	1408
23854	0	1117	0	1	0	1118
23855	0	0	1127	0	0	1127
23856	0	2	0	1134	0	1136
23857	3	0	1088	1	0	1092
23858	0	1077	0	1	0	1078
23859	0	2	0	1065	0	1067
23860	0	2	1	1083	0	1086
23861	0	0	0	1086	0	1086
23862	1074	0	1	0	0	1075
23863	1093	0	2	0	0	1095
23864	0	1104	0	0	0	1104
23865	0	1	0	1080	0	1081
23866	0	1	1080	0	0	1081
23867	0	0	1102	0	0	1102
23868	1122	0	1	0	0	1123
23869	1114	0	4	0	0	1118
23870	0	0	0	1119	0	1119
23871	1062	1	2	0	0	1065
23872	2	0	1074	0	0	1076
23873	0	1118	0	1	0	1119
23874	0	5	0	1121	0	1126
23875	3	0	1122	0	0	1125
23876	1	1	0	1113	0	1115
23877	0	2	0	1114	0	1116
23878	1	0	1123	0	0	1124
23879	1111	0	5	0	0	1116
23880	1116	0	4	0	0	1120
23881	1	1115	0	1	0	1117
23882	1052	0	4	0	0	1056
23883	1064	0	4	0	0	1068
23884	1	0	1076	0	0	1077
23885	1078	0	5	0	0	1083
23886	0	1091	0	0	0	1091
23887	1076	2	6	2	0	1086
23888	1083	1	4	0	0	1088
23889	1095	0	1	0	0	1096
23890	1098	0	3	0	0	1101
23891	1079	0	2	0	0	1081
23892	0	1068	0	1	0	1069
23893	1034	0	4	0	0	1038
23894	1	1047	0	1	0	1049
23895	2	1026	0	0	0	1028
23896	0	1046	0	1	0	1047
23897	1041	0	0	0	0	1041
23898	1039	0	3	2	0	1044
23899	0	0	1051	0	0	1051
23900	1015	0	5	0	0	1020
23901	1005	0	1	0	0	1006
23902	0	0	1034	1	0	1035
23903	0	2	1	1028	0	1031
23904	0	2	1	1012	0	1015
23905	0	1	0	1010	0	1011
23906	0	1	0	1128	0	1129
23907	0	1	0	1132	0	1133
23908	0	0	1132	0	0	1132
23909	0	1119	0	1	0	1120
23910	1152	0	3	2	0	1157
23911	0	1154	0	1	0	1155
23912	1117	0	3	0	0	1120
23913	1145	0	7	0	0	1152
23914	0	0	1153	0	0	1153
23915	1	2	0	1150	0	1153
23916	0	1152	0	1	0	1153
23917	1147	1	7	0	0	1155
23918	1140	0	4	0	0	1144
23919	1153	0	2	0	0	1155
23920	0	1060	0	0	0	1060
23921	1065	0	2	0	0	1067
23922	1022	0	4	0	0	1026
23923	969	0	3	0	0	972
23924	0	0	0	966	0	966
23925	0	2	0	986	0	988
23926	0	1	0	988	0	989
23927	997	0	0	0	0	997
23928	1	1007	0	1	0	1009
23929	1002	0	1	0	0	1003
23930	1025	0	4	0	0	1029
23931	1020	0	2	0	0	1022
23932	1014	1	4	0	0	1019
23933	0	997	0	0	0	997
23934	983	0	1	1	0	985
23935	0	1000	0	0	0	1000
23936	0	992	0	2	0	994
23937	996	1	4	1	0	1002
23938	0	999	0	0	0	999
23939	0	1047	0	0	0	1047
23940	1040	1	4	1	0	1046
23941	1106	0	0	1	0	1107
23942	0	0	0	1098	0	1098
23943	0	1	0	1087	0	1088
23944	1081	0	0	0	0	1081
23945	1066	0	1	0	0	1067
23946	1065	0	1	0	0	1066
23947	0	0	1085	0	0	1085
23948	1041	0	2	0	0	1043
23949	0	1	0	1005	0	1006
23950	0	1	0	1004	0	1005
23951	0	1	0	1015	0	1016
23952	0	1	1	1023	0	1025
23953	0	0	1034	0	0	1034
23954	0	0	1036	0	0	1036
23955	0	2	0	1041	0	1043
23956	3	0	1191	0	0	1194
23957	0	0	1424	0	0	1424
23958	0	6	5	1462	0	1473
23959	0	1	0	1453	0	1454
23960	0	1	1	1427	0	1429
23961	1	1	0	1434	0	1436
23962	1435	0	0	0	0	1435
23963	1454	0	0	0	0	1454
23964	0	0	0	1443	0	1443
23965	0	1	0	1441	0	1442
23966	0	2	0	1444	0	1446
23967	0	1	1	1454	0	1456
23968	0	1	0	1522	0	1523
23969	0	1509	0	0	0	1509
23970	1516	1	2	0	0	1519
23971	0	1538	0	0	0	1538
23972	1542	0	3	0	0	1545
23973	3515	1	12	1	0	3529
23974	3814	0	11	0	0	3825
23975	1	6	0	3953	0	3960
23976	3987	0	4	0	0	3991
23977	0	4	1	4293	0	4298
23978	0	5	0	4693	0	4698
23979	4788	0	4	0	0	4792
23980	0	4776	0	7	0	4783
23981	0	4757	0	3	0	4760
23982	4672	2	7	5	0	4686
23983	4	0	4748	0	0	4752
23984	4770	1	15	0	0	4786
23985	1	14	0	4752	0	4767
23986	0	4738	0	9	0	4747
23987	0	5716	0	1	0	5717
23988	5795	1	5	0	0	5801
23989	2	19	0	5736	0	5757
23990	0	5741	0	2	0	5743
23991	5729	2	10	3	0	5744
23992	5864	0	20	0	0	5884
23993	5890	0	15	1	0	5906
23994	5955	4	9	1	0	5969
23995	2	6158	0	2	0	6162
23996	0	6076	1	6	0	6083
23997	6175	0	7	1	0	6183
23998	6367	0	8	2	0	6377
23999	6	4	6400	0	0	6410
24000	0	6522	0	19	0	6541
24001	6538	0	8	1	0	6547
24002	6549	0	9	5	0	6563
24003	3	0	6511	3	0	6517
24004	6582	0	17	2	0	6601
24005	3	0	6738	2	0	6743
24006	2	1	6936	6	0	6945
24007	1	23	3	6962	0	6989
24008	0	7193	0	3	0	7196
24009	7202	0	10	0	0	7212
24010	1	12	2	7256	0	7271
24011	0	26	1	7259	0	7286
24012	1	11	0	7319	0	7331
24013	7534	0	5	1	0	7540
24014	0	20	0	7545	0	7565
24015	0	18	0	7469	0	7487
24016	18	1	7529	1	0	7549
24017	7442	0	17	4	0	7463
24018	7488	2	22	1	0	7513
24019	3	0	7600	0	0	7603
24020	7643	0	18	4	0	7665
24021	3	23	1	7670	0	7697
24022	0	7809	0	3	0	7812
24023	3	16	6	7826	0	7851
24024	8024	0	7	2	0	8033
24025	0	8165	0	0	0	8165
24026	0	62	0	8085	0	8147
24027	1	15	3	8166	0	8185
24028	2	32	0	8309	0	8343
24029	5	17	0	8344	0	8366
24030	1	8441	0	6	0	8448
24031	8509	0	16	1	0	8526
24032	8395	1	11	1	0	8408
24033	0	8172	0	16	0	8188
24034	8147	3	17	1	0	8168
24035	8331	2	9	1	0	8343
24036	8308	1	16	4	0	8329
24037	15	0	8340	0	0	8355
24038	3	22	1	8612	0	8638
24039	9	0	8564	0	0	8573
24040	8579	1	32	2	0	8614
24041	1	8836	0	3	0	8840
24042	8803	0	39	1	0	8843
24043	0	8924	1	0	0	8925
24044	1	28	0	8962	0	8991
24045	4	15	1	9169	0	9189
24046	4	0	9071	7	0	9082
24047	0	9182	0	5	0	9187
24048	9161	3	19	1	0	9184
24049	4	1	7371	0	0	7376
24050	7172	2	24	0	0	7198
24051	3	14	3	7198	0	7218
24052	9	0	7106	0	0	7115
24053	1	6396	1	13	0	6411
24054	2	17	0	6396	0	6415
24055	9	0	6505	1	0	6515
24056	6	0	6421	9	0	6436
24057	1	6445	1	1	0	6448
24058	1	16	0	6423	0	6440
24059	1	22	2	6673	0	6698
24060	1	6758	0	5	0	6764
24061	6785	0	5	0	0	6790
24062	1	17	0	6818	0	6836
24063	0	5852	1	0	0	5853
24064	6098	0	11	0	0	6109
24065	6201	0	7	0	0	6208
24066	6599	3	14	0	0	6616
24067	0	7107	0	4	0	7111
24068	7068	0	13	1	0	7082
24069	7683	2	21	1	0	7707
24070	0	9	1	7690	0	7700
24071	7572	2	15	2	0	7591
24072	0	7	0	7637	0	7644
24073	6	0	7641	5	0	7652
24074	9	0	7740	3	0	7752
24075	2	22	3	7595	0	7622
24076	4	0	7545	3	0	7552
24077	7515	0	17	6	0	7538
24078	0	17	0	7500	0	7517
24079	1	9	0	7462	0	7472
24080	13	0	7745	1	0	7759
24081	0	7471	1	9	0	7481
24082	0	7374	0	2	0	7376
24083	0	16	0	7380	0	7396
24084	1	18	2	7459	0	7480
24085	19	0	7624	3	0	7646
24086	9	0	7924	3	0	7936
24087	4	10	3	7976	0	7993
24088	7	0	7949	6	0	7962
24089	7776	3	19	1	0	7799
24090	1	10	0	7850	0	7861
24091	8054	0	12	0	0	8066
24092	0	8	1	7992	0	8001
24093	0	11	0	8120	0	8131
24094	10	0	8016	4	0	8030
24095	0	8257	0	3	0	8260
24096	3	20	2	8247	0	8272
24097	3	0	8580	3	0	8586
24098	0	8572	0	8	0	8580
24099	2	15	0	8528	0	8545
24100	8565	0	5	4	0	8574
24101	5	0	8423	2	0	8430
24102	8403	0	14	2	0	8419
24103	13	0	8536	1	0	8550
24104	8381	1	21	2	0	8405
24105	0	9030	1	1	0	9032
24106	2	8923	0	4	0	8929
24107	3	33	1	8937	0	8974
24108	0	9257	0	3	0	9260
24109	9219	1	9	3	0	9232
24110	0	10	2	9538	0	9550
24111	1	26	0	9356	0	9383
24112	1	14	0	9232	0	9247
24113	2	0	9229	3	0	9234
24114	1	17	1	9232	0	9251
24115	9	1	9127	2	0	9139
24116	0	9515	1	4	0	9520
24117	9619	1	21	3	0	9644
24118	1	9518	1	15	0	9535
24119	9543	0	15	5	0	9563
24120	9455	0	25	6	0	9486
24121	9243	0	8	1	0	9252
24122	9311	0	16	2	0	9329
24123	2	0	9503	0	0	9505
24124	1	20	3	9637	0	9661
24125	4	10	0	9801	0	9815
24126	2	5	0	9731	0	9738
24127	9621	2	8	0	0	9631
24128	9657	2	13	10	0	9682
24129	0	9692	0	11	0	9703
24130	5	1	9653	1	0	9660
24131	14	0	9854	6	0	9874
24132	0	9979	1	7	0	9987
24133	0	9880	0	3	0	9883
24134	3	26	2	9878	0	9909
24135	1	23	0	9952	0	9976
24136	9915	0	15	3	0	9933
24137	0	9832	1	4	0	9837
24138	2	15	3	9797	0	9817
24139	123	0	9849	0	0	9972
24140	1	36	3	9753	0	9793
24141	0	16	3	9873	0	9892
24142	1	22	0	9682	0	9705
24143	1	24	2	9119	0	9146
24144	20	0	8820	14	0	8854
24145	0	8387	0	17	0	8404
24146	0	8395	0	4	0	8399
24147	8480	1	4	5	0	8490
24148	0	8514	0	3	0	8517
24149	0	8280	0	10	0	8290
24150	3	26	3	8236	0	8268
24151	2	37	0	8277	0	8316
24152	2	16	1	8405	0	8424
24153	6	2	8335	4	0	8347
24154	0	8119	0	6	0	8125
24155	8	23	1	8091	0	8123
24156	0	8157	0	6	0	8163
24157	8107	0	22	1	0	8130
24158	1	8431	0	6	0	8438
24159	8353	2	21	2	0	8378
24160	3	0	8631	3	0	8637
24161	8493	0	15	2	0	8510
24162	0	22	0	8355	0	8377
24163	6	0	8339	1	0	8346
24164	8332	1	19	6	0	8358
24165	8312	0	21	1	0	8334
24166	8418	2	20	2	0	8442
24167	2	10	0	8321	0	8333
24168	5	0	8319	1	0	8325
24169	8176	1	20	2	0	8199
24170	3	21	0	8165	0	8189
24171	4	17	2	8490	0	8513
24172	14	2	8947	3	0	8966
24173	1	8761	0	8	0	8770
24174	0	41	3	8623	0	8667
24175	5	9124	0	2	0	9131
24176	9270	1	13	6	0	9290
24177	10157	0	28	2	0	10187
24178	1	12	0	10182	0	10195
24179	10055	0	7	2	0	10064
24180	0	9929	0	5	0	9934
24181	9474	0	17	3	0	9494
24182	0	10474	0	3	0	10477
24183	2	38	1	10374	0	10415
24184	3	20	1	10649	0	10673
24185	3	10678	0	3	0	10684
24186	2	37	0	10393	0	10432
24187	12	0	10382	5	0	10399
24188	3	10405	0	4	0	10412
24189	10419	0	14	0	0	10433
24190	2	10707	0	7	0	10716
24191	4	31	1	10124	0	10160
24192	12	0	10822	1	0	10835
24193	0	14	2	10854	0	10870
24194	0	12	0	10973	0	10985
24195	10970	0	15	3	0	10988
24196	11	0	10984	3	0	10998
24197	0	10909	0	10	0	10919
24198	38	0	10868	1	0	10907
24199	9	1	10705	7	0	10722
24200	9	0	10887	9	0	10905
24201	2	14	1	11828	0	11845
24202	11888	1	17	0	0	11906
24203	0	11925	0	11	0	11936
24204	11935	5	17	3	0	11960
24205	11930	0	26	2	0	11958
24206	5	38	0	11829	0	11872
24207	2	11632	0	9	0	11643
24208	11682	2	14	0	0	11698
24209	1	12655	0	5	0	12661
24210	3	48	5	12549	0	12605
24211	6	33	2	12579	0	12620
24212	0	12424	1	5	0	12430
24213	7	35	1	12375	0	12418
24214	17	3	12456	1	0	12477
24215	11	0	12481	8	0	12500
24216	1	19	1	12509	0	12530
24217	2	20	1	13181	0	13204
24218	17	1	12971	1	0	12990
24219	7	0	13057	6	0	13070
24220	13158	1	21	4	0	13184
24221	2	13278	1	1	0	13282
24222	3	13057	1	15	0	13076
24223	2	56	2	13598	0	13658
24224	2	17	1	13625	0	13645
24225	2	31	5	13710	0	13748
24226	9	0	13575	12	0	13596
24227	12	4	13843	2	0	13861
24228	1	40	14	14004	0	14059
24229	18	1	13767	13	0	13799
24230	0	13894	3	14	0	13911
24231	13812	1	31	0	0	13844
24232	15	0	13878	1	0	13894
24233	10	0	14111	2	0	14123
24234	1	32	2	14067	0	14102
24235	18	0	13972	1	0	13991
24236	2	13705	0	25	0	13732
24237	1	41	2	13863	0	13907
24238	20	1	14635	1	0	14657
24239	3	14709	0	18	0	14730
24240	15012	2	31	4	0	15049
24241	1	47	1	15153	0	15202
24242	0	13	1	15114	0	15128
24243	15433	0	16	4	0	15453
24244	2	15509	0	10	0	15521
24245	15369	0	30	5	0	15404
24246	15294	2	26	6	0	15328
24247	14580	2	23	1	0	14606
24248	2	19	1	14269	0	14291
24249	14289	1	20	0	0	14310
24250	2	14262	1	5	0	14270
24251	0	14033	0	2	0	14035
24252	13886	3	12	2	0	13903
24253	1	24	2	13064	0	13091
24254	1	20	0	13222	0	13243
24255	5	34	5	13235	0	13279
24256	9	1	13189	1	0	13200
24257	2	12343	1	11	0	12357
24258	3	18	0	12075	0	12096
24259	12146	0	20	4	0	12170
24260	0	29	4	11882	0	11915
24261	11	0	12061	1	0	12073
24262	1	12103	0	6	0	12110
24263	12032	0	22	6	0	12060
24264	11885	1	29	2	0	11917
24265	11842	0	27	0	0	11869
24266	0	25	0	11575	0	11600
24267	6	1	11848	1	0	11856
24268	10	0	11908	9	0	11927
24269	1	11889	0	14	0	11904
24270	2	30	0	12193	0	12225
24271	1	12	1	12248	0	12262
24272	12816	1	12	0	0	12829
24273	1	14	1	12814	0	12830
24274	12746	3	17	3	0	12769
24275	7	0	13130	0	0	13137
24276	9	0	13367	0	0	13376
24277	5	25	6	12362	0	12398
24278	1	13	0	12299	0	12313
24279	2	10	1	12331	0	12344
24280	12262	1	17	2	0	12282
24281	12285	1	12	5	0	12303
24282	0	16	2	12414	0	12432
24283	6	0	12368	2	0	12376
24284	8	2	13345	1	0	13356
24285	1	34	0	12315	0	12350
24286	12313	0	9	2	0	12324
24287	1	29	0	12275	0	12305
24288	4	29	2	12281	0	12316
24289	17	0	12229	3	0	12249
24290	14	0	12783	3	0	12800
24291	12657	0	22	6	0	12685
24292	5	0	12892	2	0	12899
24293	6	38	2	12049	0	12095
24294	1	20	0	12256	0	12277
24295	12612	0	16	0	0	12628
24296	0	12588	0	8	0	12596
24297	12553	3	35	5	0	12596
24298	0	12646	0	9	0	12655
24299	12037	3	22	2	0	12064
24300	6	1	12426	5	0	12438
24301	12394	1	20	2	0	12417
24302	12461	2	28	2	0	12493
24303	1	36	1	12365	0	12403
24304	7	0	12491	7	0	12505
24305	3	42	0	12571	0	12616
24306	3	43	0	12773	0	12819
24307	2	12874	0	4	0	12880
24308	7	45	1	12879	0	12932
24309	0	13082	0	11	0	13093
24310	3	31	0	12932	0	12966
24311	12946	1	23	4	0	12974
24312	5	37	1	12869	0	12912
24313	15	0	12654	2	0	12671
24314	11706	2	25	2	0	11735
24315	4	0	11774	3	0	11781
24316	11624	0	24	3	0	11651
24317	11587	0	25	0	0	11612
24318	0	11255	0	8	0	11263
24319	1	11162	0	5	0	11168
24320	11215	0	13	2	0	11230
24321	11195	0	13	1	0	11209
24322	11140	3	21	2	0	11166
24323	11127	2	24	3	0	11156
24324	7	0	11156	2	0	11165
24325	0	23	0	10987	0	11010
24326	1	22	0	10728	0	10751
24327	3	5	10766	1	0	10775
24328	10770	0	19	2	0	10791
24329	0	25	1	10826	0	10852
24330	2	28	0	10703	0	10733
24331	11	0	10604	5	0	10620
24332	2	10581	3	21	0	10607
24333	1	10577	0	6	0	10584
24334	10635	1	16	2	0	10654
24335	10673	2	21	0	0	10696
24336	3	10944	0	41	0	10988
24337	1	11429	0	5	0	11435
24338	11509	0	12	3	0	11524
24339	12592	1	15	2	0	12610
24340	2	16	2	12618	0	12638
24341	5	8	0	12685	0	12698
24342	0	8	0	12992	0	13000
24343	12656	0	7	0	0	12663
24344	11986	0	25	3	0	12014
24345	1	7	0	11959	0	11967
24346	11265	3	10	0	0	11278
24347	14	0	11453	0	0	11467
24348	5	32	0	11039	0	11076
24349	12	3	10966	5	0	10986
24350	0	10251	0	11	0	10262
24351	3	10	0	10156	0	10169
24352	10248	0	12	0	0	10260
24353	3	18	3	10326	0	10350
24354	3	35	2	10356	0	10396
24355	8	0	10300	2	0	10310
24356	39	3	10241	4	0	10287
24357	14	10232	0	15	0	10261
24358	10274	0	22	0	0	10296
24359	10303	2	7	1	0	10313
24360	9218	2	14	2	0	9236
24361	9596	2	14	1	0	9613
24362	0	11	0	9605	0	9616
24363	1	14	1	9589	0	9605
24364	1	9450	0	2	0	9453
24365	9584	0	19	1	0	9604
24366	8966	0	23	5	0	8994
24367	9	1	8929	1	0	8940
24368	9988	1	28	3	0	10020
24369	2	9630	1	14	0	9647
24370	8	27	1	9318	0	9354
24371	0	9477	0	2	0	9479
24372	9465	1	26	1	0	9493
24373	5	9632	1	5	0	9643
24374	3	37	1	9563	0	9604
24375	2	27	1	9929	0	9959
24376	4	31	0	9582	0	9617
24377	0	9734	0	1	0	9735
24378	5	28	1	9721	0	9755
24379	4	20	1	10013	0	10038
24380	2	9667	0	2	0	9671
24381	2	9475	0	33	0	9510
24382	9399	0	16	2	0	9417
24383	0	9271	1	0	0	9272
24384	9048	2	18	2	0	9070
24385	12	0	9005	3	0	9020
24386	2	9233	0	4	0	9239
24387	9288	0	20	1	0	9309
24388	9272	0	10	2	0	9284
24389	15	1	9288	1	0	9305
24390	7	25	0	9449	0	9481
24391	7	4	9364	2	0	9377
24392	0	9185	0	25	0	9210
24393	9257	2	17	5	0	9281
24394	2	9362	0	1	0	9365
24395	3	21	0	9283	0	9307
24396	5	26	1	9317	0	9349
24397	12	0	9288	4	0	9304
24398	5	1	9260	1	0	9267
24399	9315	0	16	1	0	9332
24400	9258	0	21	3	0	9282
24401	9226	1	10	1	0	9238
24402	9299	9	18	2	0	9328
24403	0	9733	0	5	0	9738
24404	1	47	2	9615	0	9665
24405	2	18	0	9632	0	9652
24406	3	9706	0	6	0	9715
24407	9709	3	27	2	0	9741
24408	9781	1	19	2	0	9803
24409	7	0	9807	0	0	9814
24410	9873	2	33	2	0	9910
24411	1	25	2	9868	0	9896
24412	12	0	9366	2	0	9380
24413	5	24	0	9061	0	9090
24414	12	0	8958	5	0	8975
24415	4	0	7984	3	0	7991
24416	1	21	0	8032	0	8054
24417	1	7762	1	8	0	7772
24418	7750	1	11	4	0	7766
24419	8075	1	28	0	0	8104
24420	2	8643	0	8	0	8653
24421	1	8901	0	6	0	8908
24422	8970	3	10	2	0	8985
24423	8723	2	17	1	0	8743
24424	8644	0	17	2	0	8663
24425	8694	2	11	1	0	8708
24426	1	20	1	8743	0	8765
24427	15	1	8819	3	0	8838
24428	1	8878	0	16	0	8895
24429	8864	1	21	2	0	8888
24430	2	8881	0	9	0	8892
24431	8829	1	20	1	0	8851
24432	9080	1	30	3	0	9114
24433	7	0	9702	0	0	9709
24434	0	10317	0	14	0	10331
24435	1	43	2	10299	0	10345
24436	1	33	1	10396	0	10431
24437	4	13	0	10111	0	10128
24438	10147	0	13	2	0	10162
24439	10119	0	21	0	0	10140
24440	10127	3	33	0	0	10163
24441	0	10196	0	22	0	10218
24442	9342	0	18	1	0	9361
24443	0	9124	0	4	0	9128
24444	8	0	9055	2	0	9065
24445	1	9089	0	12	0	9102
24446	4	34	2	9210	0	9250
24447	4	18	1	9414	0	9437
24448	2	0	9618	0	0	9620
24449	1	29	1	9526	0	9557
24450	4	8	1	9542	0	9555
24451	9346	0	17	0	0	9363
24452	9262	0	15	0	0	9277
24453	9103	4	28	2	0	9137
24454	0	9132	0	3	0	9135
24455	8813	1	21	0	0	8835
24456	9025	0	17	1	0	9043
24457	0	8985	0	3	0	8988
24458	0	26	6	8759	0	8791
24459	0	8	2	8824	0	8834
24460	8696	0	12	0	0	8708
24461	6	0	8565	6	0	8577
24462	2	8593	0	13	0	8608
24463	3	31	0	8401	0	8435
24464	3	8521	1	3	0	8528
24465	0	8538	1	4	0	8543
24466	8647	2	10	2	0	8661
24467	8683	1	5	0	0	8689
24468	2	20	1	8742	0	8765
24469	2	21	0	8693	0	8716
24470	2	6	1	8618	0	8627
24471	5	9	2	8632	0	8648
24472	7	0	8598	0	0	8605
24473	6	0	9491	2	0	9499
24474	3	33	1	9425	0	9462
24475	6	0	9397	10	0	9413
24476	0	9377	0	2	0	9379
24477	9468	0	16	1	0	9485
24478	9597	0	20	0	0	9617
24479	1	32	1	9688	0	9722
24480	1	13	1	9679	0	9694
24481	1	30	1	9644	0	9676
24482	3	9614	0	8	0	9625
24483	9994	1	13	0	0	10008
24484	9920	0	22	2	0	9944
24485	5	0	9958	0	0	9963
24486	1	26	2	9771	0	9800
24487	6	0	10503	0	0	10509
24488	1	30	6	10318	0	10355
24489	0	8	4	10319	0	10331
24490	3	14	2	10313	0	10332
24491	2	5	0	10327	0	10334
24492	10428	0	17	2	0	10447
24493	10402	3	13	0	0	10418
24494	10893	0	52	1	0	10946
24495	3	18	2	10773	0	10796
24496	1	0	10123	0	0	10124
24497	9882	0	28	2	0	9912
24498	1	13	1	9899	0	9914
24499	9871	1	18	6	0	9896
24500	1	17	2	9913	0	9933
24501	2	10275	0	5	0	10282
24502	3	10205	0	19	0	10227
24503	8	45	3	10240	0	10296
24504	2	26	1	10377	0	10406
24505	3	46	4	10347	0	10400
24506	2	10346	0	4	0	10352
24507	10292	0	23	1	0	10316
24508	2	9796	0	8	0	9806
24509	6	0	9766	1	0	9773
24510	1	49	2	9706	0	9758
24511	2	9870	1	3	0	9876
24512	0	26	3	10188	0	10217
24513	5	37	2	10380	0	10424
24514	7	0	10405	1	0	10413
24515	10503	1	43	4	0	10551
24516	0	10525	0	12	0	10537
24517	10455	0	42	2	0	10499
24518	10474	0	24	2	0	10500
24519	10424	1	29	3	0	10457
24520	1	0	10682	0	0	10683
24521	1	19	0	10623	0	10643
24522	0	24	1	10447	0	10472
24523	6	0	10329	2	0	10337
24524	10041	1	28	7	0	10077
24525	10	0	10026	1	0	10037
24526	10	0	10519	1	0	10530
24527	3	10599	0	3	0	10605
24528	1	26	3	10501	0	10531
24529	10	0	10544	1	0	10555
24530	10798	0	20	4	0	10822
24531	10835	1	29	3	0	10868
24532	11	1	10764	0	0	10776
24533	3	27	0	10640	0	10670
24534	17	0	10611	4	0	10632
24535	6	10739	1	12	0	10758
24536	10777	1	24	3	0	10805
24537	10769	0	30	2	0	10801
24538	10819	0	26	1	0	10846
24539	0	10	1	11885	0	11896
24540	0	17	1	12112	0	12130
24541	3	0	11990	1	0	11994
24542	11820	0	28	1	0	11849
24543	4	15	1	11867	0	11887
24544	11768	3	24	4	0	11799
24545	7	0	11844	0	0	11851
24546	16	0	12253	5	0	12274
24547	1	26	0	12187	0	12214
24548	2	22	6	11315	0	11345
24549	17	0	11411	0	0	11428
24550	11671	3	33	2	0	11709
24551	10	41	0	11704	0	11755
24552	3	11713	0	17	0	11733
24553	11732	1	40	4	0	11777
24554	1	11549	0	6	0	11556
24555	11175	0	32	2	0	11209
24556	9	0	11110	4	0	11123
24557	17	0	11515	4	0	11536
24558	2	11589	0	9	0	11600
24559	11248	1	26	2	0	11277
24560	4	0	11317	0	0	11321
24561	11383	0	28	5	0	11416
24562	0	10940	0	11	0	10951
24563	2	44	1	10827	0	10874
24564	1	22	0	10803	0	10826
24565	4	10841	0	4	0	10849
24566	10856	0	27	4	0	10887
24567	10857	0	15	1	0	10873
24568	10721	0	29	0	0	10750
24569	1	0	10810	0	0	10811
24570	0	15	2	10341	0	10358
24571	1	23	0	10405	0	10429
24572	0	17	0	10421	0	10438
24573	5	0	10313	1	0	10319
24574	0	10416	0	9	0	10425
24575	10477	0	24	1	0	10502
24576	2	1	10861	1	0	10865
24577	10501	3	19	5	0	10528
24578	1	10679	0	6	0	10686
24579	11587	1	17	2	0	11607
24580	1	19	0	11701	0	11721
24581	12004	2	11	1	0	12018
24582	4	36	0	11947	0	11987
24583	7	0	11997	2	0	12006
24584	6	22	0	11681	0	11709
24585	4	0	11120	0	0	11124
24586	11405	1	22	7	0	11435
24587	0	11658	0	10	0	11668
24588	6	37	2	11098	0	11143
24589	4	11321	0	3	0	11328
24590	11348	1	18	4	0	11371
24591	11574	0	34	0	0	11608
24592	2	12334	0	7	0	12343
24593	12287	0	19	4	0	12310
24594	12534	1	10	3	0	12548
24595	2	19	0	12311	0	12332
24596	3	7	0	12147	0	12157
24597	12570	0	14	4	0	12588
24598	12464	2	20	4	0	12490
24599	2	9	0	12458	0	12469
24600	0	11	1	12454	0	12466
24601	11952	2	26	0	0	11980
24602	4	0	11980	2	0	11986
24603	12126	1	52	2	0	12181
24604	14	0	12254	0	0	12268
24605	1	12112	0	22	0	12135
24606	3	26	0	11842	0	11871
24607	7	0	12032	2	0	12041
24608	1	12045	1	11	0	12058
24609	12043	2	38	2	0	12085
24610	4	0	12003	1	0	12008
24611	11943	0	24	1	0	11968
24612	12164	0	31	2	0	12197
24613	12140	0	23	1	0	12164
24614	2	25	2	11968	0	11997
24615	3	11037	0	2	0	11042
24616	10795	2	37	1	0	10835
24617	3	0	10764	0	0	10767
24618	10650	0	29	2	0	10681
24619	7	0	10800	0	0	10807
24620	1	10355	0	9	0	10365
24621	0	34	2	10124	0	10160
24622	2	25	1	10202	0	10230
24623	1	10149	1	8	0	10159
24624	4	38	3	10185	0	10230
24625	19	0	10315	1	0	10335
24626	2	10270	1	5	0	10278
24627	1	19	1	10243	0	10264
24628	10280	1	14	1	0	10296
24629	10617	2	14	0	0	10633
24630	2	24	0	10780	0	10806
24631	1	10959	0	2	0	10962
24632	1	28	1	10585	0	10615
24633	0	15	1	10540	0	10556
24634	14	1	10495	5	0	10515
24635	3	10409	0	13	0	10425
24636	2	29	0	10563	0	10594
24637	17	1	10530	0	0	10548
24638	0	11119	0	9	0	11128
24639	1	27	1	11549	0	11578
24640	11879	0	13	1	0	11893
24641	1	11830	1	19	0	11851
24642	2	11	1	11857	0	11871
24643	11910	2	3	2	0	11917
24644	12052	2	23	1	0	12078
24645	12017	0	18	1	0	12036
24646	12549	2	29	6	0	12586
24647	1	20	1	12340	0	12362
24648	13	1	12528	1	0	12543
24649	6	33	0	12373	0	12412
24650	3	12362	0	5	0	12370
24651	12300	3	43	4	0	12350
24652	2	0	11972	0	0	11974
24653	12091	2	37	2	0	12132
24654	10	0	12247	1	0	12258
24655	3	24	2	11480	0	11509
24656	8	0	11534	0	0	11542
24657	3	27	7	11397	0	11434
24658	8	1	11684	1	0	11694
24659	3	30	1	12190	0	12224
24660	12320	2	19	3	0	12344
24661	2	12147	0	8	0	12157
24662	6	29	2	12032	0	12069
24663	4	31	3	11750	0	11788
24664	4	1	11695	2	0	11702
24665	13	0	11571	6	0	11590
24666	11831	0	34	2	0	11867
24667	1	11560	0	7	0	11568
24668	10943	2	18	2	0	10965
24669	11788	1	23	4	0	11816
24670	4	24	0	11857	0	11885
24671	1	11972	0	8	0	11981
24672	11994	1	23	4	0	12022
24673	11634	0	17	6	0	11657
24674	11584	1	36	0	0	11621
24675	12060	0	30	1	0	12091
24676	12001	0	74	1	0	12076
24677	0	0	12145	0	0	12145
24678	11525	1	35	1	0	11562
24679	5	0	11677	0	0	11682
24680	6	22	0	11721	0	11749
24681	3	20	2	11648	0	11673
24682	4	0	11673	2	0	11679
24683	11515	1	27	1	0	11544
24684	5	15	1	11605	0	11626
24685	2	32	0	11663	0	11697
24686	1	9	0	11628	0	11638
24687	1	17	1	11673	0	11692
24688	0	24	0	11517	0	11541
24689	6	0	11490	4	0	11500
24690	3	25	0	12041	0	12069
24691	5	0	12024	1	0	12030
24692	5	0	12145	2	0	12152
24693	12104	2	40	5	0	12151
24694	12093	6	46	2	0	12147
24695	12062	1	54	1	0	12118
24696	3	0	12263	0	0	12266
24697	20	0	12360	4	0	12384
24698	5	0	12624	7	0	12636
24699	0	12334	0	13	0	12347
24700	0	20	2	12371	0	12393
24701	12610	1	29	5	0	12645
24702	1	30	1	12714	0	12746
24703	0	12891	0	2	0	12893
24704	13063	0	20	0	0	13083
24705	5	41	1	13591	0	13638
24706	0	13945	0	6	0	13951
24707	4	28	0	13706	0	13738
24708	1	5	1	13995	0	14002
24709	14000	3	21	2	0	14026
24710	0	25	1	13762	0	13788
24711	6	1	13958	1	0	13966
24712	1	48	2	13773	0	13824
24713	2	13507	0	9	0	13518
24714	1	12937	0	6	0	12944
24715	1	37	0	12505	0	12543
24716	3	28	0	12968	0	12999
24717	2	13275	0	8	0	13285
24718	5	13277	0	9	0	13291
24719	0	13320	0	2	0	13322
24720	7	35	1	13031	0	13074
24721	3	12765	3	3	0	12774
24722	12854	2	43	1	0	12900
24723	5	1	13131	1	0	13138
24724	1	34	0	13032	0	13067
24725	0	13041	2	16	0	13059
24726	12791	1	40	3	0	12835
24727	5	0	12865	0	0	12870
24728	1	12754	2	18	0	12775
24729	12926	3	35	2	0	12966
24730	0	12873	0	13	0	12886
24731	1	12518	0	7	0	12526
24732	4	44	2	12554	0	12604
24733	3	12542	0	8	0	12553
24734	12767	2	28	0	0	12797
24735	4	28	2	12369	0	12403
24736	12	0	12305	3	0	12320
24737	12	1	12996	4	0	13013
24738	1	36	1	12868	0	12906
24739	34	0	12659	0	0	12693
24740	2	30	1	12602	0	12635
24741	12327	1	27	1	0	12356
24742	7	0	12863	1	0	12871
24743	2	38	2	12810	0	12852
24744	0	12439	0	4	0	12443
24745	1	38	0	12174	0	12213
24746	4	33	1	11958	0	11996
24747	1	11917	1	2	0	11921
24748	4	25	1	11969	0	11999
24749	1	13	1	12012	0	12027
24750	10	0	12026	10	0	12046
24751	1	11678	2	13	0	11694
24752	11765	2	20	0	0	11787
24753	5	35	0	11512	0	11552
24754	11	0	11491	1	0	11503
24755	1	28	3	11604	0	11636
24756	6	2	11692	3	0	11703
24757	12260	2	45	4	0	12311
24758	0	12642	0	1	0	12643
24759	3	33	2	12561	0	12599
24760	4	14	0	12634	0	12652
24761	12629	1	25	0	0	12655
24762	9	35	2	12668	0	12714
24763	12	0	12683	2	0	12697
24764	3	36	1	12888	0	12928
24765	1	12774	1	14	0	12790
24766	5	12137	0	15	0	12157
24767	7	12202	0	7	0	12216
24768	3	30	0	12201	0	12234
24769	8	0	12273	2	0	12283
24770	2	12177	0	34	0	12213
24771	12262	1	48	0	0	12311
24772	3	12052	0	5	0	12060
24773	11854	1	16	3	0	11874
24774	11816	2	51	2	0	11871
24775	2	0	12107	1	0	12110
24776	12075	2	38	4	0	12119
24777	11859	1	39	0	0	11899
24778	11731	1	47	3	0	11782
24779	11562	0	56	5	0	11623
24780	5	1	11420	0	0	11426
24781	10672	0	35	1	0	10708
24782	10172	0	39	2	0	10213
24783	2	10568	0	5	0	10575
24784	4	19	1	10230	0	10254
24785	3	30	2	10398	0	10433
24786	3	10219	0	2	0	10224
24787	10234	3	32	1	0	10270
24788	1	10359	0	13	0	10373
24789	10633	3	25	2	0	10663
24790	10727	1	24	1	0	10753
24791	1	10375	0	7	0	10383
24792	0	9	1	10023	0	10033
24793	11	0	10124	1	0	10136
24794	0	10367	0	5	0	10372
24795	4	28	1	10381	0	10414
24796	3	10532	1	10	0	10546
24797	1	10080	0	6	0	10087
24798	6	30	1	10169	0	10206
24799	8	1	10254	0	0	10263
24800	1	11198	1	4	0	11204
24801	1	11245	0	14	0	11260
24802	11620	2	17	3	0	11642
24803	4	37	2	11406	0	11449
24804	2	19	0	11494	0	11515
24805	3	23	2	11460	0	11488
24806	19	0	11150	2	0	11171
24807	5	29	1	11177	0	11212
24808	0	10782	1	1	0	10784
24809	10750	1	42	6	0	10799
24810	1	39	1	10608	0	10649
24811	18	1	10561	1	0	10581
24812	10455	1	33	2	0	10491
24813	1	16	0	9855	0	9872
24814	5	0	9820	2	0	9827
24815	13	0	9770	1	0	9784
24816	9960	1	36	5	0	10002
24817	9995	0	38	0	0	10033
24818	9509	0	41	3	0	9553
24819	9408	5	54	3	0	9470
24820	8	0	9329	1	0	9338
24821	1	9204	0	5	0	9210
24822	9199	1	29	3	0	9232
24823	2	9294	0	12	0	9308
24824	9143	0	28	0	0	9171
24825	1	9150	0	4	0	9155
24826	1	29	4	9062	0	9096
24827	2	21	2	9171	0	9196
24828	1	19	5	9481	0	9506
24829	4	9559	0	7	0	9570
24830	0	9204	0	10	0	9214
24831	3	20	1	9298	0	9322
24832	3	8826	1	8	0	8838
24833	13	0	8861	2	0	8876
24834	1	17	5	8862	0	8885
24835	4	0	8823	1	0	8828
24836	9493	0	32	4	0	9529
24837	9450	1	19	1	0	9471
24838	11	0	9387	0	0	9398
24839	13	0	9747	0	0	9760
24840	0	22	2	10030	0	10054
24841	6	0	10072	0	0	10078
24842	1	17	1	10075	0	10094
24843	2	10089	3	2	0	10096
24844	4	25	2	10099	0	10130
24845	2	14	2	10340	0	10358
24846	1	19	0	10433	0	10453
24847	5	0	10547	0	0	10552
24848	1	30	2	10599	0	10632
24849	3	23	1	10591	0	10618
24850	2	29	0	10887	0	10918
24851	0	10592	0	1	0	10593
24852	10734	0	20	2	0	10756
24853	10979	0	13	0	0	10992
24854	11045	1	34	1	0	11081
24855	2	6	2	11092	0	11102
24856	10	0	10920	0	0	10930
24857	19	1	10939	2	0	10961
24858	2	10700	0	11	0	10713
24859	10821	2	33	4	0	10860
24860	0	10763	0	12	0	10775
24861	10851	2	24	3	0	10880
24862	0	11013	0	4	0	11017
24863	11210	1	22	5	0	11238
24864	1	11263	0	5	0	11269
24865	2	16	4	10827	0	10849
24866	6	0	11194	2	0	11202
24867	2	0	11290	1	0	11293
24868	2	21	6	11210	0	11239
24869	2	29	2	11661	0	11694
24870	2	19	1	11373	0	11395
24871	5	0	11214	0	0	11219
24872	5	17	4	11315	0	11341
24873	11142	0	16	0	0	11158
24874	11186	5	30	6	0	11227
24875	0	10433	1	8	0	10442
24876	10305	1	25	2	0	10333
24877	4	10410	0	7	0	10421
24878	10082	1	12	1	0	10096
24879	10469	1	41	5	0	10516
24880	10481	1	24	2	0	10508
24881	1	0	10419	2	0	10422
24882	8	3	10629	6	0	10646
24883	10578	0	17	1	0	10596
24884	10559	1	20	0	0	10580
24885	1	16	0	10539	0	10556
24886	3	17	2	10539	0	10561
24887	4	16	0	10583	0	10603
24888	4	12	2	10626	0	10644
24889	2	6	0	10679	0	10687
24890	10622	1	12	1	0	10636
24891	2	19	0	10559	0	10580
24892	4	0	10535	0	0	10539
24893	10653	1	38	7	0	10699
24894	10633	1	45	3	0	10682
24895	4	10850	0	15	0	10869
24896	2	10806	0	3	0	10811
24897	10883	2	25	2	0	10912
24898	4	10889	0	5	0	10898
24899	10906	2	30	8	0	10946
24900	11013	0	36	4	0	11053
24901	10962	1	21	3	0	10987
24902	6	26	6	11020	0	11058
24903	2	12007	0	15	0	12024
24904	11913	2	33	3	0	11951
24905	0	19	0	12372	0	12391
24906	2	16	1	12432	0	12451
24907	12639	1	13	2	0	12655
24908	1	12606	0	0	0	12607
24909	5	22	3	12217	0	12247
24910	12292	0	34	3	0	12329
24911	1	12174	1	9	0	12185
24912	11484	0	34	3	0	11521
24913	5	1	11539	2	0	11547
24914	11522	0	28	3	0	11553
24915	3	11517	0	7	0	11527
24916	10922	0	29	2	0	10953
24917	10954	1	42	3	0	11000
24918	0	10975	0	6	0	10981
24919	10825	2	27	2	0	10856
24920	1	11177	0	8	0	11186
24921	10957	3	26	0	0	10986
24922	0	21	1	10812	0	10834
24923	3	23	3	10721	0	10750
24924	0	19	3	11163	0	11185
24925	8	0	11242	1	0	11251
24926	3	14	2	10762	0	10781
24927	10	0	10791	0	0	10801
24928	5	28	1	10583	0	10617
24929	1	10218	0	4	0	10223
24930	5	24	2	10296	0	10327
24931	6	0	10313	0	0	10319
24932	8	1	10363	5	0	10377
24933	1	9	0	10425	0	10435
24934	11119	0	22	2	0	11143
24935	11296	2	15	4	0	11317
24936	1	11128	1	1	0	11131
24937	3	21	0	11086	0	11110
24938	11	0	11174	0	0	11185
24939	0	21	3	10841	0	10865
24940	6	0	10889	0	0	10895
24941	10947	0	35	9	0	10991
24942	1	22	0	10591	0	10614
24943	12	0	10651	0	0	10663
24944	0	28	0	10660	0	10688
24945	3	13	1	10667	0	10684
24946	7	0	10836	0	0	10843
24947	1	14	0	10798	0	10813
24948	10800	1	9	0	0	10810
24949	10758	1	29	2	0	10790
24950	0	13	0	10705	0	10718
24951	10631	0	25	1	0	10657
24952	6	0	10435	0	0	10441
24953	1	0	10494	1	0	10496
24954	10411	0	21	2	0	10434
24955	9983	1	33	1	0	10018
24956	0	16	1	9819	0	9836
24957	1	18	1	9953	0	9973
24958	12	0	9977	1	0	9990
24959	4	25	2	9940	0	9971
24960	6	9909	1	7	0	9923
24961	9986	4	34	2	0	10026
24962	9958	1	28	4	0	9991
24963	0	9895	0	9	0	9904
24964	9790	1	45	3	0	9839
24965	10451	1	36	4	0	10492
24966	2	10524	0	5	0	10531
24967	10328	1	23	2	0	10354
24968	2	10626	0	6	0	10634
24969	10431	2	32	3	0	10468
24970	3	0	13165	0	0	13168
24971	0	34	5	13585	0	13624
24972	7	25	1	14677	0	14710
24973	2	14	1	14899	0	14916
24974	14762	2	22	2	0	14788
24975	7	18	0	14898	0	14923
24976	6	0	14760	0	0	14766
24977	15005	3	40	1	0	15049
24978	2	30	1	14765	0	14798
24979	3	14133	0	9	0	14145
24980	2	13900	0	2	0	13904
24981	3	51	2	13811	0	13867
24982	2	29	2	14074	0	14107
24983	0	23	1	13926	0	13950
24984	26	0	13839	0	0	13865
24985	0	13824	1	17	0	13842
24986	13826	0	36	1	0	13863
24987	14256	1	46	2	0	14305
24988	2	14196	0	4	0	14202
24989	1	14117	0	10	0	14128
24990	2	30	0	13985	0	14017
24991	6	8	15516	2	0	15532
24992	15517	1	47	2	0	15567
24993	15635	1	22	1	0	15659
24994	4	29	2	15594	0	15629
24995	1	17	0	15626	0	15644
24996	15316	3	29	5	0	15353
24997	11	1	15481	0	0	15493
24998	15462	2	49	2	0	15515
24999	0	15557	0	15	0	15572
25000	2	78	2	14761	0	14843
25001	1	16173	0	13	0	16187
25002	16378	2	31	1	0	16412
25003	3	62	4	16576	0	16645
25004	5	55	0	16500	0	16560
25005	1	16615	1	8	0	16625
25006	16638	4	38	2	0	16682
25007	16615	1	38	2	0	16656
25008	4	0	16714	1	0	16719
25009	8	2	16875	5	0	16890
25010	15703	2	44	12	0	15761
25011	4	0	15857	5	0	15866
25012	2	1	16196	1	0	16200
25013	15726	5	40	10	0	15781
25014	4	1	16155	6	0	16166
25015	2	40	1	16260	0	16303
25016	0	15	0	16271	0	16286
25017	16329	3	42	4	0	16378
25018	16	0	16644	1	0	16661
25019	16442	0	45	6	0	16493
25020	3	9	1	17110	0	17123
25021	16505	2	15	3	0	16525
25022	16279	0	20	2	0	16301
25023	16309	4	27	1	0	16341
25024	2	8	2	16505	0	16517
25025	16488	1	11	2	0	16502
25026	1	23	2	16441	0	16467
25027	2	19	3	16122	0	16146
25028	4	17	3	16258	0	16282
25029	2	8	1	16320	0	16331
25030	16412	1	8	5	0	16426
25031	16302	0	35	4	0	16341
25032	8	2	16832	0	0	16842
25033	16559	4	42	4	0	16609
25034	16841	2	33	4	0	16880
25035	4	34	1	17036	0	17075
25036	1	17172	0	6	0	17179
25037	17394	5	40	4	0	17443
25038	4	21	2	17959	0	17986
25039	17973	1	21	5	0	18000
25040	0	17929	0	11	0	17940
25041	17434	4	43	4	0	17485
25042	6	39	0	17551	0	17596
25043	2	17289	1	7	0	17299
25044	17316	1	40	3	0	17360
25045	2	14797	2	102	0	14903
25046	1	14656	0	14	0	14671
25047	14361	3	31	8	0	14403
25048	9	0	13492	3	0	13504
25049	14892	2	31	3	0	14928
25050	1	35	1	15050	0	15087
25051	8	0	15008	1	0	15017
25052	0	47	1	15267	0	15315
25053	2	37	1	14935	0	14975
25054	12	0	15204	1	0	15217
25055	14992	2	31	5	0	15030
25056	0	20	3	14880	0	14903
25057	2	20	1	14498	0	14521
25058	3	14	1	14369	0	14387
25059	14418	4	29	3	0	14454
25060	8	1	14588	7	0	14604
25061	41	0	14630	5	0	14676
25062	6	35	0	14642	0	14683
25063	18	0	14156	5	0	14179
25064	14097	2	50	3	0	14152
25065	5	14258	0	9	0	14272
25066	14222	1	47	1	0	14271
25067	5	29	1	13481	0	13516
25068	1	13754	0	19	0	13774
25069	2	30	2	13616	0	13650
25070	0	13626	0	13	0	13639
25071	5	21	3	13662	0	13691
25072	36	0	13729	1	0	13766
25073	21	3	13878	3	0	13905
25074	1	14027	0	11	0	14039
25075	14116	0	31	12	0	14159
25076	3	25	2	13998	0	14028
25077	7	22	14	12912	0	12955
25078	12746	1	11	2	0	12760
25079	12611	2	12	0	0	12625
25080	0	22	0	12816	0	12838
25081	7	0	12653	1	0	12661
25082	1	12768	0	7	0	12776
25083	3	38	0	12854	0	12895
25084	2	42	1	12862	0	12907
25085	0	12867	0	7	0	12874
25086	12848	0	22	4	0	12874
25087	6	1	13576	0	0	13583
25088	2	30	0	13102	0	13134
25089	1	24	0	12988	0	13013
25090	26	0	12958	0	0	12984
25091	2	23	0	13233	0	13258
25092	13373	1	22	1	0	13397
25093	13733	1	32	6	0	13772
25094	13423	21	46	2	0	13492
25095	1	13550	0	7	0	13558
25096	12743	3	13	2	0	12761
25097	1	19	2	12765	0	12787
25098	6	23	0	12730	0	12759
25099	6	12586	0	10	0	12602
25100	12562	6	35	0	0	12603
25101	12636	1	29	0	0	12666
25102	12585	2	23	2	0	12612
25103	12584	2	32	2	0	12620
25104	12506	1	68	2	0	12577
25105	7	0	12713	0	0	12720
25106	12634	0	34	2	0	12670
25107	12622	5	43	2	0	12672
25108	12446	1	40	7	0	12494
25109	3	14	0	12426	0	12443
25110	1	8	1	12237	0	12247
25111	9	1	11986	2	0	11998
25112	11989	1	35	2	0	12027
25113	1	11504	1	8	0	11514
25114	2	11274	0	11	0	11287
25115	17	0	11437	2	0	11456
25116	2	11940	1	3	0	11946
25117	1	11588	0	6	0	11595
25118	2	30	0	13117	0	13149
25119	8	14680	0	7	0	14695
25120	15031	3	29	3	0	15066
25121	15061	5	15	3	0	15084
25122	1	23	2	15070	0	15096
25123	10	0	15099	3	0	15112
25124	14171	0	43	3	0	14217
25125	8	0	13168	1	0	13177
25126	22	0	13158	1	0	13181
25127	4	31	1	12943	0	12979
25128	3	42	0	12690	0	12735
25129	13	2	12667	0	0	12682
25130	6	12296	0	18	0	12320
25131	8	12324	0	9	0	12341
25132	12488	1	25	1	0	12515
25133	12474	1	18	1	0	12494
25134	4	1	12675	1	0	12681
25135	12683	0	18	1	0	12702
25136	12670	0	32	0	0	12702
25137	0	4	2	12630	0	12636
25138	1	17	1	12501	0	12520
25139	1	6	0	12665	0	12672
25140	12724	0	9	3	0	12736
25141	12571	0	10	0	0	12581
25142	12608	0	21	0	0	12629
25143	2	11	3	11768	0	11784
25144	11	0	11549	1	0	11561
25145	11359	0	25	3	0	11387
25146	11435	0	30	1	0	11466
25147	7	29	0	11431	0	11467
25148	1	11244	0	4	0	11249
25149	22	44	0	10986	0	11052
25150	0	11706	0	0	0	11706
25151	7	48	1	11692	0	11748
25152	0	11867	0	6	0	11873
25153	11806	1	18	0	0	11825
25154	2	26	1	11725	0	11754
25155	0	11610	2	9	0	11621
25156	16	1	11417	3	0	11437
25157	11404	2	16	0	0	11422
25158	4	28	1	11209	0	11242
25159	0	11077	0	4	0	11081
25160	2	40	3	11032	0	11077
25161	3	11181	0	6	0	11190
25162	1	10477	0	4	0	10482
25163	10483	3	14	2	0	10502
25164	10479	0	17	4	0	10500
25165	4	0	10472	2	0	10478
25166	10137	2	21	3	0	10163
25167	10173	2	13	1	0	10189
25168	0	10095	0	4	0	10099
25169	3	23	3	9499	0	9528
25170	0	16	9	9572	0	9597
25171	7	0	9521	1	0	9529
25172	11	0	9916	1	0	9928
25173	9823	1	25	6	0	9855
25174	10150	1	24	1	0	10176
25175	10197	1	38	1	0	10237
25176	11	1	10765	4	0	10781
25177	0	13	0	10831	0	10844
25178	10860	0	14	1	0	10875
25179	1	24	1	10794	0	10820
25180	9	0	10833	1	0	10843
25181	10540	0	26	3	0	10569
25182	12	0	10784	1	0	10797
25183	2	10915	1	6	0	10924
25184	10619	1	17	0	0	10637
25185	7	0	13724	1	0	13732
25186	0	16	0	13977	0	13993
25187	14828	0	16	4	0	14848
25188	0	16	0	14903	0	14919
25189	14862	0	14	0	0	14876
25190	0	6	0	14882	0	14888
25191	14609	1	12	3	0	14625
25192	14101	2	40	0	0	14143
25193	14053	0	36	6	0	14095
25194	12176	0	31	0	0	12207
25195	1	8	1	10631	0	10641
25196	4	0	10326	1	0	10331
25197	11	0	10325	3	0	10339
25198	4	10504	0	12	0	10520
25199	2	10612	0	8	0	10622
25200	10835	0	11	2	0	10848
25201	1	35	3	10981	0	11020
25202	18	0	11057	0	0	11075
25203	10	2	11343	1	0	11356
25204	0	16	0	11417	0	11433
25205	11453	0	16	4	0	11473
25206	1	11518	0	4	0	11523
25207	11425	0	25	2	0	11452
25208	0	16	2	11407	0	11425
25209	0	23	0	11407	0	11430
25210	2	20	0	11202	0	11224
25211	6	0	11175	14	0	11195
25212	11	2	11262	1	0	11276
25213	0	11320	0	8	0	11328
25214	4	25	0	11354	0	11383
25215	11418	0	14	2	0	11434
25216	6	0	11675	2	0	11683
25217	0	1	12586	0	0	12587
25218	3	41	7	12442	0	12493
25219	3	20	1	12481	0	12505
25220	0	24	1	12455	0	12480
25221	1	7	0	12598	0	12606
25222	12592	0	14	4	0	12610
25223	2	13	0	12649	0	12664
25224	12468	1	26	0	0	12495
25225	13	0	12407	0	0	12420
25226	1	11986	0	11	0	11998
25227	2	30	2	11740	0	11774
25228	11	1	11833	2	0	11847
25229	21	0	11773	7	0	11801
25230	1	11947	0	7	0	11955
25231	2	41	2	11924	0	11969
25232	0	25	0	12091	0	12116
25233	16	0	11929	3	0	11948
25234	11923	0	25	4	0	11952
25235	4	22	2	11979	0	12007
25236	11	25	1	11926	0	11963
25237	8	0	11937	0	0	11945
25238	3	12337	0	13	0	12353
25239	1	12410	0	9	0	12420
25240	12543	1	23	7	0	12574
25241	3	24	0	13124	0	13151
25242	13052	0	12	1	0	13065
25243	8	0	13301	2	0	13311
25244	12	17	1	13271	0	13301
25245	13281	0	12	1	0	13294
25246	13149	1	18	0	0	13168
25247	1	18	1	12777	0	12797
25248	19	0	12828	3	0	12850
25249	11	0	12834	2	0	12847
25250	2	41	3	12591	0	12637
25251	9	0	12286	7	0	12302
25252	11689	0	40	9	0	11738
25253	0	12183	0	8	0	12191
25254	12135	0	21	1	0	12157
25255	12282	2	10	1	0	12295
25256	1	24	1	12245	0	12271
25257	2	14	1	12181	0	12198
25258	12252	0	9	1	0	12262
25259	1	21	0	12222	0	12244
25260	7	0	12235	0	0	12242
25261	0	8535	0	6	0	8541
25262	1	29	2	8110	0	8142
25263	0	8	2	8328	0	8338
25264	0	24	0	8276	0	8300
25265	4	0	8326	2	0	8332
25266	9	8590	1	4	0	8604
25267	6	29	2	8570	0	8607
25268	15	1	8906	1	0	8923
25269	4	18	0	8985	0	9007
25270	8988	0	14	4	0	9006
25271	1	33	0	8995	0	9029
25272	16	0	8867	0	0	8883
25273	9170	1	18	1	0	9190
25274	1	9449	0	6	0	9456
25275	0	9251	0	9	0	9260
25276	9064	0	17	1	0	9082
25277	5	0	9202	0	0	9207
25278	0	29	0	9332	0	9361
25279	1	24	0	9117	0	9142
25280	14	0	9210	3	0	9227
25281	1	9257	0	6	0	9264
25282	3	30	0	9198	0	9231
25283	3	1	9426	1	0	9431
25284	0	20	1	9760	0	9781
25285	9709	0	19	2	0	9730
25286	9	1	9687	6	0	9703
25287	4	16	1	10465	0	10486
25288	1	30	0	10389	0	10420
25289	4	8	10524	11	0	10547
25290	2	48	2	10551	0	10603
25291	0	9623	1	1	0	9625
25292	2	39	0	9465	0	9506
25293	2	9545	0	2	0	9549
25294	9538	1	22	0	0	9561
25295	9506	0	20	0	0	9526
25296	8	0	9621	0	0	9629
25297	9	0	9727	4	0	9740
25298	9	0	9752	2	0	9763
25299	0	10037	0	13	0	10050
25300	0	24	2	9945	0	9971
25301	25	0	10109	4	0	10138
25302	0	23	1	10360	0	10384
25303	2	21	1	10335	0	10359
25304	13	1	10432	3	0	10449
25305	4	27	1	10816	0	10848
25306	6	31	0	10728	0	10765
25307	2	10976	0	3	0	10981
25308	5	44	0	10834	0	10883
25309	2	32	0	11299	0	11333
25310	11	0	11347	3	0	11361
25311	3	31	1	11406	0	11441
25312	13	0	11326	5	0	11344
25313	21	0	11157	2	0	11180
25314	10886	0	20	0	0	10906
25315	2	32	2	10940	0	10976
25316	5	10359	1	6	0	10371
25317	1	10136	0	5	0	10142
25318	1	23	0	10101	0	10125
25319	7	2	10144	1	0	10154
25320	3	10307	0	12	0	10322
25321	3	33	2	10365	0	10403
25322	17	0	10354	0	0	10371
25323	2	10576	0	2	0	10580
25324	10529	4	29	3	0	10565
25325	10605	1	20	2	0	10628
25326	10577	0	14	2	0	10593
25327	1	15	4	10595	0	10615
25328	1	23	0	10633	0	10657
25329	2	33	0	10192	0	10227
25330	3	2	10263	0	0	10268
25331	10126	1	23	1	0	10151
25332	3	19	2	10184	0	10208
25333	6	0	10194	1	0	10201
25334	10684	2	30	1	0	10717
25335	10747	1	32	2	0	10782
25336	4	0	10680	3	0	10687
25337	10722	0	30	1	0	10753
25338	0	10668	0	3	0	10671
25339	11	0	10604	1	0	10616
25340	11061	3	16	2	0	11082
25341	3	10978	0	3	0	10984
25342	7	38	1	10925	0	10971
25343	2	10731	0	4	0	10737
25344	1	25	0	10622	0	10648
25345	8	0	10695	1	0	10704
25346	10614	0	28	3	0	10645
25347	9	0	10834	0	0	10843
25348	3	10765	0	14	0	10782
25349	5	10508	0	17	0	10530
25350	10127	2	17	4	0	10150
25351	9	0	10417	3	0	10429
25352	2	19	3	10819	0	10843
25353	18	0	11314	3	0	11335
25354	0	10986	0	7	0	10993
25355	7	28	1	10869	0	10905
25356	0	10882	0	8	0	10890
25357	11016	0	18	8	0	11042
25358	11005	0	20	1	0	11026
25359	10836	2	26	2	0	10866
25360	4	1	10489	0	0	10494
25361	10	1	10538	2	0	10551
25362	9502	1	23	1	0	9527
25363	4	0	9763	0	0	9767
25364	3	21	1	9709	0	9734
25365	4	9675	0	9	0	9688
25366	9894	1	20	1	0	9916
25367	9749	0	20	0	0	9769
25368	9737	1	13	4	0	9755
25369	1	18	0	9940	0	9959
25370	1	25	0	9880	0	9906
25371	10365	2	12	1	0	10380
25372	1	10219	0	6	0	10226
25373	10073	1	16	4	0	10094
25374	0	40	1	10046	0	10087
25375	0	9	0	9810	0	9819
25376	10263	0	14	0	0	10277
25377	0	10358	2	7	0	10367
25378	10167	0	43	1	0	10211
25379	0	10135	0	9	0	10144
25380	9734	0	13	3	0	9750
25381	2	14	2	10118	0	10136
25382	10159	0	12	1	0	10172
25383	9856	5	21	4	0	9886
25384	9951	1	27	0	0	9979
25385	0	9460	0	8	0	9468
25386	8	0	9305	1	0	9314
25387	9407	2	16	2	0	9427
25388	9457	1	19	0	0	9477
25389	2	10001	1	1	0	10005
25390	3	28	0	9838	0	9869
25391	2	18	1	9856	0	9877
25392	9924	1	10	1	0	9936
25393	3	18	2	9964	0	9987
25394	13	0	9947	0	0	9960
25395	7	0	9971	2	0	9980
25396	9697	0	11	5	0	9713
25397	2	26	1	10004	0	10033
25398	1	28	1	9707	0	9737
25399	3	13	0	9762	0	9778
25400	3	0	10559	1	0	10563
25401	0	32	5	10485	0	10522
25402	3	27	1	10444	0	10475
25403	0	13	3	10557	0	10573
25404	10559	1	15	0	0	10575
25405	1	32	2	10551	0	10586
25406	9	0	10479	0	0	10488
25407	10348	0	19	3	0	10370
25408	5	0	10466	5	0	10476
25409	9747	0	31	3	0	9781
25410	9786	2	19	1	0	9808
25411	4	25	0	9666	0	9695
25412	0	9823	0	4	0	9827
25413	0	41	0	9774	0	9815
25414	3	41	0	10063	0	10107
25415	1	9638	1	2	0	9642
25416	10097	2	24	2	0	10125
25417	1	10297	1	7	0	10306
25418	10432	0	18	3	0	10453
25419	10515	0	29	1	0	10545
25420	0	12	1	10588	0	10601
25421	2	29	1	10388	0	10420
25422	5	0	10345	2	0	10352
25423	12	1	10626	8	0	10647
25424	10600	3	23	2	0	10628
25425	10758	0	26	1	0	10785
25426	1	9842	0	0	0	9843
25427	1	21	1	9519	0	9542
25428	9	0	9581	3	0	9593
25429	4	23	2	9744	0	9773
25430	9769	0	20	0	0	9789
25431	9813	1	22	3	0	9839
25432	0	9906	0	8	0	9914
25433	0	35	2	10046	0	10083
25434	1	16	2	10089	0	10108
25435	0	34	2	9960	0	9996
25436	9	1	9791	11	0	9812
25437	9802	1	28	2	0	9833
25438	9793	0	46	0	0	9839
25439	11	0	9639	5	0	9655
25440	2	9804	0	11	0	9817
25441	9669	2	27	1	0	9699
25442	9629	1	20	0	0	9650
25443	5	0	9757	2	0	9764
25444	8	0	9905	0	0	9913
25445	2	10	1	9810	0	9823
25446	13	0	9758	2	0	9773
25447	9445	1	32	2	0	9480
25448	9685	0	31	4	0	9720
25449	10054	0	22	1	0	10077
25450	1	16	1	10035	0	10053
25451	0	9685	0	4	0	9689
25452	9610	1	12	1	0	9624
25453	9339	1	20	2	0	9362
25454	7	0	9340	0	0	9347
25455	14	0	9239	0	0	9253
25456	9356	1	20	1	0	9378
25457	1	32	0	9020	0	9053
25458	18	1	8983	1	0	9003
25459	4	9911	2	14	0	9931
25460	0	10	0	9937	0	9947
25461	9995	3	16	4	0	10018
25462	1	9789	0	5	0	9795
25463	3	35	3	9674	0	9715
25464	1	9729	0	6	0	9736
25465	2	9582	0	1	0	9585
25466	3	26	0	9509	0	9538
25467	3	35	0	9507	0	9545
25468	0	9536	0	0	0	9536
25469	9474	2	25	2	0	9503
25470	6	4	9537	0	0	9547
25471	9509	0	13	0	0	9522
25472	2	21	0	9508	0	9531
25473	6	15	3	9210	0	9234
25474	1	30	0	9210	0	9241
25475	0	15	2	9268	0	9285
25476	3	0	8535	0	0	8538
25477	3	32	2	8549	0	8586
25478	2	19	0	8558	0	8579
25479	0	8434	1	8	0	8443
25480	12	0	8433	1	0	8446
25481	1	8494	0	13	0	8508
25482	13	2	8509	0	0	8524
25483	1	8827	0	4	0	8832
25484	0	9	1	8886	0	8896
25485	9440	2	12	1	0	9455
25486	1	9289	1	16	0	9307
25487	1	40	2	9409	0	9452
25488	24	0	9436	1	0	9461
25489	2	9502	2	9	0	9515
25490	9406	1	17	4	0	9428
25491	9437	0	38	2	0	9477
25492	0	8542	1	6	0	8549
25493	4	0	8519	1	0	8524
25494	8371	1	24	0	0	8396
25495	2	10	2	8358	0	8372
25496	8398	0	9	0	0	8407
25497	1	8428	0	29	0	8458
25498	3	8096	0	4	0	8103
25499	7	1	8199	0	0	8207
25500	8907	1	12	2	0	8922
25501	1	13	0	9028	0	9042
25502	8925	2	17	0	0	8944
25503	0	8793	0	9	0	8802
25504	8609	0	22	2	0	8633
25505	8576	2	25	1	0	8604
25506	3	0	8622	0	0	8625
25507	2	8579	0	4	0	8585
25508	0	8722	0	1	0	8723
25509	5	26	1	8512	0	8544
25510	1	8560	0	7	0	8568
25511	8577	0	19	1	0	8597
25512	0	8675	4	6	0	8685
25513	4	29	1	8515	0	8549
25514	2	8787	0	5	0	8794
25515	2	8836	0	3	0	8841
25516	0	8856	0	10	0	8866
25517	2	31	4	8955	0	8992
25518	2	13	0	8928	0	8943
25519	1	20	1	9065	0	9087
25520	0	8948	0	69	0	9017
25521	7	2	8849	0	0	8858
25522	10	6	8755	0	0	8771
25523	8508	0	11	3	0	8522
25524	3	15	0	8347	0	8365
25525	9	1	8411	2	0	8423
25526	8	1	8593	2	0	8604
25527	1	8555	0	3	0	8559
25528	0	31	0	8456	0	8487
25529	1	11	1	8504	0	8517
25530	8622	1	9	0	0	8632
25531	0	14	0	8764	0	8778
25532	0	13	0	8601	0	8614
25533	16	0	8507	1	0	8524
25534	2	22	1	8013	0	8038
25535	1	18	0	7814	0	7833
25536	4	0	7725	2	0	7731
25537	5	0	7798	1	0	7804
25538	0	7856	2	4	0	7862
25539	2	0	7787	1	0	7790
25540	3	25	0	7617	0	7645
25541	0	20	0	7817	0	7837
25542	17	0	7767	1	0	7785
25543	9	10160	0	13	0	10182
25544	10380	2	22	2	0	10406
25545	0	10426	0	5	0	10431
25546	1	29	2	10238	0	10270
25547	2	36	2	10239	0	10279
25548	0	10379	0	11	0	10390
25549	1	24	1	10312	0	10338
25550	2	10	4	10507	0	10523
25551	11	0	10482	2	0	10495
25552	2	10595	1	8	0	10606
25553	10	26	1	10603	0	10640
25554	6	0	10745	1	0	10752
25555	2	31	15	10683	0	10731
25556	3	40	1	10726	0	10770
25557	3	34	16	10782	0	10835
25558	3	21	0	10805	0	10829
25559	2	23	1	10416	0	10442
25560	1	10046	0	1	0	10048
25561	9896	2	33	0	0	9931
25562	18	1	9842	4	0	9865
25563	9895	1	36	6	0	9938
25564	9	1	10105	0	0	10115
25565	0	9926	2	21	0	9949
25566	9	0	9923	1	0	9933
25567	2	10056	0	4	0	10062
25568	4	41	2	10048	0	10095
25569	4	25	0	10224	0	10253
25570	6	9967	0	10	0	9983
25571	2	10031	2	14	0	10049
25572	10079	1	16	3	0	10099
25573	10000	1	18	1	0	10020
25574	10166	1	27	3	0	10197
25575	10317	1	25	4	0	10347
25576	4	20	1	9749	0	9774
25577	0	9780	0	13	0	9793
25578	9743	2	13	2	0	9760
25579	2	6	0	9768	0	9776
25580	9739	0	13	1	0	9753
25581	9695	1	17	1	0	9714
25582	4	9867	1	12	0	9884
25583	4	9842	1	14	0	9861
25584	0	10004	1	7	0	10012
25585	5	32	1	9722	0	9760
25586	1	10151	0	10	0	10162
25587	10160	0	15	4	0	10179
25588	10043	1	11	0	0	10055
25589	10063	3	16	1	0	10083
25590	9938	4	19	3	0	9964
25591	9824	0	47	0	0	9871
25592	3	0	9666	1	0	9670
25593	9557	0	28	1	0	9586
25594	2	0	9740	0	0	9742
25595	9586	0	40	4	0	9630
25596	3	20	1	9756	0	9780
25597	9	0	9717	3	0	9729
25598	18	0	9803	1	0	9822
25599	3	9916	0	5	0	9924
25600	10236	1	27	1	0	10265
25601	9991	1	25	1	0	10018
25602	3	9885	1	41	0	9930
25603	2	18	0	10053	0	10073
25604	10079	1	23	1	0	10104
25605	5	2	10066	0	0	10073
25606	3	9878	0	13	0	9894
25607	9889	0	19	2	0	9910
25608	0	10142	1	3	0	10146
25609	2	25	2	9742	0	9771
25610	2	13099	0	3	0	13104
25611	5	44	2	12953	0	13004
25612	1	13093	0	16	0	13110
25613	2	13058	0	27	0	13087
25614	13140	2	37	6	0	13185
25615	13039	1	20	3	0	13063
25616	9	0	12992	2	0	13003
25617	14	1	12843	3	0	12861
25618	19	0	12911	4	0	12934
25619	4	19	1	10026	0	10050
25620	11	0	10129	0	0	10140
25621	0	42	0	10027	0	10069
25622	7	22	0	10055	0	10084
25623	0	10085	0	7	0	10092
25624	10098	2	29	0	0	10129
25625	0	10227	0	8	0	10235
25626	3	31	1	9977	0	10012
25627	2	18	0	9967	0	9987
25628	1	9	0	9928	0	9938
25629	3	0	10126	0	0	10129
25630	1	24	5	9929	0	9959
25631	2	40	0	9905	0	9947
25632	1	33	0	9935	0	9969
25633	16	0	9849	1	0	9866
25634	2	10096	1	7	0	10106
25635	10153	1	11	1	0	10166
25636	10164	0	32	5	0	10201
25637	1	10284	0	10	0	10295
25638	4	33	1	10345	0	10383
25639	0	25	1	10542	0	10568
25640	2	0	10518	7	0	10527
25641	1	10434	0	3	0	10438
25642	1	23	0	10493	0	10517
25643	3	0	10615	0	0	10618
25644	1	29	2	10756	0	10788
25645	4	32	4	11189	0	11229
25646	7	0	11204	1	0	11212
25647	6	35	1	11226	0	11268
25648	2	15	0	11222	0	11239
25649	17	0	11488	2	0	11507
25650	3	21	1	11279	0	11304
25651	1	25	1	11263	0	11290
25652	1	33	0	11275	0	11309
25653	1	0	11331	3	0	11335
25654	0	16	2	11484	0	11502
25655	11503	1	12	3	0	11519
25656	11463	1	28	5	0	11497
25657	2	11633	0	14	0	11649
25658	11405	3	20	8	0	11436
25659	6	0	11513	0	0	11519
25660	3	33	3	11658	0	11697
25661	3	19	0	11680	0	11702
25662	2	19	0	11998	0	12019
25663	12120	2	29	5	0	12156
25664	0	12545	0	18	0	12563
25665	2	30	0	12520	0	12552
25666	1	12485	0	6	0	12492
25667	12125	2	41	5	0	12173
25668	0	12207	0	12	0	12219
25669	12138	0	31	2	0	12171
25670	0	12453	0	18	0	12471
25671	0	12302	0	15	0	12317
25672	3	65	0	12108	0	12176
25673	0	24	1	13335	0	13360
25674	0	47	1	13914	0	13962
25675	1	13	0	14035	0	14049
25676	11	0	13648	3	0	13662
25677	1	13437	0	13	0	13451
25678	4	44	0	13296	0	13344
25679	3	13322	2	7	0	13334
25680	15	1	13240	1	0	13257
25681	3	24	0	13628	0	13655
25682	1	29	1	13548	0	13579
25683	8	0	13527	2	0	13537
25684	1	10206	0	28	0	10235
25685	1	21	0	10205	0	10227
25686	6	0	10151	3	0	10160
25687	1	10065	1	21	0	10088
25688	5	17	1	10068	0	10091
25689	12	1	10029	4	0	10046
25690	15	0	10814	6	0	10835
25691	0	11020	2	17	0	11039
25692	2	10934	0	9	0	10945
25693	4	18	2	10903	0	10927
25694	1	11	2	11025	0	11039
25695	9	0	11004	1	0	11014
25696	11131	0	21	2	0	11154
25697	11083	1	52	1	0	11137
25698	12	1	11095	3	0	11111
25699	1	11040	0	9	0	11050
25700	5	10943	1	8	0	10957
25701	7	11370	1	14	0	11392
25702	0	11516	0	3	0	11519
25703	0	30	3	11446	0	11479
25704	0	36	4	11529	0	11569
25705	4	30	1	11446	0	11481
25706	8	23	0	11636	0	11667
25707	0	11884	0	12	0	11896
25708	5	46	2	11497	0	11550
25709	1	11728	1	3	0	11733
25710	2	25	2	11417	0	11446
25711	11952	3	14	1	0	11970
25712	4	22	0	12141	0	12167
25713	3	12334	2	7	0	12346
25714	4	39	1	12088	0	12132
25715	3	19	1	12001	0	12024
25716	1	13	1	12026	0	12041
25717	11955	0	6	1	0	11962
25718	1	31	1	11917	0	11950
25719	11	0	12062	2	0	12075
25720	1	12076	1	11	0	12089
25721	1	44	2	11521	0	11568
25722	1	28	2	11616	0	11647
25723	0	14	1	11687	0	11702
25724	11946	0	9	0	0	11955
25725	11	0	11896	1	0	11908
25726	1	35	0	11889	0	11925
25727	1	11654	0	7	0	11662
25728	3	27	0	11480	0	11510
25729	11838	0	22	3	0	11863
25730	2	11942	2	7	0	11953
25731	3	25	2	12039	0	12069
25732	6	24	1	12046	0	12077
25733	0	11367	0	6	0	11373
25734	4	32	3	11440	0	11479
25735	1	19	1	11587	0	11608
25736	26	0	11571	2	0	11599
25737	2	11506	0	7	0	11515
25738	11047	3	28	0	0	11078
25739	9	0	11168	0	0	11177
25740	10713	1	37	2	0	10753
25741	2	0	12606	0	0	12608
25742	1	9	3	13092	0	13105
25743	13074	2	17	4	0	13097
25744	1	16	2	13006	0	13025
25745	12965	1	24	1	0	12991
25746	12593	5	36	1	0	12635
25747	12650	0	29	3	0	12682
25748	5	12850	0	3	0	12858
25749	1	21	2	11418	0	11442
25750	0	13	0	10953	0	10966
25751	0	21	1	10795	0	10817
25752	5	0	10815	1	0	10821
25753	1	18	0	10872	0	10891
25754	10844	2	9	1	0	10856
25755	10735	0	28	3	0	10766
25756	3	1	11451	6	0	11461
25757	11197	0	44	1	0	11242
25758	11473	0	18	0	0	11491
25759	0	7	6	11517	0	11530
25760	11582	0	26	2	0	11610
25761	11780	0	24	3	0	11807
25762	4	8	0	12121	0	12133
25763	12046	2	32	0	0	12080
25764	12037	2	7	2	0	12048
25765	1	5	0	11135	0	11141
25766	3	0	11021	6	0	11030
25767	10691	0	24	2	0	10717
25768	4	0	11045	1	0	11050
25769	15	1	11108	3	0	11127
25770	1	11163	0	6	0	11170
25771	0	33	1	10999	0	11033
25772	1	16	0	11127	0	11144
25773	3	25	0	11142	0	11170
25774	10	0	11035	2	0	11047
25775	9	0	11260	4	0	11273
25776	1	11103	0	11	0	11115
25777	3	27	2	10803	0	10835
25778	1	19	0	10884	0	10904
25779	1	17	2	10910	0	10930
25780	7	0	10807	1	0	10815
25781	1	10510	1	12	0	10524
25782	1	23	1	10713	0	10738
25783	15	1	10737	0	0	10753
25784	15	0	10760	4	0	10779
25785	10744	0	34	3	0	10781
25786	11067	0	31	1	0	11099
25787	10595	2	38	1	0	10636
25788	0	17	0	10279	0	10296
25789	4	1	10124	3	0	10132
25790	6	10490	0	13	0	10509
25791	1	12198	0	15	0	12214
25792	5	1	12239	1	0	12246
25793	3	40	1	12417	0	12461
25794	7	25	1	12657	0	12690
25795	4	12475	0	11	0	12490
25796	1	12579	0	9	0	12589
25797	12593	1	23	4	0	12621
25798	12473	2	19	1	0	12495
25799	15147	3	28	0	0	15178
25800	14828	5	32	3	0	14868
25801	15402	1	26	0	0	15429
25802	4	15682	1	0	0	15687
25803	5	15633	0	11	0	15649
25804	3	15389	0	6	0	15398
25805	15374	1	23	7	0	15405
25806	2	33	0	15373	0	15408
25807	1	18	1	15283	0	15303
25808	15929	0	23	3	0	15955
25809	2	16166	0	2	0	16170
25810	2	47	14	15754	0	15817
25811	2	31	4	15677	0	15714
25812	0	15	0	15761	0	15776
25813	15834	0	14	1	0	15849
25814	3	31	5	15805	0	15844
25815	32	0	15475	1	0	15508
25816	15454	0	54	3	0	15511
25817	3	20	0	13444	0	13467
25818	11	0	13342	2	0	13355
25819	6	13460	2	14	0	13482
25820	6	13463	0	9	0	13478
25821	13530	1	40	6	0	13577
25822	13708	1	33	0	0	13742
25823	0	13784	0	5	0	13789
25824	3	19	5	13662	0	13689
25825	13858	0	1	1	0	13860
25826	4	32	2	13799	0	13837
25827	0	26	2	13864	0	13892
25828	2	42	1	13917	0	13962
25829	2	29	1	13832	0	13864
25830	1	13365	0	4	0	13370
25831	2	96	2	13163	0	13263
25832	4	14	5	13365	0	13388
25833	1	20	2	13723	0	13746
25834	18	0	13564	3	0	13585
25835	1	13082	1	10	0	13094
25836	5	35	2	13041	0	13083
25837	10	1	13161	1	0	13173
25838	9	0	13190	3	0	13202
25839	1	13358	0	16	0	13375
25840	13449	0	32	3	0	13484
25841	3	25	1	14574	0	14603
25842	14796	2	24	1	0	14823
25843	2	15157	0	5	0	15164
25844	1	11	1	15259	0	15272
25845	15595	1	24	4	0	15624
25846	15476	3	25	0	0	15504
25847	1	26	0	15931	0	15958
25848	1	15	1	16363	0	16380
25849	7	0	21378	2	0	21387
25850	2	21	1	21059	0	21083
25851	0	13	2	21215	0	21230
25852	21286	2	16	0	0	21304
25853	0	16227	1	7146	0	23374
25854	25	1	23952	1	0	23979
25855	24357	2	44	6	0	24409
25856	0	28116	1	6	0	28123
25857	4	35	8	28062	0	28109
25858	45964	7	35	6	0	46012
25859	6	148	6	48366	0	48526
25860	3	78	2	48787	0	48870
25861	48	0	50045	10	0	50103
25862	12	69	2	50152	0	50235
25863	50658	3	80	6	0	50747
25864	6	88	4	50661	0	50759
25865	50522	3	81	12	0	50618
25866	9	68173	1	39	0	68222
25867	4	66246	3	61	0	66314
25868	22	218	11	70992	0	71243
25869	4	55	2	71502	0	71563
25870	71549	4	102	10	0	71665
25871	4	72726	0	53	0	72783
25872	72829	4	145	7	0	72985
25873	73289	7	155	8	0	73459
25874	3	111	4	74263	0	74381
25875	72231	1	73	11	0	72316
25876	83	0	74788	10	0	74881
25877	14	238	3	74331	0	74586
25878	61	2	74020	11	0	74094
25879	9	152	4	74748	0	74913
25880	74483	5	85	7	0	74580
25881	74424	8	221	18	0	74671
25882	3	74535	1	27	0	74566
25883	10	255	9	74511	0	74785
25884	8	185	5	74296	0	74494
25885	1	76333	1	50	0	76385
25886	9	283	5	76105	0	76402
25887	20	235	3	76423	0	76681
25888	4	76589	0	65	0	76658
25889	76453	14	145	15	0	76627
25890	76588	9	161	7	0	76765
25891	2	180	4	76978	0	77164
25892	18	232	0	77029	0	77279
25893	72	5	77081	31	0	77189
25894	17	260	7	78040	0	78324
25895	5	78403	2	39	0	78449
25896	78474	19	140	13	0	78646
25897	10	203	9	78630	0	78852
25898	5	138	2	79512	0	79657
25899	80129	12	96	6	0	80243
25900	2	83518	1	35	0	83556
25901	6	275	7	83416	0	83704
25902	37	264	4	82972	0	83277
25903	8	82914	3	84	0	83009
25904	82676	13	185	16	0	82890
25905	115	2	83184	12	0	83313
25906	62	1	82813	38	0	82914
25907	10	215	12	83228	0	83465
25908	78	2	82054	26	0	82160
25909	81421	15	200	40	0	81676
25910	34	198	9	82909	0	83150
25911	88	3	82542	21	0	82654
25912	154	11	82373	63	0	82601
25913	14	83869	3	80	0	83966
25914	83333	12	191	31	0	83567
25915	3	84719	4	244	0	84970
25916	84663	8	169	22	0	84862
25917	84078	5	138	10	0	84231
25918	1	83613	33	53	0	83700
25919	83066	4	203	24	0	83297
25920	82798	5	171	13	0	82987
25921	72	3	83244	8	0	83327
25922	33	273	2	84454	0	84762
25923	4	86161	0	59	0	86224
25924	2	81740	4	139	0	81885
25925	9	164	0	82404	0	82577
25926	82845	2	86	7	0	82940
25927	16	288	9	83351	0	83664
25928	14	231	4	88118	0	88367
25929	17	305	12	85936	0	86270
25930	2	82563	2	27	0	82594
25931	18	263	19	81862	0	82162
25932	60	0	82113	12	0	82185
25933	82084	13	166	25	0	82288
25934	65995	4	218	7	0	66224
25935	6	63860	0	61	0	63927
25936	63949	8	106	8	0	64071
25937	4	129	7	63363	0	63503
25938	47	3	63249	14	0	63313
25939	63738	7	153	26	0	63924
25940	3	48394	1	33	0	48431
25941	22	89	6	48445	0	48562
25942	49304	3	51	10	0	49368
25943	8	44549	5	49	0	44611
25944	2	44527	1	32	0	44562
25945	44412	8	75	33	0	44528
25946	28	1	45162	3	0	45194
25947	44412	7	97	9	0	44525
25948	8	76	7	44694	0	44785
25949	13	95	8	44068	0	44184
25950	35	1	43911	9	0	43956
25951	31	1	43442	10	0	43484
25952	7	96	11	42178	0	42292
25953	73	3	42297	3	0	42376
25954	35	2	43631	7	0	43675
25955	7	104	7	43499	0	43617
25956	4	81	4	44746	0	44835
25957	45190	1	58	6	0	45255
25958	4	64	4	45086	0	45158
25959	44980	3	57	4	0	45044
25960	4	43234	1	26	0	43265
25961	11	124	4	42918	0	43057
25962	33	5	43403	5	0	43446
25963	45675	2	93	11	0	45781
25964	45827	2	86	4	0	45919
25965	45881	4	128	7	0	46020
25966	46309	5	92	7	0	46413
25967	46457	2	96	6	0	46561
25968	3	64	6	46534	0	46607
25969	42	0	45667	5	0	45714
25970	41	3	45045	10	0	45099
25971	53	1	44555	11	0	44620
25972	45117	5	116	19	0	45257
25973	46349	7	125	2	0	46483
25974	14	117	2	45502	0	45635
25975	5	41704	1	13	0	41723
25976	12	117	7	42094	0	42230
25977	42	0	42350	4	0	42396
25978	54	1	43207	9	0	43271
25979	44576	3	92	18	0	44689
25980	24	1	47024	0	0	47049
25981	2	53	5	46946	0	47006
25982	48071	4	43	4	0	48122
25983	49027	3	96	7	0	49133
25984	50712	5	109	6	0	50832
25985	50937	6	177	12	0	51132
25986	28	0	50700	2	0	50730
25987	50436	4	137	16	0	50593
25988	1	50107	1	20	0	50129
25989	14	117	11	49062	0	49204
25990	51	2	52557	4	0	52614
25991	14	140	7	53815	0	53976
25992	67	1	54692	1	0	54761
25993	11	164	6	55317	0	55498
25994	15	180	3	55056	0	55254
25995	42	11	60775	6	0	60834
25996	12	79	11	63790	0	63892
25997	64014	5	85	4	0	64108
25998	13	176	5	63426	0	63620
25999	6	119	3	60516	0	60644
26000	61427	2	102	18	0	61549
26001	0	61036	0	81	0	61117
26002	60480	4	150	20	0	60654
26003	2	60377	1	48	0	60428
26004	55548	10	100	24	0	55682
26005	38	3	57111	1	0	57153
26006	10	151	10	58694	0	58865
26007	5	80	5	58775	0	58865
26008	58613	6	52	2	0	58673
26009	6	59077	3	32	0	59118
26010	12	254	7	58767	0	59040
26011	29	162	4	58829	0	59024
26012	5	58622	5	28	0	58660
26013	58941	8	110	12	0	59071
26014	1	58502	0	15	0	58518
26015	2	214	9	57688	0	57913
26016	10	127	5	57721	0	57863
26017	4	57924	2	27	0	57957
26018	56923	10	132	19	0	57084
26019	27	1	58084	8	0	58120
26020	58203	15	146	16	0	58380
26021	6	58218	0	45	0	58269
26022	10	107	8	57919	0	58044
26023	62259	4	65	6	0	62334
26024	6	151	9	62002	0	62168
26025	9	95	3	63042	0	63149
26026	62947	9	63	15	0	63034
26027	9	61813	1	84	0	61907
26028	4	61045	3	37	0	61089
26029	60328	8	90	20	0	60446
26030	80	2	61580	11	0	61673
26031	6	62333	1	33	0	62373
26032	12	189	11	60880	0	61092
26033	52	0	61895	23	0	61970
26034	6	125	6	62212	0	62349
26035	62680	2	87	12	0	62781
26036	9	62050	0	23	0	62082
26037	23	193	9	61131	0	61356
26038	7	61712	3	56	0	61778
26039	59129	7	102	22	0	59260
26040	61683	8	101	7	0	61799
26041	4	63462	0	37	0	63503
26042	17	149	5	62404	0	62575
26043	6	63559	22	31	0	63618
26044	63240	7	92	13	0	63352
26045	64605	9	127	5	0	64746
26046	6	125	4	64850	0	64985
26047	7	76	3	64276	0	64362
26048	20	5	64611	14	0	64650
26049	63733	11	148	26	0	63918
26050	48	1	66608	3	0	66660
26051	9	99	3	66982	0	67093
26052	66431	0	72	10	0	66513
26053	3	65211	0	37	0	65251
26054	63990	9	161	12	0	64172
26055	24	2	63923	19	0	63968
26056	62909	16	154	13	0	63092
26057	7	63483	1	31	0	63522
26058	62497	5	120	33	0	62655
26059	1	61854	0	121	0	61976
26060	18	157	12	59900	0	60087
26061	48	1	60657	5	0	60711
26062	43	1	62619	12	0	62675
26063	10	183	14	61967	0	62174
26064	35	0	61914	12	0	61961
26065	8	139	7	61728	0	61882
26066	8	131	5	57339	0	57483
26067	34	2	56965	24	0	57025
26068	56286	0	129	24	0	56439
26069	57428	3	166	14	0	57611
26070	3	52634	0	41	0	52678
26071	50057	5	113	10	0	50185
26072	7	124	5	50342	0	50478
26073	98	2	49427	8	0	49535
26074	16	127	7	49390	0	49540
26075	10	115	3	49550	0	49678
26076	49660	2	79	9	0	49750
26077	9	49948	2	57	0	50016
26078	2	48894	0	23	0	48919
26079	11	182	10	48698	0	48901
26080	15	172	4	49684	0	49875
26081	6	48908	1	16	0	48931
26082	7	229	5	48398	0	48639
26083	29	181	3	48300	0	48513
26084	1	48101	0	32	0	48134
26085	48312	3	73	8	0	48396
26086	25	159	3	48011	0	48198
26087	6	49048	1	21	0	49076
26088	26	124	6	49066	0	49222
26089	50762	2	72	13	0	50849
26090	8	50950	4	45	0	51007
26091	50334	2	124	7	0	50467
26092	50840	7	89	9	0	50945
26093	7	50	3	50907	0	50967
26094	51822	2	41	7	0	51872
26095	50598	5	58	14	0	50675
26096	50758	5	110	1	0	50874
26097	51116	5	81	15	0	51217
26098	4	93	8	51581	0	51686
26099	7	128	7	47255	0	47397
26100	34	0	47807	7	0	47848
26101	10	117	0	47994	0	48121
26102	15	139	5	47912	0	48071
26103	51	0	47828	7	0	47886
26104	47484	4	104	12	0	47604
26105	6	83	5	48167	0	48261
26106	49	1	45896	6	0	45952
26107	45088	5	157	20	0	45270
26108	29	0	47403	8	0	47440
26109	10	46359	4	53	0	46426
26110	3	48661	3	34	0	48701
26111	13	155	19	49277	0	49464
26112	38	3	49982	2	0	50025
26113	49927	6	120	20	0	50073
26114	49568	5	156	13	0	49742
26115	19	1	50033	2	0	50055
26116	48021	2	101	12	0	48136
26117	46313	1	162	5	0	46481
26118	1	45480	0	26	0	45507
26119	45066	4	109	2	0	45181
26120	8	105	4	45150	0	45267
26121	55	2	44231	6	0	44294
26122	35	136	8	44225	0	44404
26123	21	43747	1	60	0	43829
26124	8	43217	1	35	0	43261
26125	43838	3	47	7	0	43895
26126	42182	0	70	4	0	42256
26127	42131	4	72	7	0	42214
26128	10	61	5	42238	0	42314
26129	8	136	2	42021	0	42167
26130	3	40979	1	18	0	41001
26131	42618	3	78	10	0	42709
26132	1	41743	0	21	0	41765
26133	43048	5	134	10	0	43197
26134	1	42992	0	24	0	43017
26135	42277	1	86	6	0	42370
26136	43702	4	101	8	0	43815
26137	19	66	4	43026	0	43115
26138	6	41591	6	45	0	41648
26139	36	1	41238	10	0	41285
26140	41117	3	87	16	0	41223
26141	4	41467	1	26	0	41498
26142	57	2	41106	11	0	41176
26143	68	2	41315	12	0	41397
26144	9	154	1	41850	0	42014
26145	7	123	4	40832	0	40966
26146	4	40664	0	33	0	40701
26147	41140	3	82	3	0	41228
26148	14	101	4	41058	0	41177
26149	6	41058	1	71	0	41136
26150	5	40884	2	35	0	40926
26151	41	9	40626	7	0	40683
26152	63	0	39949	7	0	40019
26153	39309	6	90	10	0	39415
26154	73	4	40390	0	0	40467
26155	6	107	5	40116	0	40234
26156	10	93	3	39736	0	39842
26157	39	0	39734	0	0	39773
26158	5	124	3	40691	0	40823
26159	8	62	2	41725	0	41797
26160	41453	4	52	3	0	41512
26161	41203	11	83	6	0	41303
26162	12	118	6	41626	0	41762
26163	9	40732	0	19	0	40760
26164	2	40581	0	25	0	40608
26165	38543	3	83	12	0	38641
26166	32	1	38323	3	0	38359
26167	5	59	4	41184	0	41252
26168	40919	2	45	1	0	40967
26169	40778	2	82	6	0	40868
26170	8	74	3	39563	0	39648
26171	39	4	39278	1	0	39322
26172	45	4	39817	15	0	39881
26173	39501	1	74	6	0	39582
26174	42599	1	78	4	0	42682
26175	9	41657	2	31	0	41699
26176	7	41750	0	29	0	41786
26177	42173	2	42	7	0	42224
26178	43051	0	53	5	0	43109
26179	6	70	7	43327	0	43410
26180	14	81	4	43195	0	43294
26181	6	63	2	43062	0	43133
26182	43895	1	35	6	0	43937
26183	7	109	3	42869	0	42988
26184	26	0	41546	3	0	41575
26185	41182	4	80	11	0	41277
26186	8	98	2	38831	0	38939
26187	64	0	38098	3	0	38165
26188	37674	11	75	13	0	37773
26189	37853	1	97	7	0	37958
26190	14	38156	0	11	0	38181
26191	11	37393	0	36	0	37440
26192	50	2	37762	4	0	37818
26193	37687	5	79	29	0	37800
26194	7	38149	4	24	0	38184
26195	34	0	38192	1	0	38227
26196	38303	1	77	10	0	38391
26197	1	37872	2	25	0	37900
26198	42	0	38545	6	0	38593
26199	39655	2	88	22	0	39767
26200	4	41409	1	24	0	41438
26201	1	72	0	41098	0	41171
26202	41682	4	45	7	0	41738
26203	3	41878	0	15	0	41896
26204	8	71	8	42525	0	42612
26205	42064	4	120	12	0	42200
26206	34	1	42392	6	0	42433
26207	7	41883	0	67	0	41957
26208	46	1	42033	3	0	42083
26209	14	138	5	44528	0	44685
26210	55	2	44453	10	0	44520
26211	20	43495	1	32	0	43548
26212	6	43523	0	18	0	43547
26213	13	159	0	45436	0	45608
26214	14	166	6	45630	0	45816
26215	5	167	3	50533	0	50708
26216	35	12	50689	4	0	50740
26217	7	85	5	51099	0	51196
26218	51053	5	85	2	0	51145
26219	50101	3	134	15	0	50253
26220	62	4	50037	2	0	50105
26221	16	49850	0	21	0	49887
26222	49579	5	89	7	0	49680
26223	10	49840	3	34	0	49887
26224	49594	0	105	11	0	49710
26225	49750	3	118	10	0	49881
26226	28	0	50136	1	0	50165
26227	5	49153	1	23	0	49182
26228	9	127	16	49338	0	49490
26229	25	1	49481	8	0	49515
26230	49841	0	103	14	0	49958
26231	8	94	4	49857	0	49963
26232	72	2	48877	2	0	48953
26233	47447	6	143	25	0	47621
26234	33	1	49736	4	0	49774
26235	7	97	3	48970	0	49077
26236	48960	1	76	11	0	49048
26237	3	48119	3	30	0	48155
26238	49	0	47679	12	0	47740
26239	47719	3	90	11	0	47823
26240	47634	3	119	4	0	47760
26241	1	49792	2	24	0	49819
26242	7	128	9	49185	0	49329
26243	7	46	1	47646	0	47700
26244	47549	0	52	4	0	47605
26245	14	157	13	47414	0	47598
26246	72	1	47958	2	0	48033
26247	15	80	5	48168	0	48268
26248	47218	1	63	18	0	47300
26249	7	47416	5	60	0	47488
26250	30	154	6	43609	0	43799
26251	6	44534	1	17	0	44558
26252	43855	4	36	9	0	43904
26253	6	110	1	43255	0	43372
26254	9	60	3	42360	0	42432
26255	3	42146	2	26	0	42177
26256	34	9	42160	0	0	42203
26257	4	166	4	42534	0	42708
26258	2	141	3	41463	0	41609
26259	16	91	0	42773	0	42880
26260	5	43115	2	25	0	43147
26261	55	3	43100	4	0	43162
26262	38	0	43259	7	0	43304
26263	42872	10	68	13	0	42963
26264	42803	5	129	11	0	42948
26265	10	0	42757	1	0	42768
26266	41972	3	131	15	0	42121
26267	11	0	42787	5	0	42803
26268	42480	3	142	10	0	42635
26269	3	42822	0	99	0	42924
26270	42399	6	131	21	0	42557
26271	24	3	42649	10	0	42686
26272	38	2	45963	11	0	46014
26273	8	76	1	46577	0	46662
26274	47787	3	63	8	0	47861
26275	3	47116	0	37	0	47156
26276	36	1	46931	1	0	46969
26277	7	114	2	47163	0	47286
26278	4	71	1	46717	0	46793
26279	46466	2	41	5	0	46514
26280	46163	2	56	5	0	46226
26281	4	49	4	46614	0	46671
26282	47868	6	61	4	0	47939
26283	34	0	48937	5	0	48976
26284	7	95	8	45119	0	45229
26285	4	50	1	46115	0	46170
26286	45811	2	44	10	0	45867
26287	46028	1	73	6	0	46108
26288	7	71	2	46091	0	46171
26289	43481	2	59	4	0	43546
26290	25	0	43952	5	0	43982
26291	1	39349	1	40	0	39391
26292	27	2	39258	6	0	39293
26293	6	51	2	39301	0	39360
26294	40797	4	46	6	0	40853
26295	2	41303	2	21	0	41328
26296	5	141	0	40887	0	41033
26297	11	162	4	41562	0	41739
26298	2	41173	0	49	0	41224
26299	4	256	8	40710	0	40978
26300	5	88	5	40891	0	40989
26301	12	136	3	40582	0	40733
26302	2	51	5	41385	0	41443
26303	9	129	5	41279	0	41422
26304	2	41041	11	9	0	41063
26305	12	138	3	42429	0	42582
26306	2	57	0	42222	0	42281
26307	37	1	42028	12	0	42078
26308	1	41209	1	23	0	41234
26309	4	155	7	41296	0	41462
26310	5	117	3	41835	0	41960
26311	6	110	3	41973	0	42092
26312	2	42307	2	25	0	42336
26313	83	4	42767	2	0	42856
26314	16	77	5	43994	0	44092
26315	47	1	43193	5	0	43246
26316	64	3	44790	9	0	44866
26317	6	63	5	42270	0	42344
26318	43080	4	64	3	0	43151
26319	4	113	7	42379	0	42503
26320	16	145	6	42564	0	42731
26321	3	42480	2	9	0	42494
26322	13	130	6	41819	0	41968
26323	4	96	3	41946	0	42049
26324	64	1	41521	16	0	41602
26325	4	42074	1	39	0	42118
26326	1	84	3	42768	0	42856
26327	42793	0	83	13	0	42889
26328	30	1	42858	2	0	42891
26329	13	124	13	44162	0	44312
26330	6	71	2	44223	0	44302
26331	45097	2	67	2	0	45168
26332	0	44539	0	297	0	44836
26333	44613	3	81	28	0	44725
26334	1	45159	1	24	0	45185
26335	12	79	10	44265	0	44366
26336	44344	7	100	6	0	44457
26337	54	3	44159	12	0	44228
26338	12	43979	8	47	0	44046
26339	11	44014	2	55	0	44082
26340	44114	8	62	12	0	44196
26341	7	102	15	47285	0	47409
26342	15	46914	3	23	0	46955
26343	3	46644	0	25	0	46672
26344	11	114	2	46798	0	46925
26345	4	67	2	46462	0	46535
26346	46201	3	51	4	0	46259
26347	2	45676	1	18	0	45697
26348	25	106	9	45464	0	45604
26349	46	1	45276	13	0	45336
26350	6	41651	3	31	0	41691
26351	43	4	41302	5	0	41354
26352	5	41761	1	27	0	41794
26353	8	137	7	41345	0	41497
26354	11	100	0	42054	0	42165
26355	5	41087	0	26	0	41118
26356	37	1	41297	4	0	41339
26357	40691	6	51	15	0	40763
26358	6	102	3	38409	0	38520
26359	11	69	2	37351	0	37433
26360	59	0	38715	3	0	38777
26361	17	72	3	38079	0	38171
26362	27	3	38419	5	0	38454
26363	9	105	10	37705	0	37829
26364	24	1	37657	14	0	37696
26365	5	37244	3	69	0	37321
26366	30	2	37330	2	0	37364
26367	5	63	1	37763	0	37832
26368	37639	5	50	9	0	37703
26369	2	37858	0	15	0	37875
26370	9	77	0	36030	0	36116
26371	39	7	36317	6	0	36369
26372	9	36361	0	31	0	36401
26373	3	116	7	35818	0	35944
26374	97	4	36636	6	0	36743
26375	8	36937	1	49	0	36995
26376	40058	4	62	10	0	40134
26377	40528	5	76	3	0	40612
26378	4	44	2	39406	0	39456
26379	39620	2	50	7	0	39679
26380	6	63	9	40088	0	40166
26381	8	76	5	38400	0	38489
26382	39	2	39117	9	0	39167
26383	12	88	3	38192	0	38295
26384	10	60	1	38630	0	38701
26385	38980	1	65	9	0	39055
26386	38485	5	95	5	0	38590
26387	1	38803	0	17	0	38821
26388	42	1	38624	0	0	38667
26389	9	63	7	37045	0	37124
26390	60	1	36665	6	0	36732
26391	35186	5	104	26	0	35321
26392	11	0	35865	1	0	35877
26393	8	102	3	36755	0	36868
26394	4	36087	0	6	0	36097
26395	6	136	2	36388	0	36532
26396	6	89	7	36681	0	36783
26397	24	0	36503	8	0	36535
26398	12	48	4	39190	0	39254
26399	39313	1	51	4	0	39369
26400	38917	3	117	8	0	39045
26401	37683	7	61	5	0	37756
26402	37274	14	108	5	0	37401
26403	2	37058	1	20	0	37081
26404	0	35976	1	8	0	35985
26405	1	111	3	35416	0	35531
26406	4	62	1	35544	0	35611
26407	2	36197	0	19	0	36218
26408	2	115	1	36636	0	36754
26409	3	90	2	37408	0	37503
26410	6	66	6	37159	0	37237
26411	4	53	4	36970	0	37031
26412	9	47	0	38288	0	38344
26413	38354	3	51	6	0	38414
26414	1	40795	1	24	0	40821
26415	23	1	41045	4	0	41073
26416	11	164	29	40305	0	40509
26417	12	90	6	38060	0	38168
26418	0	49	1	37947	0	37997
26419	39080	5	36	12	0	39133
26420	2	38739	0	16	0	38757
26421	12	128	2	38503	0	38645
26422	6	38401	0	35	0	38442
26423	11	134	17	37324	0	37486
26424	6	37344	1	32	0	37383
26425	44	1	37482	2	0	37529
26426	12	108	4	37911	0	38035
26427	6	0	38114	3	0	38123
26428	3	85	0	37631	0	37719
26429	5	23	1	37592	0	37621
26430	36879	3	44	4	0	36930
26431	36777	1	32	7	0	36817
26432	36535	7	51	8	0	36601
26433	36509	2	90	5	0	36606
26434	36634	2	73	4	0	36713
26435	2	63	3	36479	0	36547
26436	1	34953	0	19	0	34973
26437	4	68	4	34635	0	34711
26438	16	0	34696	1	0	34713
26439	34603	3	63	12	0	34681
26440	34604	2	47	3	0	34656
26441	7	100	2	35373	0	35482
26442	8	92	2	35021	0	35123
26443	1	36769	2	30	0	36802
26444	4	109	3	36730	0	36846
26445	9	76	1	36681	0	36767
26446	3	36444	1	34	0	36482
26447	9	100	3	36364	0	36476
26448	36446	4	67	5	0	36522
26449	12	1	36373	0	0	36386
26450	34962	4	112	6	0	35084
26451	36	1	35711	3	0	35751
26452	2	61	3	33137	0	33203
26453	6	79	3	32603	0	32691
26454	11	32503	1	19	0	32534
26455	4	30749	2	13	0	30768
26456	9	68	7	30839	0	30923
26457	19	2	30867	1	0	30889
26458	31034	6	97	8	0	31145
26459	7	94	6	31008	0	31115
26460	0	30802	0	11	0	30813
26461	10	91	3	30549	0	30653
26462	9	86	5	30649	0	30749
26463	4	31116	0	12	0	31132
26464	15	46	5	30659	0	30725
26465	37	1	32383	3	0	32424
26466	48	8	32542	5	0	32603
26467	10	82	1	32697	0	32790
26468	5	32297	2	12	0	32316
26469	6	58	1	31809	0	31874
26470	32158	1	33	2	0	32194
26471	32369	2	82	4	0	32457
26472	34877	4	83	3	0	34967
26473	1	35190	0	29	0	35220
26474	31	4	33075	1	0	33111
26475	34018	2	66	5	0	34091
26476	34513	2	93	4	0	34612
26477	2	34617	2	14	0	34635
26478	3	36	1	34499	0	34539
26479	35773	3	49	1	0	35826
26480	36807	3	26	3	0	36839
26481	38395	5	22	4	0	38426
26482	7	23	0	38630	0	38660
26483	36921	2	18	5	0	36946
26484	3	35	1	36916	0	36955
26485	2	28	3	36359	0	36392
26486	38120	4	16	1	0	38141
26487	11	21	4	38044	0	38080
26488	35984	6	11	1	0	36002
26489	8	42	0	36060	0	36110
26490	1	32	3	34021	0	34057
26491	33650	5	9	5	0	33669
26492	18	0	34213	1	0	34232
26493	2	73	8	33600	0	33683
26494	4	95	4	33479	0	33582
26495	3	81	6	32060	0	32150
26496	4	78	4	32070	0	32156
26497	5	55	3	32083	0	32146
26498	0	31980	0	10	0	31990
26499	11	74	2	31740	0	31827
26500	15	9	32426	2	0	32452
26501	6	83	10	33271	0	33370
26502	6	75	1	33385	0	33467
26503	5	77	0	33354	0	33436
26504	13	3	33293	7	0	33316
26505	23	0	33256	12	0	33291
26506	33407	4	66	16	0	33493
26507	33843	2	133	7	0	33985
26508	2	34082	1	16	0	34101
26509	1	149	1	34365	0	34516
26510	4	34	2	34452	0	34492
26511	7	27	2	34839	0	34875
26512	34699	5	34	8	0	34746
26513	35394	5	45	2	0	35446
26514	8	42	1	35531	0	35582
26515	4	54	6	35351	0	35415
26516	8	49	9	35549	0	35615
26517	2	21	2	35415	0	35440
26518	35583	6	57	4	0	35650
26519	19	0	33507	3	0	33529
26520	12	35917	2	39	0	35970
26521	8	36733	1	35	0	36777
26522	36141	7	86	16	0	36250
26523	13	78	2	36358	0	36451
26524	51	1	36530	2	0	36584
26525	91	1	36458	13	0	36563
26526	3	36156	0	53	0	36212
26527	35662	6	106	13	0	35787
26528	23	0	35896	6	0	35925
26529	36547	5	95	8	0	36655
26530	6	100	0	38602	0	38708
26531	11	52	3	38779	0	38845
26532	19	38784	0	62	0	38865
26533	10	38675	1	29	0	38715
26534	38775	1	107	9	0	38892
26535	39105	8	127	11	0	39251
26536	0	39123	2	32	0	39157
26537	53	1	38571	3	0	38628
26538	24	3	41910	6	0	41943
26539	3	41	4	42126	0	42174
26540	42544	2	80	11	0	42637
26541	28	41595	1	20	0	41644
26542	12	46	4	41518	0	41580
26543	41735	2	48	8	0	41793
26544	4	87	26	41387	0	41504
26545	7	50	3	41140	0	41200
26546	41003	6	68	2	0	41079
26547	14	41335	0	22	0	41371
26548	3	38298	0	60	0	38361
26549	32	2	38358	2	0	38394
26550	2	88	6	37101	0	37197
26551	2	79	2	36285	0	36368
26552	19	1	35778	8	0	35806
26553	36893	2	52	7	0	36954
26554	36868	5	155	6	0	37034
26555	26	1	35468	1	0	35496
26556	34147	3	122	8	0	34280
26557	29	2	33796	3	0	33830
26558	3	32947	0	41	0	32991
26559	9	56	4	33091	0	33160
26560	9	30	2	34125	0	34166
26561	34115	1	21	11	0	34148
26562	32421	3	36	2	0	32462
26563	32416	3	36	0	0	32455
26564	32352	2	86	5	0	32445
26565	31976	2	103	1	0	32082
26566	29	1	31360	2	0	31392
26567	1	31310	0	24	0	31335
26568	9	73	1	31379	0	31462
26569	20	32116	1	59	0	32196
26570	9	32346	2	40	0	32397
26571	10	73	10	32742	0	32835
26572	7	78	3	33166	0	33254
26573	14	13	33561	6	0	33594
26574	33646	4	79	6	0	33735
26575	34112	7	101	11	0	34231
26576	5	34170	1	20	0	34196
26577	32708	4	98	8	0	32818
26578	33490	6	109	10	0	33615
26579	6	31	1	34579	0	34617
26580	22	0	34629	3	0	34654
26581	14	1	35880	7	0	35902
26582	35331	2	99	13	0	35445
26583	35515	4	146	6	0	35671
26584	11	35796	1	20	0	35828
26585	5	35608	5	28	0	35646
26586	5	59	3	36517	0	36584
26587	37828	10	78	4	0	37920
26588	18	0	39206	2	0	39226
26589	6	44	5	39041	0	39096
26590	38565	7	58	4	0	38634
26591	38513	6	87	6	0	38612
26592	3	35	1	40943	0	40982
26593	40511	5	73	4	0	40593
26594	20	0	40529	2	0	40551
26595	18	0	40466	21	0	40505
26596	8	100	12	38712	0	38832
26597	4	81	0	39757	0	39842
26598	11	97	4	40304	0	40416
26599	13	40019	1	9	0	40042
26600	4	40209	0	13	0	40226
26601	7	49	3	40292	0	40351
26602	40506	5	55	3	0	40569
26603	7	98	4	40162	0	40271
26604	5	51	1	40415	0	40472
26605	10	40057	0	19	0	40086
26606	1	38437	0	13	0	38451
26607	4	74	4	38248	0	38330
26608	0	43	1	38717	0	38761
26609	38718	4	65	8	0	38795
26610	2	38673	0	17	0	38692
26611	38078	6	102	18	0	38204
26612	4	49	10	38104	0	38167
26613	37	1	37589	11	0	37638
26614	13	741	34777	10	0	35541
26615	35196	3	79	7	0	35285
26616	4	56	4	34850	0	34914
26617	4	65	1	33972	0	34042
26618	4	66	0	34316	0	34386
26619	14	0	35129	3	0	35146
26620	14	77	3	35449	0	35543
26621	2	34893	1	8	0	34904
26622	11	113	8	36220	0	36352
26623	15	84	2	35756	0	35857
26624	11	35736	1	22	0	35770
26625	11	53	1	35845	0	35910
26626	35933	0	64	6	0	36003
26627	6	36556	0	21	0	36583
26628	35382	5	71	1	0	35459
26629	35527	1	62	5	0	35595
26630	20	71	4	35231	0	35326
26631	10	76	0	35233	0	35319
26632	2	73	4	35097	0	35176
26633	27	0	35369	4	0	35400
26634	15	35187	0	41	0	35243
26635	3	35824	0	45	0	35872
26636	11	30	3	35225	0	35269
26637	35378	4	71	9	0	35462
26638	8	49	5	35791	0	35853
26639	59	2	35949	4	0	36014
26640	10	36197	6	24	0	36237
26641	9	36126	0	42	0	36177
26642	35547	5	83	13	0	35648
26643	35504	5	97	7	0	35613
26644	6	34771	2	49	0	34828
26645	34547	6	118	2	0	34673
26646	44	0	35815	1	0	35860
26647	21	0	36853	4	0	36878
26648	35717	8	115	20	0	35860
26649	35686	6	118	5	0	35815
26650	7	48	2	35996	0	36053
26651	36015	2	61	6	0	36084
26652	15	2	35976	3	0	35996
26653	28	0	36121	1	0	36150
26654	1	75	20	35003	0	35099
26655	5	84	6	33662	0	33757
26656	4	48	4	32676	0	32732
26657	5	65	2	32998	0	33070
26658	4	49	3	33002	0	33058
26659	14	0	34936	2	0	34952
26660	9	34	6	35271	0	35320
26661	35203	1	70	5	0	35279
26662	7	41	3	34593	0	34644
26663	32675	0	14	6	0	32695
26664	3	22	1	33019	0	33045
26665	32531	0	18	2	0	32551
26666	32579	2	16	7	0	32604
26667	4	42	0	32674	0	32720
26668	0	18	2	30105	0	30125
26669	30824	4	11	3	0	30842
26670	30201	0	34	6	0	30241
26671	1	0	30504	2	0	30507
26672	1	35	1	30554	0	30591
26673	2	17	1	28949	0	28969
26674	28584	1	15	6	0	28606
26675	28853	3	12	5	0	28873
26676	10	39	3	28873	0	28925
26677	1	67	0	28776	0	28844
26678	2	51	4	28538	0	28595
26679	6	59	2	28688	0	28755
26680	3	28055	0	10	0	28068
26681	1	27753	1	15	0	27770
26682	12	54	1	27542	0	27609
26683	4	27427	1	20	0	27452
26684	6	42	4	27484	0	27536
26685	19	0	28011	5	0	28035
26686	21	0	28018	9	0	28048
26687	3	28160	3	23	0	28189
26688	9	52	2	28018	0	28081
26689	19	0	29956	4	0	29979
26690	3	58	1	30099	0	30161
26691	3	42	0	30118	0	30163
26692	30101	4	60	5	0	30170
26693	16	42	2	30069	0	30129
26694	40	1	29648	10	0	29699
26695	28	1	28977	10	0	29016
26696	12	28541	4	23	0	28580
26697	4	28695	2	19	0	28720
26698	27211	12	85	6	0	27314
26699	14	2	27387	2	0	27405
26700	2	26	1	27820	0	27849
26701	28097	3	23	2	0	28125
26702	28610	3	69	3	0	28685
26703	1	28259	0	2	0	28262
26704	4	62	2	27628	0	27696
26705	1	54	2	27678	0	27735
26706	3	33	4	28585	0	28625
26707	28787	3	46	1	0	28837
26708	15	0	28780	0	0	28795
26709	2	27989	1	33	0	28025
26710	3	57	1	27782	0	27843
26711	7	58	7	28631	0	28703
26712	10	0	29504	2	0	29516
26713	5	62	25	29880	0	29972
26714	4	63	8	29803	0	29878
26715	4	74	1	29682	0	29761
26716	7	62	2	29361	0	29432
26717	41	0	28949	21	0	29011
26718	8	46	2	29374	0	29430
26719	11	1	29100	12	0	29124
26720	0	28665	4	52	0	28721
26721	5	59	6	28379	0	28449
26722	13	62	3	28413	0	28491
26723	26	0	27442	3	0	27471
26724	5	27589	1	26	0	27621
26725	10	55	4	27995	0	28064
26726	19	2	28551	2	0	28574
26727	2	27695	2	21	0	27720
26728	5	45	1	27667	0	27718
26729	15	0	28199	3	0	28217
26730	6	52	27	28745	0	28830
26731	15	61	5	29473	0	29554
26732	3	31	1	29472	0	29507
26733	29101	2	50	10	0	29163
26734	2	27125	0	16	0	27143
26735	25886	3	80	5	0	25974
26736	16	0	26987	0	0	27003
26737	27392	2	77	7	0	27478
26738	27450	1	80	2	0	27533
26739	0	16	2	27729	0	27747
26740	26832	2	21	4	0	26859
26741	26986	8	36	3	0	27033
26742	27083	3	39	5	0	27130
26743	4	36	3	27189	0	27232
26744	6	49	3	27069	0	27127
26745	21	0	26131	2	0	26154
26746	11	1	25833	6	0	25851
26747	25925	5	58	10	0	25998
26748	9	54	4	25785	0	25852
26749	6	25483	0	43	0	25532
26750	27155	4	80	8	0	27247
26751	5	27415	0	18	0	27438
26752	4	27781	2	22	0	27809
26753	36	3	27721	2	0	27762
26754	34	3	28188	2	0	28227
26755	3	35	4	27879	0	27921
26756	20	1	27358	3	0	27382
26757	19	2	27593	5	0	27619
26758	27872	11	62	4	0	27949
26759	27942	1	87	5	0	28035
26760	3	68	2	28305	0	28378
26761	4	29	1	27783	0	27817
26762	15	1	27794	0	0	27810
26763	4	25239	1	24	0	25268
26764	6	47	1	25319	0	25373
26765	25420	1	51	4	0	25476
26766	16	49	0	25326	0	25391
26767	1	25775	1	29	0	25806
26768	20	2	25875	1	0	25898
26769	8	26067	0	23	0	26098
26770	26069	3	36	7	0	26115
26771	25767	0	63	4	0	25834
26772	1	36	1	25624	0	25662
26773	58	1	26193	2	0	26254
26774	14	0	27532	7	0	27553
26775	4	27165	0	27	0	27196
26776	7	63	2	27217	0	27289
26777	19	51	3	28175	0	28248
26778	10	0	29155	0	0	29165
26779	10	65	1	28973	0	29049
26780	1	29403	1	8	0	29413
26781	13	57	3	29657	0	29730
26782	3	58	0	29482	0	29543
26783	17	0	28996	6	0	29019
26784	9	29	2	29141	0	29181
26785	28994	3	53	6	0	29056
26786	15	4	29365	3	0	29387
26787	19	1	27950	6	0	27976
26788	1	27418	1	21	0	27441
26789	4	67	1	26871	0	26943
26790	5	93	3	26677	0	26778
26791	14	1	26866	4	0	26885
26792	27819	4	84	6	0	27913
26793	9	59	3	27932	0	28003
26794	15	0	28013	3	0	28031
26795	8	60	1	27114	0	27183
26796	42	0	26964	11	0	27017
26797	23	2	27040	10	0	27075
26798	4	27042	0	45	0	27091
26799	14	52	3	27201	0	27270
26800	1	25846	1	1882	0	27730
26801	27438	6	49	6	0	27499
26802	40	1	27167	0	0	27208
26803	6	27421	1	35	0	27463
26804	4	38	0	27592	0	27634
26805	27087	3	45	13	0	27148
26806	2	26736	1	20	0	26759
26807	10	51	7	26652	0	26720
26808	13	51	3	26848	0	26915
26809	2	27277	1	11	0	27291
26810	26766	4	40	4	0	26814
26811	4	54	0	26704	0	26762
26812	2	47	4	25545	0	25598
26813	20	0	25587	7	0	25614
26814	2	25242	1	9	0	25254
26815	1	46	7	24876	0	24930
26816	8	62	0	25020	0	25090
26817	1	25803	1	6	0	25811
26818	9	83	4	26812	0	26908
26819	0	53	4	27501	0	27558
26820	13	66	2	27418	0	27499
26821	0	27360	0	23	0	27383
26822	26529	4	89	5	0	26627
26823	8	1	27117	5	0	27131
26824	27919	7	482	9	0	28417
26825	0	28889	0	14	0	28903
26826	4	211	4	27669	0	27888
26827	68	2	29933	2	0	30005
26828	6	43	20	29606	0	29675
26829	11	60	1	29701	0	29773
26830	4	47	5	29296	0	29352
26831	48	0	29836	5	0	29889
26832	4	32239	0	50	0	32293
26833	31	1	28950	3422	0	32404
26834	6	32223	5	44	0	32278
26835	60	0	32289	1	0	32350
26836	7	35	1	36879	0	36922
26837	36832	1	70	2	0	36905
26838	0	36691	2	23	0	36716
26839	43	4	36679	3	0	36729
26840	4	37490	2	36	0	37532
26841	45	1	37547	1	0	37594
26842	9	99	4	38264	0	38376
26843	9	80	4	38052	0	38145
26844	6	39380	0	31	0	39417
26845	8	39033	1	57	0	39099
26846	39378	2	83	14	0	39477
26847	8	80	11	39299	0	39398
26848	24	0	39507	6	0	39537
26849	29	55	3	38036	0	38123
26850	42	4	37698	12	0	37756
26851	29	1	37992	13	0	38035
26852	19	104	4	40984	0	41111
26853	1	38872	1	30	0	38904
26854	39249	1	51	12	0	39313
26855	6	98	4	39148	0	39256
26856	18	77	3	38578	0	38676
26857	7	38274	0	16	0	38297
26858	37809	3	71	8	0	37891
26859	38289	8	83	13	0	38393
26860	12	68	3	38679	0	38762
26861	9	38662	0	40	0	38711
26862	3	38582	1	20	0	38606
26863	38108	4	101	10	0	38223
26864	16	3	38385	1	0	38405
26865	38180	6	113	7	0	38306
26866	39263	3	103	5	0	39374
26867	39370	6	118	4	0	39498
26868	2	39395	0	9	0	39406
26869	2	56	5	39098	0	39161
26870	39228	2	49	4	0	39283
26871	39479	7	117	8	0	39611
26872	0	39333	0	39	0	39372
26873	39237	4	86	5	0	39332
26874	3	90	18	39106	0	39217
26875	9	95	0	38295	0	38399
26876	4	40131	0	18	0	40153
26877	8	107	1	39334	0	39450
26878	9	97	7	39594	0	39707
26879	2	40201	0	8	0	40211
26880	13	104	2	39396	0	39515
26881	2	40486	14	38	0	40540
26882	40225	8	95	9	0	40337
26883	40663	3	76	2	0	40744
26884	2	40597	0	50	0	40649
26885	45	1	40200	3	0	40249
26886	5	114	9	40292	0	40420
26887	34	2	40106	16	0	40158
26888	7	41822	1	51	0	41881
26889	5	41906	0	52	0	41963
26890	41925	7	104	37	0	42073
26891	3	42168	0	20	0	42191
26892	24	124	7	41324	0	41479
26893	10	42922	4	51	0	42987
26894	10	41654	2	74	0	41740
26895	41362	2	97	12	0	41473
26896	16	71	6	41787	0	41880
26897	45	0	41566	9	0	41620
26898	49	2	42300	14	0	42365
26899	19	42961	1	46	0	43027
26900	42310	10	102	9	0	42431
26901	2	40348	1	30	0	40381
26902	5	44	3	39339	0	39391
26903	43958	3	46	3	0	44010
26904	6	115	4	43927	0	44052
26905	7	110	5	43855	0	43977
26906	4	43623	1	42	0	43670
26907	148	94	8	41042	0	41292
26908	26	1	41695	3	0	41725
26909	43056	4	120	17	0	43197
26910	11	42950	0	27	0	42988
26911	8	41405	1	39	0	41453
26912	37175	5	76	12	0	37268
26913	29	0	37202	9	0	37240
26914	37857	5	115	3	0	37980
26915	3	37111	0	26	0	37140
26916	6	37752	0	30	0	37788
26917	52	3	37519	6	0	37580
26918	6	42877	1	21	0	42905
26919	14	140	3	42783	0	42940
26920	12	115	1	43669	0	43797
26921	2	43847	0	10	0	43859
26922	3	65	1	43792	0	43861
26923	43788	0	68	4	0	43860
26924	16	1	43558	3	0	43578
26925	43045	4	102	13	0	43164
26926	42951	8	141	11	0	43111
26927	39338	5	122	6	0	39471
26928	40	0	39580	3	0	39623
26929	6	64	12	40712	0	40794
26930	41	1	40198	1	0	40241
26931	40306	3	132	10	0	40451
26932	40492	1	127	3	0	40623
26933	3	40206	0	23	0	40232
26934	13	108	3	40469	0	40593
26935	1	41897	0	30	0	41928
26936	45	1	41878	2	0	41926
26937	6	44	3	42667	0	42720
26938	42651	3	50	6	0	42710
26939	42445	6	102	5	0	42558
26940	5	49	5	42639	0	42698
26941	2	42440	0	34	0	42476
26942	31	5	41567	7	0	41610
26943	30	2	41775	4	0	41811
26944	40263	5	122	21	0	40411
26945	26	0	41134	1	0	41161
26946	4	47151	2	51	0	47208
26947	16	99	4	47118	0	47237
26948	41	6	47526	4	0	47577
26949	8	92	9	47138	0	47247
26950	27	1	47110	10	0	47148
26951	47453	6	134	12	0	47605
26952	15	79	8	45796	0	45898
26953	6	45966	1	41	0	46014
26954	3	46126	0	28	0	46157
26955	4	122	266	46968	0	47360
26956	10	118	2	47702	0	47832
26957	3	47239	1	37	0	47280
26958	42	2	47422	3	0	47469
26959	9	111	3	47337	0	47460
26960	44	0	46918	9	0	46971
26961	42	3	47555	16	0	47616
26962	49294	1	140	14	0	49449
26963	45	50441	1	40	0	50527
26964	48930	4	245	8	0	49187
26965	3	120	8	49792	0	49923
26966	5	49822	0	23	0	49850
26967	11	98	3	49639	0	49751
26968	17	113	4	50304	0	50438
26969	5	50322	0	32	0	50359
26970	33	1	50450	1	0	50485
26971	10	83	21	51194	0	51308
26972	50822	2	69	3	0	50896
26973	7	98	4	51313	0	51422
26974	14	115	2	48790	0	48921
26975	35	0	49207	9	0	49251
26976	1	45239	1	43	0	45284
26977	10	115	6	44697	0	44828
26978	37	2	44527	2	0	44568
26979	35	0	44484	15	0	44534
26980	45134	3	127	15	0	45279
26981	10	44948	0	44	0	45002
26982	44184	5	121	12	0	44322
26983	13	44271	3	67	0	44354
26984	7	42976	2	53	0	43038
26985	46947	4	82	7	0	47040
26986	18	126	7	46601	0	46752
26987	4	47117	0	35	0	47156
26988	12	92	6	46993	0	47103
26989	46726	4	86	4	0	46820
26990	39	1	46595	7	0	46642
26991	42	1	46351	14	0	46408
26992	45503	2	120	23	0	45648
26993	3	43463	2	27	0	43495
26994	36	0	37608	5	0	37649
26995	4	37774	0	10	0	37788
26996	11	108	4	37559	0	37682
26997	24	1	37813	4	0	37842
26998	11	70	9	37597	0	37687
26999	33	4	37523	8	0	37568
27000	37794	10	131	17	0	37952
27001	3	38075	2	40	0	38120
27002	38624	6	84	9	0	38723
27003	9	102	4	38852	0	38967
27004	4	37243	0	29	0	37276
27005	37072	6	83	10	0	37171
27006	36740	5	88	8	0	36841
27007	26	1	36728	3	0	36758
27008	19	0	36608	5	0	36632
27009	36249	3	84	14	0	36350
27010	4	35392	0	35	0	35431
27011	5	34718	1	15	0	34739
27012	10	93	3	34025	0	34131
27013	32	3	35865	5	0	35905
27014	10	35787	2	27	0	35826
27015	0	35941	0	18	0	35959
27016	10	54	4	35904	0	35972
27017	35859	3	44	0	0	35906
27018	35777	2	59	3	0	35841
27019	35401	2	135	3	0	35541
27020	13	0	35712	2	0	35727
27021	34435	4	75	7	0	34521
27022	28281	6	92	6	0	28385
27023	28270	3	68	4	0	28345
27024	11	70	2	28157	0	28240
27025	1	28265	0	13	0	28279
27026	27811	3	47	6	0	27867
27027	0	27197	0	11	0	27208
27028	3	71	6	26620	0	26700
27029	13	0	26818	4	0	26835
27030	5	61	2	26854	0	26922
27031	3	93	4	26409	0	26509
27032	59	1	26351	2	0	26413
27033	2	26380	2	21	0	26405
27034	10	50	4	26860	0	26924
27035	26965	5	29	3	0	27002
27036	0	25896	2	14	0	25912
27037	24969	1	59	3	0	25032
27038	9	112	0	23514	0	23635
27039	11	22965	0	9	0	22985
27040	22547	4	42	2	0	22595
27041	0	21605	0	24	0	21629
27042	20	0	20870	5	0	20895
27043	20775	1	32	12	0	20820
27044	20423	2	54	6	0	20485
27045	0	19927	0	16	0	19943
27046	30	2	19187	11	0	19230
27047	0	19064	0	6	0	19070
27048	7	90	1	19981	0	20079
27049	3	51	2	20274	0	20330
27050	4	62	1	20395	0	20462
27051	0	19771	0	3	0	19774
27052	0	62	1	19713	0	19776
27053	1	35	1	20101	0	20138
27054	20001	1	22	2	0	20026
27055	1	30	1	19998	0	20030
27056	1	33	0	19787	0	19821
27057	19815	1	33	4	0	19853
27058	1	19583	0	5	0	19589
27059	19289	0	40	3	0	19332
27060	19332	4	36	2	0	19374
27061	15986	3	28	0	0	16017
27062	1	26	1	16206	0	16234
27063	4	20	3	16328	0	16355
27064	17	0	16322	3	0	16342
27065	16	0	16222	6	0	16244
27066	9	0	16291	4	0	16304
27067	15844	2	41	9	0	15896
27068	3	1	16498	3	0	16505
27069	1	17283	0	12	0	17296
27070	2	51	3	17177	0	17233
27071	6	43	2	17399	0	17450
27072	3	17313	1	16	0	17333
27073	26	2	17240	6	0	17274
27074	5	17421	1	9	0	17436
27075	17276	20	30	2	0	17328
27076	28	2	17791	2	0	17823
27077	1	17199	1	9	0	17210
27078	16	2	18495	1	0	18514
27079	4	35	3	18630	0	18672
27080	9	0	18724	3	0	18736
27081	5	45	1	19067	0	19118
27082	19036	1	22	2	0	19061
27083	13	0	19080	3	0	19096
27084	2	19227	2	17	0	19248
27085	18925	2	36	9	0	18972
27086	20	0	18839	1	0	18860
27087	17	1	19663	1	0	19682
27088	3	43	3	19546	0	19595
27089	6	2	17955	6	0	17969
27090	18060	2	41	10	0	18113
27091	0	18028	0	10	0	18038
27092	4	49	5	17867	0	17925
27093	0	18054	0	7	0	18061
27094	17941	2	31	2	0	17976
27095	16	1	18093	3	0	18113
27096	9	0	18169	1	0	18179
27097	8	69	1	18312	0	18390
27098	2	41	2	18104	0	18149
27099	2	26	3	18971	0	19002
27100	3	38	2	18859	0	18902
27101	27	1	19136	0	0	19164
27102	2	18655	1	17	0	18675
27103	3	62	1	18591	0	18657
27104	25	1	19060	2	0	19088
27105	2	18904	0	13	0	18919
27106	19129	0	37	2	0	19168
27107	1	20	1	19138	0	19160
27108	18902	0	22	4	0	18928
27109	0	18865	0	22	0	18887
27110	18122	0	26	8	0	18156
27111	6	0	18222	4	0	18232
27112	2	49	2	19261	0	19314
27113	3	18885	0	11	0	18899
27114	14	10	18894	4	0	18922
27115	5	20137	0	9	0	20151
27116	3	42	2	20440	0	20487
27117	20542	4	27	6	0	20579
27118	2	20382	0	7	0	20391
27119	20243	2	45	5	0	20295
27120	22	0	20455	0	0	20477
27121	16	1	21107	3	0	21127
27122	20759	2	41	4	0	20806
27123	2	42	3	20913	0	20960
27124	6	57	2	19634	0	19699
27125	17	0	19464	8	0	19489
27126	10	3	19526	7	0	19546
27127	4	19498	1	22	0	19525
27128	19769	2	46	2	0	19819
27129	19726	0	36	3	0	19765
27130	2	20119	0	9	0	20130
27131	1	33	2	20207	0	20243
27132	20284	1	40	2	0	20327
27133	5	25	1	20257	0	20288
27134	20213	1	14	1	0	20229
27135	20286	2	38	4	0	20330
27136	21423	3	35	8	0	21469
27137	2	17	8	21167	0	21194
27138	0	13	3	21034	0	21050
27139	20576	1	18	2	0	20597
27140	20603	4	37	3	0	20647
27141	21056	5	38	5	0	21104
27142	1	21110	0	15	0	21126
27143	20804	1	37	4	0	20846
27144	0	20521	0	20	0	20541
27145	19241	1	52	5	0	19299
27146	15	1	19527	3	0	19546
27147	19517	1	46	5	0	19569
27148	2	19709	0	16	0	19727
27149	1	19528	1	8	0	19538
27150	19530	3	26	8	0	19567
27151	1	71	1	20661	0	20734
27152	9	52	8	20252	0	20321
27153	2	19359	0	30	0	19391
27154	1	19354	0	20	0	19375
27155	18928	4	22	9	0	18963
27156	25	0	18839	2	0	18866
27157	6	41	2	19511	0	19560
27158	19436	1	20	5	0	19462
27159	9	2	19155	2	0	19168
27160	2	18367	1	19	0	18389
27161	18139	0	42	5	0	18186
27162	19	0	18245	2	0	18266
27163	6	37	1	21368	0	21412
27164	11	1	21174	4	0	21190
27165	21628	3	37	8	0	21676
27166	3	21924	1	10	0	21938
27167	22360	2	42	7	0	22411
27168	22570	5	32	4	0	22611
27169	6	34	1	22510	0	22551
27170	22574	1	22	2	0	22599
27171	6	77	2	23308	0	23393
27172	5	44	1	23766	0	23816
27173	20	0	23751	3	0	23774
27174	2	23932	1	36	0	23971
27175	7	79	2	23338	0	23426
27176	6	59	5	23775	0	23845
27177	0	44	2	23576	0	23622
27178	44	1	23695	12	0	23752
27179	1	23744	1	12	0	23758
27180	7	78	0	23909	0	23994
27181	9	67	4	23873	0	23953
27182	30	1	23955	4	0	23990
27183	2	42	1	24613	0	24658
27184	24658	2	32	5	0	24697
27185	3	24638	2	21	0	24664
27186	23787	4	44	4	0	23839
27187	175	0	24086	1	0	24262
27188	2	35	1	24337	0	24375
27189	24092	3	21	2	0	24118
27190	24014	6	43	5	0	24068
27191	12	0	22894	0	0	22906
27192	7	78	5	22585	0	22675
27193	23	1	22513	4	0	22541
27194	22403	8	58	16	0	22485
27195	3	23447	1	14	0	23465
27196	22578	6	44	10	0	22638
27197	22655	2	54	22	0	22733
27198	1	22760	0	5	0	22766
27199	22360	4	52	7	0	22423
27200	15	0	22419	0	0	22434
27201	22120	4	34	6	0	22164
27202	2	39	0	22205	0	22246
27203	31	0	22274	2	0	22307
27204	5	87	5	21991	0	22088
27205	9	109	2	21753	0	21873
27206	10	80	5	21319	0	21414
27207	4	21151	0	12	0	21167
27208	21204	0	41	2	0	21247
27209	11	73	3	21116	0	21203
27210	2	20040	0	5	0	20047
27211	5	53	4	19848	0	19910
27212	2	19770	0	12	0	19784
27213	18	0	19788	0	0	19806
27214	4	54	1	19837	0	19896
27215	8	68	5	19725	0	19806
27216	26	1	19533	3	0	19563
27217	19573	2	43	3	0	19621
27218	0	20047	1	7	0	20055
27219	4	88	5	20060	0	20157
27220	5	41	1	20436	0	20483
27221	3	42	0	20428	0	20473
27222	3	20086	0	9	0	20098
27223	20059	2	49	8	0	20118
27224	12	0	20208	0	0	20220
27225	19	0	20196	7	0	20222
27226	3	63	2	19956	0	20024
27227	0	42	0	19776	0	19818
27228	21260	1	33	12	0	21306
27229	2	22528	0	7	0	22537
27230	4	59	3	22541	0	22607
27231	22779	1	27	9	0	22816
27232	5	45	1	22767	0	22818
27233	21819	2	33	4	0	21858
27234	18	0	21962	3	0	21983
27235	2	21849	0	19	0	21870
27236	21445	2	38	5	0	21490
27237	1	1	21586	2	0	21590
27238	18687	2	42	5	0	18736
27239	3	0	19574	0	0	19577
27240	19103	1	36	2	0	19142
27241	1	21	1	19299	0	19322
27242	18985	0	17	1	0	19003
27243	1	19	3	18788	0	18811
27244	0	25	0	18592	0	18617
27245	18700	1	32	8	0	18741
27246	3	18519	0	2	0	18524
27247	1	16	1	17538	0	17556
27248	16978	2	12	2	0	16994
27249	16744	2	17	0	0	16763
27250	1	10	0	16960	0	16971
27251	2	14	1	16924	0	16941
27252	17051	1	15	1	0	17068
27253	1	23	1	16784	0	16809
27254	2	30	0	16443	0	16475
27255	16277	1	12	0	0	16290
27256	5	33	0	16066	0	16104
27257	4	0	15997	4	0	16005
27258	15291	3	43	6	0	15343
27259	11	0	14956	3	0	14970
27260	4	0	15540	2	0	15546
27261	15220	0	16	4	0	15240
27262	1	15498	0	7	0	15506
27263	3	75	2	15357	0	15437
27264	3	15	1	15464	0	15483
27265	1	37	0	15471	0	15509
27266	4	19	0	15462	0	15485
27267	15433	0	22	7	0	15462
27268	15301	2	29	3	0	15335
27269	15251	1	39	0	0	15291
27270	15	0	15328	4	0	15347
27271	4	49	14	14691	0	14758
27272	4	57	4	14677	0	14742
27273	3	34	2	14696	0	14735
27274	8	14803	1	9	0	14821
27275	1	14796	1	7	0	14805
27276	14906	0	16	0	0	14922
27277	1	52	4	14861	0	14918
27278	4	25	1	14890	0	14920
27279	1	31	2	14811	0	14845
27280	10	0	14718	3	0	14731
27281	13	0	14850	2	0	14865
27282	14793	1	26	3	0	14823
27283	15021	2	42	0	0	15065
27284	1	56	3	15170	0	15230
27285	3	15511	0	2	0	15516
27286	3	36	1	15660	0	15700
27287	1	22	0	15920	0	15943
27288	20	0	15858	5	0	15883
27289	15883	4	31	7	0	15925
27290	2	35	3	16310	0	16350
27291	1	26	1	16348	0	16376
27292	16153	2	25	7	0	16187
27293	2	16350	0	5	0	16357
27294	16253	1	33	3	0	16290
27295	4	60	2	17155	0	17221
27296	0	16933	0	5	0	16938
27297	16892	2	35	3	0	16932
27298	2	24	0	16965	0	16991
27299	16930	1	14	2	0	16947
27300	17107	4	37	3	0	17151
27301	17075	7	52	0	0	17134
27302	2	17369	0	5	0	17376
27303	3	14927	1	8	0	14939
27304	2	53	1	13650	0	13706
27305	1	13795	0	2	0	13798
27306	13728	2	23	4	0	13757
27307	1	14	0	13608	0	13623
27308	13626	2	18	0	0	13646
27309	13825	0	20	1	0	13846
27310	2	7	0	13722	0	13731
27311	1	3	0	13347	0	13351
27312	13309	0	7	4	0	13320
27313	13119	0	14	1	0	13134
27314	13225	1	15	1	0	13242
27315	12739	0	12	0	0	12751
27316	12611	2	10	0	0	12623
27317	1	4	3	12571	0	12579
27318	1	12	1	12333	0	12347
27319	0	11	1	12199	0	12211
27320	12440	0	6	2	0	12448
27321	0	32	3	12300	0	12335
27322	2	12186	0	7	0	12195
27323	0	21	3	12073	0	12097
27324	12139	1	3	3	0	12146
27325	11927	1	30	1	0	11959
27326	9	3	12538	4	0	12554
27327	7	46	1	12589	0	12643
27328	1	12766	0	3	0	12770
27329	12617	3	31	2	0	12653
27330	1	12820	0	2	0	12823
27331	0	41	2	12812	0	12855
27332	12892	1	15	1	0	12909
27333	12920	1	27	2	0	12950
27334	1	12906	0	4	0	12911
27335	3	37	3	12355	0	12398
27336	7	0	12468	1	0	12476
27337	12010	2	41	4	0	12057
27338	1	0	12571	2	0	12574
27339	12499	0	42	8	0	12549
27340	12615	0	15	3	0	12633
27341	1	3	1	13009	0	13014
27342	13340	0	13	0	0	13353
27343	13332	2	23	3	0	13360
27344	13340	2	18	4	0	13364
27345	1	10	1	13310	0	13322
27346	13299	0	14	2	0	13315
27347	3	36	0	12827	0	12866
27348	5	42	4	12739	0	12790
27349	0	12881	1	1	0	12883
27350	1	54	3	12500	0	12558
27351	7	13797	0	4	0	13808
27352	14246	0	28	2	0	14276
27353	14530	2	21	2	0	14555
27354	2	34	2	14465	0	14503
27355	0	11	0	14573	0	14584
27356	14547	0	23	2	0	14572
27357	6	1	15456	12	0	15475
27358	15597	1	41	3	0	15642
27359	5	27	1	15584	0	15617
27360	9	0	15263	0	0	15272
27361	15135	2	40	4	0	15181
27362	15066	1	50	0	0	15117
27363	7	0	14989	2	0	14998
27364	15039	2	44	9	0	15094
27365	8	0	15141	6	0	15155
27366	1	15098	0	11	0	15110
27367	15552	0	50	1	0	15603
27368	15807	1	33	2	0	15843
27369	3	15450	0	7	0	15460
27370	2	14620	0	14	0	14636
27371	14697	4	14	3	0	14718
27372	14770	2	23	3	0	14798
27373	2	35	1	14907	0	14945
27374	15	1	14932	2	0	14950
27375	8	1	15178	2	0	15189
27376	14323	7	36	11	0	14377
27377	8	0	14650	3	0	14661
27378	14024	3	44	3	0	14074
27379	7	42	2	14103	0	14154
27380	0	31	0	13991	0	14022
27381	7	0	14583	1	0	14591
27382	14624	0	36	3	0	14663
27383	1	33	0	16207	0	16241
27384	8	20	0	16207	0	16235
27385	16079	0	16	4	0	16099
27386	15966	0	48	7	0	16021
27387	16036	1	32	1	0	16070
27388	0	16055	2	7	0	16064
27389	20	1	16007	2	0	16030
27390	15922	2	35	1	0	15960
27391	16139	1	53	10	0	16203
27392	0	16301	0	24	0	16325
27393	16854	0	29	7	0	16890
27394	2	57	2	17285	0	17346
27395	27	0	17279	1	0	17307
27396	17103	7	34	4	0	17148
27397	17241	0	40	3	0	17284
27398	17214	1	46	1	0	17262
27399	17283	1	12	11	0	17307
27400	0	16	0	18267	0	18283
27401	3	11	0	18155	0	18169
27402	18072	2	20	5	0	18099
27403	3	29	1	17996	0	18029
27404	9	57	1	17361	0	17428
27405	0	17721	1	12	0	17734
27406	4	87	1	17499	0	17591
27407	1	40	3	17810	0	17854
27408	1	66	2	17788	0	17857
27409	2	24	1	18319	0	18346
27410	1	18440	0	5	0	18446
27411	2	37	4	18344	0	18387
27412	4	28	0	18472	0	18504
27413	27	2	18206	8	0	18243
27414	21	2	17414	3	0	17440
27415	4	17544	0	17	0	17565
27416	17679	2	60	5	0	17746
27417	2	17831	0	12	0	17845
27418	1	36	2	17754	0	17793
27419	7	0	18958	0	0	18965
27420	18915	2	51	8	0	18976
27421	4	31	3	19059	0	19097
27422	18939	3	31	6	0	18979
27423	18735	1	48	7	0	18791
27424	0	19015	0	13	0	19028
27425	18931	0	44	4	0	18979
27426	1	18440	0	10	0	18451
27427	3	56	2	17722	0	17783
27428	1	17548	2	10	0	17561
27429	33	2	17502	1	0	17538
27430	3	17827	0	16	0	17846
27431	1	25	0	17854	0	17880
27432	19030	0	19	5	0	19054
27433	3	18399	0	14	0	18416
27434	1	64	0	18435	0	18500
27435	0	46	2	18380	0	18428
27436	19	1	18337	2	0	18359
27437	7	31	3	18111	0	18152
27438	12	0	17898	7	0	17917
27439	17676	3	76	6	0	17761
27440	18	0	18254	1	0	18273
27441	0	18011	0	8	0	18019
27442	1	70	7	17808	0	17886
27443	3	30	2	18244	0	18279
27444	1	28	0	18041	0	18070
27445	17684	2	25	2	0	17713
27446	0	28	1	17613	0	17642
27447	0	17474	0	19	0	17493
27448	17514	2	56	7	0	17579
27449	2	19108	0	13	0	19123
27450	2	38	2	19160	0	19202
27451	19747	1	32	3	0	19783
27452	0	19648	0	19	0	19667
27453	2	19749	0	17	0	19768
27454	19741	3	37	7	0	19788
27455	19707	0	46	4	0	19757
27456	5	1	20016	2	0	20024
27457	19226	2	69	8	0	19305
27458	5	0	19738	1	0	19744
27459	10	49	1	18216	0	18276
27460	11	0	19494	1	0	19506
27461	5	52	4	19740	0	19801
27462	11	0	20029	0	0	20040
27463	5	48	3	20114	0	20170
27464	0	7	2	20123	0	20132
27465	19800	1	46	1	0	19848
27466	4	1	19907	0	0	19912
27467	20304	0	91	6	0	20401
27468	13	2	20715	4	0	20734
27469	22	0	21156	6	0	21184
27470	3	25	3	20837	0	20868
27471	20623	1	45	10	0	20679
27472	5	20605	1	15	0	20626
27473	20706	2	64	6	0	20778
27474	20848	1	51	1	0	20901
27475	2	20836	0	21	0	20859
27476	19817	4	46	8	0	19875
27477	20	18	19947	1	0	19986
27478	2	27	3	19485	0	19517
27479	19580	2	26	3	0	19611
27480	2	19718	0	11	0	19731
27481	1	83	4	19428	0	19516
27482	1	17	2	19443	0	19463
27483	3	18	0	19535	0	19556
27484	3	12	0	19843	0	19858
27485	19276	2	3	2	0	19283
27486	19089	2	35	1	0	19127
27487	19106	4	13	1	0	19124
27488	18944	4	75	4	0	19027
27489	16	0	18945	1	0	18962
27490	18657	2	54	5	0	18718
27491	18927	3	67	1	0	18998
27492	1	18617	0	18	0	18636
27493	1	17581	2	25	0	17609
27494	5	38	2	17849	0	17894
27495	4	47	2	17817	0	17870
27496	29	1	17705	4	0	17739
27497	2	17881	0	28	0	17911
27498	7	46	4	17685	0	17742
27499	1	19365	0	3	0	19369
27500	2	65	1	19153	0	19221
27501	3	33	1	19265	0	19302
27502	1	18882	2	16	0	18901
27503	11	35	3	18845	0	18894
27504	18	1	18929	2	0	18950
27505	40	1	19180	8	0	19229
27506	18622	3	49	3	0	18677
27507	18913	4	77	0	0	18994
27508	3	17540	0	30	0	17573
27509	17858	1	40	1	0	17900
27510	0	30	1	18441	0	18472
27511	18470	1	28	3	0	18502
27512	1	18433	4	27	0	18465
27513	18	0	18314	1	0	18333
27514	17648	3	49	12	0	17712
27515	26	0	17734	6	0	17766
27516	13	0	17727	4	0	17744
27517	23	1	17546	4	0	17574
27518	4	17550	0	9	0	17563
27519	17269	1	22	1	0	17293
27520	17580	1	45	2	0	17628
27521	1	34	3	17589	0	17627
27522	11	42	1	17522	0	17576
27523	2	17541	0	10	0	17553
27524	17746	2	42	4	0	17794
27525	5	16119	0	10	0	16134
27526	0	15787	1	15	0	15803
27527	16031	2	37	5	0	16075
27528	1	42	3	16056	0	16102
27529	3	52	2	15896	0	15953
27530	6	36	2	15956	0	16000
27531	1	15661	1	8	0	15671
27532	15581	1	20	2	0	15604
27533	2	39	0	15946	0	15987
27534	1	16514	0	8	0	16523
27535	3	15512	0	6	0	15521
27536	3	41	1	15234	0	15279
27537	3	15100	0	7	0	15110
27538	9	27	0	15029	0	15065
27539	15031	3	35	4	0	15073
27540	18	2	15081	5	0	15106
27541	11	14095	0	35	0	14141
27542	2	38	2	13865	0	13907
27543	10	0	13947	3	0	13960
27544	13862	3	34	6	0	13905
27545	0	18	0	13716	0	13734
27546	13828	2	27	3	0	13860
27547	13885	1	35	3	0	13924
27548	0	14035	0	6	0	14041
27549	13972	5	28	2	0	14007
27550	14173	1	24	1	0	14199
27551	14115	10	23	2	0	14150
27552	0	10	2	13965	0	13977
27553	4	25	2	14042	0	14073
27554	8	25	1	14134	0	14168
27555	16	0	14150	0	0	14166
27556	0	13915	0	20	0	13935
27557	13943	1	28	7	0	13979
27558	0	13687	0	4	0	13691
27559	3	44	5	13792	0	13844
27560	25	0	14668	2	0	14695
27561	14730	5	46	6	0	14787
27562	1	14772	0	4	0	14777
27563	1	34	2	14813	0	14850
27564	3	28	1	14919	0	14951
27565	16	0	15277	6	0	15299
27566	1	15394	0	18	0	15413
27567	3	53	1	15360	0	15417
27568	8	20	2	15443	0	15473
27569	3	29	3	15275	0	15310
27570	14958	1	26	1	0	14986
27571	7	1	14966	3	0	14977
27572	1	14870	0	17	0	14888
27573	16183	1	33	3	0	16220
27574	1	15095	0	24	0	15120
27575	6	33	6	14590	0	14635
27576	2	15009	0	47	0	15058
27577	15005	0	20	1	0	15026
27578	15082	2	17	0	0	15101
27579	4	17	4	15115	0	15140
27580	2	35	2	14969	0	15008
27581	2	32	0	15001	0	15035
27582	42	1	15172	0	0	15215
27583	0	15135	1	12	0	15148
27584	4	65	2	14984	0	15055
27585	1	33	1	14819	0	14854
27586	2	35	1	14431	0	14469
27587	3	25	1	14604	0	14633
27588	18	1	14593	3	0	14615
27589	1	14595	0	10	0	14606
27590	2	37	0	14617	0	14656
27591	1	55	1	15014	0	15071
27592	20	1	15141	2	0	15164
27593	10	61	1	15309	0	15381
27594	6	15348	0	10	0	15364
27595	1	15178	1	5	0	15185
27596	4	32	1	15065	0	15102
27597	21	0	14976	1	0	14998
27598	15014	1	44	7	0	15066
27599	5	14971	0	16	0	14992
27600	14	1	14626	1	0	14642
27601	9	2	14734	1	0	14746
27602	0	14454	0	18	0	14472
27603	15	1	14561	0	0	14577
27604	1	23	1	14974	0	14999
27605	14890	0	19	0	0	14909
27606	14953	0	32	1	0	14986
27607	14942	2	24	2	0	14970
27608	15375	14	48	3	0	15440
27609	2	14936	1	5	0	14944
27610	14432	1	36	0	0	14469
27611	2	14379	0	16	0	14397
27612	31	0	14452	3	0	14486
27613	6	28	3	14619	0	14656
27614	5	14562	1	7	0	14575
27615	2	13	1	14721	0	14737
27616	14902	1	12	0	0	14915
27617	6	34	0	14871	0	14911
27618	3	14766	1	4	0	14774
27619	14566	4	29	2	0	14601
27620	19	0	14684	2	0	14705
27621	2	24	0	14742	0	14768
27622	1	14	2	14528	0	14545
27623	14584	0	23	4	0	14611
27624	1	14107	0	13	0	14121
27625	11	0	13969	0	0	13980
27626	2	31	0	13821	0	13854
27627	15	0	13632	5	0	13652
27628	9	13930	0	21	0	13960
27629	2	13839	1	12	0	13854
27630	13671	1	32	7	0	13711
27631	8	1	13698	4	0	13711
27632	13602	2	42	5	0	13651
27633	5	15	3	13679	0	13702
27634	1	13733	0	12	0	13746
27635	13317	4	24	0	0	13345
27636	27	0	12669	1	0	12697
27637	1	27	1	12800	0	12829
27638	3	33	2	12710	0	12748
27639	1	34	1	13321	0	13357
27640	3	13311	0	31	0	13345
27641	13794	3	46	8	0	13851
27642	3	13837	1	5	0	13846
27643	2	13771	1	20	0	13794
27644	5	23	0	13840	0	13868
27645	13631	1	7	4	0	13643
27646	13733	1	40	6	0	13780
27647	14000	4	38	2	0	14044
27648	3	13877	0	4	0	13884
27649	4	25	0	13700	0	13729
27650	5	0	13911	2	0	13918
27651	0	45	3	15572	0	15620
27652	12	39	0	15589	0	15640
27653	2	15685	0	17	0	15704
27654	15628	1	46	4	0	15679
27655	6	40	0	15634	0	15680
27656	1	15686	0	19	0	15706
27657	15468	1	42	6	0	15517
27658	7	2	15608	1	0	15618
27659	15715	1	42	6	0	15764
27660	1	15754	0	21	0	15776
27661	15854	3	45	3	0	15905
27662	15703	1	45	2	0	15751
27663	3	0	15616	0	0	15619
27664	15675	0	50	16	0	15741
27665	6	2	15841	1	0	15850
27666	13	0	15760	3	0	15776
27667	14995	2	49	6	0	15052
27668	14755	3	85	4	0	14847
27669	14	0	14817	1	0	14832
27670	1	33	1	15029	0	15064
27671	2	34	1	15428	0	15465
27672	2	15388	0	7	0	15397
27673	15446	1	41	2	0	15490
27674	15438	3	45	3	0	15489
27675	5	0	15587	0	0	15592
27676	16263	1	55	4	0	16323
27677	16136	0	31	2	0	16169
27678	0	16053	0	7	0	16060
27679	1	63	2	15467	0	15533
27680	5	33	4	15530	0	15572
27681	4	9	1	15787	0	15801
27682	15807	0	21	2	0	15830
27683	2	15749	0	2	0	15753
27684	5	33	0	15236	0	15274
27685	1	15188	1	4	0	15194
27686	3	43	1	14948	0	14995
27687	1	15089	1	18	0	15109
27688	9	14863	0	11	0	14883
27689	15133	1	36	2	0	15172
27690	15151	3	9	3	0	15166
27691	2	29	0	14923	0	14954
27692	2	25	2	14735	0	14764
27693	6	36	2	14662	0	14706
27694	2	33	4	14563	0	14602
27695	3	29	1	14611	0	14644
27696	1	14627	0	11	0	14639
27697	4	25	1	14459	0	14489
27698	0	9	1	14511	0	14521
27699	14810	6	15	1	0	14832
27700	1	11	0	14811	0	14823
27701	0	25	2	15132	0	15159
27702	9	1	15020	3	0	15033
27703	1	34	1	14936	0	14972
27704	2	25	3	14781	0	14811
27705	18	0	14773	6	0	14797
27706	6	14857	1	18	0	14882
27707	17	0	14835	9	0	14861
27708	18	1	15021	6	0	15046
27709	9	15030	0	10	0	15049
27710	15494	1	29	5	0	15529
27711	15662	0	37	1	0	15700
27712	1	16	0	15601	0	15618
27713	15622	1	22	2	0	15647
27714	16	0	15757	1	0	15774
27715	5	34	4	15542	0	15585
27716	32	0	15452	1	0	15485
27717	3	32	12	14901	0	14948
27718	6	37	3	15667	0	15713
27719	2	32	0	15722	0	15756
27720	15609	0	14	0	0	15623
27721	3	18	0	15450	0	15471
27722	15276	3	23	4	0	15306
27723	15282	0	48	1	0	15331
27724	2	15531	0	11	0	15544
27725	14100	1	26	4	0	14131
27726	0	13898	1	27	0	13926
27727	3	24	1	11990	0	12018
27728	2	24	1	12082	0	12109
27729	2	21	0	11975	0	11998
27730	13	0	12002	1	0	12016
27731	3	12114	1	6	0	12124
27732	1	31	0	11956	0	11988
27733	11	27	2	12065	0	12105
27734	5	11706	0	10	0	11721
27735	11643	3	44	1	0	11691
27736	1	13073	3	12	0	13089
27737	12968	0	50	3	0	13021
27738	0	13270	0	12	0	13282
27739	8	47	0	12841	0	12896
27740	4	12987	0	18	0	13009
27741	13117	1	19	8	0	13145
27742	13341	0	34	1	0	13376
27743	13561	1	32	2	0	13596
27744	13482	1	47	2	0	13532
27745	6	0	13318	1	0	13325
27746	13098	0	59	4	0	13161
27747	12793	0	52	1	0	12846
27748	12704	2	66	3	0	12775
27749	4	0	12675	0	0	12679
27750	12583	0	52	8	0	12643
27751	0	12585	0	11	0	12596
27752	11655	1	42	12	0	11710
27753	4	1	11686	1	0	11692
27754	13200	2	42	6	0	13250
27755	13246	1	48	1	0	13296
27756	4	19	3	13285	0	13311
27757	8	0	13262	1	0	13271
27758	13256	1	51	3	0	13311
27759	0	33	0	13769	0	13802
27760	4	29	3	14264	0	14300
27761	13	0	14125	0	0	14138
27762	14025	1	56	6	0	14088
27763	14043	2	30	1	0	14076
27764	0	14101	1	13	0	14115
27765	1	42	0	13813	0	13856
27766	1	32	0	14335	0	14368
27767	5	32	0	14331	0	14368
27768	1	14552	0	2	0	14555
27769	14715	2	28	0	0	14745
27770	2	27	0	14607	0	14636
27771	2	15	1	14519	0	14537
27772	14410	0	15	0	0	14425
27773	14319	4	40	1	0	14364
27774	4	15	2	14651	0	14672
27775	2	14	0	14355	0	14371
27776	5	0	14315	0	0	14320
27777	13988	2	49	5	0	14044
27778	1	14083	1	3	0	14088
27779	13	24	0	14907	0	14944
27780	5	28	1	14885	0	14919
27781	1	15043	0	3	0	15047
27782	2	35	0	14986	0	15023
27783	15009	1	21	0	0	15031
27784	9	21	1	14822	0	14853
27785	1	37	1	14705	0	14744
27786	7	25	2	14520	0	14554
27787	14	1	14263	1	0	14279
27788	3	33	2	14572	0	14610
27789	7	0	14474	2	0	14483
27790	4	13884	0	21	0	13909
27791	3	74	1	13440	0	13518
27792	5	35	1	13649	0	13690
27793	2	26	1	13807	0	13836
27794	3	20	1	13359	0	13383
27795	2	20	1	13409	0	13432
27796	13162	1	26	1	0	13190
27797	5	0	13314	7	0	13326
27798	4	13735	0	8	0	13747
27799	1	13523	0	30	0	13554
27800	1	22	1	13262	0	13286
27801	0	40	2	13283	0	13325
27802	6	36	0	13202	0	13244
27803	2	13335	0	3	0	13340
27804	7	32	2	13409	0	13450
27805	17	0	13470	2	0	13489
27806	0	13475	0	7	0	13482
27807	0	7	1	13245	0	13253
27808	13407	2	26	3	0	13438
27809	1	32	2	13165	0	13200
27810	3	15	2	13161	0	13181
27811	6	13126	0	3	0	13135
27812	1	11464	1	7	0	11473
27813	2	35	1	11775	0	11813
27814	1	17	0	11848	0	11866
27815	26	0	12001	6	0	12033
27816	2	22	9	12072	0	12105
27817	5	22	0	11937	0	11964
27818	5	19	0	11687	0	11711
27819	1	25	0	11571	0	11597
27820	11493	1	7	3	0	11504
27821	11542	0	7	1	0	11550
27822	1	13	0	11555	0	11569
27823	3	18	8	11395	0	11424
27824	10883	0	9	3	0	10895
27825	0	18	2	10187	0	10207
27826	2	1	10314	0	0	10317
27827	1	10335	1	8	0	10345
27828	4	15	3	9898	0	9920
27829	0	9	1	9921	0	9931
27830	9997	0	6	0	0	10003
27831	5	15	1	9962	0	9983
27832	1	18	1	9931	0	9951
27833	9956	1	12	1	0	9970
27834	3	24	1	9769	0	9797
27835	0	9458	0	2	0	9460
27836	0	48	1	8743	0	8792
27837	2	15	3	8635	0	8655
27838	2	17	2	8615	0	8636
27839	4	10	0	8575	0	8589
27840	9	0	8533	1	0	8543
27841	12	0	8546	2	0	8560
27842	0	18	0	8189	0	8207
27843	3	21	0	8226	0	8250
27844	0	8082	0	2	0	8084
27845	7	17	0	7848	0	7872
27846	1	7987	0	2	0	7990
27847	8074	2	24	2	0	8102
27848	0	8140	0	6	0	8146
27849	2	17	1	8126	0	8146
27850	3	21	0	7918	0	7942
27851	14	0	7870	1	0	7885
27852	8966	1	32	6	0	9005
27853	8969	1	22	3	0	8995
27854	2	9181	0	11	0	9194
27855	1	13	2	8228	0	8244
27856	7	1	8184	1	0	8193
27857	2	8642	0	6	0	8650
27858	8893	0	26	3	0	8922
27859	8887	1	36	1	0	8925
27860	1	0	8863	1	0	8865
27861	9271	1	34	1	0	9307
27862	5	23	1	9393	0	9422
27863	1	9171	0	5	0	9177
27864	9143	0	19	3	0	9165
27865	2	12	0	9091	0	9105
27866	9041	0	20	0	0	9061
27867	8994	1	25	2	0	9022
27868	3	20	1	9427	0	9451
27869	3	1	9309	1	0	9314
27870	8997	0	21	3	0	9021
27871	8933	1	22	0	0	8956
27872	8942	1	46	0	0	8989
27873	1	8969	1	5	0	8976
27874	1	9	2	8661	0	8673
27875	4	22	0	8689	0	8715
27876	7	0	8626	0	0	8633
27877	9	18	2	8819	0	8848
27878	0	8544	1	14	0	8559
27879	9228	1	34	3	0	9266
27880	0	10034	0	13	0	10047
27881	10	2	9989	4	0	10005
27882	10	10584	0	14	0	10608
27883	4	10628	1	8	0	10641
27884	8	16	1	11277	0	11302
27885	11271	3	8	1	0	11283
27886	11680	0	27	6	0	11713
27887	11944	0	29	0	0	11973
27888	1	12063	0	8	0	12072
27889	7	0	11590	1	0	11598
27890	11254	0	25	3	0	11282
27891	10980	1	43	6	0	11030
27892	0	10972	0	16	0	10988
27893	10916	6	32	1	0	10955
27894	1	18	1	10929	0	10949
27895	10	0	10821	0	0	10831
27896	10763	0	53	1	0	10817
27897	10704	0	11	0	0	10715
27898	10788	0	28	1	0	10817
27899	2	35	1	10663	0	10701
27900	0	15	0	10630	0	10645
27901	2	23	1	10478	0	10504
27902	1	10402	0	6	0	10409
27903	1	22	0	10416	0	10439
27904	0	15	1	10397	0	10413
27905	20	0	10391	3	0	10414
27906	1	12	16	10263	0	10292
27907	2	23	1	10257	0	10283
27908	4	28	3	10218	0	10253
27909	0	18	1	10071	0	10090
27910	0	10067	0	1	0	10068
27911	3	22	0	10014	0	10039
27912	1	9	1	10064	0	10075
27913	10073	1	22	5	0	10101
27914	6	0	10010	0	0	10016
27915	8	0	10007	1	0	10016
27916	10011	0	40	1	0	10052
27917	9937	0	26	1	0	9964
27918	2	9	0	9742	0	9753
27919	5	9474	1	15	0	9495
27920	9534	2	30	2	0	9568
27921	1	25	2	9491	0	9519
27922	4	9549	0	12	0	9565
27923	9491	2	20	2	0	9515
27924	2	9414	0	5	0	9421
27925	9327	1	36	1	0	9365
27926	9291	2	24	3	0	9320
27927	1	9369	0	5	0	9375
27928	1	10	1	8051	0	8063
27929	11	0	8069	0	0	8080
27930	0	6	1	7635	0	7642
27931	7608	1	21	0	0	7630
27932	6	0	7617	1	0	7624
27933	0	6993	0	9	0	7002
27934	2	7	1	6772	0	6782
27935	3	0	6655	0	0	6658
27936	3	6102	0	8	0	6113
27937	6159	0	12	0	0	6171
27938	0	21	1	6039	0	6061
27939	1	16	1	5865	0	5883
27940	2	21	0	5839	0	5862
27941	8	5766	0	4	0	5778
27942	5750	1	15	0	0	5766
27943	2	5729	0	5	0	5736
27944	0	5105	0	5	0	5110
27945	4920	0	10	3	0	4933
27946	4859	0	14	5	0	4878
27947	2	0	4876	0	0	4878
27948	4837	0	1	0	0	4838
27949	4808	0	0	1	0	4809
27950	0	1	1	4529	0	4531
27951	1	0	4476	0	0	4477
27952	1	2	0	4406	0	4409
27953	4223	0	1	0	0	4224
27954	0	0	4198	0	0	4198
27955	0	0	0	3412	0	3412
27956	0	0	0	2451	0	2451
27957	1	0	0	2362	0	2363
27958	1659	0	0	1	0	1660
27959	1	1659	0	0	0	1660
27960	851	0	0	0	0	851
27961	0	0	788	0	0	788
27962	0	0	0	231	0	231
27963	0	27	0	0	0	27
27964	28	0	0	0	0	28
27965	0	0	0	27	0	27
27966	0	0	28	0	0	28
27967	0	0	0	28	0	28
27968	24	0	0	0	0	24
27969	0	10	0	0	0	10
27970	0	0	0	10	0	10
27971	0	11	0	0	0	11
27972	11	0	0	0	0	11
27973	11	0	0	0	0	11
27974	0	11	0	0	0	11
27975	11	0	0	0	0	11
27976	0	0	0	11	0	11
27977	0	11	0	0	0	11
27978	11	0	0	0	0	11
27979	12	0	0	0	0	12
27980	0	12	0	0	0	12
27981	0	12	0	0	0	12
27982	11	0	0	0	0	11
27983	0	0	0	11	0	11
27984	12	0	0	0	0	12
27985	0	0	0	12	0	12
27986	0	0	12	0	0	12
27987	0	0	0	12	0	12
27988	11	0	0	0	0	11
27989	0	0	11	0	0	11
27990	0	0	0	11	0	11
27991	0	0	0	11	0	11
27992	0	0	11	0	0	11
27993	9	0	0	0	0	9
27994	0	0	0	8	0	8
27995	0	0	8	0	0	8
27996	8	0	0	0	0	8
27997	0	8	0	0	0	8
27998	0	8	0	0	0	8
27999	0	7	0	0	0	7
28000	0	0	7	0	0	7
28001	0	0	0	7	0	7
28002	0	0	8	0	0	8
28003	0	0	0	8	0	8
28004	0	8	0	0	0	8
28005	0	8	0	0	0	8
28006	0	0	0	8	0	8
28007	8	0	0	0	0	8
28008	0	0	0	8	0	8
28009	0	0	0	8	0	8
28010	0	8	0	0	0	8
28011	8	0	0	0	0	8
28012	0	9	0	0	0	9
28013	0	0	0	9	0	9
28014	0	0	0	9	0	9
28015	0	9	0	0	0	9
28016	0	0	0	9	0	9
28017	9	0	0	0	0	9
28018	0	0	0	11	0	11
28019	0	0	0	11	0	11
28020	0	11	0	0	0	11
28021	0	0	0	11	0	11
28022	11	0	0	0	0	11
28023	12	0	0	0	0	12
28024	12	0	0	0	0	12
28025	0	0	0	12	0	12
28026	0	0	11	0	0	11
28027	0	0	11	0	0	11
28028	0	0	0	11	0	11
28029	11	0	0	0	0	11
28030	0	0	0	11	0	11
28031	11	0	0	0	0	11
28032	0	0	0	11	0	11
28033	0	0	0	11	0	11
28034	9	0	0	0	0	9
28035	0	0	9	0	0	9
28036	7	0	0	0	0	7
28037	0	0	7	0	0	7
28038	0	0	0	7	0	7
28039	6	0	0	0	0	6
28040	0	0	6	0	0	6
28041	0	0	6	0	0	6
28042	6	0	0	0	0	6
28043	0	0	6	0	0	6
28044	0	6	0	0	0	6
28045	0	0	0	6	0	6
28046	6	0	0	0	0	6
28047	0	0	6	0	0	6
28048	6	0	0	0	0	6
28049	6	0	0	0	0	6
28050	6	0	0	0	0	6
28051	6	0	0	0	0	6
28052	0	0	0	6	0	6
28053	0	6	0	0	0	6
28054	6	0	0	0	0	6
28055	0	0	5	0	0	5
28056	0	6	0	0	0	6
28057	6	0	0	0	0	6
28058	0	6	0	0	0	6
28059	0	6	0	0	0	6
28060	0	0	0	6	0	6
28061	0	0	0	6	0	6
28062	0	0	0	6	0	6
28063	6	0	0	0	0	6
28064	7	0	0	0	0	7
28065	0	0	0	7	0	7
28066	0	0	0	7	0	7
28067	0	0	7	0	0	7
28068	7	0	0	0	0	7
28069	7	0	0	0	0	7
28070	0	0	0	7	0	7
28071	0	0	0	7	0	7
28072	0	0	7	0	0	7
28073	0	0	0	7	0	7
28074	0	0	7	0	0	7
28075	0	7	0	0	0	7
28076	0	0	7	0	0	7
28077	0	0	0	7	0	7
28078	0	0	6	0	0	6
28079	0	0	6	0	0	6
28080	6	0	0	0	0	6
28081	0	0	0	6	0	6
28082	0	0	6	0	0	6
28083	6	0	0	0	0	6
28084	0	0	6	0	0	6
28085	0	0	5	0	0	5
28086	0	4	0	0	0	4
28087	0	0	0	5	0	5
28088	0	0	5	0	0	5
28089	0	0	5	0	0	5
28090	0	0	0	5	0	5
28091	0	0	0	5	0	5
28092	0	5	0	0	0	5
28093	0	0	0	5	0	5
28094	3	0	0	0	0	3
28095	3	0	0	0	0	3
28096	3	0	0	0	0	3
28097	0	0	0	3	0	3
28098	0	1	0	0	0	1
28099	2	0	0	0	0	2
28100	0	1	0	0	0	1
28101	0	2	0	0	0	2
28102	0	2	0	0	0	2
28103	4	0	0	0	0	4
28104	0	0	0	4	0	4
28105	0	0	0	4	0	4
28106	0	4	0	0	0	4
28107	4	0	0	0	0	4
28108	0	0	4	0	0	4
28109	0	0	0	4	0	4
28110	4	0	0	0	0	4
28111	0	4	0	0	0	4
28112	4	0	0	0	0	4
28113	0	0	0	4	0	4
28114	0	4	0	0	0	4
28115	0	0	4	0	0	4
28116	7	0	0	0	0	7
28117	0	0	0	6	0	6
28118	7	0	0	0	0	7
28119	0	0	0	7	0	7
28120	0	7	0	0	0	7
28121	0	0	7	0	0	7
28122	0	0	7	0	0	7
28123	0	0	0	7	0	7
28124	7	0	0	0	0	7
28125	7	0	0	0	0	7
28126	0	0	0	7	0	7
28127	0	0	0	7	0	7
28128	7	0	0	0	0	7
28129	0	0	0	7	0	7
28130	7	0	0	0	0	7
28131	0	7	0	0	0	7
28132	6	0	0	0	0	6
28133	0	0	6	0	0	6
28134	0	0	0	6	0	6
28135	0	0	0	6	0	6
28136	0	0	0	6	0	6
28137	0	6	0	0	0	6
28138	0	5	0	0	0	5
28139	0	0	0	5	0	5
28140	0	0	5	0	0	5
28141	0	0	0	5	0	5
28142	0	0	0	5	0	5
28143	0	0	0	5	0	5
28144	5	0	0	0	0	5
28145	0	6	0	0	0	6
28146	0	6	0	0	0	6
28147	0	0	0	6	0	6
28148	0	0	0	6	0	6
28149	0	0	0	6	0	6
28150	0	0	0	6	0	6
28151	6	0	0	0	0	6
28152	0	6	0	0	0	6
28153	6	0	0	0	0	6
28154	6	0	0	0	0	6
28155	0	0	0	7	0	7
28156	0	0	0	7	0	7
28157	7	0	0	0	0	7
28158	7	0	0	0	0	7
28159	0	0	0	7	0	7
28160	0	0	0	7	0	7
28161	0	0	7	0	0	7
28162	0	7	0	0	0	7
28163	0	7	0	0	0	7
28164	7	0	0	0	0	7
28165	0	0	7	0	0	7
28166	0	0	7	0	0	7
28167	7	0	0	0	0	7
28168	7	0	0	0	0	7
28169	0	7	0	0	0	7
28170	0	7	0	0	0	7
28171	0	0	0	7	0	7
28172	8	0	0	0	0	8
28173	7	0	1	0	0	8
28174	8	0	0	0	0	8
28175	0	0	0	8	0	8
28176	0	0	0	8	0	8
28177	0	0	8	0	0	8
28178	0	0	8	0	0	8
28179	0	0	6	0	0	6
28180	0	0	0	6	0	6
28181	6	0	0	0	0	6
28182	0	0	6	0	0	6
28183	0	0	0	6	0	6
28184	0	6	0	0	0	6
28185	0	0	0	6	0	6
28186	0	2	0	4	0	6
28187	0	0	7	0	0	7
28188	0	0	0	7	0	7
28189	7	0	0	0	0	7
28190	0	0	7	0	0	7
28191	0	0	0	4	0	4
28192	0	0	4	0	0	4
28193	0	4	0	0	0	4
28194	0	0	4	0	0	4
28195	0	0	0	6	0	6
28196	0	0	0	6	0	6
28197	0	0	6	0	0	6
28198	0	0	0	6	0	6
28199	0	0	0	6	0	6
28200	0	7	0	0	0	7
28201	0	0	7	0	0	7
28202	0	0	0	7	0	7
28203	0	0	0	6	0	6
28204	0	7	0	0	0	7
28205	0	0	0	7	0	7
28206	7	0	0	0	0	7
28207	0	0	0	7	0	7
28208	0	0	7	0	0	7
28209	7	0	0	0	0	7
28210	7	0	0	0	0	7
28211	0	0	7	0	0	7
28212	6	0	0	0	0	6
28213	0	7	0	0	0	7
28214	0	0	0	7	0	7
28215	0	0	0	7	0	7
28216	0	0	0	7	0	7
28217	0	0	0	7	0	7
28218	0	0	0	7	0	7
28219	7	0	0	0	0	7
28220	0	0	7	0	0	7
28221	5	0	0	0	0	5
28222	0	0	6	0	0	6
28223	0	0	0	6	0	6
28224	7	0	0	0	0	7
28225	0	0	0	7	0	7
28226	0	7	0	0	0	7
28227	7	0	0	0	0	7
28228	0	0	0	7	0	7
28229	0	0	7	0	0	7
28230	7	0	0	0	0	7
28231	0	7	0	0	0	7
28232	0	0	7	0	0	7
28233	0	0	0	6	0	6
28234	0	0	0	8	0	8
28235	0	8	0	0	0	8
28236	0	0	8	0	0	8
28237	0	0	0	8	0	8
28238	0	0	8	0	0	8
28239	0	0	0	8	0	8
28240	0	0	0	8	0	8
28241	0	0	8	0	0	8
28242	0	0	0	7	0	7
28243	0	0	0	8	0	8
28244	0	0	0	8	0	8
28245	0	0	0	8	0	8
28246	8	0	0	0	0	8
28247	0	0	8	0	0	8
28248	7	0	0	0	0	7
28249	0	0	0	7	0	7
28250	0	0	0	7	0	7
28251	0	0	0	7	0	7
28252	0	7	0	0	0	7
28253	7	0	0	0	0	7
28254	0	0	0	7	0	7
28255	0	7	0	0	0	7
28256	0	0	0	7	0	7
28257	7	0	0	0	0	7
28258	7	0	0	0	0	7
28259	7	0	0	0	0	7
28260	0	7	0	0	0	7
28261	0	0	7	0	0	7
28262	7	0	0	0	0	7
28263	6	0	0	0	0	6
28264	0	6	0	0	0	6
28265	6	0	0	0	0	6
28266	6	0	0	0	0	6
28267	6	0	0	0	0	6
28268	0	7	0	0	0	7
28269	0	0	0	7	0	7
28270	7	0	0	0	0	7
28271	5	0	0	0	0	5
28272	5	0	0	0	0	5
28273	5	0	0	0	0	5
28274	0	0	0	5	0	5
28275	0	0	5	0	0	5
28276	0	0	0	5	0	5
28277	0	5	0	0	0	5
28278	0	0	0	5	0	5
28279	0	0	5	0	0	5
28280	6	0	0	0	0	6
28281	0	0	0	6	0	6
28282	6	0	0	0	0	6
28283	6	0	0	0	0	6
28284	0	0	0	6	0	6
28285	0	0	6	0	0	6
28286	0	0	6	0	0	6
28287	5	0	1	0	0	6
28288	0	6	0	0	0	6
28289	0	7	0	0	0	7
28290	0	7	0	0	0	7
28291	0	7	0	0	0	7
28292	7	0	0	0	0	7
28293	8	0	0	0	0	8
28294	8	0	0	0	0	8
28295	8	0	0	0	0	8
28296	0	0	0	8	0	8
28297	0	8	0	0	0	8
28298	8	0	0	0	0	8
28299	0	0	8	0	0	8
28300	0	7	0	0	0	7
28301	0	0	7	0	0	7
28302	7	0	0	0	0	7
28303	7	0	0	0	0	7
28304	7	0	0	0	0	7
28305	0	0	0	7	0	7
28306	0	0	7	0	0	7
28307	0	6	0	0	0	6
28308	6	0	0	0	0	6
28309	0	5	0	0	0	5
28310	0	5	0	0	0	5
28311	0	5	0	0	0	5
28312	0	5	0	0	0	5
28313	0	0	6	0	0	6
28314	0	6	0	0	0	6
28315	6	0	0	0	0	6
28316	0	0	0	6	0	6
28317	0	0	0	6	0	6
28318	6	0	0	0	0	6
28319	0	6	0	0	0	6
28320	0	0	7	0	0	7
28321	0	0	0	8	0	8
28322	0	0	0	8	0	8
28323	0	0	0	8	0	8
28324	0	0	8	0	0	8
28325	0	0	10	0	0	10
28326	0	0	0	9	0	9
28327	0	0	32	0	0	32
28328	0	0	71	0	0	71
28329	188	0	0	0	0	188
28330	0	1135	0	0	0	1135
28331	0	1402	0	1	0	1403
28332	0	1881	1	0	0	1882
28333	0	1	1	1876	0	1878
28334	0	1939	0	1	0	1940
28335	2071	0	0	0	0	2071
28336	1	0	2493	0	0	2494
28337	2573	0	0	0	0	2573
28338	0	3	0	2580	0	2583
28339	0	0	0	2598	0	2598
28340	0	2866	0	0	0	2866
28341	3090	0	2	0	0	3092
28342	3033	0	4	78	0	3115
28343	0	3147	0	2	0	3149
28344	1	13	0	3143	0	3157
28345	7	1	3358	1	0	3367
28346	2	0	3756	2	0	3760
28347	0	3795	1	4	0	3800
28348	3805	0	9	2	0	3816
28349	1	0	3832	1	0	3834
28350	0	9	0	3867	0	3876
28351	4547	0	6	0	0	4553
28352	4565	0	8	1	0	4574
28353	0	4977	0	9	0	4986
28354	0	4994	0	1	0	4995
28355	5260	2	11	1	0	5274
28356	0	0	5616	2	0	5618
28357	5592	1	19	4	0	5616
28358	5826	0	24	0	0	5850
28359	2	10	1	5855	0	5868
28360	3	0	6412	1	0	6416
28361	6	0	6467	2	0	6475
28362	6437	0	13	2	0	6452
28363	3	0	6534	4	0	6541
28364	6531	2	10	7	0	6550
28365	6952	2	29	0	0	6983
28366	0	7011	0	11	0	7022
28367	3	0	7140	0	0	7143
28368	0	7267	0	6	0	7273
28369	7267	0	15	3	0	7285
28370	1	0	7567	0	0	7568
28371	0	30	1	7580	0	7611
28372	9	0	7530	1	0	7540
28373	5	0	7530	4	0	7539
28374	12	0	7553	3	0	7568
28375	6	0	7588	7	0	7601
28376	0	7596	0	8	0	7604
28377	9	0	7614	1	0	7624
28378	1	7668	0	11	0	7680
28379	11	1	7795	0	0	7807
28380	7838	4	12	6	0	7860
28381	2	25	0	7775	0	7802
28382	1	8004	0	3	0	8008
28383	8000	1	5	1	0	8007
28384	8375	0	18	0	0	8393
28385	8352	1	12	0	0	8365
28386	8399	2	21	4	0	8426
28387	0	8422	0	4	0	8426
28388	8370	1	33	0	0	8404
28389	8440	1	21	1	0	8463
28390	1	8468	0	21	0	8490
28391	4	0	8488	0	0	8492
28392	0	19	0	8470	0	8489
28393	1	8445	0	3	0	8449
28394	25	1	8364	3	0	8393
28395	3	1	8684	5	0	8693
28396	0	8861	0	6	0	8867
28397	0	8760	0	12	0	8772
28398	2	8867	1	4	0	8874
28399	5	8909	0	7	0	8921
28400	8929	4	12	2	0	8947
28401	8974	3	13	0	0	8990
28402	2	0	9418	2	0	9422
28403	2	0	9409	2	0	9413
28404	1	19	11	9236	0	9267
28405	3	18	0	9228	0	9249
28406	0	13	0	8446	0	8459
28407	7314	0	6	2	0	7322
28408	0	7235	0	2	0	7237
28409	0	7276	2	7	0	7285
28410	1	8240	0	17	0	8258
28411	8317	1	6	3	0	8327
28412	8987	0	11	1	0	8999
28413	1	7	1	8896	0	8905
28414	8865	0	12	1	0	8878
28415	9126	1	17	1	0	9145
28416	1	14	0	9014	0	9029
28417	8886	0	11	1	0	8898
28418	0	8758	0	2	0	8760
28419	4	18	1	8715	0	8738
28420	5	0	8766	6	0	8777
28421	0	8612	0	22	0	8634
28422	1	0	8808	0	0	8809
28423	4	39	2	9040	0	9085
28424	1	9131	0	2	0	9134
28425	1	16	2	9211	0	9230
28426	3	9	2	9250	0	9264
28427	5	0	8823	1	0	8829
28428	16	1	8955	5	0	8977
28429	0	39	2	8684	0	8725
28430	9	25	0	8859	0	8893
28431	0	8613	0	6	0	8619
28432	8642	3	12	4	0	8661
28433	2	8554	0	7	0	8563
28434	0	8474	1	35	0	8510
28435	14	8	8571	2	0	8595
28436	0	8501	0	2	0	8503
28437	3	40	1	8157	0	8201
28438	0	8641	0	3	0	8644
28439	2	49	2	8614	0	8667
28440	2	8972	0	7	0	8981
28441	9112	0	9	2	0	9123
28442	0	9012	0	0	0	9012
28443	0	38	1	8788	0	8827
28444	0	9224	0	5	0	9229
28445	9201	0	11	2	0	9214
28446	9346	2	19	0	0	9367
28447	0	9337	0	7	0	9344
28448	9259	1	33	1	0	9294
28449	3	26	0	9454	0	9483
28450	7	2	9491	7	0	9507
28451	10	1	9575	2	0	9588
28452	0	9644	0	2	0	9646
28453	9677	0	26	1	0	9704
28454	9690	0	19	0	0	9709
28455	1	0	9557	2	0	9560
28456	2	0	9450	3	0	9455
28457	9410	0	14	1	0	9425
28458	9323	1	44	1	0	9369
28459	4	0	9365	0	0	9369
28460	9314	3	17	2	0	9336
28461	1	9719	0	3	0	9723
28462	1	9741	0	5	0	9747
28463	0	32	1	9888	0	9921
28464	1	9	0	9950	0	9960
28465	10061	1	8	0	0	10070
28466	9920	2	63	0	0	9985
28467	10015	2	18	0	0	10035
28468	3	16	0	10048	0	10067
28469	1	32	0	9977	0	10010
28470	0	9717	0	10	0	9727
28471	0	9573	0	8	0	9581
28472	2	9907	0	4	0	9913
28473	3	27	3	9866	0	9899
28474	3	10025	0	7	0	10035
28475	9	0	9972	3	0	9984
28476	10017	2	25	2	0	10046
28477	5	1	10264	0	0	10270
28478	1	1	9902	4	0	9908
28479	9872	0	13	4	0	9889
28480	0	9932	0	7	0	9939
28481	9847	1	26	3	0	9877
28482	9828	4	17	6	0	9855
28483	11	0	9616	0	0	9627
28484	9	0	9165	3	0	9177
28485	0	8376	0	4	0	8380
28486	5	0	8461	1	0	8467
28487	0	35	1	8427	0	8463
28488	3	16	2	7595	0	7616
28489	0	7776	0	2	0	7778
28490	0	7605	0	5	0	7610
28491	8035	0	25	2	0	8062
28492	8162	0	8	0	0	8170
28493	2	13	1	8124	0	8140
28494	2	12	2	8101	0	8117
28495	8121	0	9	1	0	8131
28496	7919	0	17	0	0	7936
28497	0	8447	0	1	0	8448
28498	8689	1	21	1	0	8712
28499	0	9163	0	4	0	9167
28500	1	9180	0	5	0	9186
28501	9198	1	11	8	0	9218
28502	9248	0	10	0	0	9258
28503	2	11	0	9416	0	9429
28504	9247	1	6	1	0	9255
28505	14	0	9234	1	0	9249
28506	1	9173	0	9	0	9183
28507	8992	1	9	0	0	9002
28508	6	0	9378	1	0	9385
28509	6	42	1	9367	0	9416
28510	1	9422	0	6	0	9429
28511	0	9179	0	4	0	9183
28512	9173	0	11	4	0	9188
28513	6	0	9156	0	0	9162
28514	8997	1	26	1	0	9025
28515	2	45	4	8967	0	9018
28516	3	0	8539	0	0	8542
28517	8549	0	10	5	0	8564
28518	2	8518	0	2	0	8522
28519	3	8793	0	1	0	8797
28520	8898	3	8	4	0	8913
28521	8897	0	18	2	0	8917
28522	8651	3	12	2	0	8668
28523	0	13	0	8713	0	8726
28524	1	14	0	8748	0	8763
28525	5	0	8764	2	0	8771
28526	20	0	8639	6	0	8665
28527	2	8700	0	2	0	8704
28528	1	17	2	8642	0	8662
28529	8780	0	8	0	0	8788
28530	0	9423	0	3	0	9426
28531	0	10	0	9422	0	9432
28532	9929	0	17	1	0	9947
28533	3	10246	0	1	0	10250
28534	0	10073	0	10	0	10083
28535	3	0	10119	2	0	10124
28536	9985	2	6	3	0	9996
28537	9627	2	38	2	0	9669
28538	5	2	9697	0	0	9704
28539	9440	1	17	1	0	9459
28540	16	0	9587	1	0	9604
28541	1	10394	0	6	0	10401
28542	3	32	1	10413	0	10449
28543	10479	2	16	1	0	10498
28544	2	10359	0	16	0	10377
28545	0	10290	1	1	0	10292
28546	10225	2	13	12	0	10252
28547	8	0	10267	3	0	10278
28548	10019	2	20	3	0	10044
28549	1	10078	0	8	0	10087
28550	12	0	10023	0	0	10035
28551	10076	2	18	4	0	10100
28552	10074	0	30	0	0	10104
28553	0	24	1	9910	0	9935
28554	2	25	1	9915	0	9943
28555	1	9965	1	11	0	9978
28556	9	2	9992	1	0	10004
28557	2	22	2	9968	0	9994
28558	9	2	9903	1	0	9915
28559	9	0	10164	1	0	10174
28560	2	17	1	9942	0	9962
28561	10	1	9942	3	0	9956
28562	7	1	9926	2	0	9936
28563	5	41	1	9810	0	9857
28564	4	1	9799	2	0	9806
28565	9743	2	20	2	0	9767
28566	1	9688	1	6	0	9696
28567	7	0	9691	1	0	9699
28568	3	0	9644	2	0	9649
28569	1	27	1	10756	0	10785
28570	10799	0	13	0	0	10812
28571	10858	4	25	5	0	10892
28572	10787	0	44	2	0	10833
28573	10336	0	28	0	0	10364
28574	3	24	0	10132	0	10159
28575	8	0	9511	0	0	9519
28576	9633	1	14	4	0	9652
28577	9635	4	36	2	0	9677
28578	9589	1	67	4	0	9661
28579	3	0	9458	0	0	9461
28580	9517	0	30	0	0	9547
28581	5	43	0	9779	0	9827
28582	1	9432	1	5	0	9439
28583	1	35	1	9283	0	9320
28584	0	9491	0	6	0	9497
28585	9420	0	20	0	0	9440
28586	4	0	10132	0	0	10136
28587	6	34	1	10071	0	10112
28588	1	10166	0	1	0	10168
28589	2	10188	0	5	0	10195
28590	10137	0	29	0	0	10166
28591	10073	0	44	3	0	10120
28592	2	0	10158	1	0	10161
28593	10722	0	28	4	0	10754
28594	2	22	2	10970	0	10996
28595	20	0	10438	1	0	10459
28596	7	0	11486	0	0	11493
28597	1	20	1	11514	0	11536
28598	11503	0	11	1	0	11515
28599	2	27	0	11445	0	11474
28600	2	23	0	11912	0	11937
28601	2	40	3	12023	0	12068
28602	1	12299	0	4	0	12304
28603	0	24	0	12322	0	12346
28604	12341	0	14	0	0	12355
28605	1	11410	2	561	0	11974
28606	1	28	0	11649	0	11678
28607	12860	0	24	1	0	12885
28608	1	13348	1	4	0	13354
28609	2	13049	0	4	0	13055
28610	0	27	0	13041	0	13068
28611	12878	0	32	0	0	12910
28612	5	0	12906	0	0	12911
28613	2	1	13026	2	0	13031
28614	12909	0	27	5	0	12941
28615	13011	1	31	0	0	13043
28616	4	12705	0	17	0	12726
28617	4	22	0	12723	0	12749
28618	7	1	12741	2	0	12751
28619	9	0	12729	15	0	12753
28620	16	0	13160	0	0	13176
28621	3	13181	3	9	0	13196
28622	2	13044	2	8	0	13056
28623	13037	1	22	6	0	13066
28624	4	1	13165	0	0	13170
28625	13467	1	35	4	0	13507
28626	13483	2	45	1	0	13531
28627	5	0	13394	0	0	13399
28628	0	13473	1	5	0	13479
28629	5	34	1	13510	0	13550
28630	11	1	13586	0	0	13598
28631	11	1	13574	4	0	13590
28632	13619	0	30	1	0	13650
28633	0	13699	0	4	0	13703
28634	1	46	2	13591	0	13640
28635	1	38	0	15406	0	15445
28636	2	15495	0	4	0	15501
28637	3	15498	0	7	0	15508
28638	1	15701	0	5	0	15707
28639	1	44	3	15580	0	15628
28640	15776	0	14	1	0	15791
28641	4	34	4	15696	0	15738
28642	10	1	15446	1	0	15458
28643	7	0	15775	5	0	15787
28644	5	40	1	14583	0	14629
28645	10	0	14347	7	0	14364
28646	0	14495	0	7	0	14502
28647	2	33	3	14484	0	14522
28648	15105	0	15	2	0	15122
28649	15240	1	32	4	0	15277
28650	0	15199	0	9	0	15208
28651	15052	1	27	1	0	15081
28652	14751	3	32	1	0	14787
28653	14605	0	73	6	0	14684
28654	3	0	14676	1	0	14680
28655	14666	2	35	0	0	14703
28656	2	15064	0	16	0	15082
28657	20	0	14678	1	0	14699
28658	9	0	14954	5	0	14968
28659	3	15221	1	18	0	15243
28660	15468	0	25	1	0	15494
28661	6	56	7	15851	0	15920
28662	1	15854	0	7	0	15862
28663	15927	1	26	3	0	15957
28664	0	19	0	15945	0	15964
28665	15944	0	9	3	0	15956
28666	3	32	2	16013	0	16050
28667	13	0	15453	1	0	15467
28668	7	2	15817	6	0	15832
28669	4	1	15698	6	0	15709
28670	2	48	2	15648	0	15700
28671	1	27	2	15198	0	15228
28672	12	0	14574	0	0	14586
28673	4	14741	1	9	0	14755
28674	14879	0	26	0	0	14905
28675	14991	1	45	4	0	15041
28676	1	14214	0	19	0	14234
28677	2	28	1	13941	0	13972
28678	18	0	14022	0	0	14040
28679	14052	0	43	8	0	14103
28680	48	0	14120	1	0	14169
28681	14	1	14119	2	0	14136
28682	26	0	13962	2	0	13990
28683	12734	0	35	11	0	12780
28684	11	1	12569	1	0	12582
28685	4	12596	0	6	0	12606
28686	3	12739	0	4	0	12746
28687	4	45	1	12729	0	12779
28688	2	26	0	12835	0	12863
28689	4	0	12868	6	0	12878
28690	13048	6	75	4	0	13133
28691	13206	0	31	2	0	13239
28692	1	31	0	13185	0	13217
28693	12353	1	15	2	0	12371
28694	3	12886	0	10	0	12899
28695	12637	3	33	2	0	12675
28696	0	13038	1	8	0	13047
28697	0	12955	0	11	0	12966
28698	12773	1	23	0	0	12797
28699	12858	0	21	1	0	12880
28700	12871	3	37	5	0	12916
28701	12664	0	39	3	0	12706
28702	3	0	12814	1	0	12818
28703	12624	0	39	3	0	12666
28704	3	55	1	12554	0	12613
28705	1	12543	1	6	0	12551
28706	12824	1	21	4	0	12850
28707	0	13245	0	3	0	13248
28708	13140	2	25	0	0	13167
28709	1	13	0	13017	0	13031
28710	4	32	1	12941	0	12978
28711	2	0	11172	9	0	11183
28712	14	1	11022	8	0	11045
28713	1	11186	0	7	0	11194
28714	11163	2	26	2	0	11193
28715	1	11531	0	7	0	11539
28716	3	11487	0	9	0	11499
28717	2	11485	0	9	0	11496
28718	12	0	11461	3	0	11476
28719	10	11131	0	4	0	11145
28720	11879	0	12	1	0	11892
28721	12028	1	14	2	0	12045
28722	4	34	1	12110	0	12149
28723	1	12139	0	6	0	12146
28724	0	12070	0	4	0	12074
28725	0	48	1	12177	0	12226
28726	15	1	12466	2	0	12484
28727	0	12572	1	5	0	12578
28728	0	28	2	12664	0	12694
28729	12809	0	15	0	0	12824
28730	12862	3	21	3	0	12889
28731	1	12970	0	4	0	12975
28732	12499	2	15	3	0	12519
28733	12657	0	22	1	0	12680
28734	0	28	1	12388	0	12417
28735	17	0	12195	2	0	12214
28736	2	11259	0	6	0	11267
28737	0	26	1	11179	0	11206
28738	9	0	11181	0	0	11190
28739	0	11186	1	7	0	11194
28740	11127	0	20	0	0	11147
28741	11162	2	19	1	0	11184
28742	2	27	0	11048	0	11077
28743	1	10657	0	8	0	10666
28744	13	4	10730	1	0	10748
28745	2	37	1	11211	0	11251
28746	12	0	11103	3	0	11118
28747	1	10986	0	11	0	10998
28748	1	23	0	11136	0	11160
28749	11311	0	19	5	0	11335
28750	0	11168	1	2	0	11171
28751	11226	4	25	1	0	11256
28752	11266	1	18	1	0	11286
28753	0	11197	0	5	0	11202
28754	2	44	2	10875	0	10923
28755	4	23	0	10998	0	11025
28756	1	11309	1	6	0	11317
28757	0	11388	2	10	0	11400
28758	2	42	1	11131	0	11176
28759	4	10969	0	3	0	10976
28760	10944	1	17	3	0	10965
28761	11145	3	24	2	0	11174
28762	8	0	11072	1	0	11081
28763	27	0	11459	2	0	11488
28764	11627	0	36	1	0	11664
28765	11326	3	41	2	0	11372
28766	2	11464	2	6	0	11474
28767	11438	5	30	3	0	11476
28768	11618	1	29	3	0	11651
28769	0	11275	1	2	0	11278
28770	10967	2	13	0	0	10982
28771	1	20	3	10895	0	10919
28772	6	31	1	10443	0	10481
28773	14	0	10774	9	0	10797
28774	2	11482	0	16	0	11500
28775	2	11665	2	9	0	11678
28776	11639	3	13	6	0	11661
28777	11526	2	15	3	0	11546
28778	11429	0	28	2	0	11459
28779	11398	2	38	0	0	11438
28780	4	0	11514	1	0	11519
28781	11	0	11493	2	0	11506
28782	0	11264	0	1	0	11265
28783	6	45	1	11615	0	11667
28784	0	17	0	11746	0	11763
28785	1	11684	1	4	0	11690
28786	3	13	0	11741	0	11757
28787	12488	0	20	0	0	12508
28788	1	12482	4	10	0	12497
28789	17	0	12439	1	0	12457
28790	0	12313	0	8	0	12321
28791	11968	1	23	4	0	11996
28792	9	0	12339	2	0	12350
28793	12435	2	26	4	0	12467
28794	12508	0	40	0	0	12548
28795	3	0	12522	0	0	12525
28796	8	2	11747	3	0	11760
28797	20	0	11807	1	0	11828
28798	11464	2	43	6	0	11515
28799	6	0	11359	2	0	11367
28800	2	11345	0	9	0	11356
28801	11011	2	19	3	0	11035
28802	2	0	10810	0	0	10812
28803	10670	2	25	4	0	10701
28804	1	0	10693	0	0	10694
28805	14	1	10623	2	0	10640
28806	3	10472	1	10	0	10486
28807	12	0	10401	2	0	10415
28808	8	0	10649	2	0	10659
28809	0	10688	1	4	0	10693
28810	10795	0	14	3	0	10812
28811	2	0	10881	0	0	10883
28812	4	25	3	11109	0	11141
28813	4	11092	0	5	0	11101
28814	11181	0	21	3	0	11205
28815	11218	0	36	4	0	11258
28816	4	0	11326	2	0	11332
28817	2	11431	0	19	0	11452
28818	3	11407	0	5	0	11415
28819	3	37	0	11246	0	11286
28820	0	10948	0	3	0	10951
28821	4	34	2	11035	0	11075
28822	3	33	0	11321	0	11357
28823	0	11313	0	6	0	11319
28824	3	28	1	11134	0	11166
28825	0	11217	0	9	0	11226
28826	14	0	11177	1	0	11192
28827	0	44	0	11362	0	11406
28828	6	44	1	11440	0	11491
28829	2	11608	0	2	0	11612
28830	1	11351	0	6	0	11358
28831	5	48	0	11213	0	11266
28832	1	11404	0	3	0	11408
28833	11382	0	13	1	0	11396
28834	4	27	2	11295	0	11328
28835	3	11485	1	12	0	11501
28836	11427	1	31	3	0	11462
28837	0	11291	0	15	0	11306
28838	11	2	11097	1	0	11111
28839	1	28	1	10880	0	10910
28840	11072	1	31	2	0	11106
28841	4	0	11264	0	0	11268
28842	2	24	1	11316	0	11343
28843	0	11030	1	22	0	11053
28844	17	3	11017	2	0	11039
28845	2	11178	1	10	0	11191
28846	11213	2	22	1	0	11238
28847	11257	0	27	2	0	11286
28848	0	10931	0	6	0	10937
28849	10144	2	13	0	0	10159
28850	12	0	10488	1	0	10501
28851	3	32	2	10425	0	10462
28852	7	38	1	10557	0	10603
28853	3	10615	0	7	0	10625
28854	10546	1	31	2	0	10580
28855	10580	0	27	1	0	10608
28856	2	1	10453	3	0	10459
28857	10783	0	35	0	0	10818
28858	10622	1	44	1	0	10668
28859	10279	0	36	0	0	10315
28860	1	11	1	10223	0	10236
28861	7	21	1	10209	0	10238
28862	1	9599	1	2	0	9603
28863	9563	2	21	2	0	9588
28864	9761	1	25	0	0	9787
28865	2	9713	0	31	0	9746
28866	6	30	4	9547	0	9587
28867	3	9328	1	3	0	9335
28868	0	9165	1	3	0	9169
28869	9182	3	20	2	0	9207
28870	7	1	9081	7	0	9096
28871	5	0	9111	5	0	9121
28872	1	8958	0	40	0	8999
28873	8842	0	26	1	0	8869
28874	11	0	9199	0	0	9210
28875	1	9924	0	18	0	9943
28876	9895	3	18	3	0	9919
28877	10	0	10444	1	0	10455
28878	1	13	1	10460	0	10475
28879	10378	2	21	1	0	10402
28880	10	0	10421	0	0	10431
28881	8	0	10205	3	0	10216
28882	28	0	10206	1	0	10235
28883	42	0	10410	2	0	10454
28884	10179	0	27	0	0	10206
28885	10233	2	18	0	0	10253
28886	0	10217	0	5	0	10222
28887	0	25	1	9798	0	9824
28888	1	22	2	10004	0	10029
28889	1	9862	0	0	0	9863
28890	3	32	0	9792	0	9827
28891	2	9900	0	4	0	9906
28892	0	9928	0	11	0	9939
28893	3	35	1	10058	0	10097
28894	8	1	10281	0	0	10290
28895	3	10076	0	11	0	10090
28896	1	21	1	9997	0	10020
28897	9987	4	22	3	0	10016
28898	4	0	9751	1	0	9756
28899	9864	0	21	0	0	9885
28900	9919	2	29	1	0	9951
28901	1	16	1	9884	0	9902
28902	10	0	9679	1	0	9690
28903	13	3	9517	4	0	9537
28904	0	8986	0	22	0	9008
28905	7	25	3	9054	0	9089
28906	12	1	9155	1	0	9169
28907	38	0	9202	5	0	9245
28908	2	9685	0	4	0	9691
28909	9688	0	18	0	0	9706
28910	9629	2	20	1	0	9652
28911	2	10	1	9705	0	9718
28912	7	0	9711	1	0	9719
28913	34	0	9744	2	0	9780
28914	2	9843	2	11	0	9858
28915	11	2	9763	0	0	9776
28916	8	0	9411	1	0	9420
28917	6	25	2	9181	0	9214
28918	5	0	9212	1	0	9218
28919	9469	3	20	0	0	9492
28920	2	21	1	9482	0	9506
28921	23	0	9322	1	0	9346
28922	3	9492	0	5	0	9500
28923	1	19	2	9488	0	9510
28924	14	0	9843	1	0	9858
28925	0	9508	1	1	0	9510
28926	2	29	1	9427	0	9459
28927	3	9624	0	1	0	9628
28928	3	25	0	9468	0	9496
28929	0	20	1	9516	0	9537
28930	8	1	9610	0	0	9619
28931	1	9719	0	7	0	9727
28932	3	31	2	9595	0	9631
28933	0	18	1	9655	0	9674
28934	2	17	0	9574	0	9593
28935	17	1	9327	7	0	9352
28936	0	9431	0	4	0	9435
28937	2	29	0	9457	0	9488
28938	7	0	9537	1	0	9545
28939	3	9544	1	6	0	9554
28940	3	25	2	9473	0	9503
28941	21	0	9631	3	0	9655
28942	0	9886	0	3	0	9889
28943	0	23	1	9955	0	9979
28944	3	35	2	9992	0	10032
28945	3	0	9900	0	0	9903
28946	9851	0	21	4	0	9876
28947	2	9833	0	4	0	9839
28948	9305	3	21	4	0	9333
28949	4	0	9656	0	0	9660
28950	9391	3	17	3	0	9414
28951	0	16	0	9341	0	9357
28952	7	22	2	9318	0	9349
28953	10	0	8996	0	0	9006
28954	8987	1	26	3	0	9017
28955	9007	0	27	0	0	9034
28956	5	8937	0	30	0	8972
28957	0	8959	0	8	0	8967
28958	8610	1	26	0	0	8637
28959	15	0	8712	0	0	8727
28960	0	8868	0	4	0	8872
28961	0	20	1	8797	0	8818
28962	2	14	1	8661	0	8678
28963	3	0	8681	0	0	8684
28964	8364	0	32	2	0	8398
28965	11	2	8499	1	0	8513
28966	8792	1	40	1	0	8834
28967	6	0	8882	1	0	8889
28968	4	9277	1	32	0	9314
28969	9349	20	10	4	0	9383
28970	9286	0	22	2	0	9310
28971	9207	0	13	1	0	9221
28972	9284	1	23	1	0	9309
28973	0	8	0	9272	0	9280
28974	7	0	9484	0	0	9491
28975	4	41	0	9359	0	9404
28976	1	9236	0	3	0	9240
28977	10	9	1	9239	0	9259
28978	6	1	9550	0	0	9557
28979	9	0	9680	2	0	9691
28980	13	11	2	9810	0	9836
28981	9744	1	14	0	0	9759
28982	9596	1	19	3	0	9619
28983	9060	0	33	0	0	9093
28984	3	0	9188	1	0	9192
28985	25	1	9136	27	0	9189
28986	4	9979	1	6	0	9990
28987	5	9811	0	6	0	9822
28988	9942	0	23	5	0	9970
28989	10164	5	26	5	0	10200
28990	0	10337	0	8	0	10345
28991	10301	3	26	0	0	10330
28992	10271	1	23	4	0	10299
28993	0	10423	0	8	0	10431
28994	10276	3	16	4	0	10299
28995	10175	0	32	1	0	10208
28996	0	10703	0	17	0	10720
28997	10782	0	20	0	0	10802
28998	10764	0	25	3	0	10792
28999	11	1	10788	1	0	10801
29000	6	0	10780	2	0	10788
29001	6	11733	2	6	0	11747
29002	3	11639	0	4	0	11646
29003	12078	1	19	3	0	12101
29004	12411	0	28	4	0	12443
29005	12462	2	54	0	0	12518
29006	0	12717	0	5	0	12722
29007	3	48	6	12453	0	12510
29008	6	0	12801	1	0	12808
29009	2	32	2	13115	0	13151
29010	6	13155	0	13	0	13174
29011	14238	2	27	2	0	14269
29012	20	14387	1	3	0	14411
29013	3	18	3	14637	0	14661
29014	14852	0	12	0	0	14864
29015	14597	3	24	5	0	14629
29016	4	0	14852	2	0	14858
29017	14348	3	35	3	0	14389
29018	14258	2	46	4	0	14310
29019	14398	0	45	0	0	14443
29020	1	23	3	14272	0	14299
29021	2	14409	0	3	0	14414
29022	2	26	1	14320	0	14349
29023	13	2	14391	2	0	14408
29024	1	14168	1	5	0	14175
29025	2	50	0	14062	0	14114
29026	14	0	14275	1	0	14290
29027	1	14212	1	10	0	14224
29028	3	34	1	14112	0	14150
29029	18	0	14457	1	0	14476
29030	14332	2	36	2	0	14372
29031	3	0	14602	1	0	14606
29032	6	0	14701	5	0	14712
29033	2	14888	0	4	0	14894
29034	4	75	2	14769	0	14850
29035	4	56	2	15071	0	15133
29036	2	15398	0	9	0	15409
29037	6	27	2	15578	0	15613
29038	16724	0	16	227	0	16967
29039	16814	2	29	11	0	16856
29040	3	2	16602	1	0	16608
29041	16135	0	75	4	0	16214
29042	15386	2	57	2	0	15447
29043	11	0	15511	1	0	15523
29044	7	15666	0	4	0	15677
29045	5	15468	0	7	0	15480
29046	3	16	1	15463	0	15483
29047	1	15509	1	13	0	15524
29048	99	0	15204	2	0	15305
29049	25	1	15423	6	0	15455
29050	11	15193	0	9	0	15213
29051	15352	2	24	2	0	15380
29052	15412	1	22	2	0	15437
29053	15249	2	34	4	0	15289
29054	15025	3	35	5	0	15068
29055	15042	6	40	2	0	15090
29056	0	15103	0	9	0	15112
29057	10	1	15065	0	0	15076
29058	3	15	0	14954	0	14972
29059	14999	1	23	1	0	15024
29060	3	14733	0	6	0	14742
29061	4	27	2	14573	0	14606
29062	29	0	14888	3	0	14920
29063	7	15168	1	17	0	15193
29064	1	15308	0	19	0	15328
29065	15410	1	34	5	0	15450
29066	1	15346	0	3	0	15350
29067	2	17	0	15361	0	15380
29068	16828	1	27	1	0	16857
29069	16464	3	65	3	0	16535
29070	16675	4	77	0	0	16756
29071	4	0	17215	0	0	17219
29072	1	16697	0	26	0	16724
29073	17273	1	33	1	0	17308
29074	1	20	0	17131	0	17152
29075	16841	1	13	3	0	16858
29076	4	17441	0	16	0	17461
29077	16476	0	29	6	0	16511
29078	18291	1	54	3	0	18349
29079	1	25	1	17864	0	17891
29080	12	0	17577	1	0	17590
29081	1	34	5	17519	0	17559
29082	17118	0	21	3	0	17142
29083	17269	7	53	3	0	17332
29084	0	17420	0	7	0	17427
29085	16615	4	38	3	0	16660
29086	0	16687	0	5	0	16692
29087	15632	2	38	3	0	15675
29088	15415	2	49	0	0	15466
29089	19	0	15561	4	0	15584
29090	1	15483	0	8	0	15492
29091	0	71	2	15312	0	15385
29092	1	25	0	15333	0	15359
29093	6	17	1	15346	0	15370
29094	0	15550	0	13	0	15563
29095	12	1	15563	2	0	15578
29096	15	3	15989	8	0	16015
29097	1	16062	1	17	0	16081
29098	15719	0	199	0	0	15918
29099	5	1	15903	2	0	15911
29100	16139	1	39	2	0	16181
29101	0	15980	0	12	0	15992
29102	8	2	16015	1	0	16026
29103	5	20	1	15822	0	15848
29104	19	0	15543	10	0	15572
29105	11	1	17398	4	0	17414
29106	3	63	1	17400	0	17467
29107	6	16917	1	9	0	16933
29108	3	16545	0	15	0	16563
29109	16423	4	43	8	0	16478
29110	5	0	16900	1	0	16906
29111	16568	2	40	3	0	16613
29112	16409	0	47	4	0	16460
29113	1	16331	1	9	0	16342
29114	14832	1	27	0	0	14860
29115	14822	0	32	1	0	14855
29116	14983	2	40	3	0	15028
29117	1	15134	0	14	0	15149
29118	1	15082	0	14	0	15097
29119	1	14842	0	9	0	14852
29120	14739	2	15	1	0	14757
29121	14717	0	39	4	0	14760
29122	0	0	14838	0	0	14838
29123	5	0	14880	2	0	14887
29124	14946	0	22	0	0	14968
29125	14823	0	37	0	0	14860
29126	14814	4	19	1	0	14838
29127	0	18	5	14822	0	14845
29128	1	23	1	14714	0	14739
29129	1	23	2	14864	0	14890
29130	0	32	3	14790	0	14825
29131	9	1	14513	10	0	14533
29132	6	0	14428	13	0	14447
29133	14	0	14372	9	0	14395
29134	6	0	14527	7	0	14540
29135	14796	1	40	4	0	14841
29136	3	14991	1	7	0	15002
29137	0	14703	0	18	0	14721
29138	14729	4	22	4	0	14759
29139	4	0	14391	3	0	14398
29140	6	0	14779	3	0	14788
29141	14638	1	137	5	0	14781
29142	14695	2	46	8	0	14751
29143	0	13594	0	37	0	13631
29144	5	13	3	13581	0	13602
29145	13912	1	23	0	0	13936
29146	13644	0	28	5	0	13677
29147	5	17	3	13570	0	13595
29148	0	13245	0	7	0	13252
29149	12689	1	50	3	0	12743
29150	3	1	13545	0	0	13549
29151	13749	2	45	2	0	13798
29152	1	13032	0	8	0	13041
29153	12910	2	29	0	0	12941
29154	11150	1	76	4	0	11231
29155	20	0	11181	1	0	11202
29156	8	2	11496	1	0	11507
29157	11500	1	34	3	0	11538
29158	11472	1	35	3	0	11511
29159	2	11329	0	5	0	11336
29160	2	10	0	10790	0	10802
29161	5	0	11624	3	0	11632
29162	11830	2	35	6	0	11873
29163	1	16	3	12205	0	12225
29164	0	11	4	12221	0	12236
29165	11909	3	17	0	0	11929
29166	2	12358	0	6	0	12366
29167	12703	1	25	1	0	12730
29168	12717	4	42	4	0	12767
29169	12799	6	36	3	0	12844
29170	0	12607	0	5	0	12612
29171	12049	2	33	1	0	12085
29172	0	20	0	11937	0	11957
29173	1	9	0	12029	0	12039
29174	10	0	11842	11	0	11863
29175	8	2	11955	7	0	11972
29176	4	12008	1	18	0	12031
29177	1	11993	4	6	0	12004
29178	12	1	12037	1	0	12051
29179	1	12063	0	12	0	12076
29180	12439	0	8	1	0	12448
29181	11127	0	22	2	0	11151
29182	11293	2	18	2	0	11315
29183	1	12	1	11472	0	11486
29184	1	19	2	11525	0	11547
29185	4	0	11577	5	0	11586
29186	0	11113	0	19	0	11132
29187	11199	0	44	3	0	11246
29188	0	11525	0	8	0	11533
29189	11451	1	26	2	0	11480
29190	11760	1	18	0	0	11779
29191	3	29	4	11655	0	11691
29192	2	16	3	11654	0	11675
29193	2	17	0	11778	0	11797
29194	17	0	11748	2	0	11767
29195	1	11711	3	6	0	11721
29196	5	11606	0	15	0	11626
29197	13	11632	1	13	0	11659
29198	3	14760	0	9	0	14772
29199	1	14811	0	14	0	14826
29200	14688	1	56	2	0	14747
29201	7	0	14961	3	0	14971
29202	4	15336	1	18	0	15359
29203	18	0	15355	3	0	15376
29204	3	15969	0	10	0	15982
29205	2	46	1	15878	0	15927
29206	7	22	4	15982	0	16015
29207	1	16083	3	5	0	16092
29208	15987	1	54	5	0	16047
29209	15	1	16071	3	0	16090
29210	4	15858	0	15	0	15877
29211	25	1	15927	0	0	15953
29212	1	34	2	15800	0	15837
29213	1	37	1	15705	0	15744
29214	1	15823	0	23	0	15847
29215	2	41	0	15811	0	15854
29216	2	24	5	16161	0	16192
29217	0	16320	0	5	0	16325
29218	9	0	16230	2	0	16241
29219	23	0	16176	2	0	16201
29220	15990	8	42	4	0	16044
29221	15692	0	41	2	0	15735
29222	2	17	0	15951	0	15970
29223	5	0	15637	1	0	15643
29224	8	35	1	15558	0	15602
29225	4	14602	0	15	0	14621
29226	18	1	14626	3	0	14648
29227	1	14675	1	12	0	14689
29228	16	0	14636	0	0	14652
29229	1	14674	0	38	0	14713
29230	14683	0	35	0	0	14718
29231	0	19	4	14723	0	14746
29232	1	18	1	14419	0	14439
29233	12	1	14738	4	0	14755
29234	7	1	14975	5	0	14988
29235	5	14890	0	14	0	14909
29236	15001	0	38	2	0	15041
29237	2	25	2	14302	0	14331
29238	17	0	13949	0	0	13966
29239	3	0	13712	5	0	13720
29240	13845	2	34	3	0	13884
29241	13894	1	47	10	0	13952
29242	2	0	13401	0	0	13403
29243	7	40	0	12984	0	13031
29244	2	12829	0	5	0	12836
29245	12923	0	34	2	0	12959
29246	1	12832	2	14	0	12849
29247	12967	0	61	2	0	13030
29248	1	13264	0	8	0	13273
29249	0	12986	0	4	0	12990
29250	3	80	1	12730	0	12814
29251	7	29	0	12887	0	12923
29252	2	12986	0	25	0	13013
29253	7	1	12936	0	0	12944
29254	6	0	12951	0	0	12957
29255	8	0	13060	1	0	13069
29256	12769	1	39	4	0	12813
29257	12497	1	30	3	0	12531
29258	2	12195	0	7	0	12204
29259	10	1	12172	1	0	12184
29260	2	13	2	12346	0	12363
29261	10	0	12232	1	0	12243
29262	14	0	12323	1	0	12338
29263	0	22	1	12412	0	12435
29264	3	31	0	12763	0	12797
29265	24	0	14152	1	0	14177
29266	14153	1	61	9	0	14224
29267	4	14420	0	7	0	14431
29268	2	14505	0	16	0	14523
29269	3	25	2	14400	0	14430
29270	16080	1	25	2	0	16108
29271	0	16008	0	16	0	16024
29272	15998	1	49	4	0	16052
29273	0	16037	0	14	0	16051
29274	12455	6	31	2	0	12494
29275	5	0	12470	2	0	12477
29276	8	0	12685	2	0	12695
29277	1	31	1	12496	0	12529
29278	11	1	12411	11	0	12434
29279	1	11962	0	14	0	11977
29280	0	11942	1	48	0	11991
29281	12149	3	25	3	0	12180
29282	4	30	0	13019	0	13053
29283	1	13145	0	3	0	13149
29284	13020	2	17	4	0	13043
29285	13026	0	17	10	0	13053
29286	13151	1	38	0	0	13190
29287	2	22	2	13138	0	13164
29288	3	16	2	13014	0	13035
29289	4	0	13032	3	0	13039
29290	7	0	12613	1	0	12621
29291	12702	2	29	7	0	12740
29292	2	26	1	12454	0	12483
29293	12	0	12349	0	0	12361
29294	12963	1	41	7	0	13012
29295	7	12867	0	4	0	12878
29296	13444	2	36	2	0	13484
29297	13421	0	17	2	0	13440
29298	13017	1	48	2	0	13068
29299	5	1	13036	1	0	13043
29300	13035	2	36	4	0	13077
29301	2	22	2	13040	0	13066
29302	5	13152	1	13	0	13171
29303	3	13070	0	6	0	13079
29304	13108	2	29	2	0	13141
29305	13299	3	24	1	0	13327
29306	13918	1	13	2	0	13934
29307	3	43	1	14003	0	14050
29308	1	26	0	13901	0	13928
29309	4	33	0	13481	0	13518
29310	12	13249	1	2	0	13264
29311	13427	1	26	1	0	13455
29312	13460	0	9	0	0	13469
29313	13338	1	46	4	0	13389
29314	0	0	13469	0	0	13469
29315	13158	2	47	3	0	13210
29316	8	27	1	13087	0	13123
29317	4	13220	0	13	0	13237
29318	13243	0	37	3	0	13283
29319	13249	2	42	1	0	13294
29320	8	1	13347	0	0	13356
29321	8	22	2	13473	0	13505
29322	1	13573	0	11	0	13585
29323	13463	0	26	1	0	13490
29324	1	33	1	13410	0	13445
29325	2	26	0	13336	0	13364
29326	5	24	0	13407	0	13436
29327	3	31	1	13312	0	13347
29328	3	0	13285	1	0	13289
29329	1	13263	0	18	0	13282
29330	0	18	1	13387	0	13406
29331	7	0	13867	0	0	13874
29332	13786	0	39	4	0	13829
29333	13859	1	61	0	0	13921
29334	3	14	2	14019	0	14038
29335	14056	2	17	3	0	14078
29336	13846	22	33	2	0	13903
29337	3	1	14130	1	0	14135
29338	4	14082	1	10	0	14097
29339	14264	1	33	2	0	14300
29340	1	17	0	13965	0	13983
29341	12561	0	16	2	0	12579
29342	7	22	0	12250	0	12279
29343	4	25	0	11961	0	11990
29344	7	0	11875	2	0	11884
29345	11823	0	30	3	0	11856
29346	1	10228	0	20	0	10249
29347	7	5	10563	1	0	10576
29348	10	16002	3	14	0	16029
29349	102685	97	32	16	0	102830
29350	12	34	11	112244	0	112301
29351	113933	3	23	24	0	113983
29352	18	131390	2	50	0	131460
29353	133958	326	34	5	0	134323
29354	150725	3	49	10	0	150787
29355	150729	6	31	9	0	150775
29356	158141	10	66	12	0	158229
29357	4	165226	3	50	0	165283
29358	170198	9	37	20	0	170264
29359	12	67	4	171642	0	171725
29360	32	232	9	171171	0	171444
29361	14	225913	4	75	0	226006
29362	17	226560	9	64	0	226650
29363	16	277444	11	165	0	277636
29364	279149	63	361	80	0	279653
29365	12	284518	15	238	0	284783
29366	29	293092	7	390	0	293518
29367	297042	68	476	146	0	297732
29368	299288	27	1059	72	0	300446
29369	8	299925	8	173	0	300114
29370	298565	27	1839	72	0	300503
29371	189	13	301350	43	0	301595
29372	302846	21	795	96	0	303758
29373	338	15	329318	22	0	329693
29374	21	326471	13	3399	0	329904
29375	30	331699	7	190	0	331926
29376	100	769	46	329342	0	330257
29377	336106	70	444	66	0	336686
29378	334842	89	612	143	0	335686
29379	335421	37	921	51	0	336430
29380	335367	46	1161	82	0	336656
29381	332022	124	3890	49	0	336085
29382	182	13	342469	30	0	342694
29383	148	11	343186	133	0	343478
29384	341614	38	735	163	0	342550
29385	19	346356	6	184	0	346565
29386	346033	44	952	117	0	347146
29387	350526	55	684	112	0	351377
29388	350726	68	907	70	0	351771
29389	353327	30	1190	47	0	354594
29390	352884	64	2482	83	0	355513
29391	99	13	371366	40	0	371518
29392	370181	27	1032	203	0	371443
29393	370445	44	1451	125	0	372065
29394	142	17	370815	64	0	371038
29395	369447	37	929	147	0	370560
29396	370778	26	3074	100	0	373978
29397	120	1	377481	46	0	377648
29398	277	11	375525	177	0	375990
29399	14	377404	16	242	0	377676
29400	92	925	68	378329	0	379414
29401	288	7	390436	36	0	390767
29402	389845	70	990	174	0	391079
29403	80	941	47	391836	0	392904
29404	1722	14	389469	62	0	391267
29405	391197	28	1036	200	0	392461
29406	393655	35	1403	56	0	395149
29407	406456	78	1124	104	0	407762
29408	9	409143	4	229	0	409385
29409	140	1293	31	402357	0	403821
29410	12	408167	12	193	0	408384
29411	407530	76	835	94	0	408535
29412	410716	47	913	83	0	411759
29413	328	8	413136	97	0	413569
29414	25	422012	12	300	0	422349
29415	24	423589	4	159	0	423776
29416	95	1219	67	429132	0	430513
29417	49	929	17	430398	0	431393
29418	435517	29	533	70	0	436149
29419	15	439582	19	277	0	439893
29420	35	438546	13	472	0	439066
29421	417	34	440425	46	0	440922
29422	22	440992	9	219	0	441242
29423	434527	66	4513	101	0	439207
29424	176	6	433255	43	0	433480
29425	357534	29	985	150	0	358698
29426	105	14	355966	45	0	356130
29427	354384	24	849	96	0	355353
29428	10	340493	9	143	0	340655
29429	340546	39	790	164	0	341539
29430	210	7	333690	25	0	333932
29431	335243	32	910	149	0	336334
29432	331000	31	914	91	0	332036
29433	130	11	324556	40	0	324737
29434	332116	27	779	143	0	333065
29435	332608	25	874	79	0	333586
29436	334051	85	2102	84	0	336322
29437	19	287738	6	104	0	287867
29438	288053	16	687	103	0	288859
29439	193	3	241447	20	0	241663
29440	15	238627	16	186	0	238844
29441	238451	14	442	52	0	238959
29442	235586	40	564	74	0	236264
29443	243722	103	625	49	0	244499
29444	4	247924	1	74	0	248003
29445	41	564	25	246747	0	247377
29446	1496	3	249819	24	0	251342
29447	55	603	41	250866	0	251565
29448	145	5	250171	55	0	250376
29449	233183	23	529	140	0	233875
29450	5	240045	4	94	0	240148
29451	94	759	36	235201	0	236090
29452	7	242658	2	61	0	242728
29453	49	769	15	241269	0	242102
29454	63	619	9	255690	0	256381
29455	19	256666	4	95	0	256784
29456	90	988	28	255752	0	256858
29457	73	700	12	257691	0	258476
29458	26	246845	3	2455	0	249329
29459	11	256905	7	136	0	257059
29460	57	539	22	260483	0	261101
29461	229	7	260473	46	0	260755
29462	21	255859	7	136	0	256023
29463	45	839	23	255985	0	256892
29464	175	11	256082	114	0	256382
29465	24	256122	3	301	0	256450
29466	256701	13	771	50	0	257535
29467	111	4	248231	17	0	248363
29468	252773	26	523	64	0	253386
29469	36	510	24	258424	0	258994
29470	55	609	39	258223	0	258926
29471	115	513	93	258946	0	259667
29472	207	9	256657	91	0	256964
29473	114	13	253307	128	0	253562
29474	257710	17	580	77	0	258384
29475	42	526	19	263572	0	264159
29476	123	7	263437	21	0	263588
29477	255090	33	422	59	0	255604
29478	34	987	34	253167	0	254222
29479	43	868	20	266236	0	267167
29480	132	800	22	271405	0	272359
29481	23	266326	7	111	0	266467
29482	77	691	17	264376	0	265161
29483	56	265744	13	116	0	265929
29484	43	269872	10	224	0	270149
29485	271884	61	531	65	0	272541
29486	271681	39	989	71	0	272780
29487	275785	84	737	87	0	276693
29488	20	282930	3	98	0	283051
29489	283330	23	502	39	0	283894
29490	275865	29	483	21	0	276398
29491	35	610	12	275881	0	276538
29492	187	673	34	275765	0	276659
29493	266	21	276548	120	0	276955
29494	60	279415	10	204	0	279689
29495	281929	16	541	29	0	282515
29496	281668	21	669	105	0	282463
29497	39	292349	7	136	0	292531
29498	290857	33	579	48	0	291517
29499	301799	21	660	48	0	302528
29500	144	634	60	338533	0	339371
29501	80	335991	8	181	0	336260
29502	25	336548	4	237	0	336814
29503	335257	40	632	69	0	335998
29504	78	901	54	332651	0	333684
29505	287	6	339504	53	0	339850
29506	327073	31	998	155	0	328257
29507	147	12	332484	42	0	332685
29508	26	330895	14	325	0	331260
29509	319572	36	695	77	0	320380
29510	936	9	355365	23	0	356333
29511	100	534	29	356019	0	356682
29512	315	15	350434	126	0	350890
29513	27	342345	9	435	0	342816
29514	179	1018	61	342855	0	344113
29515	233	2	348534	59	0	348828
29516	341992	139	727	475	0	343333
29517	34	344997	8	184	0	345223
29518	138	1231	43	342891	0	344303
29519	36	333423	7	229	0	333695
29520	330317	136	893	92	0	331438
29521	343703	23	685	46	0	344457
29522	15	339649	4	154	0	339822
29523	137	793	29	348996	0	349955
29524	40	351416	6	124	0	351586
29525	344749	45	600	131	0	345525
29526	199	7	358095	45	0	358346
29527	231	17	375010	117	0	375375
29528	84	386606	14	209	0	386913
29529	52	378146	4	187	0	378389
29530	48	565	23	379219	0	379855
29531	382006	16	1064	52	0	383138
29532	397261	49	875	103	0	398288
29533	424975	97	914	64	0	426050
29534	19	433066	2	137	0	433224
29535	180	1177	52	419639	0	421048
29536	34	429363	5	238	0	429640
29537	431230	60	875	138	0	432303
29538	71	929	23	442887	0	443910
29539	389	9	441126	83	0	441607
29540	36	442365	18	285	0	442704
29541	438894	47	1183	108	0	440232
29542	189	12	446785	59	0	447045
29543	444537	47	1074	205	0	445863
29544	55	451078	14	212	0	451359
29545	37	446217	16	360	0	446630
29546	469009	57	1008	199	0	470273
29547	35	473978	7	213	0	474233
29548	478212	44	1169	186	0	479611
29549	41	480157	10	259	0	480467
29550	472729	149	1085	106	0	474069
29551	479335	49	1196	197	0	480777
29552	189	7	480095	40	0	480331
29553	247	30	480192	129	0	480598
29554	42	483454	11	314	0	483821
29555	469037	47	1164	327	0	470575
29556	187	5	465858	30	0	466080
29557	459304	37	1191	202	0	460734
29558	75	648	52	461060	0	461835
29559	259	3	466612	87	0	466961
29560	374	26	473561	212	0	474173
29561	487	32	477338	119	0	477976
29562	58	482168	56	275	0	482557
29563	88	2182	48	478854	0	481172
29564	546608	31	911	111	0	547661
29565	60	595	26	546159	0	546840
29566	559699	38	1347	94	0	561178
29567	86	1001	30	560829	0	561946
29568	550537	41	655	43	0	551276
29569	538383	64	1319	149	0	539915
29570	539276	166	1298	67	0	540807
29571	11	562086	13	300	0	562410
29572	202	5	562411	12	0	562630
29573	62	1128	441	544240	0	545871
29574	148	1616	124	545508	0	547396
29575	164	1391	51	541704	0	543310
29576	257	1025	63	519577	0	520922
29577	49	517784	23	365	0	518221
29578	435	22	517459	53	0	517969
29579	33	516329	6	231	0	516599
29580	146	3506	79	515515	0	519246
29581	107	1424	52	520952	0	522535
29582	111	1656	49	519509	0	521325
29583	180	1019	30	523597	0	524826
29584	96	525230	24	241	0	525591
29585	46	490960	25	425	0	491456
29586	199	18	496043	29	0	496289
29587	91	1324	259	493749	0	495423
29588	82	829	42	490932	0	491885
29589	35	588	17	495795	0	496435
29590	522294	35	720	63	0	523112
29591	44	519477	24	559	0	520104
29592	292	10	523770	34	0	524106
29593	546687	67	1489	333	0	548576
29594	90	724	102	555166	0	556082
29595	593307	35	1831	143	0	595316
29596	123	760	46	597857	0	598786
29597	594207	48	876	160	0	595291
29598	98	954	29	598551	0	599632
29599	588378	70	856	165	0	589469
29600	291	34	633225	79	0	633629
29601	277	1712	74	627939	0	630002
29602	84	601746	13	300	0	602143
29603	102	1040	72	596665	0	597879
29604	589583	33	873	114	0	590603
29605	31	604342	3	216	0	604592
29606	237	1610	42	597187	0	599076
29607	40	597853	8	195	0	598096
29608	172	2477	81	587720	0	590450
29609	156	1325	60	562206	0	563747
29610	309	15	556952	97	0	557373
29611	282	1626	51	618075	0	620034
29612	552	36	606423	164	0	607175
29613	39	611419	37	406	0	611901
29614	595443	90	1634	276	0	597443
29615	279	18	603565	70	0	603932
29616	596318	53	1173	200	0	597744
29617	596263	39	1626	77	0	598005
29618	50	1048	59	589977	0	591134
29619	366	17	589191	41	0	589615
29620	619198	53	1291	206	0	620748
29621	625283	46	1606	67	0	627002
29622	106	1125	53	626194	0	627478
29623	195	1657	67	622140	0	624059
29624	47	624194	14	261	0	624516
29625	247	1711	42	625139	0	627139
29626	44	621222	19	412	0	621697
29627	520	40	621976	81	0	622617
29628	82	811	40	686750	0	687683
29629	682868	49	832	73	0	683822
29630	681474	58	1557	148	0	683237
29631	60	689909	12	307	0	690288
29632	215	1001	54	690517	0	691787
29633	711956	29	758	128	0	712871
29634	64	703037	7	416	0	703524
29635	696783	123	1555	137	0	698598
29636	288	977	31	688575	0	689871
29637	670327	38	785	153	0	671303
29638	404	25	682310	126	0	682865
29639	174	647729	23	499	0	648425
29640	646846	73	1243	262	0	648424
29641	135	653332	8	306	0	653781
29642	640374	58	1688	238	0	642358
29643	651990	87	1314	174	0	653565
29644	189	24	658608	47	0	658868
29645	89	673	85	661143	0	661990
29646	656985	49	1015	97	0	658146
29647	260	11	639672	50	0	639993
29648	632930	68	1619	176	0	634793
29649	129	1305	67	637669	0	639170
29650	308	18	637457	32	0	637815
29651	114	791	49	637859	0	638813
29652	623190	25	1046	116	0	624377
29653	226	6	623864	25	0	624121
29654	226	1178	97	619403	0	620904
29655	107	857	43	617705	0	618712
29656	624967	19	591	74	0	625651
29657	628303	57	1323	89	0	629772
29658	36	631536	7	154	0	631733
29659	80	1642	75	627381	0	629178
29660	135	1327	69	624722	0	626253
29661	72	795	41	626202	0	627110
29662	618884	35	711	172	0	619802
29663	618841	71	1207	61	0	620180
29664	212	1501	66	617507	0	619286
29665	36	597499	16	221	0	597772
29666	404	1992	100	577448	0	579944
29667	74	586804	9	239	0	587126
29668	588063	81	1166	190	0	589500
29669	36	561080	12	273	0	561401
29670	558441	24	1218	148	0	559831
29671	107	1138	29	518775	0	520049
29672	517774	60	631	114	0	518579
29673	717	15	508613	69	0	509414
29674	42	505433	7	418	0	505900
29675	501623	42	1054	114	0	502833
29676	461136	50	822	53	0	462061
29677	126	1063	34	519771	0	520994
29678	37	522232	4	206	0	522479
29679	94	1793	58	524171	0	526116
29680	106	1338	60	522369	0	523873
29681	87	591	28	511015	0	511721
29682	508631	20	710	148	0	509509
29683	500218	66	1165	85	0	501534
29684	99	978	45	504440	0	505562
29685	39	504473	12	226	0	504750
29686	435241	65	767	131	0	436204
29687	169	7	454728	27	0	454931
29688	128	888	39	490473	0	491528
29689	232	7	502987	35	0	503261
29690	147	1504	61	501412	0	503124
29691	381	15	495967	29	0	496392
29692	198	1627	23	504374	0	506222
29693	517168	32	779	59	0	518038
29694	531445	60	1243	180	0	532928
29695	36	535439	4	310	0	535789
29696	494683	48	1069	99	0	495899
29697	84	1427	53	491167	0	492731
29698	114	677	37	478697	0	479525
29699	479194	31	1085	78	0	480388
29700	272	4	472443	53	0	472772
29701	192	16	469811	102	0	470121
29702	301	7	466742	116	0	467166
29703	422531	56	1223	195	0	424005
29704	189	13	404499	31	0	404732
29705	225	11	453763	76	0	454075
29706	465583	32	1190	150	0	466955
29707	41	435338	6	4784	0	440169
29708	124	1110	44	440343	0	441621
29709	74	1256	57	440881	0	442268
29710	210	22	442249	39	0	442520
29711	442132	28	1361	103	0	443624
29712	442009	36	1127	42	0	443214
29713	431920	44	1582	134	0	433680
29714	112	7	413493	25	0	413637
29715	399753	46	1234	166	0	401199
29716	229	11	405896	26	0	406162
29717	141	401096	30	342	0	401609
29718	211	430784	16	389	0	431400
29719	447589	75	1100	159	0	448923
29720	134	458358	13	223	0	458728
29721	80	457203	15	281	0	457579
29722	489282	34	763	180	0	490259
29723	28	488947	8	210	0	489193
29724	488663	35	953	25	0	489676
29725	134	1247	58	487159	0	488598
29726	112	1453	66	482602	0	484233
29727	140	2415	158	490022	0	492735
29728	301	1389	103	486260	0	488053
29729	84	489741	8	210	0	490043
29730	492911	51	1278	83	0	494323
29731	109	494597	10	4245	0	498961
29732	60	576142	22	524	0	576748
29733	415	15	576248	77	0	576755
29734	569240	50	1029	210	0	570529
29735	293	15	570425	47	0	570780
29736	474	77	574538	58	0	575147
29737	284	573834	17	551	0	574686
29738	171	570429	15	502	0	571117
29739	578011	49	1135	91	0	579286
29740	86	586289	58	2336	0	588769
29741	718	14	589375	32	0	590139
29742	179	584786	32	545	0	585542
29743	527	24	585008	47	0	585606
29744	359	11	592362	86	0	592818
29745	588372	50	1636	247	0	590305
29746	232	15	592524	18	0	592789
29747	47	646	45	595933	0	596671
29748	597023	32	917	88	0	598060
29749	67	589949	26	476	0	590518
29750	1019	19	587224	36	0	588298
29751	588079	107	1403	173	0	589762
29752	285	1075	74	590814	0	592248
29753	127	529500	19	441	0	530087
29754	384	24	531937	40	0	532385
29755	522253	48	1484	149	0	523934
29756	240	8	530491	13	0	530752
29757	177	1100	600	542358	0	544235
29758	255	8	544195	8	0	544466
29759	110	2377	39	543631	0	546157
29760	542516	38	846	91	0	543491
29761	173	534642	22	4205	0	539042
29762	527939	52	1525	101	0	529617
29763	341	9	512186	17	0	512553
29764	146	1412	91	570070	0	571719
29765	335	17	559635	30	0	560017
29766	587251	62	1722	223	0	589258
29767	600046	44	2714	222	0	603026
29768	337	594345	18	534	0	595234
29769	592013	39	1140	79	0	593271
29770	583700	59	1308	77	0	585144
29771	78	922	60	582027	0	583087
29772	577	11	577241	25	0	577854
29773	104	573848	27	282	0	574261
29774	104	1058	66	566926	0	568154
29775	567713	42	1557	175	0	569487
29776	725	11	565790	81	0	566607
29777	285	16	584426	69	0	584796
29778	298	8	586976	36	0	587318
29779	530151	47	1829	189	0	532216
29780	198	11	531681	15	0	531905
29781	512800	53	1777	197	0	514827
29782	253	11	517546	19	0	517829
29783	85	513729	16	355	0	514185
29784	64	860	47	510946	0	511917
29785	277	9	512699	29	0	513014
29786	289	508632	20	361	0	509302
29787	94	512116	22	280	0	512512
29788	119	900	36	512411	0	513466
29789	509975	35	643	89	0	510742
29790	95	591	68	508636	0	509390
29791	508761	21	700	61	0	509543
29792	216	1019	57	506760	0	508052
29793	281	6	501720	30	0	502037
29794	247	13	452070	30	0	452360
29795	441532	19	865	68	0	442484
29796	421711	30	1627	73	0	423441
29797	158	6	421522	9	0	421695
29798	382973	41	1274	95	0	384383
29799	133	8	387142	10	0	387293
29800	239	381149	14	316	0	381718
29801	260	382459	10	236	0	382965
29802	85	380328	4	4483	0	384900
29803	83	624	32	375238	0	375977
29804	374747	15	498	37	0	375297
29805	375103	30	589	47	0	375769
29806	73	714	30	368040	0	368857
29807	169	3	368685	12	0	368869
29808	63	649	37	268545	0	269294
29809	161	5	267787	9	0	267962
29810	52	378	22	268065	0	268517
29811	263651	14	230	19	0	263914
29812	262126	15	442	21	0	262604
29813	258499	19	270	30	0	258818
29814	259715	13	427	52	0	260207
29815	18	561	37	258037	0	258653
29816	20	160	13	244396	0	244589
29817	243177	13	113	32	0	243335
29818	242258	16	285	18	0	242577
29819	42	528	28	240968	0	241566
29820	31	795	29	237221	0	238076
29821	72	517	44	233273	0	233906
29822	22	346	20	234614	0	235002
29823	233262	11	306	24	0	233603
29824	86	3	232674	6	0	232769
29825	53	304	14	232358	0	232729
29826	224404	15	479	61	0	224959
29827	155	3	224702	8	0	224868
29828	67	374	28	215573	0	216042
29829	174	2	215343	8	0	215527
29830	29	215368	8	158	0	215563
29831	57	283	29	199496	0	199865
29832	199433	5	395	38	0	199871
29833	150	395	47	193071	0	193663
29834	102	196090	8	158	0	196358
29835	75	195646	4	50	0	195775
29836	39	135981	2	106	0	136128
29837	38	107480	2	251	0	107771
29838	97776	119	28	8	0	97931
29839	8	12	2	96318	0	96340
29840	10	0	96630	3	0	96643
29841	7	13	2	70675	0	70697
29842	6	0	68817	0	0	68823
29843	44220	8	8	211	0	44447
29844	2	4	2	39379	0	39387
29845	3	1	2	35862	0	35868
29846	1	1	1	30837	0	30840
29847	29	1	0	27374	0	27404
29848	26379	0	5	0	0	26384
29849	26078	0	2	21	0	26101
29850	2	1	1	25934	0	25938
29851	402	9	0	1	0	412
29852	0	2	321	0	0	323
29853	0	139	0	0	0	139
29854	0	0	0	134	0	134
29855	0	0	0	131	0	131
29856	0	129	0	0	0	129
29857	0	0	0	1	0	1
