Pos	A	C	G	T	Other	Total
0	0	0	0	0	0
1	0	0	0	0	0
2	0	0	0	0	0
3	0	0	0	0	0
4	0	0	0	0	0
5	0	0	0	0	0
6	0	0	0	0	0
7	0	0	0	0	0
8	0	0	0	0	0
9	0	0	0	0	0
10	0	0	0	0	0
11	0	0	0	0	0
12	0	0	0	0	0
13	0	0	0	0	0
14	0	0	0	0	0
15	0	1	0	0	0	1
16	0	0	0	1	0	1
17	0	0	0	1	0	1
18	0	1	0	0	0	1
19	0	1	0	0	0	1
20	0	2	0	0	0	2
21	2	0	0	0	0	2
22	0	0	1	0	0	1
23	0	0	4	0	0	4
24	0	0	0	4	0	4
25	7	0	0	0	0	7
26	7	0	0	0	0	7
27	0	8	0	0	0	8
28	9	0	0	1	0	10
29	7	0	0	0	0	7
30	9	0	0	0	0	9
31	0	10	0	0	0	10
32	0	11	0	0	0	11
33	13	0	0	0	0	13
34	14	0	0	0	0	14
35	0	14	0	0	0	14
36	0	26	0	0	0	26
37	29	0	0	0	0	29
38	30	0	0	0	0	30
39	0	33	0	0	0	33
40	0	0	0	45	0	45
41	0	0	0	42	0	42
42	0	0	0	44	0	44
43	0	38	0	0	0	38
44	0	0	34	0	0	34
45	44	0	0	0	0	44
46	0	0	0	45	0	45
47	0	47	0	0	0	47
48	0	0	0	46	0	46
49	0	45	0	0	0	45
50	0	0	0	46	0	46
51	0	0	0	47	0	47
52	0	0	47	0	0	47
53	0	0	0	46	0	46
54	45	0	0	0	0	45
55	0	0	46	0	0	46
56	46	0	0	0	0	46
57	0	0	0	46	0	46
58	0	46	0	0	0	46
59	0	0	0	47	0	47
60	0	0	45	0	0	45
61	0	0	0	45	0	45
62	0	0	0	48	0	48
63	0	48	0	0	0	48
64	0	0	0	47	0	47
65	0	47	0	0	0	47
66	0	0	0	47	0	47
67	49	0	0	0	0	49
68	45	0	0	0	0	45
69	48	0	0	0	0	48
70	0	48	0	0	0	48
71	0	0	46	0	0	46
72	47	0	0	0	0	47
73	47	0	0	0	0	47
74	0	47	0	0	0	47
75	0	0	0	41	0	41
76	0	0	0	34	0	34
77	0	0	0	31	0	31
78	32	0	0	0	0	32
79	30	0	0	0	0	30
80	35	0	0	0	0	35
81	35	0	0	0	0	35
82	0	0	0	35	0	35
83	0	35	0	0	0	35
84	0	0	0	36	0	36
85	0	0	34	0	0	34
86	0	0	0	34	0	34
87	0	0	36	0	0	36
88	1	0	0	35	0	36
89	0	0	37	0	0	37
90	0	0	34	0	0	34
91	0	38	0	0	0	38
92	0	0	0	37	0	37
93	0	0	37	0	0	37
94	0	0	0	38	0	38
95	1	38	0	0	0	39
96	39	0	0	0	0	39
97	0	39	0	0	0	39
98	0	0	0	38	0	38
99	0	37	0	1	0	38
100	0	0	37	0	0	37
101	0	0	35	0	0	35
102	0	37	0	0	0	37
103	0	0	0	38	0	38
104	0	0	40	0	0	40
105	0	38	0	0	0	38
106	40	0	0	0	0	40
107	0	0	0	40	0	40
108	0	0	41	0	0	41
109	0	41	0	0	0	41
110	0	0	0	42	0	42
111	0	0	0	44	0	44
112	42	0	0	0	0	42
113	0	0	39	0	0	39
114	0	0	0	42	0	42
115	0	0	40	0	0	40
116	0	39	0	0	0	39
117	40	0	0	0	0	40
118	0	35	0	0	0	35
119	0	0	0	38	0	38
120	0	38	0	0	0	38
121	37	0	0	0	0	37
122	0	36	0	0	0	36
123	0	0	35	0	0	35
124	0	36	0	0	0	36
125	35	0	0	0	0	35
126	0	0	35	0	0	35
127	0	0	0	32	0	32
128	33	0	0	0	0	33
129	0	0	0	27	0	27
130	26	0	0	0	0	26
131	27	0	0	0	0	27
132	0	0	0	24	0	24
133	0	0	0	20	0	20
134	20	0	0	0	0	20
135	18	0	0	0	0	18
136	0	0	0	19	0	19
137	19	0	0	0	0	19
138	20	0	0	0	0	20
139	0	20	0	0	0	20
140	0	0	0	20	0	20
141	20	0	0	0	0	20
142	22	0	0	0	0	22
143	0	0	0	24	0	24
144	0	0	0	24	0	24
145	23	0	0	0	0	23
146	0	24	0	0	0	24
147	0	0	0	25	0	25
148	0	0	24	0	0	24
149	0	0	0	23	0	23
150	0	23	0	0	0	23
151	0	0	23	0	0	23
152	0	0	0	22	0	22
153	0	0	0	21	0	21
154	0	0	24	0	0	24
155	24	0	0	0	0	24
156	0	27	0	0	0	27
157	27	0	0	0	0	27
158	0	0	24	0	0	24
159	0	0	25	0	0	25
160	28	0	0	0	0	28
161	0	28	0	0	0	28
162	28	0	0	0	0	28
163	0	27	0	0	0	27
164	0	0	26	1	0	27
165	28	0	0	0	0	28
166	0	0	30	0	0	30
167	0	0	0	31	0	31
168	31	0	0	0	0	31
169	31	0	0	0	0	31
170	0	33	0	0	0	33
171	0	0	0	35	0	35
172	0	33	0	0	0	33
173	0	0	32	0	0	32
174	1	0	0	32	0	33
175	0	33	0	0	0	33
176	0	0	0	33	0	33
177	33	0	0	0	0	33
178	0	0	0	33	0	33
179	0	33	0	0	0	33
180	0	0	0	36	0	36
181	0	0	0	35	0	35
182	0	32	1	0	0	33
183	0	0	0	34	0	34
184	0	0	32	0	0	32
185	0	32	0	0	0	32
186	34	0	0	0	0	34
187	0	0	35	0	0	35
188	0	0	29	0	0	29
189	0	33	0	0	0	33
190	0	0	0	35	0	35
191	0	0	36	0	0	36
192	0	33	0	0	0	33
193	0	0	0	33	0	33
194	0	0	0	33	0	33
195	34	0	0	0	0	34
196	0	34	0	0	0	34
197	1	0	28	0	0	29
198	0	0	34	0	0	34
199	0	0	0	35	0	35
200	0	0	0	37	0	37
201	0	0	0	34	0	34
202	0	36	0	0	0	36
203	0	0	36	0	0	36
204	0	0	0	34	0	34
205	0	32	0	0	0	32
206	0	35	0	0	0	35
207	0	0	35	0	0	35
208	0	0	0	38	0	38
209	0	0	38	0	0	38
210	0	0	0	38	0	38
211	0	0	0	37	0	37
212	0	0	36	0	0	36
213	0	36	0	0	0	36
214	39	0	0	0	0	39
215	0	0	39	0	0	39
216	0	35	0	0	0	35
217	0	39	0	0	0	39
218	0	0	40	0	0	40
219	40	0	0	0	0	40
220	0	0	0	38	0	38
221	0	39	0	0	0	39
222	39	0	0	0	0	39
223	0	0	0	39	0	39
224	0	38	0	0	0	38
225	40	0	0	0	0	40
226	0	0	40	0	0	40
227	0	38	0	0	0	38
228	39	0	0	0	0	39
229	0	39	0	0	0	39
230	41	0	0	0	0	41
231	0	0	0	40	0	40
232	0	39	0	0	0	39
233	0	0	0	39	0	39
234	40	0	0	0	0	40
235	0	0	38	0	0	38
236	0	0	37	0	0	37
237	0	0	0	36	0	36
238	0	0	0	39	0	39
239	0	0	0	40	0	40
240	0	38	0	0	0	38
241	0	0	40	0	0	40
242	1	0	0	37	0	38
243	0	39	0	0	0	39
244	0	38	0	0	0	38
245	1	0	39	0	0	40
246	1	0	38	0	0	39
247	0	0	38	0	0	38
248	0	0	0	39	0	39
249	0	0	37	0	0	37
250	0	0	0	36	0	36
251	0	0	38	0	0	38
252	40	0	0	0	0	40
253	0	36	0	0	0	36
254	0	38	0	0	0	38
255	0	0	40	0	0	40
256	42	0	0	0	0	42
257	42	0	0	0	0	42
258	41	0	0	0	0	41
259	0	0	40	0	0	40
260	0	0	43	0	0	43
261	0	0	0	43	0	43
262	41	0	0	0	0	41
263	38	0	0	0	0	38
264	0	2	36	0	0	38
265	36	0	0	2	0	38
266	0	0	0	34	0	34
267	0	0	37	0	0	37
268	0	0	38	0	0	38
269	41	0	0	0	0	41
270	0	0	38	0	0	38
271	39	0	0	0	0	39
272	0	0	34	0	0	34
273	0	38	0	0	0	38
274	0	40	0	0	0	40
275	0	0	0	43	0	43
276	0	0	0	43	0	43
277	0	0	44	0	0	44
278	0	0	0	45	0	45
279	0	38	0	0	0	38
280	0	40	0	0	0	40
281	0	44	0	0	0	44
282	1	0	0	44	0	45
283	0	0	43	0	0	43
284	0	0	42	0	0	42
285	0	0	0	44	0	44
286	0	0	0	44	0	44
287	0	0	0	43	0	43
288	0	43	0	0	0	43
289	45	0	0	0	0	45
290	44	0	0	0	0	44
291	0	44	0	0	0	44
292	0	0	38	0	0	38
293	46	0	0	0	0	46
294	0	0	43	0	0	43
295	46	0	0	0	0	46
296	45	0	0	0	0	45
297	45	0	0	0	0	45
298	47	0	0	0	0	47
299	0	48	0	0	0	48
300	48	0	0	0	0	48
301	0	45	0	0	0	45
302	45	0	0	0	0	45
303	0	44	0	0	0	44
304	0	0	46	0	0	46
305	0	0	0	44	0	44
306	0	46	0	0	0	46
307	0	44	0	0	0	44
308	48	0	0	0	0	48
309	45	0	0	0	0	45
310	0	49	0	0	0	49
311	0	0	0	51	0	51
312	0	50	0	0	0	50
313	50	0	0	0	0	50
314	0	0	52	0	0	52
315	0	0	0	50	0	50
316	0	0	0	52	0	52
317	0	0	0	49	0	49
318	0	0	52	0	0	52
319	0	46	0	0	0	46
320	0	50	0	0	0	50
321	0	0	0	51	0	51
322	0	0	53	0	0	53
323	0	0	0	51	0	51
324	0	0	0	52	0	52
325	0	0	0	54	0	54
326	0	0	0	51	0	51
327	54	0	0	0	0	54
328	0	53	0	0	0	53
329	52	0	0	0	0	52
330	0	0	50	0	0	50
331	0	0	46	0	0	46
332	0	0	0	50	0	50
333	0	0	0	49	0	49
334	0	49	0	0	0	49
335	1	0	50	0	0	51
336	0	52	0	0	0	52
337	0	0	51	0	0	51
338	52	0	0	0	0	52
339	0	50	0	0	0	50
340	0	0	51	0	0	51
341	0	0	0	49	0	49
342	0	0	46	0	0	46
343	0	51	0	0	0	51
344	0	0	0	52	0	52
345	0	51	0	0	0	51
346	0	0	51	0	0	51
347	1	0	0	50	0	51
348	51	0	0	0	0	51
349	0	53	0	0	0	53
350	0	0	53	0	0	53
351	0	0	0	53	0	53
352	0	0	53	0	0	53
353	0	0	55	0	0	55
354	0	53	0	0	0	53
355	0	0	0	57	0	57
356	0	0	0	57	0	57
357	0	0	0	56	0	56
358	0	0	56	0	0	56
359	0	0	53	0	0	53
360	54	0	0	0	0	54
361	0	0	53	0	0	53
362	49	0	0	0	0	49
363	0	49	0	0	0	49
364	0	0	0	51	0	51
365	0	47	0	0	0	47
366	0	46	0	0	0	46
367	0	0	51	0	0	51
368	0	0	0	49	0	49
369	0	0	48	0	0	48
370	0	0	44	0	0	44
371	49	0	0	0	0	49
372	0	0	49	0	0	49
373	0	0	47	0	0	47
374	45	0	0	0	0	45
375	0	0	47	0	0	47
376	0	0	52	0	0	52
377	0	0	0	53	0	53
378	0	58	0	0	0	58
379	0	0	0	57	0	57
380	0	0	0	55	0	55
381	57	0	0	0	0	57
382	0	0	0	56	0	56
383	0	54	0	0	0	54
384	58	0	0	0	0	58
385	0	0	50	0	0	50
386	53	0	0	0	0	53
387	0	0	49	0	0	49
388	0	1	50	0	0	51
389	0	51	0	1	0	52
390	52	0	0	0	0	52
391	0	48	0	0	0	48
392	0	0	49	0	0	49
393	0	0	0	47	0	47
394	0	51	0	0	0	51
395	50	0	0	0	0	50
396	48	0	0	0	0	48
397	0	46	0	0	0	46
398	49	0	0	0	0	49
399	0	0	0	47	0	47
400	0	47	0	0	0	47
401	0	0	0	46	0	46
402	0	0	0	50	0	50
403	45	0	0	0	0	45
404	45	0	0	0	0	45
405	46	0	0	0	0	46
406	0	0	45	0	0	45
407	46	0	0	0	0	46
408	0	0	0	49	0	49
409	1	0	44	0	0	45
410	0	0	46	0	0	46
411	0	45	0	1	0	46
412	51	0	0	0	0	51
413	0	48	0	0	0	48
414	0	0	0	49	0	49
415	0	0	0	50	0	50
416	0	0	51	0	0	51
417	0	0	0	46	0	46
418	0	0	49	0	0	49
419	0	0	50	1	0	51
420	0	49	0	0	0	49
421	0	0	0	51	0	51
422	0	0	0	53	0	53
423	50	0	0	0	0	50
424	0	0	52	0	0	52
425	0	0	0	52	0	52
426	53	0	0	0	0	53
427	0	0	54	0	0	54
428	50	0	0	0	0	50
429	52	0	0	0	0	52
430	0	0	50	0	0	50
431	0	0	0	51	0	51
432	0	0	0	53	0	53
433	0	0	54	0	0	54
434	55	0	0	0	0	55
435	52	0	0	0	0	52
436	50	0	0	0	0	50
437	50	0	0	0	0	50
438	42	0	0	0	0	42
439	0	0	37	0	0	37
440	0	0	40	0	0	40
441	0	34	1	0	0	35
442	0	0	41	0	0	41
443	0	0	0	42	0	42
444	0	0	1	46	0	47
445	0	0	0	51	0	51
446	0	0	0	54	0	54
447	0	0	56	0	0	56
448	1	47	0	0	0	48
449	0	50	0	0	0	50
450	0	0	0	53	0	53
451	0	53	0	0	0	53
452	52	0	0	0	0	52
453	53	0	0	0	0	53
454	0	59	0	0	0	59
455	0	0	0	59	0	59
456	0	0	0	58	0	58
457	0	0	55	0	0	55
458	62	0	0	0	0	62
459	61	0	0	0	0	61
460	0	59	0	0	0	59
461	62	0	0	0	0	62
462	0	0	61	0	0	61
463	0	63	0	0	0	63
464	0	63	0	1	0	64
465	0	69	0	0	0	69
466	0	0	0	68	0	68
467	67	0	0	0	0	67
468	0	0	0	65	0	65
469	0	0	60	0	0	60
470	0	0	0	62	0	62
471	0	1	59	0	0	60
472	0	0	0	59	0	59
473	0	0	0	61	0	61
474	0	62	0	0	0	62
475	61	0	0	0	0	61
476	0	1	0	65	0	66
477	0	61	0	0	0	61
478	65	0	0	0	0	65
479	59	0	0	0	0	59
480	63	0	0	0	0	63
481	0	63	0	0	0	63
482	2	0	63	0	0	65
483	0	0	0	67	0	67
484	0	0	0	66	0	66
485	0	66	0	0	0	66
486	0	0	64	0	0	64
487	0	0	62	0	0	62
488	67	0	0	0	0	67
489	0	0	0	69	0	69
490	0	0	69	0	0	69
491	0	69	0	0	0	69
492	0	0	0	73	0	73
493	0	72	0	0	0	72
494	0	0	70	0	0	70
495	70	0	0	0	0	70
496	67	0	0	0	0	67
497	0	73	0	0	0	73
498	0	0	0	73	0	73
499	0	0	67	0	0	67
500	0	69	0	0	0	69
501	71	0	0	0	0	71
502	0	67	0	0	0	67
503	0	66	0	0	0	66
504	0	0	0	69	0	69
505	0	70	0	0	0	70
506	73	0	0	0	0	73
507	0	0	0	73	0	73
508	0	0	70	0	0	70
509	0	0	66	0	0	66
510	2	0	0	68	0	70
511	1	69	0	0	0	70
512	70	0	0	0	0	70
513	2	0	0	69	0	71
514	0	0	73	0	0	73
515	0	0	0	72	0	72
516	0	0	0	72	0	72
517	68	0	0	0	0	68
518	0	1	0	67	0	68
519	0	0	63	0	0	63
520	0	0	63	1	0	64
521	0	0	0	66	0	66
522	0	0	0	68	0	68
523	0	0	67	0	0	67
524	66	0	0	0	0	66
525	0	0	62	0	0	62
526	0	63	0	0	0	63
527	0	0	0	64	0	64
528	1	0	64	0	0	65
529	1	0	66	0	0	67
530	0	0	0	64	0	64
531	66	0	0	0	0	66
532	1	0	62	0	0	63
533	1	60	0	0	0	61
534	66	0	0	1	0	67
535	0	0	63	0	0	63
536	65	0	0	0	0	65
537	63	0	0	0	0	63
538	0	62	0	0	0	62
539	0	0	0	66	0	66
540	0	64	0	0	0	64
541	0	0	66	0	0	66
542	66	0	0	0	0	66
543	65	0	0	0	0	65
544	1	0	65	0	0	66
545	0	0	60	0	0	60
546	0	62	0	0	0	62
547	65	0	0	0	0	65
548	0	0	0	64	0	64
549	0	0	0	66	0	66
550	0	65	0	0	0	65
551	65	0	0	0	0	65
552	0	0	60	0	0	60
553	0	0	0	60	0	60
554	65	0	0	0	0	65
555	0	62	0	0	0	62
556	0	0	59	0	0	59
557	0	2	54	0	0	56
558	0	0	0	55	0	55
559	0	60	0	0	0	60
560	0	0	58	0	0	58
561	0	0	0	58	0	58
562	60	0	0	0	0	60
563	0	0	55	0	0	55
564	0	0	0	59	0	59
565	0	0	55	0	0	55
566	0	0	56	0	0	56
567	0	0	0	55	0	55
568	0	0	58	0	0	58
569	55	0	0	0	0	55
570	0	0	58	0	0	58
571	58	0	0	0	0	58
572	0	56	0	0	0	56
573	60	0	0	0	0	60
574	0	56	0	0	0	56
575	0	0	0	58	0	58
576	0	0	0	60	0	60
577	0	0	59	0	0	59
578	0	0	55	0	0	55
579	0	0	0	61	0	61
580	0	0	57	0	0	57
581	0	0	0	58	0	58
582	0	53	0	0	0	53
583	0	56	0	0	0	56
584	0	0	0	56	0	56
585	0	0	0	58	0	58
586	0	0	57	0	0	57
587	0	0	0	58	0	58
588	0	54	0	0	0	54
589	0	55	0	0	0	55
590	0	58	0	1	0	59
591	0	0	0	60	0	60
592	0	58	0	0	0	58
593	59	0	0	0	0	59
594	0	0	0	62	0	62
595	0	0	62	0	0	62
596	0	0	0	62	0	62
597	0	0	61	0	0	61
598	0	0	54	0	0	54
599	0	0	61	0	0	61
600	0	61	0	0	0	61
601	0	0	61	0	0	61
602	64	0	0	0	0	64
603	65	0	0	0	0	65
604	60	0	0	0	0	60
605	0	0	0	65	0	65
606	59	0	0	0	0	59
607	0	62	0	0	0	62
608	0	62	0	0	0	62
609	62	0	0	0	0	62
610	0	0	61	0	0	61
611	0	0	0	60	0	60
612	0	0	62	0	0	62
613	0	0	58	1	0	59
614	0	64	0	0	0	64
615	0	0	0	64	0	64
616	0	0	0	67	0	67
617	67	0	0	0	0	67
618	0	66	0	0	0	66
619	0	67	0	0	0	67
620	0	0	67	0	0	67
621	0	71	0	0	0	71
622	70	0	0	0	0	70
623	70	0	0	0	0	70
624	0	0	71	0	0	71
625	0	0	66	0	0	66
626	0	0	0	71	0	71
627	0	0	0	71	0	71
628	0	71	0	0	0	71
629	0	0	0	70	0	70
630	0	0	0	66	0	66
631	0	64	0	0	0	64
632	0	0	0	66	0	66
633	0	0	0	63	0	63
634	0	61	0	0	0	61
635	0	0	64	0	0	64
636	0	0	0	61	0	61
637	64	0	0	0	0	64
638	65	0	0	0	0	65
639	0	1	62	0	0	63
640	58	0	0	1	0	59
641	59	0	0	0	0	59
642	0	55	0	0	0	55
643	0	0	55	0	0	55
644	0	0	64	0	0	64
645	0	0	0	72	0	72
646	75	0	0	0	0	75
647	76	0	0	1	0	77
648	0	0	0	73	0	73
649	76	0	0	0	0	76
650	76	0	0	0	0	76
651	76	0	0	0	0	76
652	1	0	72	0	0	73
653	0	0	76	0	0	76
654	81	0	0	0	0	81
655	0	0	81	0	0	81
656	0	73	0	0	0	73
657	0	0	0	80	0	80
658	0	0	82	0	0	82
659	0	0	78	0	0	78
660	0	0	0	82	0	82
661	0	0	81	0	0	81
662	0	0	77	0	0	77
663	0	65	0	0	0	65
664	0	79	0	0	0	79
665	79	0	0	0	0	79
666	0	0	0	75	0	75
667	75	0	0	0	0	75
668	0	0	75	1	0	76
669	1	0	0	74	0	75
670	1	0	0	74	0	75
671	71	0	0	0	0	71
672	0	73	0	0	0	73
673	0	0	59	1	0	60
674	0	0	64	0	0	64
675	0	71	0	0	0	71
676	0	0	75	0	0	75
677	0	69	0	0	0	69
678	1	72	0	0	0	73
679	0	0	72	0	0	72
680	71	0	0	0	0	71
681	0	0	0	69	0	69
682	0	69	0	0	0	69
683	1	0	0	71	0	72
684	67	0	0	1	0	68
685	70	0	0	0	0	70
686	70	0	0	0	0	70
687	0	0	69	0	0	69
688	0	0	0	70	0	70
689	0	68	0	0	0	68
690	72	0	0	0	0	72
691	0	0	0	72	0	72
692	0	0	0	69	0	69
693	0	0	0	72	0	72
694	0	0	70	1	0	71
695	67	0	0	1	0	68
696	0	72	0	0	0	72
697	0	0	0	70	0	70
698	1	0	0	71	0	72
699	75	0	0	0	0	75
700	0	0	69	0	0	69
701	0	0	75	0	0	75
702	0	68	0	0	0	68
703	0	0	73	0	0	73
704	71	1	0	0	0	72
705	0	71	0	0	0	71
706	0	0	76	0	0	76
707	78	0	0	0	0	78
708	0	0	77	0	0	77
709	0	71	0	0	0	71
710	0	0	0	76	0	76
711	0	0	0	78	0	78
712	0	0	76	0	0	76
713	0	0	71	0	0	71
714	0	72	0	0	0	72
715	71	0	0	0	0	71
716	0	75	0	0	0	75
717	0	0	0	73	0	73
718	0	0	75	1	0	76
719	79	0	0	0	0	79
720	0	0	0	80	0	80
721	0	71	0	0	0	71
722	0	73	0	0	0	73
723	0	0	0	79	0	79
724	0	0	0	80	0	80
725	80	0	0	0	0	80
726	0	0	0	82	0	82
727	0	0	78	0	0	78
728	79	0	0	0	0	79
729	78	0	0	0	0	78
730	0	0	74	0	0	74
731	81	0	0	0	0	81
732	0	0	0	76	0	76
733	0	0	0	76	0	76
734	0	0	0	84	0	84
735	0	0	0	78	0	78
736	0	77	0	0	0	77
737	77	0	0	0	0	77
738	72	0	0	0	0	72
739	0	0	68	0	0	68
740	59	1	0	0	0	60
741	66	0	0	0	0	66
742	61	0	0	0	0	61
743	61	0	0	0	0	61
744	0	61	0	0	0	61
745	0	0	0	53	0	53
746	0	0	54	0	0	54
747	0	0	50	0	0	50
748	55	0	0	0	0	55
749	58	0	0	0	0	58
750	0	51	0	0	0	51
751	53	0	0	0	0	53
752	0	52	0	0	0	52
753	0	0	0	50	0	50
754	53	0	0	0	0	53
755	52	0	0	0	0	52
756	53	0	0	0	0	53
757	0	51	0	0	0	51
758	55	0	0	0	0	55
759	0	0	0	54	0	54
760	57	0	0	0	0	57
761	0	0	56	0	0	56
762	0	55	0	0	0	55
763	56	0	0	0	0	56
764	0	0	57	0	0	57
765	0	0	0	55	0	55
766	0	0	56	0	0	56
767	0	0	54	0	0	54
768	1	0	0	57	0	58
769	0	0	63	0	0	63
770	0	0	0	60	0	60
771	3	0	0	59	0	62
772	60	0	0	0	0	60
773	0	60	0	0	0	60
774	0	56	0	3	0	59
775	0	56	0	0	0	56
776	0	0	58	0	0	58
777	0	0	0	61	0	61
778	0	0	64	0	0	64
779	65	0	0	0	0	65
780	60	0	0	0	0	60
781	0	63	0	0	0	63
782	0	0	0	62	0	62
783	0	61	0	0	0	61
784	64	0	0	0	0	64
785	0	0	0	63	0	63
786	0	0	62	0	0	62
787	0	65	0	0	0	65
788	0	0	65	0	0	65
789	0	0	0	67	0	67
790	0	0	66	0	0	66
791	68	0	0	0	0	68
792	0	0	67	0	0	67
793	0	69	0	0	0	69
794	0	0	0	71	0	71
795	0	0	0	69	0	69
796	69	0	0	0	0	69
797	66	0	0	0	0	66
798	0	65	0	0	0	65
799	0	0	67	0	0	67
800	0	0	64	1	0	65
801	67	0	0	0	0	67
802	0	0	67	0	0	67
803	0	0	60	0	0	60
804	0	0	66	0	0	66
805	0	0	68	0	0	68
806	0	75	0	0	0	75
807	75	0	0	0	0	75
808	0	0	0	73	0	73
809	75	0	0	0	0	75
810	0	77	0	0	0	77
811	75	0	0	0	0	75
812	0	74	0	0	0	74
813	0	0	0	80	0	80
814	0	78	0	0	0	78
815	0	0	78	0	0	78
816	0	80	0	0	0	80
817	0	0	0	79	0	79
818	82	0	0	0	0	82
819	0	0	0	81	0	81
820	0	0	83	0	0	83
821	0	0	0	86	0	86
822	0	86	0	0	0	86
823	0	0	83	0	0	83
824	81	0	0	0	0	81
825	0	0	0	84	0	84
826	84	0	0	0	0	84
827	82	0	0	0	0	82
828	0	87	0	0	0	87
829	86	0	0	0	0	86
830	86	0	0	0	0	86
831	0	85	0	0	0	85
832	0	0	0	84	0	84
833	0	0	0	84	0	84
834	0	83	0	0	0	83
835	0	0	0	86	0	86
836	0	0	88	0	0	88
837	0	0	0	90	0	90
838	0	0	90	0	0	90
839	0	0	86	0	0	86
840	0	88	1	0	0	89
841	0	86	0	0	0	86
842	0	88	0	0	0	88
843	0	0	0	94	0	94
844	0	0	91	0	0	91
845	94	0	0	0	0	94
846	0	0	0	99	0	99
847	0	0	94	0	0	94
848	0	0	90	0	0	90
849	0	97	0	0	0	97
850	0	0	0	93	0	93
851	92	0	0	0	0	92
852	0	90	0	0	0	90
853	0	90	0	0	0	90
854	0	94	0	0	0	94
855	0	1	0	94	0	95
856	0	95	0	0	0	95
857	0	0	0	99	0	99
858	0	0	0	97	0	97
859	0	0	94	0	0	94
860	93	0	0	0	0	93
861	0	0	91	0	0	91
862	1	0	0	91	0	92
863	0	0	91	0	0	91
864	0	94	0	0	0	94
865	93	0	0	0	0	93
866	0	0	0	93	0	93
867	0	0	0	99	0	99
868	98	0	0	0	0	98
869	98	0	0	0	0	98
870	101	0	0	0	0	101
871	0	0	96	0	0	96
872	98	0	0	0	0	98
873	0	97	0	0	0	97
874	0	101	0	0	0	101
875	0	0	0	100	0	100
876	0	0	0	99	0	99
877	0	99	0	0	0	99
878	1	0	0	97	0	98
879	103	0	0	0	0	103
880	0	0	97	0	0	97
881	0	101	0	0	0	101
882	95	0	0	0	0	95
883	0	95	0	0	0	95
884	0	0	94	0	0	94
885	0	0	0	96	0	96
886	0	0	95	0	0	95
887	0	95	0	0	0	95
888	0	0	0	93	0	93
889	0	0	91	0	0	91
890	0	0	93	0	0	93
891	0	0	0	91	0	91
892	96	0	0	0	0	96
893	101	0	0	0	0	101
894	94	0	0	0	0	94
895	0	0	99	0	0	99
896	0	96	0	0	0	96
897	0	0	0	95	0	95
898	0	0	0	92	0	92
899	0	93	0	0	0	93
900	96	0	0	0	0	96
901	0	0	0	95	0	95
902	0	0	88	0	0	88
903	0	88	0	0	0	88
904	86	1	0	0	0	87
905	0	87	0	0	0	87
906	0	0	0	80	0	80
907	0	0	0	81	0	81
908	0	0	0	82	0	82
909	0	0	83	0	0	83
910	0	0	0	87	0	87
911	0	81	0	0	0	81
912	0	80	0	0	0	80
913	0	0	80	0	0	80
914	82	0	0	0	0	82
915	82	0	0	0	0	82
916	0	82	0	0	0	82
917	85	0	0	0	0	85
918	80	0	0	0	0	80
919	0	80	0	0	0	80
920	0	0	0	83	0	83
921	0	0	79	0	0	79
922	0	0	74	0	0	74
923	80	0	0	0	0	80
924	0	78	0	0	0	78
925	0	0	0	82	0	82
926	0	0	0	83	0	83
927	0	0	0	85	0	85
928	80	0	0	0	0	80
929	0	0	0	82	0	82
930	0	0	0	82	0	82
931	0	0	76	0	0	76
932	80	0	0	1	0	81
933	0	79	0	0	0	79
934	82	0	0	0	0	82
935	0	76	0	0	0	76
936	0	0	0	79	0	79
937	81	0	0	0	0	81
938	81	0	0	0	0	81
939	0	0	75	0	0	75
940	76	0	0	0	0	76
941	0	0	72	0	0	72
942	0	0	67	0	0	67
943	0	0	64	0	0	64
944	0	0	68	0	0	68
945	0	0	0	74	0	74
946	0	1	77	0	0	78
947	0	0	0	79	0	79
948	81	0	0	0	0	81
949	0	0	0	78	0	78
950	76	0	0	0	0	76
951	0	75	1	0	0	76
952	0	0	0	82	0	82
953	0	0	70	0	0	70
954	0	80	0	0	0	80
955	0	0	0	83	0	83
956	0	0	84	0	0	84
957	0	77	0	0	0	77
958	0	79	0	1	0	80
959	0	0	83	0	0	83
960	1	0	0	81	0	82
961	0	0	80	0	0	80
962	87	0	0	0	0	87
963	83	1	0	0	0	84
964	0	79	0	0	0	79
965	82	0	0	0	0	82
966	0	0	0	79	0	79
967	0	0	77	0	0	77
968	75	0	0	0	0	75
969	0	0	75	0	0	75
970	0	78	0	0	0	78
971	78	0	0	0	0	78
972	0	0	0	83	0	83
973	0	0	82	0	0	82
974	84	0	0	0	0	84
975	76	0	0	0	0	76
976	83	0	0	0	0	83
977	0	0	0	80	0	80
978	0	0	0	82	0	82
979	0	0	76	0	0	76
980	0	86	0	0	0	86
981	0	0	0	88	0	88
982	0	0	0	84	0	84
983	0	0	81	0	0	81
984	0	0	83	0	0	83
985	0	0	0	85	0	85
986	77	0	0	0	0	77
987	0	78	1	2	0	81
988	79	0	0	0	0	79
989	0	80	0	0	0	80
990	0	0	80	0	0	80
991	0	1	83	0	0	84
992	87	0	0	0	0	87
993	82	0	0	0	0	82
994	0	84	0	0	0	84
995	0	0	85	0	0	85
996	0	0	0	87	0	87
997	0	0	0	85	0	85
998	0	83	1	0	0	84
999	0	0	0	86	0	86
1000	0	0	84	0	0	84
1001	88	0	0	0	0	88
1002	83	0	0	0	0	83
1003	86	0	0	0	0	86
1004	85	0	0	0	0	85
1005	1	0	78	0	0	79
1006	88	0	0	0	0	88
1007	0	0	84	0	0	84
1008	0	76	0	0	0	76
1009	0	0	0	85	0	85
1010	84	0	0	0	0	84
1011	0	0	0	85	0	85
1012	0	0	84	0	0	84
1013	88	0	0	1	0	89
1014	84	1	0	0	0	85
1015	0	0	0	84	0	84
1016	1	0	0	84	0	85
1017	0	0	82	0	0	82
1018	0	82	0	0	0	82
1019	79	0	0	0	0	79
1020	0	0	78	0	0	78
1021	80	0	0	0	0	80
1022	0	73	0	0	0	73
1023	80	0	0	0	0	80
1024	0	77	0	2	0	79
1025	0	78	0	0	0	78
1026	0	0	0	84	0	84
1027	0	0	0	82	0	82
1028	0	0	0	83	0	83
1029	0	0	0	82	0	82
1030	0	0	76	0	0	76
1031	81	0	0	0	0	81
1032	76	0	0	1	0	77
1033	75	0	0	0	0	75
1034	0	0	0	74	0	74
1035	0	0	0	73	0	73
1036	75	0	0	0	0	75
1037	75	0	0	0	0	75
1038	73	0	0	0	0	73
1039	0	0	0	71	0	71
1040	0	0	0	69	0	69
1041	0	0	74	0	0	74
1042	0	0	66	0	0	66
1043	0	71	0	0	0	71
1044	72	0	0	0	0	72
1045	67	0	1	0	0	68
1046	72	0	0	0	0	72
1047	0	0	70	0	0	70
1048	69	0	0	0	0	69
1049	68	0	0	0	0	68
1050	67	0	0	0	0	67
1051	1	0	0	65	0	66
1052	0	0	0	66	0	66
1053	0	0	0	68	0	68
1054	0	0	59	0	0	59
1055	70	0	0	0	0	70
1056	0	67	0	0	0	67
1057	70	0	0	0	0	70
1058	0	61	0	0	0	61
1059	0	66	0	0	0	66
1060	0	0	0	68	0	68
1061	0	0	0	70	0	70
1062	0	68	0	0	0	68
1063	74	0	0	0	0	74
1064	66	0	0	0	0	66
1065	0	0	0	65	0	65
1066	0	0	63	0	0	63
1067	0	0	57	0	0	57
1068	0	0	59	0	0	59
1069	1	0	63	0	0	64
1070	64	0	0	0	0	64
1071	66	0	0	0	0	66
1072	0	0	0	65	0	65
1073	0	0	63	0	0	63
1074	0	0	0	65	0	65
1075	1	52	0	1	0	54
1076	1	59	0	0	0	60
1077	66	0	0	0	0	66
1078	61	0	0	0	0	61
1079	64	0	0	0	0	64
1080	0	0	0	67	0	67
1081	0	1	0	62	0	63
1082	0	0	0	65	0	65
1083	0	0	0	64	0	64
1084	0	0	60	0	0	60
1085	0	0	0	60	0	60
1086	56	0	0	0	0	56
1087	0	0	0	60	0	60
1088	0	0	0	62	0	62
1089	0	0	0	59	0	59
1090	0	53	0	0	0	53
1091	0	57	0	0	0	57
1092	0	66	0	0	0	66
1093	0	0	0	65	0	65
1094	0	0	0	65	0	65
1095	65	0	0	0	0	65
1096	66	0	0	0	0	66
1097	60	1	0	0	0	61
1098	0	0	0	57	0	57
1099	0	0	0	59	0	59
1100	0	53	0	0	0	53
1101	0	60	0	0	0	60
1102	59	0	0	0	0	59
1103	0	0	0	63	0	63
1104	66	0	0	0	0	66
1105	63	0	0	0	0	63
1106	0	0	0	67	0	67
1107	0	67	0	0	0	67
1108	61	0	0	0	0	61
1109	63	0	0	0	0	63
1110	0	0	60	0	0	60
1111	62	0	0	0	0	62
1112	0	60	0	0	0	60
1113	0	0	0	61	0	61
1114	63	0	0	1	0	64
1115	0	0	0	65	0	65
1116	0	0	0	62	0	62
1117	0	60	0	0	0	60
1118	61	0	0	0	0	61
1119	57	0	0	0	0	57
1120	0	55	1	0	0	56
1121	0	57	0	0	0	57
1122	61	0	0	0	0	61
1123	61	0	0	0	0	61
1124	0	0	59	0	0	59
1125	0	0	49	0	0	49
1126	0	0	57	0	0	57
1127	0	0	0	63	0	63
1128	0	0	0	63	0	63
1129	0	0	65	0	0	65
1130	70	0	0	0	0	70
1131	70	0	0	0	0	70
1132	70	0	0	0	0	70
1133	75	0	0	0	0	75
1134	0	0	65	0	0	65
1135	78	0	0	0	0	78
1136	79	0	0	0	0	79
1137	81	0	0	0	0	81
1138	82	0	0	0	0	82
1139	80	0	0	0	0	80
1140	0	0	77	0	0	77
1141	1	68	0	0	0	69
1142	0	0	0	81	0	81
1143	0	0	0	81	0	81
1144	0	0	79	0	0	79
1145	83	0	0	0	0	83
1146	0	0	0	83	0	83
1147	0	0	85	0	0	85
1148	1	0	73	0	0	74
1149	0	84	0	0	0	84
1150	0	0	0	91	0	91
1151	0	0	0	92	0	92
1152	0	0	0	89	0	89
1153	89	0	0	1	0	90
1154	0	0	0	94	0	94
1155	1	0	87	0	0	88
1156	0	0	74	0	0	74
1157	1	1	84	0	0	86
1158	0	0	0	87	0	87
1159	92	0	0	0	0	92
1160	0	0	91	0	0	91
1161	92	0	0	0	0	92
1162	92	0	0	0	0	92
1163	0	0	0	87	0	87
1164	0	0	0	87	0	87
1165	0	86	0	0	0	86
1166	0	0	88	0	0	88
1167	85	0	0	0	0	85
1168	0	0	0	91	0	91
1169	0	84	0	0	0	84
1170	0	0	0	90	0	90
1171	0	0	87	0	0	87
1172	0	0	0	90	0	90
1173	0	88	0	0	0	88
1174	0	0	0	89	0	89
1175	93	0	0	0	0	93
1176	0	0	0	93	0	93
1177	0	92	0	0	0	92
1178	0	88	0	0	0	88
1179	90	0	0	0	0	90
1180	0	0	89	0	0	89
1181	0	0	0	88	0	88
1182	0	0	0	87	0	87
1183	0	0	87	0	0	87
1184	0	83	0	0	0	83
1185	0	0	84	0	0	84
1186	0	0	0	83	0	83
1187	0	82	0	0	0	82
1188	81	0	0	0	0	81
1189	0	80	0	0	0	80
1190	0	86	0	0	0	86
1191	88	0	0	0	0	88
1192	84	0	0	0	0	84
1193	84	0	0	1	0	85
1194	0	0	0	87	0	87
1195	0	0	85	0	0	85
1196	85	0	0	0	0	85
1197	82	0	0	0	0	82
1198	0	0	0	80	0	80
1199	0	0	78	0	0	78
1200	0	80	0	0	0	80
1201	83	0	0	0	0	83
1202	83	0	0	0	0	83
1203	1	81	0	0	0	82
1204	0	84	0	0	0	84
1205	86	0	0	0	0	86
1206	83	0	0	0	0	83
1207	79	0	0	1	0	80
1208	0	0	0	82	0	82
1209	0	0	81	0	0	81
1210	0	0	0	83	0	83
1211	0	0	81	0	0	81
1212	0	81	0	0	0	81
1213	0	83	0	0	0	83
1214	0	0	0	86	0	86
1215	0	0	0	85	0	85
1216	0	0	0	87	0	87
1217	0	85	0	0	0	85
1218	85	0	0	0	0	85
1219	85	0	0	0	0	85
1220	0	81	0	0	0	81
1221	0	0	0	86	0	86
1222	0	80	0	0	0	80
1223	1	0	0	83	0	84
1224	0	83	0	0	0	83
1225	82	0	0	0	0	82
1226	0	0	0	79	0	79
1227	0	0	78	0	0	78
1228	74	0	0	0	0	74
1229	71	0	0	0	0	71
1230	0	0	68	0	0	68
1231	0	0	0	70	0	70
1232	0	0	68	0	0	68
1233	0	0	0	73	0	73
1234	0	0	73	0	0	73
1235	72	0	0	0	0	72
1236	0	0	0	74	0	74
1237	0	74	0	0	0	74
1238	71	0	0	0	0	71
1239	1	0	0	72	0	73
1240	0	0	0	72	0	72
1241	0	0	71	0	0	71
1242	0	0	0	72	0	72
1243	0	0	69	0	0	69
1244	0	0	76	0	0	76
1245	0	0	0	81	0	81
1246	0	0	87	0	0	87
1247	87	0	0	0	0	87
1248	85	0	0	0	0	85
1249	86	0	0	0	0	86
1250	0	88	0	0	0	88
1251	1	0	0	90	0	91
1252	0	0	0	88	0	88
1253	0	88	0	0	0	88
1254	89	0	0	0	0	89
1255	0	0	0	91	0	91
1256	0	0	89	0	0	89
1257	0	0	90	0	0	90
1258	0	92	0	0	0	92
1259	92	0	0	0	0	92
1260	0	0	89	0	0	89
1261	92	0	0	0	0	92
1262	0	91	0	0	0	91
1263	0	0	86	0	0	86
1264	1	0	79	0	0	80
1265	0	0	79	0	0	79
1266	0	83	0	0	0	83
1267	0	0	82	0	0	82
1268	79	0	0	0	0	79
1269	0	0	0	77	0	77
1270	0	0	0	82	0	82
1271	0	0	0	82	0	82
1272	1	0	0	76	0	77
1273	0	0	83	0	0	83
1274	0	0	0	84	0	84
1275	0	0	0	82	0	82
1276	83	0	0	0	0	83
1277	77	1	0	0	0	78
1278	80	0	0	0	0	80
1279	0	0	77	0	0	77
1280	0	77	0	0	0	77
1281	0	81	0	0	0	81
1282	80	0	0	0	0	80
1283	0	83	0	0	0	83
1284	0	0	0	80	0	80
1285	0	0	0	78	0	78
1286	0	0	78	0	0	78
1287	0	73	0	0	0	73
1288	0	0	75	0	0	75
1289	78	0	0	0	0	78
1290	76	0	0	0	0	76
1291	0	0	0	73	0	73
1292	0	0	0	73	0	73
1293	0	0	0	76	0	76
1294	0	0	0	75	0	75
1295	0	0	72	0	0	72
1296	0	0	1	71	0	72
1297	0	0	69	1	0	70
1298	0	0	69	0	0	69
1299	0	72	0	0	0	72
1300	73	0	0	0	0	73
1301	0	68	0	0	0	68
1302	0	0	0	67	0	67
1303	1	0	64	0	0	65
1304	71	0	0	0	0	71
1305	0	0	72	0	0	72
1306	66	0	0	0	0	66
1307	64	0	0	0	0	64
1308	0	0	1	62	0	63
1309	0	0	0	61	0	61
1310	0	0	0	67	0	67
1311	0	0	69	0	0	69
1312	65	0	0	0	0	65
1313	1	67	0	0	0	68
1314	0	0	0	72	0	72
1315	72	0	0	0	0	72
1316	72	0	0	0	0	72
1317	70	0	0	0	0	70
1318	0	0	72	0	0	72
1319	72	0	0	0	0	72
1320	74	0	0	0	0	74
1321	0	0	57	0	0	57
1322	0	0	68	0	0	68
1323	0	0	0	77	0	77
1324	0	0	74	0	0	74
1325	0	68	0	1	0	69
1326	0	83	0	0	0	83
1327	87	0	0	1	0	88
1328	0	82	0	0	0	82
1329	0	0	0	83	0	83
1330	76	0	0	0	0	76
1331	0	81	0	0	0	81
1332	0	0	0	80	0	80
1333	0	0	0	81	0	81
1334	0	0	80	0	0	80
1335	0	0	0	75	0	75
1336	2	1	74	0	0	77
1337	0	0	71	0	0	71
1338	0	0	0	78	0	78
1339	0	1	0	70	0	71
1340	71	0	0	0	0	71
1341	0	67	2	0	0	69
1342	0	0	0	63	0	63
1343	0	0	0	60	0	60
1344	61	0	0	0	0	61
1345	0	56	0	0	0	56
1346	0	56	0	0	0	56
1347	0	53	0	0	0	53
1348	0	56	0	0	0	56
1349	58	0	0	0	0	58
1350	56	0	0	0	0	56
1351	57	0	0	0	0	57
1352	58	0	0	0	0	58
1353	0	0	0	57	0	57
1354	0	0	53	0	0	53
1355	0	55	0	0	0	55
1356	0	0	0	59	0	59
1357	0	0	58	0	0	58
1358	0	0	0	60	0	60
1359	0	0	0	62	0	62
1360	0	0	59	0	0	59
1361	0	0	0	62	0	62
1362	0	0	0	62	0	62
1363	63	0	0	0	0	63
1364	61	0	0	1	0	62
1365	63	0	0	0	0	63
1366	61	0	0	0	0	61
1367	0	0	0	63	0	63
1368	1	0	0	58	0	59
1369	0	0	0	59	0	59
1370	59	0	0	0	0	59
1371	0	0	0	61	0	61
1372	0	0	0	60	0	60
1373	0	0	60	0	0	60
1374	0	0	0	59	0	59
1375	0	52	0	0	0	52
1376	0	58	0	0	0	58
1377	59	0	0	1	0	60
1378	0	0	54	0	0	54
1379	0	56	0	1	0	57
1380	58	0	0	0	0	58
1381	0	0	0	61	0	61
1382	0	0	61	0	0	61
1383	0	0	0	58	0	58
1384	0	61	0	0	0	61
1385	58	0	0	0	0	58
1386	0	58	0	0	0	58
1387	61	0	0	0	0	61
1388	57	0	0	0	0	57
1389	0	0	0	56	0	56
1390	0	0	0	58	0	58
1391	0	61	0	0	0	61
1392	61	0	0	0	0	61
1393	0	0	58	0	0	58
1394	53	0	0	0	0	53
1395	59	0	0	0	0	59
1396	0	0	57	0	0	57
1397	0	0	0	57	0	57
1398	54	0	0	0	0	54
1399	0	1	53	0	0	54
1400	0	0	48	0	0	48
1401	53	1	0	0	0	54
1402	0	47	0	1	0	48
1403	0	50	0	0	0	50
1404	0	0	0	51	0	51
1405	0	0	52	0	0	52
1406	52	0	0	0	0	52
1407	0	0	50	0	0	50
1408	0	51	0	0	0	51
1409	52	0	0	0	0	52
1410	0	0	0	51	0	51
1411	49	0	0	0	0	49
1412	0	0	49	0	0	49
1413	1	0	0	48	0	49
1414	0	46	0	0	0	46
1415	0	0	0	48	0	48
1416	0	0	0	46	0	46
1417	0	0	45	0	0	45
1418	0	38	0	0	0	38
1419	0	33	0	0	0	33
1420	0	0	33	0	0	33
1421	35	0	0	0	0	35
1422	33	0	0	0	0	33
1423	0	0	0	35	0	35
1424	29	0	0	0	0	29
1425	0	34	0	1	0	35
1426	0	35	0	0	0	35
1427	37	0	0	0	0	37
1428	0	0	0	35	0	35
1429	36	0	0	0	0	36
1430	34	0	0	0	0	34
1431	0	0	0	35	0	35
1432	0	0	32	0	0	32
1433	36	0	0	0	0	36
1434	34	0	0	0	0	34
1435	0	0	0	36	0	36
1436	0	36	0	0	0	36
1437	0	0	0	35	0	35
1438	0	0	35	0	0	35
1439	1	0	30	0	0	31
1440	0	35	0	0	0	35
1441	0	0	0	34	0	34
1442	0	0	0	35	0	35
1443	0	0	33	0	0	33
1444	33	0	0	0	0	33
1445	31	0	0	0	0	31
1446	32	0	0	0	0	32
1447	29	0	0	0	0	29
1448	0	34	0	0	0	34
1449	0	37	0	0	0	37
1450	41	0	0	0	0	41
1451	0	0	0	37	0	37
1452	0	0	0	42	0	42
1453	0	47	0	0	0	47
1454	0	0	0	50	0	50
1455	1	0	0	38	0	39
1456	0	44	0	0	0	44
1457	0	0	49	0	0	49
1458	0	0	0	47	0	47
1459	51	0	0	0	0	51
1460	52	0	0	0	0	52
1461	0	0	53	0	0	53
1462	0	0	49	0	0	49
1463	0	0	49	0	0	49
1464	1	0	0	54	0	55
1465	0	0	54	0	0	54
1466	0	0	51	0	0	51
1467	0	0	0	58	0	58
1468	0	55	0	0	0	55
1469	0	0	57	0	0	57
1470	0	58	0	0	0	58
1471	61	0	0	0	0	61
1472	0	61	0	0	0	61
1473	0	0	0	63	0	63
1474	63	0	0	1	0	64
1475	0	0	0	63	0	63
1476	0	0	0	63	0	63
1477	0	0	59	0	0	59
1478	1	57	0	0	0	58
1479	0	56	0	0	0	56
1480	0	0	0	62	0	62
1481	0	0	0	61	0	61
1482	0	0	0	63	0	63
1483	0	0	61	0	0	61
1484	0	0	59	0	0	59
1485	60	0	0	0	0	60
1486	0	0	60	0	0	60
1487	0	0	59	0	0	59
1488	0	60	0	0	0	60
1489	0	0	0	61	0	61
1490	0	0	58	0	0	58
1491	0	0	0	61	0	61
1492	0	0	63	0	0	63
1493	0	0	0	61	0	61
1494	0	0	59	0	0	59
1495	0	0	0	62	0	62
1496	0	0	0	63	0	63
1497	0	65	0	1	0	66
1498	0	0	0	69	0	69
1499	0	68	0	0	0	68
1500	0	0	0	73	0	73
1501	0	0	0	76	0	76
1502	70	0	0	0	0	70
1503	0	0	0	76	0	76
1504	0	0	72	0	0	72
1505	0	0	0	76	0	76
1506	0	0	0	75	0	75
1507	0	0	73	0	0	73
1508	0	0	72	0	0	72
1509	1	0	0	74	0	75
1510	0	0	0	76	0	76
1511	0	0	76	0	0	76
1512	0	72	0	0	0	72
1513	0	77	0	0	0	77
1514	78	0	0	0	0	78
1515	0	0	0	78	0	78
1516	81	0	0	0	0	81
1517	80	0	0	0	0	80
1518	0	80	0	0	0	80
1519	80	0	0	0	0	80
1520	82	0	0	0	0	82
1521	1	0	81	0	0	82
1522	0	0	0	80	0	80
1523	0	0	83	0	0	83
1524	0	0	0	90	0	90
1525	0	0	86	0	0	86
1526	0	84	0	0	0	84
1527	0	90	1	0	0	91
1528	0	0	0	89	0	89
1529	89	0	0	0	0	89
1530	0	0	0	88	0	88
1531	0	0	0	90	0	90
1532	0	0	86	0	0	86
1533	0	0	83	0	0	83
1534	0	0	84	0	0	84
1535	0	0	0	90	0	90
1536	0	0	0	90	0	90
1537	0	91	0	0	0	91
1538	0	92	0	0	0	92
1539	95	0	0	0	0	95
1540	0	95	0	0	0	95
1541	0	0	84	0	0	84
1542	0	0	0	95	0	95
1543	0	0	90	0	0	90
1544	0	91	0	0	0	91
1545	0	0	0	94	0	94
1546	96	0	0	0	0	96
1547	0	0	88	0	0	88
1548	0	91	0	0	0	91
1549	0	0	82	0	0	82
1550	0	83	0	0	0	83
1551	0	0	0	87	0	87
1552	86	0	0	0	0	86
1553	84	0	0	0	0	84
1554	0	86	0	0	0	86
1555	88	0	0	0	0	88
1556	0	0	0	87	0	87
1557	88	0	0	0	0	88
1558	0	0	87	0	0	87
1559	0	0	89	0	0	89
1560	0	0	0	90	0	90
1561	0	0	0	101	0	101
1562	0	0	96	0	0	96
1563	0	0	0	98	0	98
1564	96	0	0	0	0	96
1565	91	0	0	0	0	91
1566	0	91	0	0	0	91
1567	0	92	0	0	0	92
1568	95	0	0	0	0	95
1569	0	0	0	95	0	95
1570	94	0	0	0	0	94
1571	0	91	0	0	0	91
1572	96	0	0	0	0	96
1573	0	0	88	0	0	88
1574	0	0	89	0	0	89
1575	0	0	0	94	0	94
1576	0	0	97	0	0	97
1577	0	0	0	96	0	96
1578	0	0	0	99	0	99
1579	0	0	101	0	0	101
1580	0	0	0	96	0	96
1581	0	0	0	102	0	102
1582	0	0	98	0	0	98
1583	0	0	87	1	0	88
1584	100	0	0	0	0	100
1585	0	0	99	0	0	99
1586	98	0	0	0	0	98
1587	101	0	0	0	0	101
1588	0	0	98	0	0	98
1589	0	0	99	0	0	99
1590	0	0	0	96	0	96
1591	0	0	0	97	0	97
1592	0	90	0	0	0	90
1593	0	94	0	0	0	94
1594	0	0	92	0	0	92
1595	94	0	0	0	0	94
1596	95	0	0	0	0	95
1597	0	0	91	0	0	91
1598	0	0	90	0	0	90
1599	0	0	0	92	0	92
1600	0	96	0	0	0	96
1601	0	0	0	96	0	96
1602	0	0	0	98	0	98
1603	99	0	0	0	0	99
1604	89	1	0	0	0	90
1605	0	0	0	95	0	95
1606	0	0	97	0	0	97
1607	97	0	0	0	0	97
1608	0	92	0	0	0	92
1609	94	0	0	0	0	94
1610	90	0	0	0	0	90
1611	0	92	0	0	0	92
1612	0	87	0	0	0	87
1613	0	0	0	90	0	90
1614	0	0	0	87	0	87
1615	0	91	0	0	0	91
1616	0	0	0	87	0	87
1617	0	0	0	89	0	89
1618	0	0	89	0	0	89
1619	90	0	0	0	0	90
1620	92	0	0	0	0	92
1621	86	0	0	0	0	86
1622	0	0	0	86	0	86
1623	86	0	0	0	0	86
1624	0	87	0	0	0	87
1625	0	0	0	85	0	85
1626	0	83	0	0	0	83
1627	0	90	0	0	0	90
1628	91	0	0	0	0	91
1629	88	0	0	0	0	88
1630	89	0	0	0	0	89
1631	89	0	0	0	0	89
1632	86	0	0	0	0	86
1633	0	0	86	0	0	86
1634	83	0	0	0	0	83
1635	0	0	85	0	0	85
1636	87	0	0	0	0	87
1637	81	0	1	0	0	82
1638	80	0	0	0	0	80
1639	0	0	83	0	0	83
1640	0	0	0	85	0	85
1641	0	83	0	0	0	83
1642	83	0	0	0	0	83
1643	78	1	0	0	0	79
1644	0	79	0	0	0	79
1645	83	0	0	0	0	83
1646	1	0	0	82	0	83
1647	0	82	0	0	0	82
1648	83	0	0	0	0	83
1649	83	0	0	0	0	83
1650	0	1	0	78	0	79
1651	83	0	0	0	0	83
1652	0	0	0	79	0	79
1653	1	0	0	73	0	74
1654	0	0	74	0	0	74
1655	4	0	0	75	0	79
1656	0	0	0	73	0	73
1657	1	0	73	0	0	74
1658	0	0	65	3	0	68
1659	0	0	0	74	0	74
1660	0	0	69	0	0	69
1661	73	0	0	2	0	75
1662	0	72	0	0	0	72
1663	0	0	0	78	0	78
1664	0	0	0	78	0	78
1665	0	0	0	78	0	78
1666	78	0	0	0	0	78
1667	80	0	0	0	0	80
1668	79	0	0	1	0	80
1669	0	76	1	0	0	77
1670	0	0	0	76	0	76
1671	0	0	0	72	0	72
1672	73	0	0	0	0	73
1673	75	0	0	0	0	75
1674	0	0	0	77	0	77
1675	0	0	75	0	0	75
1676	77	0	0	0	0	77
1677	77	0	0	0	0	77
1678	0	0	72	0	0	72
1679	82	0	0	0	0	82
1680	0	0	80	0	0	80
1681	77	0	0	0	0	77
1682	0	0	0	75	0	75
1683	0	77	0	0	0	77
1684	0	0	72	1	0	73
1685	0	73	0	0	0	73
1686	0	75	0	0	0	75
1687	79	0	0	0	0	79
1688	0	0	0	85	0	85
1689	0	0	0	78	0	78
1690	79	0	0	0	0	79
1691	0	0	0	82	0	82
1692	0	0	0	83	0	83
1693	0	0	0	82	0	82
1694	0	0	0	81	0	81
1695	0	0	76	0	0	76
1696	0	0	70	0	0	70
1697	0	78	0	0	0	78
1698	82	0	0	0	0	82
1699	0	0	0	83	0	83
1700	0	78	0	0	0	78
1701	0	0	0	86	0	86
1702	0	0	0	80	0	80
1703	0	0	0	87	0	87
1704	0	0	0	89	0	89
1705	0	0	0	89	0	89
1706	0	88	0	0	0	88
1707	0	0	0	92	0	92
1708	0	0	87	0	0	87
1709	0	91	0	0	0	91
1710	0	0	0	93	0	93
1711	0	0	0	91	0	91
1712	0	86	0	0	0	86
1713	0	87	0	0	0	87
1714	89	0	0	0	0	89
1715	0	90	0	0	0	90
1716	89	0	0	0	0	89
1717	85	0	0	0	0	85
1718	0	0	89	0	0	89
1719	0	0	0	91	0	91
1720	0	0	86	0	0	86
1721	0	86	0	0	0	86
1722	0	0	0	86	0	86
1723	0	0	0	87	0	87
1724	0	0	0	85	0	85
1725	0	0	0	87	0	87
1726	0	0	87	0	0	87
1727	0	0	0	85	0	85
1728	0	0	82	0	0	82
1729	0	0	79	0	0	79
1730	89	0	0	1	0	90
1731	86	0	0	0	0	86
1732	86	0	0	0	0	86
1733	0	90	0	0	0	90
1734	0	0	0	89	0	89
1735	0	0	86	0	0	86
1736	0	0	0	86	0	86
1737	0	0	89	0	0	89
1738	92	0	0	0	0	92
1739	87	0	0	0	0	87
1740	89	0	0	0	0	89
1741	0	0	86	0	0	86
1742	0	0	75	0	0	75
1743	0	0	0	83	0	83
1744	1	0	0	85	0	86
1745	0	0	0	88	0	88
1746	0	0	84	0	0	84
1747	0	0	83	1	0	84
1748	90	0	0	0	0	90
1749	0	0	0	89	0	89
1750	0	0	0	91	0	91
1751	91	0	0	0	0	91
1752	0	0	0	89	0	89
1753	91	0	0	0	0	91
1754	87	0	0	0	0	87
1755	89	0	0	0	0	89
1756	0	0	83	0	0	83
1757	0	77	0	0	0	77
1758	84	0	0	0	0	84
1759	0	0	0	83	0	83
1760	0	0	0	84	0	84
1761	0	81	0	0	0	81
1762	83	0	0	0	0	83
1763	81	0	0	0	0	81
1764	80	0	0	0	0	80
1765	0	78	0	0	0	78
1766	86	0	0	0	0	86
1767	86	0	0	0	0	86
1768	91	0	0	0	0	91
1769	0	1	0	89	0	90
1770	0	0	0	91	0	91
1771	0	0	89	0	0	89
1772	0	0	0	84	0	84
1773	1	0	0	84	0	85
1774	0	0	78	0	0	78
1775	82	0	0	1	0	83
1776	83	0	0	0	0	83
1777	0	0	0	85	0	85
1778	0	80	0	0	0	80
1779	0	82	0	0	0	82
1780	0	0	0	85	0	85
1781	0	0	80	0	0	80
1782	0	0	0	80	0	80
1783	0	0	75	0	0	75
1784	0	0	72	0	0	72
1785	0	0	0	76	0	76
1786	78	0	0	0	0	78
1787	81	0	0	0	0	81
1788	0	0	0	77	0	77
1789	0	0	0	77	0	77
1790	0	0	0	79	0	79
1791	0	0	1	76	0	77
1792	71	0	0	1	0	72
1793	71	0	0	0	0	71
1794	74	0	0	0	0	74
1795	0	0	70	0	0	70
1796	0	0	0	68	0	68
1797	0	0	0	63	0	63
1798	67	0	0	0	0	67
1799	0	68	0	0	0	68
1800	58	0	0	1	0	59
1801	57	0	0	0	0	57
1802	57	0	0	0	0	57
1803	58	0	0	0	0	58
1804	0	0	58	0	0	58
1805	0	0	60	0	0	60
1806	65	0	0	0	0	65
1807	67	0	0	0	0	67
1808	65	0	0	0	0	65
1809	65	0	0	0	0	65
1810	0	0	64	0	0	64
1811	0	63	0	0	0	63
1812	0	0	0	74	0	74
1813	77	0	0	0	0	77
1814	81	0	0	0	0	81
1815	79	0	0	0	0	79
1816	85	0	0	0	0	85
1817	88	0	0	1	0	89
1818	87	0	0	0	0	87
1819	1	0	77	0	0	78
1820	0	0	80	0	0	80
1821	0	0	0	88	0	88
1822	0	0	87	0	0	87
1823	0	80	0	0	0	80
1824	0	88	0	0	0	88
1825	1	0	0	92	0	93
1826	0	0	87	0	0	87
1827	0	0	79	0	0	79
1828	86	0	0	0	0	86
1829	91	0	0	0	0	91
1830	0	0	0	87	0	87
1831	89	0	0	0	0	89
1832	0	0	0	88	0	88
1833	0	0	0	89	0	89
1834	0	0	89	0	0	89
1835	0	0	84	0	0	84
1836	0	0	0	89	0	89
1837	0	0	91	0	0	91
1838	90	0	0	0	0	90
1839	91	0	0	0	0	91
1840	0	89	0	0	0	89
1841	92	0	0	0	0	92
1842	0	0	89	0	0	89
1843	88	0	0	0	0	88
1844	90	0	0	1	0	91
1845	94	0	2	0	0	96
1846	0	0	0	97	0	97
1847	0	92	0	1	0	93
1848	97	0	0	0	0	97
1849	94	0	0	1	0	95
1850	0	0	0	96	0	96
1851	93	0	0	0	0	93
1852	0	93	0	0	0	93
1853	0	0	0	98	0	98
1854	0	0	92	0	0	92
1855	100	0	0	0	0	100
1856	0	0	102	0	0	102
1857	0	0	0	99	0	99
1858	0	96	0	0	0	96
1859	0	94	0	0	0	94
1860	0	0	0	100	0	100
1861	0	98	0	0	0	98
1862	0	0	0	105	0	105
1863	1	0	0	105	0	106
1864	0	0	0	105	0	105
1865	103	1	0	0	0	104
1866	0	0	0	105	0	105
1867	0	0	111	0	0	111
1868	0	111	0	0	0	111
1869	113	0	0	0	0	113
1870	1	0	0	117	0	118
1871	0	0	0	114	0	114
1872	1	0	0	117	0	118
1873	0	0	117	0	0	117
1874	0	115	0	0	0	115
1875	120	0	0	0	0	120
1876	0	0	0	119	0	119
1877	0	123	0	0	0	123
1878	120	0	0	1	0	121
1879	0	0	117	0	0	117
1880	117	0	0	0	0	117
1881	0	0	109	1	0	110
1882	0	0	107	0	0	107
1883	0	114	0	0	0	114
1884	0	0	0	119	0	119
1885	0	0	113	0	0	113
1886	0	116	0	0	0	116
1887	0	0	0	117	0	117
1888	0	113	0	0	0	113
1889	0	0	118	0	0	118
1890	0	0	0	118	0	118
1891	0	0	119	0	0	119
1892	0	0	0	123	0	123
1893	0	0	0	119	0	119
1894	0	0	123	0	0	123
1895	0	0	0	122	0	122
1896	118	0	0	1	0	119
1897	0	119	0	0	0	119
1898	0	0	115	0	0	115
1899	117	0	0	0	0	117
1900	0	0	0	118	0	118
1901	0	117	0	0	0	117
1902	119	0	0	0	0	119
1903	115	0	0	0	0	115
1904	0	0	0	111	0	111
1905	0	0	0	115	0	115
1906	0	0	0	112	0	112
1907	0	0	0	108	0	108
1908	0	100	1	0	0	101
1909	0	0	0	100	0	100
1910	0	92	0	0	0	92
1911	0	90	0	0	0	90
1912	0	90	0	0	0	90
1913	0	0	95	0	0	95
1914	0	94	0	0	0	94
1915	92	0	0	0	0	92
1916	0	90	0	0	0	90
1917	0	0	0	93	0	93
1918	0	94	0	0	0	94
1919	0	0	0	98	0	98
1920	0	0	0	93	0	93
1921	0	0	96	0	0	96
1922	86	0	0	0	0	86
1923	98	0	0	0	0	98
1924	80	2	0	0	0	82
1925	0	86	0	0	0	86
1926	0	0	0	89	0	89
1927	0	0	86	0	0	86
1928	0	87	0	0	0	87
1929	0	0	0	86	0	86
1930	0	87	1	0	0	88
1931	88	0	0	0	0	88
1932	88	0	0	1	0	89
1933	90	0	0	0	0	90
1934	85	1	0	1	0	87
1935	0	0	0	87	0	87
1936	0	0	0	87	0	87
1937	0	80	2	0	0	82
1938	0	0	0	87	0	87
1939	0	0	81	0	0	81
1940	0	0	0	86	0	86
1941	0	0	82	0	0	82
1942	0	76	0	1	0	77
1943	0	0	84	0	0	84
1944	0	0	0	84	0	84
1945	0	0	80	0	0	80
1946	0	0	0	84	0	84
1947	0	0	0	82	0	82
1948	0	0	0	75	0	75
1949	0	0	0	78	0	78
1950	75	0	0	0	0	75
1951	0	75	0	0	0	75
1952	77	0	0	0	0	77
1953	0	0	79	0	0	79
1954	70	0	0	2	0	72
1955	81	0	0	0	0	81
1956	0	0	79	0	0	79
1957	0	0	64	0	0	64
1958	0	63	0	0	0	63
1959	0	71	0	0	0	71
1960	0	0	63	0	0	63
1961	0	60	0	0	0	60
1962	0	0	0	54	0	54
1963	58	0	0	0	0	58
1964	0	0	0	55	0	55
1965	50	0	0	0	0	50
1966	53	0	0	0	0	53
1967	0	51	0	0	0	51
1968	52	0	0	0	0	52
1969	53	0	0	0	0	53
1970	0	0	0	53	0	53
1971	55	0	0	0	0	55
1972	0	54	0	0	0	54
1973	0	0	0	56	0	56
1974	55	0	0	0	0	55
1975	0	0	55	0	0	55
1976	55	0	0	0	0	55
1977	0	0	0	57	0	57
1978	0	0	57	0	0	57
1979	0	0	54	0	0	54
1980	54	0	0	0	0	54
1981	55	0	0	0	0	55
1982	0	0	0	50	0	50
1983	0	0	0	50	0	50
1984	0	0	0	52	0	52
1985	1	44	0	1	0	46
1986	47	0	0	0	0	47
1987	0	47	0	0	0	47
1988	50	0	0	0	0	50
1989	0	0	50	0	0	50
1990	0	0	0	51	0	51
1991	48	0	0	0	0	48
1992	0	0	0	47	0	47
1993	0	0	0	46	0	46
1994	0	43	0	0	0	43
1995	42	0	0	0	0	42
1996	0	47	0	0	0	47
1997	0	0	0	48	0	48
1998	0	1	48	0	0	49
1999	48	0	0	0	0	48
2000	0	0	44	0	0	44
2001	51	0	0	0	0	51
2002	0	51	0	1	0	52
2003	0	0	0	55	0	55
2004	0	55	0	0	0	55
2005	56	0	0	0	0	56
2006	2	0	0	54	0	56
2007	0	0	0	57	0	57
2008	0	0	54	1	0	55
2009	58	0	0	0	0	58
2010	0	0	0	53	0	53
2011	0	0	49	0	0	49
2012	0	52	0	0	0	52
2013	0	0	0	52	0	52
2014	48	0	0	0	0	48
2015	0	0	0	51	0	51
2016	0	0	50	0	0	50
2017	51	0	0	0	0	51
2018	0	0	0	51	0	51
2019	0	0	51	0	0	51
2020	0	0	0	55	0	55
2021	0	0	0	55	0	55
2022	0	54	0	0	0	54
2023	51	0	0	0	0	51
2024	0	53	0	0	0	53
2025	52	0	0	0	0	52
2026	0	0	0	53	0	53
2027	0	53	0	0	0	53
2028	0	0	0	57	0	57
2029	0	0	55	0	0	55
2030	56	0	0	0	0	56
2031	0	0	0	57	0	57
2032	0	0	0	58	0	58
2033	0	0	0	58	0	58
2034	0	0	58	0	0	58
2035	0	0	55	0	0	55
2036	0	62	1	0	0	63
2037	1	0	0	61	0	62
2038	63	0	0	0	0	63
2039	0	64	0	0	0	64
2040	0	0	0	64	0	64
2041	64	0	0	0	0	64
2042	62	0	0	0	0	62
2043	0	60	0	0	0	60
2044	58	0	0	0	0	58
2045	54	0	0	0	0	54
2046	0	0	0	57	0	57
2047	0	58	0	0	0	58
2048	0	0	0	56	0	56
2049	53	0	0	1	0	54
2050	0	0	55	0	0	55
2051	0	0	0	54	0	54
2052	0	0	0	55	0	55
2053	1	0	56	0	0	57
2054	0	0	0	56	0	56
2055	54	0	0	0	0	54
2056	56	0	0	0	0	56
2057	0	0	0	57	0	57
2058	0	0	55	0	0	55
2059	0	0	53	0	0	53
2060	0	51	0	0	0	51
2061	0	60	0	0	0	60
2062	0	0	0	58	0	58
2063	61	0	0	0	0	61
2064	0	60	0	0	0	60
2065	60	0	0	0	0	60
2066	0	0	0	62	0	62
2067	0	0	0	62	0	62
2068	60	0	0	0	0	60
2069	0	62	0	0	0	62
2070	58	0	0	0	0	58
2071	0	0	57	0	0	57
2072	1	0	53	0	0	54
2073	0	0	0	56	0	56
2074	0	0	54	0	0	54
2075	0	0	55	0	0	55
2076	0	0	0	57	0	57
2077	0	0	59	0	0	59
2078	0	0	0	63	0	63
2079	0	0	0	61	0	61
2080	0	0	64	0	0	64
2081	0	0	0	59	0	59
2082	0	0	0	63	0	63
2083	0	59	0	0	0	59
2084	61	0	0	0	0	61
2085	0	0	61	0	0	61
2086	0	0	0	65	0	65
2087	0	0	0	67	0	67
2088	0	0	67	0	0	67
2089	59	0	0	0	0	59
2090	0	58	0	1	0	59
2091	0	0	0	60	0	60
2092	0	0	0	61	0	61
2093	0	59	0	0	0	59
2094	0	0	59	0	0	59
2095	0	58	0	0	0	58
2096	57	0	0	0	0	57
2097	0	0	53	0	0	53
2098	0	0	0	55	0	55
2099	0	0	55	0	0	55
2100	0	0	53	0	0	53
2101	0	52	0	0	0	52
2102	0	0	0	57	0	57
2103	60	0	0	0	0	60
2104	57	0	0	0	0	57
2105	0	58	3	0	0	61
2106	0	0	0	59	0	59
2107	59	0	0	1	0	60
2108	61	0	0	0	0	61
2109	0	62	0	0	0	62
2110	56	0	0	3	0	59
2111	0	0	0	55	0	55
2112	0	59	0	0	0	59
2113	0	0	0	59	0	59
2114	0	0	0	58	0	58
2115	0	0	0	62	0	62
2116	0	0	56	0	0	56
2117	0	0	56	0	0	56
2118	0	56	0	0	0	56
2119	58	0	0	0	0	58
2120	0	54	0	0	0	54
2121	0	0	0	56	0	56
2122	0	0	55	0	0	55
2123	0	0	0	57	0	57
2124	0	0	0	51	0	51
2125	0	0	0	57	0	57
2126	56	0	0	0	0	56
2127	0	0	0	60	0	60
2128	0	0	58	0	0	58
2129	60	0	0	0	0	60
2130	63	0	0	0	0	63
2131	58	0	0	0	0	58
2132	62	0	1	0	0	63
2133	66	0	0	0	0	66
2134	0	65	0	0	0	65
2135	0	0	0	65	0	65
2136	0	65	0	0	0	65
2137	65	0	0	0	0	65
2138	65	0	0	0	0	65
2139	60	0	0	0	0	60
2140	0	58	0	0	0	58
2141	0	51	0	0	0	51
2142	0	61	0	0	0	61
2143	0	0	56	0	0	56
2144	1	0	0	60	0	61
2145	0	57	0	0	0	57
2146	1	62	1	0	0	64
2147	0	0	0	64	0	64
2148	0	1	0	63	0	64
2149	0	0	61	0	0	61
2150	62	0	0	0	0	62
2151	0	0	0	66	0	66
2152	0	0	0	60	0	60
2153	0	0	57	0	0	57
2154	0	0	52	0	0	52
2155	0	62	0	0	0	62
2156	0	0	0	62	0	62
2157	0	0	0	64	0	64
2158	0	0	60	0	0	60
2159	64	0	0	0	0	64
2160	64	0	0	0	0	64
2161	0	0	63	0	0	63
2162	65	0	0	0	0	65
2163	0	0	60	0	0	60
2164	66	0	0	0	0	66
2165	65	0	0	0	0	65
2166	0	0	65	0	0	65
2167	0	0	0	68	0	68
2168	0	0	0	65	0	65
2169	0	0	0	70	0	70
2170	67	0	0	0	0	67
2171	65	0	0	0	0	65
2172	0	0	62	0	0	62
2173	0	0	54	0	0	54
2174	63	0	0	0	0	63
2175	61	0	0	0	0	61
2176	0	0	58	0	0	58
2177	2	0	53	0	0	55
2178	0	0	0	56	0	56
2179	0	0	54	0	0	54
2180	0	0	0	50	0	50
2181	55	0	0	0	0	55
2182	0	0	54	0	0	54
2183	55	0	0	0	0	55
2184	0	0	49	0	0	49
2185	0	0	0	53	0	53
2186	0	0	0	53	0	53
2187	0	0	0	52	0	52
2188	0	54	0	0	0	54
2189	0	0	0	52	0	52
2190	0	0	0	54	0	54
2191	54	0	0	0	0	54
2192	0	0	51	0	0	51
2193	52	0	0	0	0	52
2194	0	0	55	0	0	55
2195	48	0	0	0	0	48
2196	0	49	0	2	0	51
2197	0	0	51	1	0	52
2198	0	0	49	0	0	49
2199	0	0	0	50	0	50
2200	0	0	0	52	0	52
2201	0	0	50	0	0	50
2202	0	0	50	0	0	50
2203	0	0	51	0	0	51
2204	56	0	0	0	0	56
2205	55	0	0	0	0	55
2206	55	0	0	0	0	55
2207	0	0	0	55	0	55
2208	0	0	0	57	0	57
2209	0	0	57	0	0	57
2210	2	0	0	60	0	62
2211	0	0	0	54	0	54
2212	62	0	0	0	0	62
2213	63	0	0	0	0	63
2214	64	0	0	0	0	64
2215	0	0	0	66	0	66
2216	0	0	0	64	0	64
2217	0	0	0	66	0	66
2218	63	0	0	0	0	63
2219	0	0	0	67	0	67
2220	0	66	0	0	0	66
2221	0	0	0	64	0	64
2222	0	62	0	0	0	62
2223	60	0	0	0	0	60
2224	52	0	0	1	0	53
2225	0	59	0	0	0	59
2226	0	58	0	0	0	58
2227	1	0	0	58	0	59
2228	0	0	57	0	0	57
2229	0	0	0	56	0	56
2230	0	0	58	0	0	58
2231	0	57	0	0	0	57
2232	0	0	0	60	0	60
2233	0	0	0	61	0	61
2234	0	0	61	0	0	61
2235	0	0	0	60	0	60
2236	0	0	60	0	0	60
2237	62	0	0	0	0	62
2238	60	0	0	0	0	60
2239	58	0	0	1	0	59
2240	0	0	0	62	0	62
2241	0	0	0	62	0	62
2242	0	0	64	0	0	64
2243	0	0	0	61	0	61
2244	0	63	0	0	0	63
2245	0	0	60	0	0	60
2246	0	0	58	0	0	58
2247	0	0	0	61	0	61
2248	0	0	57	0	0	57
2249	0	0	59	0	0	59
2250	58	0	0	0	0	58
2251	0	63	0	0	0	63
2252	64	0	0	0	0	64
2253	59	1	0	0	0	60
2254	60	0	0	0	0	60
2255	0	0	0	62	0	62
2256	0	0	0	62	0	62
2257	0	0	60	0	0	60
2258	0	0	0	61	0	61
2259	0	60	0	0	0	60
2260	58	0	0	1	0	59
2261	0	55	0	0	0	55
2262	0	58	0	0	0	58
2263	0	0	0	60	0	60
2264	0	0	58	0	0	58
2265	0	0	0	57	0	57
2266	0	0	57	0	0	57
2267	0	58	0	0	0	58
2268	58	0	0	0	0	58
2269	57	0	0	0	0	57
2270	62	0	0	0	0	62
2271	0	0	60	0	0	60
2272	0	0	59	0	0	59
2273	63	0	0	0	0	63
2274	62	0	0	0	0	62
2275	62	0	0	0	0	62
2276	0	0	0	62	0	62
2277	0	0	0	64	0	64
2278	63	0	0	0	0	63
2279	63	0	0	0	0	63
2280	0	0	62	0	0	62
2281	0	0	56	0	0	56
2282	62	0	0	0	0	62
2283	0	0	57	0	0	57
2284	60	0	0	0	0	60
2285	0	0	59	0	0	59
2286	0	0	0	60	0	60
2287	0	0	55	0	0	55
2288	0	0	0	57	0	57
2289	0	0	0	63	0	63
2290	0	59	0	0	0	59
2291	63	0	0	0	0	63
2292	0	0	61	0	0	61
2293	60	0	0	0	0	60
2294	0	61	0	0	0	61
2295	63	0	0	0	0	63
2296	0	0	0	63	0	63
2297	0	0	0	60	0	60
2298	0	55	0	0	0	55
2299	0	0	0	62	0	62
2300	0	0	0	64	0	64
2301	0	0	0	64	0	64
2302	62	0	0	0	0	62
2303	66	0	0	0	0	66
2304	0	0	62	0	0	62
2305	0	57	0	0	0	57
2306	0	0	0	57	0	57
2307	0	0	0	59	0	59
2308	0	0	58	0	0	58
2309	0	0	0	57	0	57
2310	56	0	0	0	0	56
2311	56	0	0	0	0	56
2312	57	0	0	0	0	57
2313	0	0	0	51	0	51
2314	55	0	0	0	0	55
2315	51	0	0	0	0	51
2316	53	0	0	0	0	53
2317	0	0	0	54	0	54
2318	0	0	0	51	0	51
2319	0	0	0	53	0	53
2320	0	0	0	54	0	54
2321	0	0	0	53	0	53
2322	0	0	52	0	0	52
2323	0	0	44	0	0	44
2324	0	51	0	0	0	51
2325	0	0	0	54	0	54
2326	0	0	0	53	0	53
2327	0	0	0	54	0	54
2328	0	0	51	0	0	51
2329	0	0	0	52	0	52
2330	0	0	50	0	0	50
2331	0	0	0	54	0	54
2332	0	0	54	0	0	54
2333	0	58	0	0	0	58
2334	0	0	0	57	0	57
2335	0	0	52	0	0	52
2336	56	0	0	0	0	56
2337	0	54	0	0	0	54
2338	0	0	0	55	0	55
2339	0	54	0	0	0	54
2340	0	0	0	56	0	56
2341	57	0	0	0	0	57
2342	0	0	0	57	0	57
2343	0	58	0	0	0	58
2344	57	0	0	1	0	58
2345	0	0	0	58	0	58
2346	0	0	0	58	0	58
2347	59	0	0	0	0	59
2348	0	0	0	57	0	57
2349	0	0	0	58	0	58
2350	0	0	54	0	0	54
2351	0	0	53	0	0	53
2352	0	0	0	56	0	56
2353	0	0	60	0	0	60
2354	0	0	58	0	0	58
2355	68	0	0	0	0	68
2356	0	0	70	0	0	70
2357	0	72	0	0	0	72
2358	0	0	0	72	0	72
2359	67	0	0	0	0	67
2360	72	0	0	0	0	72
2361	71	0	0	0	0	71
2362	0	70	0	0	0	70
2363	0	0	0	70	0	70
2364	0	0	0	70	0	70
2365	71	0	0	0	0	71
2366	71	0	0	0	0	71
2367	72	0	0	0	0	72
2368	0	0	70	0	0	70
2369	1	68	0	0	0	69
2370	0	67	0	0	0	67
2371	0	0	0	68	0	68
2372	0	0	0	72	0	72
2373	0	0	70	0	0	70
2374	68	0	0	0	0	68
2375	69	0	0	0	0	69
2376	0	0	0	70	0	70
2377	0	0	0	70	0	70
2378	0	0	0	70	0	70
2379	71	0	0	0	0	71
2380	0	0	69	0	0	69
2381	0	0	68	0	0	68
2382	0	0	0	66	0	66
2383	0	0	69	0	0	69
2384	68	0	0	0	0	68
2385	72	0	0	0	0	72
2386	70	0	0	0	0	70
2387	0	68	0	0	0	68
2388	66	0	0	1	0	67
2389	0	0	0	65	0	65
2390	0	0	0	68	0	68
2391	0	0	0	67	0	67
2392	0	0	66	0	0	66
2393	0	0	0	63	0	63
2394	0	58	0	0	0	58
2395	63	0	0	0	0	63
2396	0	61	0	0	0	61
2397	0	0	60	1	0	61
2398	0	64	0	0	0	64
2399	63	0	0	0	0	63
2400	0	63	0	0	0	63
2401	0	0	0	56	0	56
2402	0	62	0	0	0	62
2403	63	0	0	0	0	63
2404	62	0	0	0	0	62
2405	60	0	0	0	0	60
2406	0	0	61	0	0	61
2407	0	0	57	0	0	57
2408	0	0	58	0	0	58
2409	58	0	0	0	0	58
2410	0	0	0	56	0	56
2411	0	0	0	56	0	56
2412	0	0	55	0	0	55
2413	0	0	0	58	0	58
2414	56	0	0	0	0	56
2415	0	55	0	0	0	55
2416	58	0	0	0	0	58
2417	0	0	59	0	0	59
2418	55	0	0	0	0	55
2419	57	0	0	0	0	57
2420	56	0	0	0	0	56
2421	0	0	57	0	0	57
2422	0	0	0	54	0	54
2423	0	0	52	0	0	52
2424	1	0	0	55	0	56
2425	0	0	56	0	0	56
2426	0	0	0	52	0	52
2427	0	0	0	58	0	58
2428	57	0	0	0	0	57
2429	56	1	0	0	0	57
2430	57	0	0	0	0	57
2431	0	0	0	59	0	59
2432	0	52	0	0	0	52
2433	0	50	0	0	0	50
2434	58	0	0	0	0	58
2435	0	0	55	0	0	55
2436	57	0	0	0	0	57
2437	0	0	54	0	0	54
2438	53	0	0	0	0	53
2439	55	0	0	0	0	55
2440	0	0	52	0	0	52
2441	54	0	0	1	0	55
2442	54	0	0	0	0	54
2443	51	0	0	0	0	51
2444	0	53	0	0	0	53
2445	0	0	0	54	0	54
2446	0	0	48	0	0	48
2447	0	0	42	0	0	42
2448	0	41	0	0	0	41
2449	0	43	0	0	0	43
2450	0	0	0	45	0	45
2451	44	0	0	0	0	44
2452	0	45	0	0	0	45
2453	0	0	0	41	0	41
2454	0	41	0	0	0	41
2455	42	0	0	0	0	42
2456	0	0	0	43	0	43
2457	0	0	44	0	0	44
2458	0	42	0	0	0	42
2459	0	42	1	0	0	43
2460	0	0	0	44	0	44
2461	1	42	0	0	0	43
2462	0	0	0	42	0	42
2463	44	0	0	0	0	44
2464	45	0	0	0	0	45
2465	43	0	0	0	0	43
2466	42	0	0	0	0	42
2467	0	0	38	0	0	38
2468	0	42	0	0	0	42
2469	0	36	0	0	0	36
2470	0	38	0	0	0	38
2471	0	42	0	0	0	42
2472	44	0	0	0	0	44
2473	43	0	0	0	0	43
2474	41	0	0	0	0	41
2475	43	0	0	0	0	43
2476	0	0	39	0	0	39
2477	46	0	0	0	0	46
2478	43	0	0	0	0	43
2479	45	0	0	0	0	45
2480	0	0	0	44	0	44
2481	0	0	0	45	0	45
2482	43	0	0	0	0	43
2483	0	0	0	45	0	45
2484	0	43	0	0	0	43
2485	0	0	0	45	0	45
2486	0	0	0	47	0	47
2487	0	45	0	0	0	45
2488	0	0	0	48	0	48
2489	0	0	0	46	0	46
2490	46	0	0	0	0	46
2491	0	0	44	0	0	44
2492	45	0	0	0	0	45
2493	0	0	45	0	0	45
2494	0	0	41	0	0	41
2495	0	0	45	0	0	45
2496	47	0	0	0	0	47
2497	0	0	46	0	0	46
2498	48	0	0	0	0	48
2499	48	0	0	0	0	48
2500	46	0	0	0	0	46
2501	0	48	0	0	0	48
2502	47	0	0	0	0	47
2503	0	50	0	0	0	50
2504	0	0	0	49	0	49
2505	0	0	0	49	0	49
2506	0	48	0	0	0	48
2507	0	45	0	0	0	45
2508	0	46	0	0	0	46
2509	46	0	0	0	0	46
2510	0	47	0	0	0	47
2511	45	0	0	0	0	45
2512	0	0	47	0	0	47
2513	50	0	0	0	0	50
2514	51	0	0	0	0	51
2515	0	0	49	0	0	49
2516	0	0	0	51	0	51
2517	0	0	47	0	0	47
2518	0	0	0	51	0	51
2519	0	0	0	47	0	47
2520	49	0	0	0	0	49
2521	48	0	0	0	0	48
2522	0	50	0	0	0	50
2523	49	0	0	0	0	49
2524	0	0	48	0	0	48
2525	48	0	0	0	0	48
2526	0	0	47	0	0	47
2527	0	0	40	0	0	40
2528	47	0	0	0	0	47
2529	48	0	0	0	0	48
2530	0	0	46	0	0	46
2531	0	0	0	44	0	44
2532	0	0	0	45	0	45
2533	0	0	45	0	0	45
2534	0	0	0	46	0	46
2535	0	39	0	0	0	39
2536	0	0	0	47	0	47
2537	0	0	0	47	0	47
2538	0	0	47	0	0	47
2539	43	0	0	0	0	43
2540	46	0	0	0	0	46
2541	43	0	0	0	0	43
2542	42	0	0	0	0	42
2543	0	41	0	0	0	41
2544	0	0	0	46	0	46
2545	0	0	47	0	0	47
2546	0	0	43	0	0	43
2547	0	0	0	47	0	47
2548	0	0	45	0	0	45
2549	46	0	0	0	0	46
2550	0	0	0	45	0	45
2551	0	0	0	50	0	50
2552	0	0	0	49	0	49
2553	49	0	0	0	0	49
2554	0	49	0	0	0	49
2555	52	0	0	0	0	52
2556	48	0	0	0	0	48
2557	0	45	0	0	0	45
2558	0	50	0	0	0	50
2559	52	0	0	0	0	52
2560	0	0	0	51	0	51
2561	0	0	0	52	0	52
2562	51	0	0	0	0	51
2563	0	0	49	0	0	49
2564	51	0	0	0	0	51
2565	52	0	0	0	0	52
2566	0	54	0	0	0	54
2567	56	0	0	0	0	56
2568	52	0	0	0	0	52
2569	0	53	0	0	0	53
2570	0	53	0	0	0	53
2571	0	0	0	53	0	53
2572	54	0	0	0	0	54
2573	0	55	0	0	0	55
2574	0	0	0	56	0	56
2575	57	0	0	0	0	57
2576	0	0	59	0	0	59
2577	0	0	0	57	0	57
2578	0	0	59	0	0	59
2579	59	0	0	0	0	59
2580	57	0	0	0	0	57
2581	0	0	55	0	0	55
2582	0	53	0	0	0	53
2583	0	0	0	55	0	55
2584	0	0	58	0	0	58
2585	0	0	0	56	0	56
2586	0	0	0	60	0	60
2587	0	0	57	0	0	57
2588	60	0	0	0	0	60
2589	60	0	0	0	0	60
2590	0	0	57	0	0	57
2591	0	59	0	0	0	59
2592	0	0	0	62	0	62
2593	0	57	1	0	0	58
2594	0	61	0	0	0	61
2595	63	0	0	1	0	64
2596	0	0	0	60	0	60
2597	0	0	0	61	0	61
2598	0	0	62	0	0	62
2599	0	0	60	0	0	60
2600	0	0	0	60	0	60
2601	0	0	0	61	0	61
2602	0	0	61	0	0	61
2603	0	0	57	0	0	57
2604	0	0	0	61	0	61
2605	62	0	0	0	0	62
2606	0	58	0	0	0	58
2607	56	0	0	0	0	56
2608	0	59	0	0	0	59
2609	0	59	0	0	0	59
2610	64	0	0	0	0	64
2611	0	0	63	0	0	63
2612	0	0	0	62	0	62
2613	0	0	0	62	0	62
2614	0	0	0	62	0	62
2615	0	0	63	0	0	63
2616	0	0	0	64	0	64
2617	64	0	0	0	0	64
2618	0	0	0	63	0	63
2619	0	0	0	66	0	66
2620	67	0	0	0	0	67
2621	62	0	0	1	0	63
2622	0	63	0	0	0	63
2623	0	0	66	0	0	66
2624	0	0	60	0	0	60
2625	0	0	66	0	0	66
2626	0	65	0	0	0	65
2627	0	0	0	66	0	66
2628	0	0	0	66	0	66
2629	62	0	0	0	0	62
2630	0	0	0	64	0	64
2631	0	0	63	0	0	63
2632	0	0	0	62	0	62
2633	0	0	0	63	0	63
2634	0	0	61	0	0	61
2635	0	62	0	0	0	62
2636	0	0	0	61	0	61
2637	0	61	0	0	0	61
2638	0	0	62	0	0	62
2639	67	0	0	1	0	68
2640	64	0	0	0	0	64
2641	66	0	0	0	0	66
2642	0	0	0	63	0	63
2643	0	66	0	0	0	66
2644	67	0	0	0	0	67
2645	70	0	0	0	0	70
2646	68	0	0	0	0	68
2647	0	0	70	0	0	70
2648	65	0	0	0	0	65
2649	0	68	0	0	0	68
2650	64	0	0	0	0	64
2651	0	65	0	0	0	65
2652	66	0	0	0	0	66
2653	0	0	68	0	0	68
2654	67	0	0	0	0	67
2655	68	0	0	0	0	68
2656	68	0	0	0	0	68
2657	70	0	0	0	0	70
2658	0	0	72	0	0	72
2659	1	0	0	67	0	68
2660	68	0	0	0	0	68
2661	0	66	0	0	0	66
2662	0	0	0	69	0	69
2663	0	0	67	0	0	67
2664	0	0	0	69	0	69
2665	0	0	64	0	0	64
2666	0	61	0	1	0	62
2667	0	60	0	0	0	60
2668	0	65	0	0	0	65
2669	0	0	0	65	0	65
2670	0	0	0	64	0	64
2671	0	0	62	0	0	62
2672	0	63	0	0	0	63
2673	62	0	0	0	0	62
2674	0	60	0	1	0	61
2675	0	60	0	0	0	60
2676	0	0	0	58	0	58
2677	61	0	0	0	0	61
2678	56	1	0	0	0	57
2679	0	0	0	57	0	57
2680	62	0	0	0	0	62
2681	0	0	0	62	0	62
2682	0	0	62	0	0	62
2683	62	0	0	0	0	62
2684	0	0	0	60	0	60
2685	0	0	56	1	0	57
2686	0	0	62	0	0	62
2687	0	0	0	65	0	65
2688	63	0	0	1	0	64
2689	60	0	0	0	0	60
2690	0	66	0	0	0	66
2691	66	0	0	0	0	66
2692	67	0	0	0	0	67
2693	59	0	0	0	0	59
2694	0	63	0	0	0	63
2695	69	0	0	0	0	69
2696	67	0	0	0	0	67
2697	1	0	0	67	0	68
2698	70	0	0	0	0	70
2699	0	64	0	0	0	64
2700	0	65	0	0	0	65
2701	0	0	0	68	0	68
2702	0	0	0	69	0	69
2703	0	67	0	0	0	67
2704	65	0	0	0	0	65
2705	0	66	0	0	0	66
2706	68	0	0	0	0	68
2707	0	64	0	0	0	64
2708	0	0	0	66	0	66
2709	0	68	0	0	0	68
2710	70	0	0	0	0	70
2711	71	0	0	0	0	71
2712	66	0	0	0	0	66
2713	0	0	64	0	0	64
2714	1	0	62	0	0	63
2715	0	67	0	0	0	67
2716	0	0	61	0	0	61
2717	0	0	60	0	0	60
2718	0	0	0	64	0	64
2719	0	0	61	0	0	61
2720	0	67	0	0	0	67
2721	67	0	0	0	0	67
2722	0	64	0	0	0	64
2723	0	66	0	0	0	66
2724	65	0	0	0	0	65
2725	68	0	0	0	0	68
2726	0	67	0	0	0	67
2727	66	0	0	0	0	66
2728	64	0	0	0	0	64
2729	65	0	0	0	0	65
2730	0	0	56	0	0	56
2731	0	0	55	0	0	55
2732	0	0	0	56	0	56
2733	0	0	0	58	0	58
2734	56	0	0	0	0	56
2735	0	56	0	0	0	56
2736	0	0	0	55	0	55
2737	0	0	0	56	0	56
2738	0	0	0	50	0	50
2739	0	0	0	54	0	54
2740	0	0	51	0	0	51
2741	0	0	48	0	0	48
2742	0	0	0	51	0	51
2743	0	0	51	0	0	51
2744	51	0	0	0	0	51
2745	0	0	0	47	0	47
2746	0	0	46	0	0	46
2747	47	0	0	0	0	47
2748	0	44	0	0	0	44
2749	46	0	0	0	0	46
2750	0	46	0	0	0	46
2751	0	0	0	46	0	46
2752	0	0	44	0	0	44
2753	0	0	0	44	0	44
2754	0	0	45	0	0	45
2755	46	0	0	0	0	46
2756	0	0	0	44	0	44
2757	47	0	0	0	0	47
2758	0	0	46	0	0	46
2759	46	0	0	0	0	46
2760	52	0	0	0	0	52
2761	0	0	51	0	0	51
2762	0	0	0	54	0	54
2763	0	0	51	0	0	51
2764	0	51	0	0	0	51
2765	55	0	0	0	0	55
2766	54	0	0	0	0	54
2767	0	0	51	0	0	51
2768	0	0	51	0	0	51
2769	0	0	0	52	0	52
2770	0	0	0	56	0	56
2771	58	0	0	0	0	58
2772	0	59	0	0	0	59
2773	58	0	0	0	0	58
2774	61	0	0	0	0	61
2775	0	0	52	0	0	52
2776	56	0	0	0	0	56
2777	0	0	51	0	0	51
2778	0	0	0	54	0	54
2779	0	0	56	0	0	56
2780	0	0	0	57	0	57
2781	0	0	55	0	0	55
2782	58	0	0	0	0	58
2783	56	0	0	0	0	56
2784	0	0	0	54	0	54
2785	55	0	0	0	0	55
2786	0	0	0	57	0	57
2787	0	53	1	0	0	54
2788	54	0	0	0	0	54
2789	0	53	0	0	0	53
2790	0	0	0	54	0	54
2791	0	0	0	52	0	52
2792	0	0	0	53	0	53
2793	0	0	0	47	0	47
2794	0	0	51	0	0	51
2795	50	0	0	0	0	50
2796	51	0	0	0	0	51
2797	0	49	0	0	0	49
2798	0	0	0	51	0	51
2799	0	0	0	55	0	55
2800	0	0	48	0	0	48
2801	55	0	0	0	0	55
2802	0	0	0	51	0	51
2803	0	0	52	0	0	52
2804	52	0	0	0	0	52
2805	49	0	0	0	0	49
2806	55	0	0	0	0	55
2807	0	0	49	0	0	49
2808	0	0	45	2	0	47
2809	51	0	0	0	0	51
2810	0	0	0	54	0	54
2811	1	0	0	50	0	51
2812	0	0	52	0	0	52
2813	52	0	0	0	0	52
2814	0	0	0	54	0	54
2815	54	0	0	0	0	54
2816	55	0	0	0	0	55
2817	57	0	0	0	0	57
2818	0	0	56	0	0	56
2819	0	0	0	58	0	58
2820	57	0	0	0	0	57
2821	0	59	0	0	0	59
2822	0	0	0	59	0	59
2823	0	0	0	61	0	61
2824	58	0	0	0	0	58
2825	60	0	0	0	0	60
2826	0	0	0	60	0	60
2827	0	0	58	0	0	58
2828	64	0	0	0	0	64
2829	0	0	58	0	0	58
2830	63	0	0	0	0	63
2831	61	0	0	0	0	61
2832	0	0	62	0	0	62
2833	0	0	0	63	0	63
2834	0	0	64	0	0	64
2835	0	65	0	0	0	65
2836	0	0	0	67	0	67
2837	0	64	0	0	0	64
2838	0	0	0	71	0	71
2839	0	0	71	0	0	71
2840	0	66	0	0	0	66
2841	0	72	0	0	0	72
2842	0	0	0	73	0	73
2843	71	0	0	0	0	71
2844	0	0	0	75	0	75
2845	71	0	0	0	0	71
2846	0	75	0	0	0	75
2847	76	0	0	0	0	76
2848	0	0	73	0	0	73
2849	0	0	0	73	0	73
2850	0	0	1	71	0	72
2851	0	0	72	0	0	72
2852	73	0	0	0	0	73
2853	68	0	0	0	0	68
2854	0	61	0	0	0	61
2855	0	0	0	61	0	61
2856	3	61	0	0	0	64
2857	0	0	63	0	0	63
2858	0	0	52	3	0	55
2859	0	0	0	64	0	64
2860	64	0	0	0	0	64
2861	0	63	0	0	0	63
2862	65	0	0	0	0	65
2863	0	0	65	0	0	65
2864	60	0	0	0	0	60
2865	62	0	0	0	0	62
2866	0	0	58	0	0	58
2867	0	0	0	63	0	63
2868	59	0	0	0	0	59
2869	64	0	0	0	0	64
2870	61	0	0	0	0	61
2871	0	0	0	62	0	62
2872	0	0	61	0	0	61
2873	62	0	0	0	0	62
2874	0	0	63	0	0	63
2875	0	0	0	65	0	65
2876	0	1	0	61	0	62
2877	0	61	0	0	0	61
2878	0	0	63	0	0	63
2879	0	51	0	0	0	51
2880	0	62	0	0	0	62
2881	0	0	0	65	0	65
2882	0	0	62	0	0	62
2883	0	0	0	62	0	62
2884	0	0	61	0	0	61
2885	0	0	0	60	0	60
2886	0	0	1	61	0	62
2887	0	0	61	0	0	61
2888	0	0	0	62	0	62
2889	0	0	58	0	0	58
2890	0	0	54	1	0	55
2891	1	50	0	0	0	51
2892	56	0	0	0	0	56
2893	0	0	54	0	0	54
2894	54	0	0	0	0	54
2895	1	0	0	55	0	56
2896	0	0	54	0	0	54
2897	0	54	0	0	0	54
2898	0	0	0	60	0	60
2899	0	0	56	0	0	56
2900	0	0	0	55	0	55
2901	0	57	0	0	0	57
2902	60	0	0	0	0	60
2903	0	0	0	64	0	64
2904	60	0	0	0	0	60
2905	65	0	0	0	0	65
2906	68	0	0	0	0	68
2907	69	0	0	0	0	69
2908	69	0	0	0	0	69
2909	0	66	0	0	0	66
2910	0	0	0	70	0	70
2911	1	0	0	70	0	71
2912	0	0	0	67	0	67
2913	0	0	63	0	0	63
2914	0	67	0	0	0	67
2915	71	0	0	0	0	71
2916	69	0	0	0	0	69
2917	0	60	0	0	0	60
2918	0	69	0	0	0	69
2919	66	0	0	0	0	66
2920	0	0	69	0	0	69
2921	0	1	0	67	0	68
2922	72	0	0	0	0	72
2923	2	0	0	71	0	73
2924	0	70	0	0	0	70
2925	0	0	0	79	0	79
2926	0	0	72	0	0	72
2927	79	0	0	0	0	79
2928	76	0	4	0	0	80
2929	0	0	0	82	0	82
2930	0	0	0	91	0	91
2931	85	0	0	1	0	86
2932	0	87	0	0	0	87
2933	0	0	0	85	0	85
2934	0	0	0	82	0	82
2935	85	0	0	0	0	85
2936	0	84	0	0	0	84
2937	84	0	0	0	0	84
2938	0	81	0	0	0	81
2939	0	79	0	0	0	79
2940	85	0	0	0	0	85
2941	0	86	0	0	0	86
2942	0	0	0	85	0	85
2943	0	0	83	0	0	83
2944	1	0	72	0	0	73
2945	0	0	81	0	0	81
2946	0	85	0	0	0	85
2947	85	0	0	0	0	85
2948	0	0	0	86	0	86
2949	0	0	0	90	0	90
2950	0	0	89	0	0	89
2951	93	0	0	0	0	93
2952	0	0	0	90	0	90
2953	0	0	0	90	0	90
2954	0	0	0	91	0	91
2955	91	0	0	0	0	91
2956	0	0	89	0	0	89
2957	92	0	0	0	0	92
2958	0	0	0	92	0	92
2959	1	0	93	0	0	94
2960	93	0	0	0	0	93
2961	1	0	95	0	0	96
2962	0	0	0	89	0	89
2963	0	0	91	0	0	91
2964	0	0	96	0	0	96
2965	96	0	0	0	0	96
2966	0	0	97	0	0	97
2967	0	0	0	93	0	93
2968	94	0	0	0	0	94
2969	0	0	0	96	0	96
2970	0	0	94	0	0	94
2971	0	0	82	0	0	82
2972	1	91	0	0	0	92
2973	0	0	0	96	0	96
2974	93	0	0	0	0	93
2975	0	95	0	0	0	95
2976	97	0	0	0	0	97
2977	0	0	0	94	0	94
2978	97	0	0	0	0	97
2979	0	90	1	1	0	92
2980	0	0	0	98	0	98
2981	94	0	0	0	0	94
2982	0	91	1	0	0	92
2983	0	0	0	94	0	94
2984	0	0	0	94	0	94
2985	96	0	0	0	0	96
2986	0	0	0	84	0	84
2987	0	0	0	89	0	89
2988	0	0	0	91	0	91
2989	0	0	90	0	0	90
2990	88	0	0	0	0	88
2991	0	0	0	87	0	87
2992	0	0	83	0	0	83
2993	83	0	0	0	0	83
2994	0	0	81	0	0	81
2995	0	0	0	80	0	80
2996	0	81	0	0	0	81
2997	0	0	0	81	0	81
2998	0	0	78	0	0	78
2999	0	0	67	0	0	67
3000	0	0	0	76	0	76
3001	0	0	75	0	0	75
3002	78	0	0	0	0	78
3003	0	0	76	0	0	76
3004	0	0	0	77	0	77
3005	0	0	0	77	0	77
3006	0	0	0	77	0	77
3007	77	0	0	0	0	77
3008	71	0	0	0	0	71
3009	75	0	0	0	0	75
3010	0	0	0	73	0	73
3011	0	0	0	80	0	80
3012	0	0	74	0	0	74
3013	0	0	75	0	0	75
3014	0	76	0	0	0	76
3015	0	0	0	77	0	77
3016	0	0	0	77	0	77
3017	0	78	0	0	0	78
3018	71	0	0	0	0	71
3019	0	67	0	0	0	67
3020	69	0	0	0	0	69
3021	0	0	0	70	0	70
3022	67	0	0	0	0	67
3023	0	0	0	66	0	66
3024	0	0	65	0	0	65
3025	0	0	0	62	0	62
3026	63	0	0	0	0	63
3027	0	0	0	63	0	63
3028	0	0	0	63	0	63
3029	0	0	64	0	0	64
3030	0	0	0	64	0	64
3031	0	0	0	65	0	65
3032	1	63	0	0	0	64
3033	0	0	0	65	0	65
3034	0	0	0	60	0	60
3035	0	0	0	62	0	62
3036	0	61	0	0	0	61
3037	0	0	0	63	0	63
3038	58	0	0	0	0	58
3039	0	56	0	0	0	56
3040	0	54	0	0	0	54
3041	0	54	0	0	0	54
3042	0	0	0	62	0	62
3043	0	62	0	0	0	62
3044	0	61	0	0	0	61
3045	59	0	0	0	0	59
3046	0	0	60	0	0	60
3047	62	0	0	0	0	62
3048	0	0	0	58	0	58
3049	0	0	58	0	0	58
3050	57	0	0	0	0	57
3051	0	0	56	0	0	56
3052	0	0	52	1	0	53
3053	56	0	0	0	0	56
3054	0	0	0	56	0	56
3055	0	0	54	0	0	54
3056	54	0	0	0	0	54
3057	57	0	0	0	0	57
3058	0	0	58	0	0	58
3059	54	0	0	0	0	54
3060	53	0	0	0	0	53
3061	0	0	53	0	0	53
3062	56	0	0	0	0	56
3063	54	0	0	0	0	54
3064	0	0	48	0	0	48
3065	0	0	50	0	0	50
3066	1	0	0	51	0	52
3067	0	0	53	0	0	53
3068	56	0	0	0	0	56
3069	0	0	0	53	0	53
3070	0	0	0	60	0	60
3071	0	0	59	0	0	59
3072	0	0	0	58	0	58
3073	0	0	59	0	0	59
3074	60	0	0	0	0	60
3075	60	0	0	0	0	60
3076	0	0	57	0	0	57
3077	60	0	0	0	0	60
3078	62	0	0	0	0	62
3079	0	0	63	0	0	63
3080	68	0	0	0	0	68
3081	68	0	0	0	0	68
3082	0	0	64	0	0	64
3083	67	0	0	0	0	67
3084	0	0	66	0	0	66
3085	0	0	0	69	0	69
3086	0	0	0	72	0	72
3087	0	0	0	72	0	72
3088	0	0	73	0	0	73
3089	74	0	0	0	0	74
3090	0	0	68	0	0	68
3091	0	67	0	0	0	67
3092	0	73	0	0	0	73
3093	69	0	0	0	0	69
3094	0	0	0	70	0	70
3095	0	67	0	0	0	67
3096	72	0	0	0	0	72
3097	71	0	0	0	0	71
3098	0	76	0	0	0	76
3099	0	0	0	76	0	76
3100	0	73	0	1	0	74
3101	78	0	0	0	0	78
3102	75	0	0	0	0	75
3103	1	0	0	74	0	75
3104	75	0	0	0	0	75
3105	0	0	0	77	0	77
3106	0	0	70	0	0	70
3107	71	0	0	0	0	71
3108	0	0	71	0	0	71
3109	0	0	0	73	0	73
3110	74	0	0	0	0	74
3111	0	0	0	72	0	72
3112	0	0	72	0	0	72
3113	0	1	64	0	0	65
3114	0	0	0	72	0	72
3115	71	0	0	0	0	71
3116	0	72	0	0	0	72
3117	0	0	0	72	0	72
3118	0	0	73	0	0	73
3119	72	0	0	1	0	73
3120	70	0	0	0	0	70
3121	0	0	70	0	0	70
3122	72	0	0	0	0	72
3123	0	0	0	75	0	75
3124	0	0	75	0	0	75
3125	72	0	0	0	0	72
3126	0	0	0	71	0	71
3127	0	0	0	75	0	75
3128	70	0	0	0	0	70
3129	0	69	0	0	0	69
3130	0	73	0	0	0	73
3131	76	0	0	0	0	76
3132	74	0	0	0	0	74
3133	0	0	74	0	0	74
3134	0	0	64	0	0	64
3135	0	0	0	75	0	75
3136	73	0	0	0	0	73
3137	77	0	0	0	0	77
3138	73	0	0	0	0	73
3139	0	72	1	0	0	73
3140	0	70	0	0	0	70
3141	0	0	0	75	0	75
3142	0	0	0	73	0	73
3143	0	0	0	79	0	79
3144	0	0	79	0	0	79
3145	0	0	72	0	0	72
3146	82	0	0	0	0	82
3147	81	0	0	0	0	81
3148	0	0	0	75	0	75
3149	0	0	0	75	0	75
3150	0	0	0	74	0	74
3151	0	0	71	0	0	71
3152	0	0	70	0	0	70
3153	0	0	0	74	0	74
3154	0	0	71	0	0	71
3155	0	72	0	0	0	72
3156	0	73	0	0	0	73
3157	78	0	0	0	0	78
3158	0	76	0	0	0	76
3159	0	0	0	76	0	76
3160	0	0	0	76	0	76
3161	0	74	0	0	0	74
3162	0	0	0	75	0	75
3163	0	0	65	0	0	65
3164	0	70	0	0	0	70
3165	0	0	0	75	0	75
3166	0	0	69	0	0	69
3167	0	73	0	0	0	73
3168	0	0	0	75	0	75
3169	0	75	0	0	0	75
3170	0	0	0	75	0	75
3171	0	0	0	82	0	82
3172	0	79	0	0	0	79
3173	78	0	0	0	0	78
3174	79	0	0	0	0	79
3175	0	73	0	0	0	73
3176	0	76	0	0	0	76
3177	0	0	0	82	0	82
3178	0	0	74	0	0	74
3179	80	0	0	0	0	80
3180	80	0	0	0	0	80
3181	0	0	74	0	0	74
3182	73	0	0	1	0	74
3183	76	0	0	0	0	76
3184	0	0	73	0	0	73
3185	76	0	0	0	0	76
3186	0	0	77	0	0	77
3187	0	71	0	0	0	71
3188	77	0	0	0	0	77
3189	74	0	0	0	0	74
3190	0	0	71	0	0	71
3191	73	0	0	0	0	73
3192	72	0	0	0	0	72
3193	0	0	67	0	0	67
3194	71	0	0	0	0	71
3195	72	0	0	0	0	72
3196	0	0	69	0	0	69
3197	73	0	0	0	0	73
3198	0	0	0	72	0	72
3199	0	0	0	72	0	72
3200	1	0	69	0	0	70
3201	1	0	64	0	0	65
3202	0	0	0	73	0	73
3203	0	0	0	74	0	74
3204	74	0	0	1	0	75
3205	0	1	70	0	0	71
3206	75	0	0	0	0	75
3207	0	0	0	77	0	77
3208	0	0	75	0	0	75
3209	78	0	0	0	0	78
3210	0	0	0	76	0	76
3211	0	0	74	1	0	75
3212	71	0	0	0	0	71
3213	0	0	0	73	0	73
3214	71	1	0	0	0	72
3215	0	0	72	0	0	72
3216	0	0	0	63	0	63
3217	0	67	0	0	0	67
3218	71	0	0	0	0	71
3219	67	0	0	0	0	67
3220	0	71	0	0	0	71
3221	72	0	0	0	0	72
3222	70	0	1	1	0	72
3223	69	0	0	0	0	69
3224	0	70	0	0	0	70
3225	0	0	0	69	0	69
3226	0	0	69	0	0	69
3227	0	0	0	68	0	68
3228	0	0	0	65	0	65
3229	0	0	62	0	0	62
3230	0	0	59	0	0	59
3231	0	0	0	61	0	61
3232	0	64	0	0	0	64
3233	64	0	0	0	0	64
3234	59	0	0	0	0	59
3235	0	63	0	0	0	63
3236	62	0	0	0	0	62
3237	62	0	0	0	0	62
3238	0	0	64	0	0	64
3239	63	0	0	0	0	63
3240	0	60	0	0	0	60
3241	0	0	63	0	0	63
3242	0	0	57	0	0	57
3243	0	64	0	0	0	64
3244	64	0	0	0	0	64
3245	0	0	63	0	0	63
3246	0	0	0	61	0	61
3247	0	0	64	0	0	64
3248	64	0	0	0	0	64
3249	0	0	60	0	0	60
3250	0	0	60	0	0	60
3251	67	0	0	0	0	67
3252	0	64	0	0	0	64
3253	65	0	0	0	0	65
3254	65	0	0	0	0	65
3255	0	0	0	65	0	65
3256	0	68	0	0	0	68
3257	68	0	0	0	0	68
3258	0	0	60	0	0	60
3259	68	0	0	0	0	68
3260	0	64	0	0	0	64
3261	65	0	0	0	0	65
3262	68	0	0	0	0	68
3263	0	63	0	0	0	63
3264	0	0	0	65	0	65
3265	65	0	0	0	0	65
3266	0	62	0	0	0	62
3267	0	0	0	64	0	64
3268	66	0	0	0	0	66
3269	0	0	1	61	0	62
3270	0	0	0	57	0	57
3271	0	59	0	0	0	59
3272	61	0	0	0	0	61
3273	60	0	0	0	0	60
3274	60	0	0	0	0	60
3275	0	66	0	0	0	66
3276	66	0	0	0	0	66
3277	66	0	0	0	0	66
3278	0	0	0	68	0	68
3279	0	0	0	65	0	65
3280	0	0	63	0	0	63
3281	1	0	0	64	0	65
3282	0	0	0	67	0	67
3283	0	0	62	0	0	62
3284	63	0	0	0	0	63
3285	0	0	62	0	0	62
3286	0	0	61	0	0	61
3287	0	0	0	65	0	65
3288	0	0	0	67	0	67
3289	0	65	0	0	0	65
3290	64	1	0	1	0	66
3291	63	0	0	0	0	63
3292	0	62	0	1	0	63
3293	0	64	0	0	0	64
3294	0	0	0	68	0	68
3295	0	67	0	0	0	67
3296	68	0	0	0	0	68
3297	67	0	0	0	0	67
3298	0	0	0	66	0	66
3299	1	0	0	65	0	66
3300	67	0	0	0	0	67
3301	0	0	65	0	0	65
3302	67	0	0	0	0	67
3303	0	0	67	0	0	67
3304	64	0	0	0	0	64
3305	0	0	0	65	0	65
3306	0	0	68	0	0	68
3307	0	0	65	0	0	65
3308	69	0	0	0	0	69
3309	71	0	0	0	0	71
3310	0	68	0	0	0	68
3311	0	0	0	69	0	69
3312	0	0	0	68	0	68
3313	68	0	0	0	0	68
3314	0	69	0	0	0	69
3315	70	0	0	0	0	70
3316	0	67	0	0	0	67
3317	0	70	0	0	0	70
3318	73	0	0	0	0	73
3319	0	0	70	0	0	70
3320	0	0	0	72	0	72
3321	0	0	0	74	0	74
3322	0	0	69	0	0	69
3323	0	0	0	70	0	70
3324	0	0	0	72	0	72
3325	0	72	0	0	0	72
3326	76	0	0	0	0	76
3327	0	0	77	0	0	77
3328	71	0	0	0	0	71
3329	0	68	0	0	0	68
3330	0	1	0	74	0	75
3331	71	0	0	0	0	71
3332	0	0	0	70	0	70
3333	0	0	0	68	0	68
3334	0	0	67	0	0	67
3335	67	0	0	0	0	67
3336	67	0	0	0	0	67
3337	0	0	66	0	0	66
3338	0	0	0	67	0	67
3339	0	0	66	0	0	66
3340	69	0	0	0	0	69
3341	69	0	0	1	0	70
3342	0	0	0	67	0	67
3343	64	0	0	0	0	64
3344	0	1	63	0	0	64
3345	0	0	0	66	0	66
3346	0	0	0	62	0	62
3347	0	0	0	65	0	65
3348	0	0	0	63	0	63
3349	64	0	0	0	0	64
3350	0	0	64	0	0	64
3351	0	0	0	66	0	66
3352	0	0	58	0	0	58
3353	0	0	57	0	0	57
3354	0	0	0	63	0	63
3355	0	0	0	60	0	60
3356	58	0	0	0	0	58
3357	0	0	0	59	0	59
3358	0	0	0	60	0	60
3359	0	0	0	54	0	54
3360	60	0	0	0	0	60
3361	59	0	0	0	0	59
3362	58	0	0	0	0	58
3363	56	0	0	1	0	57
3364	0	58	0	0	0	58
3365	0	0	0	61	0	61
3366	0	0	0	59	0	59
3367	58	0	0	1	0	59
3368	0	57	0	1	0	58
3369	0	0	0	59	0	59
3370	0	0	58	0	0	58
3371	58	0	0	1	0	59
3372	0	56	0	0	0	56
3373	60	0	0	0	0	60
3374	57	0	0	0	0	57
3375	0	0	0	56	0	56
3376	0	0	60	0	0	60
3377	0	0	0	60	0	60
3378	59	0	0	0	0	59
3379	1	0	0	56	0	57
3380	58	0	0	0	0	58
3381	0	59	0	0	0	59
3382	59	0	0	0	0	59
3383	1	0	0	59	0	60
3384	0	0	0	65	0	65
3385	65	0	0	0	0	65
3386	69	0	0	0	0	69
3387	68	0	0	0	0	68
3388	68	0	0	0	0	68
3389	70	0	0	0	0	70
3390	0	0	0	68	0	68
3391	0	0	67	0	0	67
3392	0	65	0	0	0	65
3393	68	0	0	0	0	68
3394	1	0	62	0	0	63
3395	67	0	0	0	0	67
3396	0	65	0	0	0	65
3397	70	0	0	0	0	70
3398	0	0	0	66	0	66
3399	0	0	0	65	0	65
3400	0	0	60	0	0	60
3401	0	0	0	63	0	63
3402	0	0	60	0	0	60
3403	0	0	52	0	0	52
3404	63	0	0	0	0	63
3405	60	0	0	1	0	61
3406	0	0	58	0	0	58
3407	59	0	0	0	0	59
3408	58	0	0	0	0	58
3409	0	0	57	0	0	57
3410	0	51	0	0	0	51
3411	0	0	0	54	0	54
3412	56	0	0	0	0	56
3413	59	0	0	0	0	59
3414	59	0	0	0	0	59
3415	58	0	0	0	0	58
3416	58	0	0	0	0	58
3417	0	0	49	0	0	49
3418	0	0	51	0	0	51
3419	0	0	0	59	0	59
3420	62	1	0	0	0	63
3421	65	0	0	0	0	65
3422	64	0	0	0	0	64
3423	67	0	0	0	0	67
3424	0	63	0	0	0	63
3425	1	61	0	0	0	62
3426	64	0	0	0	0	64
3427	63	0	0	0	0	63
3428	0	65	0	0	0	65
3429	66	0	0	0	0	66
3430	1	0	58	0	0	59
3431	0	0	0	64	0	64
3432	0	0	65	0	0	65
3433	2	0	52	0	0	54
3434	0	0	0	62	0	62
3435	0	0	0	64	0	64
3436	0	0	69	0	0	69
3437	0	0	0	65	0	65
3438	0	0	0	68	0	68
3439	73	0	0	0	0	73
3440	69	0	0	0	0	69
3441	0	0	0	67	0	67
3442	0	0	67	0	0	67
3443	0	67	0	0	0	67
3444	72	0	0	0	0	72
3445	0	0	68	0	0	68
3446	0	67	0	0	0	67
3447	0	71	0	0	0	71
3448	73	0	0	0	0	73
3449	73	0	0	0	0	73
3450	0	0	1	75	0	76
3451	0	0	77	0	0	77
3452	1	0	0	77	0	78
3453	0	0	0	78	0	78
3454	0	0	0	81	0	81
3455	78	0	0	0	0	78
3456	0	77	0	0	0	77
3457	0	79	0	0	0	79
3458	0	0	0	78	0	78
3459	0	0	0	80	0	80
3460	80	0	0	0	0	80
3461	81	0	0	0	0	81
3462	78	0	0	0	0	78
3463	0	75	0	0	0	75
3464	78	0	0	0	0	78
3465	0	0	0	78	0	78
3466	0	0	75	0	0	75
3467	0	0	72	0	0	72
3468	78	0	0	0	0	78
3469	0	0	73	0	0	73
3470	0	0	70	0	0	70
3471	73	0	0	0	0	73
3472	0	0	76	0	0	76
3473	0	0	69	0	0	69
3474	0	0	0	71	0	71
3475	0	0	79	0	0	79
3476	0	0	0	74	0	74
3477	0	0	0	78	0	78
3478	0	0	77	0	0	77
3479	0	73	0	0	0	73
3480	76	0	0	0	0	76
3481	0	0	73	0	0	73
3482	0	0	72	0	0	72
3483	72	0	0	0	0	72
3484	0	0	76	0	0	76
3485	0	80	0	0	0	80
3486	0	80	0	0	0	80
3487	0	0	0	89	0	89
3488	0	0	0	90	0	90
3489	86	0	0	0	0	86
3490	83	0	0	1	0	84
3491	88	0	0	0	0	88
3492	0	0	0	86	0	86
3493	85	0	0	0	0	85
3494	84	0	1	0	0	85
3495	0	0	85	0	0	85
3496	0	0	80	0	0	80
3497	0	85	0	0	0	85
3498	0	0	0	88	0	88
3499	90	0	0	0	0	90
3500	0	87	0	0	0	87
3501	0	0	0	89	0	89
3502	91	0	0	0	0	91
3503	89	0	0	0	0	89
3504	0	88	0	0	0	88
3505	84	0	0	0	0	84
3506	87	0	0	0	0	87
3507	0	0	0	85	0	85
3508	0	0	83	0	0	83
3509	0	76	0	0	0	76
3510	0	87	0	0	0	87
3511	86	0	0	0	0	86
3512	0	0	0	85	0	85
3513	0	0	82	0	0	82
3514	0	80	0	0	0	80
3515	81	0	0	0	0	81
3516	77	0	0	0	0	77
3517	0	0	75	0	0	75
3518	0	0	0	82	0	82
3519	0	0	0	83	0	83
3520	0	0	89	0	0	89
3521	87	0	0	0	0	87
3522	85	0	0	0	0	85
3523	0	0	0	91	0	91
3524	0	89	0	0	0	89
3525	0	0	0	92	0	92
3526	0	0	98	0	0	98
3527	106	0	0	0	0	106
3528	0	0	0	103	0	103
3529	0	0	105	0	0	105
3530	112	0	0	0	0	112
3531	0	0	0	111	0	111
3532	0	0	0	111	0	111
3533	111	0	0	1	0	112
3534	0	109	0	0	0	109
3535	108	0	0	0	0	108
3536	0	0	0	110	0	110
3537	109	0	0	0	0	109
3538	0	0	103	0	0	103
3539	0	100	0	2	0	102
3540	0	0	0	106	0	106
3541	106	0	0	0	0	106
3542	0	105	0	0	0	105
3543	0	0	0	105	0	105
3544	104	0	0	0	0	104
3545	100	0	0	0	0	100
3546	0	3	0	94	0	97
3547	0	0	96	0	0	96
3548	0	0	93	1	0	94
3549	96	0	0	0	0	96
3550	1	91	1	0	0	93
3551	0	97	0	0	0	97
3552	95	0	0	0	0	95
3553	1	95	0	0	0	96
3554	0	0	0	101	0	101
3555	0	0	0	105	0	105
3556	105	0	0	1	0	106
3557	103	0	0	0	0	103
3558	107	0	0	0	0	107
3559	0	0	106	0	0	106
3560	0	0	0	100	0	100
3561	0	0	103	0	0	103
3562	0	0	100	0	0	100
3563	0	0	102	0	0	102
3564	0	0	0	105	0	105
3565	0	0	103	0	0	103
3566	0	0	100	0	0	100
3567	0	0	0	105	0	105
3568	107	0	0	0	0	107
3569	0	0	109	0	0	109
3570	0	0	0	108	0	108
3571	0	0	0	109	0	109
3572	0	1	105	0	0	106
3573	0	0	0	103	0	103
3574	0	0	105	0	0	105
3575	0	0	0	100	0	100
3576	0	0	0	101	0	101
3577	0	0	0	100	0	100
3578	0	0	0	95	0	95
3579	96	0	0	0	0	96
3580	94	0	0	0	0	94
3581	0	0	89	0	0	89
3582	0	83	0	0	0	83
3583	0	0	80	0	0	80
3584	0	0	84	0	0	84
3585	90	0	0	0	0	90
3586	0	90	0	0	0	90
3587	87	0	0	0	0	87
3588	0	93	0	0	0	93
3589	93	0	0	0	0	93
3590	90	0	0	0	0	90
3591	0	0	0	91	0	91
3592	0	84	0	0	0	84
3593	0	0	0	90	0	90
3594	0	0	0	90	0	90
3595	0	1	84	0	0	85
3596	0	84	0	0	0	84
3597	0	0	0	88	0	88
3598	84	0	0	0	0	84
3599	83	0	0	0	0	83
3600	84	0	0	0	0	84
3601	0	79	0	0	0	79
3602	85	0	0	0	0	85
3603	0	86	0	0	0	86
3604	0	0	0	85	0	85
3605	0	0	79	0	0	79
3606	0	0	0	83	0	83
3607	0	79	0	0	0	79
3608	0	0	0	77	0	77
3609	0	0	0	82	0	82
3610	0	79	0	0	0	79
3611	83	0	0	0	0	83
3612	0	0	0	80	0	80
3613	0	0	72	0	0	72
3614	0	0	0	69	0	69
3615	0	0	0	69	0	69
3616	0	0	69	0	0	69
3617	0	0	0	67	0	67
3618	0	63	0	0	0	63
3619	0	0	54	1	0	55
3620	0	0	49	0	0	49
3621	0	43	0	0	0	43
3622	1	39	0	0	0	40
3623	0	44	0	0	0	44
3624	49	0	0	0	0	49
3625	45	0	0	0	0	45
3626	45	0	0	0	0	45
3627	0	0	0	45	0	45
3628	0	0	43	0	0	43
3629	0	0	0	45	0	45
3630	0	0	0	41	0	41
3631	46	0	0	0	0	46
3632	47	0	0	0	0	47
3633	0	44	0	0	0	44
3634	46	0	0	0	0	46
3635	47	0	0	0	0	47
3636	48	0	0	0	0	48
3637	0	0	43	0	0	43
3638	0	0	44	0	0	44
3639	0	0	0	47	0	47
3640	0	0	48	0	0	48
3641	52	0	0	0	0	52
3642	54	0	0	0	0	54
3643	0	0	48	0	0	48
3644	50	0	0	0	0	50
3645	1	49	0	0	0	50
3646	47	0	0	0	0	47
3647	0	0	0	47	0	47
3648	0	0	0	43	0	43
3649	0	41	0	0	0	41
3650	42	0	0	0	0	42
3651	41	0	0	0	0	41
3652	0	42	0	0	0	42
3653	0	0	0	40	0	40
3654	0	0	0	41	0	41
3655	0	42	0	0	0	42
3656	0	0	0	38	0	38
3657	0	0	0	37	0	37
3658	41	0	0	0	0	41
3659	40	0	0	0	0	40
3660	0	0	40	0	0	40
3661	40	0	0	0	0	40
3662	0	0	41	0	0	41
3663	0	0	0	40	0	40
3664	0	0	41	0	0	41
3665	0	42	0	0	0	42
3666	0	0	0	45	0	45
3667	0	0	0	45	0	45
3668	43	0	0	0	0	43
3669	1	0	0	42	0	43
3670	0	0	48	0	0	48
3671	46	0	0	1	0	47
3672	48	0	0	0	0	48
3673	45	0	0	0	0	45
3674	47	0	0	0	0	47
3675	0	0	0	45	0	45
3676	0	0	0	48	0	48
3677	0	0	0	48	0	48
3678	0	0	0	46	0	46
3679	48	0	0	0	0	48
3680	45	0	0	0	0	45
3681	0	0	0	46	0	46
3682	0	46	0	0	0	46
3683	45	0	0	0	0	45
3684	0	0	47	0	0	47
3685	0	48	0	0	0	48
3686	46	0	0	1	0	47
3687	0	46	0	0	0	46
3688	0	0	51	1	0	52
3689	54	0	0	0	0	54
3690	56	0	0	0	0	56
3691	0	0	57	0	0	57
3692	0	0	0	57	0	57
3693	0	0	0	60	0	60
3694	0	57	0	1	0	58
3695	0	0	0	58	0	58
3696	58	0	0	0	0	58
3697	0	60	0	0	0	60
3698	0	0	0	63	0	63
3699	0	0	0	65	0	65
3700	0	0	67	0	0	67
3701	0	67	0	0	0	67
3702	65	0	0	0	0	65
3703	0	67	0	0	0	67
3704	0	68	0	0	0	68
3705	71	0	0	0	0	71
3706	0	0	0	73	0	73
3707	0	0	0	74	0	74
3708	70	0	0	0	0	70
3709	0	0	0	72	0	72
3710	0	0	0	72	0	72
3711	70	0	0	0	0	70
3712	0	0	0	69	0	69
3713	0	70	0	0	0	70
3714	69	0	0	0	0	69
3715	0	0	67	0	0	67
3716	0	62	0	0	0	62
3717	0	0	0	64	0	64
3718	0	0	64	0	0	64
3719	0	0	65	0	0	65
3720	0	0	0	65	0	65
3721	63	0	0	0	0	63
3722	0	0	0	66	0	66
3723	0	0	0	71	0	71
3724	0	0	0	70	0	70
3725	0	0	0	69	0	69
3726	0	0	0	73	0	73
3727	0	0	68	0	0	68
3728	0	0	67	0	0	67
3729	0	0	0	71	0	71
3730	0	0	68	0	0	68
3731	0	70	0	0	0	70
3732	0	0	0	68	0	68
3733	0	0	65	0	0	65
3734	61	0	0	0	0	61
3735	0	57	0	0	0	57
3736	0	56	0	0	0	56
3737	0	60	0	0	0	60
3738	0	0	0	66	0	66
3739	66	0	0	0	0	66
3740	0	0	0	67	0	67
3741	65	0	0	0	0	65
3742	0	68	0	0	0	68
3743	68	0	0	0	0	68
3744	0	0	0	69	0	69
3745	0	0	0	71	0	71
3746	0	68	0	0	0	68
3747	0	0	0	72	0	72
3748	0	0	0	71	0	71
3749	0	0	0	72	0	72
3750	73	0	0	0	0	73
3751	70	0	0	0	0	70
3752	0	0	66	0	0	66
3753	71	0	0	0	0	71
3754	0	0	67	0	0	67
3755	0	0	0	66	0	66
3756	0	0	0	69	0	69
3757	0	0	0	71	0	71
3758	0	0	72	0	0	72
3759	0	0	0	72	0	72
3760	0	0	74	0	0	74
3761	1	0	0	67	0	68
3762	70	0	0	0	0	70
3763	0	0	67	0	0	67
3764	71	0	0	1	0	72
3765	0	0	0	69	0	69
3766	67	0	0	0	0	67
3767	0	65	0	0	0	65
3768	0	0	0	68	0	68
3769	0	0	65	0	0	65
3770	0	0	0	67	0	67
3771	0	0	0	71	0	71
3772	0	67	0	0	0	67
3773	0	0	62	0	0	62
3774	0	66	0	0	0	66
3775	72	0	0	0	0	72
3776	0	71	0	0	0	71
3777	70	0	0	0	0	70
3778	72	0	0	0	0	72
3779	66	0	0	0	0	66
3780	0	0	0	65	0	65
3781	0	0	64	0	0	64
3782	0	0	0	60	0	60
3783	0	61	0	0	0	61
3784	0	0	0	61	0	61
3785	57	0	0	1	0	58
3786	0	51	0	0	0	51
3787	0	0	0	57	0	57
3788	0	0	0	56	0	56
3789	57	0	0	0	0	57
3790	0	0	46	0	0	46
3791	0	47	0	0	0	47
3792	0	0	0	49	0	49
3793	0	0	43	0	0	43
3794	0	0	0	45	0	45
3795	0	45	0	0	0	45
3796	0	0	0	47	0	47
3797	0	0	0	42	0	42
3798	0	0	0	48	0	48
3799	0	0	48	0	0	48
3800	46	0	0	0	0	46
3801	0	0	0	50	0	50
3802	52	0	0	0	0	52
3803	51	0	0	0	0	51
3804	49	0	0	0	0	49
3805	52	0	0	0	0	52
3806	52	0	0	0	0	52
3807	0	0	0	54	0	54
3808	0	55	0	0	0	55
3809	0	0	0	56	0	56
3810	0	55	0	0	0	55
3811	0	0	0	56	0	56
3812	55	0	0	0	0	55
3813	0	0	0	56	0	56
3814	0	0	56	0	0	56
3815	57	0	0	0	0	57
3816	0	54	0	0	0	54
3817	55	0	0	0	0	55
3818	52	0	0	0	0	52
3819	50	0	0	0	0	50
3820	0	50	0	0	0	50
3821	0	0	0	56	0	56
3822	0	0	0	54	0	54
3823	0	0	54	0	0	54
3824	0	0	0	54	0	54
3825	0	0	0	55	0	55
3826	0	0	0	57	0	57
3827	0	53	0	0	0	53
3828	56	0	0	0	0	56
3829	57	0	0	0	0	57
3830	0	0	57	0	0	57
3831	0	53	1	1	0	55
3832	0	0	0	52	0	52
3833	0	0	0	57	0	57
3834	0	0	0	57	0	57
3835	0	0	0	51	0	51
3836	0	0	0	52	0	52
3837	0	0	49	0	0	49
3838	0	0	53	0	0	53
3839	54	0	0	0	0	54
3840	50	0	0	0	0	50
3841	53	0	0	0	0	53
3842	0	0	1	54	0	55
3843	0	0	55	0	0	55
3844	55	0	0	0	0	55
3845	59	0	0	0	0	59
3846	0	0	58	0	0	58
3847	56	0	0	0	0	56
3848	0	0	56	0	0	56
3849	0	0	0	60	0	60
3850	0	0	58	0	0	58
3851	58	0	0	0	0	58
3852	55	0	0	0	0	55
3853	57	0	0	0	0	57
3854	59	0	0	0	0	59
3855	0	0	57	0	0	57
3856	0	57	0	0	0	57
3857	58	0	0	0	0	58
3858	60	0	0	0	0	60
3859	0	0	57	0	0	57
3860	0	0	0	59	0	59
3861	0	0	0	59	0	59
3862	0	0	59	0	0	59
3863	62	0	0	0	0	62
3864	65	0	0	0	0	65
3865	0	61	0	0	0	61
3866	57	0	0	0	0	57
3867	56	0	0	0	0	56
3868	55	0	0	0	0	55
3869	55	0	0	0	0	55
3870	0	0	48	0	0	48
3871	53	0	0	0	0	53
3872	0	0	0	49	0	49
3873	0	52	0	0	0	52
3874	0	0	50	0	0	50
3875	0	48	1	0	0	49
3876	0	0	0	51	0	51
3877	0	0	53	0	0	53
3878	50	0	0	0	0	50
3879	0	0	52	0	0	52
3880	50	0	0	0	0	50
3881	0	0	0	50	0	50
3882	0	0	0	51	0	51
3883	0	48	0	0	0	48
3884	0	50	0	0	0	50
3885	0	0	0	52	0	52
3886	50	0	0	0	0	50
3887	53	0	0	0	0	53
3888	50	0	0	0	0	50
3889	0	0	50	0	0	50
3890	52	0	0	0	0	52
3891	0	0	52	0	0	52
3892	0	0	53	0	0	53
3893	54	0	0	0	0	54
3894	54	0	0	0	0	54
3895	0	0	58	0	0	58
3896	0	0	0	55	0	55
3897	0	0	0	56	0	56
3898	52	0	0	0	0	52
3899	53	1	0	0	0	54
3900	0	0	52	0	0	52
3901	0	48	1	0	0	49
3902	0	52	0	0	0	52
3903	55	0	0	0	0	55
3904	0	0	1	51	0	52
3905	0	0	0	55	0	55
3906	0	0	0	56	0	56
3907	55	0	0	0	0	55
3908	0	0	1	53	0	54
3909	50	0	0	0	0	50
3910	54	0	0	0	0	54
3911	0	50	0	0	0	50
3912	1	0	0	51	0	52
3913	0	0	48	0	0	48
3914	49	0	0	0	0	49
3915	51	0	0	0	0	51
3916	47	0	0	0	0	47
3917	0	0	49	0	0	49
3918	0	0	0	48	0	48
3919	50	0	0	0	0	50
3920	49	0	0	0	0	49
3921	47	0	0	0	0	47
3922	0	48	0	0	0	48
3923	0	47	0	0	0	47
3924	0	0	0	50	0	50
3925	0	0	0	46	0	46
3926	0	48	0	0	0	48
3927	49	0	0	0	0	49
3928	0	0	50	0	0	50
3929	0	0	0	52	0	52
3930	0	0	0	52	0	52
3931	0	0	47	0	0	47
3932	51	0	0	0	0	51
3933	50	0	0	0	0	50
3934	0	48	0	0	0	48
3935	53	0	0	0	0	53
3936	0	0	50	0	0	50
3937	52	0	0	0	0	52
3938	0	0	51	1	0	52
3939	53	0	0	0	0	53
3940	54	0	0	0	0	54
3941	54	0	0	0	0	54
3942	50	0	0	0	0	50
3943	0	52	0	0	0	52
3944	51	0	0	0	0	51
3945	51	0	0	0	0	51
3946	0	0	51	0	0	51
3947	50	0	0	0	0	50
3948	0	0	0	52	0	52
3949	0	0	49	0	0	49
3950	51	0	0	0	0	51
3951	0	0	0	49	0	49
3952	51	0	0	0	0	51
3953	51	0	0	0	0	51
3954	0	0	55	0	0	55
3955	54	0	0	0	0	54
3956	54	0	0	0	0	54
3957	54	0	0	0	0	54
3958	54	0	0	0	0	54
3959	0	0	0	54	0	54
3960	0	53	0	0	0	53
3961	51	0	0	0	0	51
3962	51	0	0	0	0	51
3963	56	0	0	0	0	56
3964	0	0	55	0	0	55
3965	0	52	0	0	0	52
3966	0	0	0	59	0	59
3967	1	0	0	58	0	59
3968	0	0	57	0	0	57
3969	0	0	0	58	0	58
3970	0	0	61	0	0	61
3971	0	0	0	61	0	61
3972	0	0	0	67	0	67
3973	0	0	65	0	0	65
3974	65	0	0	1	0	66
3975	70	0	0	0	0	70
3976	0	0	65	0	0	65
3977	68	0	0	1	0	69
3978	73	0	0	0	0	73
3979	0	0	72	0	0	72
3980	0	0	0	70	0	70
3981	2	0	0	74	0	76
3982	76	0	0	0	0	76
3983	0	78	0	0	0	78
3984	66	0	0	2	0	68
3985	66	0	0	0	0	66
3986	0	70	0	0	0	70
3987	72	0	0	0	0	72
3988	70	0	0	0	0	70
3989	0	67	0	0	0	67
3990	0	0	0	71	0	71
3991	0	71	0	0	0	71
3992	0	0	0	71	0	71
3993	0	0	68	0	0	68
3994	0	1	63	0	0	64
3995	73	0	0	0	0	73
3996	76	0	0	0	0	76
3997	0	0	77	0	0	77
3998	78	0	0	0	0	78
3999	78	0	0	0	0	78
4000	76	0	0	0	0	76
4001	0	76	0	0	0	76
4002	0	0	0	79	0	79
4003	79	0	0	0	0	79
4004	79	0	0	0	0	79
4005	0	0	80	0	0	80
4006	0	0	0	79	0	79
4007	0	0	0	81	0	81
4008	0	79	0	0	0	79
4009	0	81	0	0	0	81
4010	0	0	0	83	0	83
4011	1	77	0	0	0	78
4012	82	0	0	0	0	82
4013	0	82	0	0	0	82
4014	87	0	0	0	0	87
4015	0	0	90	0	0	90
4016	90	0	0	0	0	90
4017	88	0	0	0	0	88
4018	89	0	0	0	0	89
4019	88	0	0	0	0	88
4020	0	82	0	0	0	82
4021	0	0	0	86	0	86
4022	0	0	0	86	0	86
4023	0	0	87	0	0	87
4024	0	0	0	91	0	91
4025	0	0	0	92	0	92
4026	85	0	0	0	0	85
4027	0	89	0	0	0	89
4028	0	0	0	83	0	83
4029	0	0	0	90	0	90
4030	0	0	0	89	0	89
4031	87	0	0	0	0	87
4032	0	0	0	83	0	83
4033	85	0	0	0	0	85
4034	0	0	0	82	0	82
4035	0	0	0	82	0	82
4036	0	0	78	0	0	78
4037	81	0	0	0	0	81
4038	0	80	0	0	0	80
4039	82	0	0	0	0	82
4040	0	0	0	85	0	85
4041	0	0	0	79	0	79
4042	84	0	0	0	0	84
4043	77	0	0	0	0	77
4044	0	0	0	85	0	85
4045	0	0	83	0	0	83
4046	0	1	76	0	0	77
4047	0	83	0	0	0	83
4048	83	0	0	0	0	83
4049	80	0	0	0	0	80
4050	0	0	0	82	0	82
4051	0	78	0	0	0	78
4052	0	0	0	74	0	74
4053	0	1	0	79	0	80
4054	0	75	0	0	0	75
4055	76	0	0	0	0	76
4056	0	0	0	70	0	70
4057	0	71	0	0	0	71
4058	0	75	0	0	0	75
4059	72	0	0	0	0	72
4060	0	0	71	0	0	71
4061	74	0	0	0	0	74
4062	0	0	0	70	0	70
4063	0	0	0	67	0	67
4064	0	69	0	0	0	69
4065	0	0	0	68	0	68
4066	0	0	66	0	0	66
4067	1	58	0	0	0	59
4068	0	64	0	0	0	64
4069	64	0	0	1	0	65
4070	0	62	0	0	0	62
4071	0	0	0	64	0	64
4072	0	64	0	0	0	64
4073	0	0	0	65	0	65
4074	0	0	0	64	0	64
4075	0	0	66	0	0	66
4076	0	0	0	61	0	61
4077	0	0	0	68	0	68
4078	64	0	0	0	0	64
4079	0	0	65	0	0	65
4080	0	0	0	64	0	64
4081	2	0	61	0	0	63
4082	67	0	0	0	0	67
4083	0	68	0	0	0	68
4084	68	0	0	2	0	70
4085	0	0	0	70	0	70
4086	0	0	0	68	0	68
4087	0	0	67	0	0	67
4088	68	0	0	1	0	69
4089	0	68	0	0	0	68
4090	67	0	0	0	0	67
4091	0	0	0	71	0	71
4092	0	68	0	0	0	68
4093	67	0	0	0	0	67
4094	0	69	0	0	0	69
4095	0	0	0	71	0	71
4096	0	0	0	69	0	69
4097	0	0	0	69	0	69
4098	0	69	0	0	0	69
4099	0	0	0	70	0	70
4100	0	0	0	67	0	67
4101	67	0	0	0	0	67
4102	73	0	0	0	0	73
4103	70	0	0	0	0	70
4104	0	0	70	0	0	70
4105	73	0	0	0	0	73
4106	73	0	0	0	0	73
4107	70	0	0	0	0	70
4108	0	0	68	0	0	68
4109	69	0	0	0	0	69
4110	0	0	0	71	0	71
4111	0	0	71	0	0	71
4112	0	68	0	0	0	68
4113	0	0	0	74	0	74
4114	0	67	0	0	0	67
4115	0	71	0	0	0	71
4116	73	0	0	0	0	73
4117	0	0	0	73	0	73
4118	70	0	0	1	0	71
4119	0	0	0	68	0	68
4120	68	0	0	0	0	68
4121	0	0	0	70	0	70
4122	69	0	0	0	0	69
4123	0	0	69	0	0	69
4124	0	0	0	69	0	69
4125	0	0	65	0	0	65
4126	0	0	62	0	0	62
4127	0	0	69	0	0	69
4128	1	0	0	75	0	76
4129	0	0	73	0	0	73
4130	75	0	0	0	0	75
4131	0	0	0	73	0	73
4132	0	0	77	0	0	77
4133	0	0	0	73	0	73
4134	0	0	0	72	0	72
4135	0	0	72	0	0	72
4136	0	0	0	70	0	70
4137	0	0	0	70	0	70
4138	0	66	0	0	0	66
4139	67	0	0	0	0	67
4140	66	0	0	0	0	66
4141	0	0	70	0	0	70
4142	72	0	0	0	0	72
4143	0	0	71	0	0	71
4144	0	0	70	0	0	70
4145	0	0	70	0	0	70
4146	0	0	0	66	0	66
4147	0	0	71	0	0	71
4148	0	0	0	70	0	70
4149	1	0	0	71	0	72
4150	0	0	2	67	0	69
4151	0	0	0	72	0	72
4152	72	0	0	0	0	72
4153	69	0	0	0	0	69
4154	0	71	0	0	0	71
4155	0	0	0	74	0	74
4156	0	0	71	0	0	71
4157	0	73	0	0	0	73
4158	0	0	0	76	0	76
4159	0	0	75	0	0	75
4160	0	0	0	75	0	75
4161	0	0	69	0	0	69
4162	0	0	73	0	0	73
4163	0	0	0	72	0	72
4164	1	0	1	72	0	74
4165	71	0	0	0	0	71
4166	0	0	0	74	0	74
4167	74	0	0	0	0	74
4168	0	69	0	0	0	69
4169	0	69	0	0	0	69
4170	0	0	0	69	0	69
4171	70	0	0	0	0	70
4172	0	70	0	0	0	70
4173	0	0	0	69	0	69
4174	70	0	0	0	0	70
4175	70	0	0	0	0	70
4176	67	0	0	0	0	67
4177	72	0	0	0	0	72
4178	74	0	0	0	0	74
4179	0	0	71	0	0	71
4180	1	0	69	0	0	70
4181	0	71	0	0	0	71
4182	0	0	0	75	0	75
4183	0	0	73	0	0	73
4184	0	0	76	0	0	76
4185	0	0	0	75	0	75
4186	0	0	75	0	0	75
4187	0	0	66	0	0	66
4188	1	68	0	0	0	69
4189	76	0	0	0	0	76
4190	0	76	0	0	0	76
4191	0	0	0	75	0	75
4192	72	0	0	0	0	72
4193	0	79	0	0	0	79
4194	0	0	0	81	0	81
4195	0	0	85	0	0	85
4196	82	0	0	0	0	82
4197	85	0	0	0	0	85
4198	84	0	0	0	0	84
4199	0	0	0	82	0	82
4200	0	0	81	0	0	81
4201	0	86	0	0	0	86
4202	0	0	0	89	0	89
4203	92	0	0	2	0	94
4204	0	0	90	0	0	90
4205	0	86	0	0	0	86
4206	0	0	87	0	0	87
4207	96	0	0	0	0	96
4208	94	0	0	0	0	94
4209	99	0	0	0	0	99
4210	0	0	98	0	0	98
4211	0	99	0	0	0	99
4212	0	0	0	102	0	102
4213	0	0	0	101	0	101
4214	0	0	0	103	0	103
4215	0	0	103	0	0	103
4216	100	0	0	0	0	100
4217	0	0	106	0	0	106
4218	108	0	0	0	0	108
4219	106	0	0	0	0	106
4220	105	0	0	0	0	105
4221	105	0	0	0	0	105
4222	1	0	103	0	0	104
4223	0	0	0	110	0	110
4224	0	0	102	0	0	102
4225	0	99	0	0	0	99
4226	0	109	0	0	0	109
4227	110	0	0	0	0	110
4228	111	0	0	0	0	111
4229	0	107	0	0	0	107
4230	110	0	0	0	0	110
4231	0	0	105	0	0	105
4232	112	0	0	0	0	112
4233	0	115	0	0	0	115
4234	114	0	0	0	0	114
4235	111	0	0	0	0	111
4236	1	0	0	109	0	110
4237	0	0	0	110	0	110
4238	110	0	0	0	0	110
4239	0	0	0	110	0	110
4240	111	0	0	0	0	111
4241	0	0	0	114	0	114
4242	115	0	0	0	0	115
4243	114	0	0	0	0	114
4244	0	111	0	0	0	111
4245	0	115	0	0	0	115
4246	120	0	0	0	0	120
4247	0	116	0	0	0	116
4248	0	0	0	128	0	128
4249	0	0	0	122	0	122
4250	121	1	0	0	0	122
4251	0	118	0	0	0	118
4252	0	109	0	0	0	109
4253	0	111	0	0	0	111
4254	0	0	111	0	0	111
4255	0	0	107	0	0	107
4256	0	0	117	0	0	117
4257	0	0	0	115	0	115
4258	0	117	0	0	0	117
4259	116	0	0	0	0	116
4260	0	0	115	0	0	115
4261	0	1	110	0	0	111
4262	0	0	115	0	0	115
4263	0	0	0	116	0	116
4264	0	0	0	115	0	115
4265	0	0	0	115	0	115
4266	116	0	0	0	0	116
4267	111	0	0	0	0	111
4268	114	0	0	0	0	114
4269	0	0	0	116	0	116
4270	1	0	103	0	0	104
4271	0	0	110	0	0	110
4272	0	0	0	113	0	113
4273	0	0	0	111	0	111
4274	108	0	0	0	0	108
4275	0	102	0	4	0	106
4276	97	0	1	0	0	98
4277	0	94	0	0	0	94
4278	0	0	0	91	0	91
4279	0	0	92	0	0	92
4280	0	0	0	93	0	93
4281	94	0	0	0	0	94
4282	0	0	90	0	0	90
4283	95	0	0	0	0	95
4284	0	0	95	0	0	95
4285	1	0	87	0	0	88
4286	83	0	0	0	0	83
4287	0	0	78	0	0	78
4288	0	0	75	0	0	75
4289	0	77	0	0	0	77
4290	77	0	0	0	0	77
4291	79	0	0	0	0	79
4292	76	0	0	1	0	77
4293	0	0	75	0	0	75
4294	75	0	0	0	0	75
4295	0	71	0	0	0	71
4296	73	0	0	0	0	73
4297	0	0	75	0	0	75
4298	0	0	0	75	0	75
4299	0	0	73	0	0	73
4300	0	71	0	0	0	71
4301	0	0	0	73	0	73
4302	0	0	0	73	0	73
4303	71	0	0	0	0	71
4304	70	0	0	0	0	70
4305	71	0	0	0	0	71
4306	70	0	0	0	0	70
4307	72	0	0	0	0	72
4308	0	0	68	0	0	68
4309	2	0	0	67	0	69
4310	0	0	67	0	0	67
4311	0	0	0	65	0	65
4312	71	0	0	0	0	71
4313	65	0	0	0	0	65
4314	67	0	0	0	0	67
4315	65	0	0	0	0	65
4316	0	0	64	0	0	64
4317	0	0	0	64	0	64
4318	0	0	58	0	0	58
4319	0	56	0	0	0	56
4320	0	62	0	0	0	62
4321	0	0	0	63	0	63
4322	0	0	0	65	0	65
4323	0	0	0	64	0	64
4324	0	0	0	65	0	65
4325	67	0	0	1	0	68
4326	0	65	0	0	0	65
4327	62	0	0	0	0	62
4328	0	0	0	58	0	58
4329	0	0	0	61	0	61
4330	0	60	0	0	0	60
4331	0	0	0	60	0	60
4332	59	0	0	0	0	59
4333	0	56	0	0	0	56
4334	0	52	0	0	0	52
4335	56	0	0	0	0	56
4336	0	0	0	57	0	57
4337	0	54	0	0	0	54
4338	0	0	0	53	0	53
4339	51	0	0	0	0	51
4340	0	0	0	50	0	50
4341	0	0	0	44	0	44
4342	49	0	0	0	0	49
4343	0	0	0	44	0	44
4344	0	44	0	0	0	44
4345	0	0	0	47	0	47
4346	0	45	0	0	0	45
4347	0	0	0	47	0	47
4348	47	0	0	0	0	47
4349	44	0	0	0	0	44
4350	0	0	0	43	0	43
4351	0	0	44	0	0	44
4352	44	0	0	0	0	44
4353	0	0	41	0	0	41
4354	43	0	0	0	0	43
4355	43	0	0	0	0	43
4356	0	0	40	0	0	40
4357	0	43	0	0	0	43
4358	47	0	0	0	0	47
4359	49	0	0	0	0	49
4360	0	0	50	0	0	50
4361	52	0	0	0	0	52
4362	52	0	0	0	0	52
4363	50	0	0	0	0	50
4364	0	0	0	51	0	51
4365	0	0	0	55	0	55
4366	0	54	0	0	0	54
4367	0	0	0	55	0	55
4368	0	0	0	53	0	53
4369	0	0	51	0	0	51
4370	1	0	47	0	0	48
4371	57	0	0	0	0	57
4372	56	0	0	0	0	56
4373	0	53	0	0	0	53
4374	0	0	0	55	0	55
4375	0	0	54	0	0	54
4376	0	0	0	53	0	53
4377	0	0	0	51	0	51
4378	0	0	0	50	0	50
4379	0	51	0	0	0	51
4380	0	0	0	53	0	53
4381	0	0	0	54	0	54
4382	0	0	52	0	0	52
4383	0	0	50	0	0	50
4384	49	0	0	0	0	49
4385	52	0	0	0	0	52
4386	0	0	0	51	0	51
4387	0	0	0	50	0	50
4388	0	0	0	51	0	51
4389	0	0	50	0	0	50
4390	0	48	0	0	0	48
4391	0	0	48	0	0	48
4392	47	0	0	0	0	47
4393	0	0	45	0	0	45
4394	48	0	0	0	0	48
4395	45	0	0	0	0	45
4396	47	0	0	0	0	47
4397	0	0	0	48	0	48
4398	0	0	45	0	0	45
4399	0	47	0	0	0	47
4400	0	0	0	42	0	42
4401	0	0	0	48	0	48
4402	0	0	54	0	0	54
4403	0	50	0	1	0	51
4404	52	0	0	0	0	52
4405	0	47	0	2	0	49
4406	50	0	0	0	0	50
4407	0	0	0	51	0	51
4408	0	0	49	0	0	49
4409	0	51	0	0	0	51
4410	52	0	0	0	0	52
4411	0	1	47	0	0	48
4412	51	0	0	0	0	51
4413	51	0	0	0	0	51
4414	0	0	52	0	0	52
4415	46	0	0	3	0	49
4416	48	0	0	0	0	48
4417	45	0	0	0	0	45
4418	0	45	1	0	0	46
4419	45	0	0	2	0	47
4420	0	45	0	0	0	45
4421	0	0	44	0	0	44
4422	0	49	0	0	0	49
4423	51	0	0	0	0	51
4424	53	0	0	0	0	53
4425	53	0	0	0	0	53
4426	0	0	0	53	0	53
4427	0	0	0	54	0	54
4428	52	0	0	1	0	53
4429	52	0	0	0	0	52
4430	0	0	0	56	0	56
4431	0	0	53	0	0	53
4432	0	51	0	1	0	52
4433	0	55	0	0	0	55
4434	0	0	0	57	0	57
4435	0	0	54	0	0	54
4436	0	0	0	53	0	53
4437	0	53	0	0	0	53
4438	0	0	0	53	0	53
4439	0	0	56	0	0	56
4440	0	0	0	57	0	57
4441	0	0	58	0	0	58
4442	0	0	0	57	0	57
4443	0	0	55	0	0	55
4444	0	0	55	0	0	55
4445	61	0	0	0	0	61
4446	60	0	0	0	0	60
4447	61	0	0	0	0	61
4448	0	61	0	0	0	61
4449	0	0	0	63	0	63
4450	63	0	0	0	0	63
4451	60	0	0	0	0	60
4452	61	0	0	0	0	61
4453	1	0	60	0	0	61
4454	0	57	0	0	0	57
4455	0	64	0	0	0	64
4456	69	0	0	0	0	69
4457	0	0	0	65	0	65
4458	65	0	0	0	0	65
4459	0	0	59	0	0	59
4460	0	0	0	63	0	63
4461	1	0	0	65	0	66
4462	0	0	0	64	0	64
4463	1	63	0	0	0	64
4464	63	0	0	0	0	63
4465	64	0	0	0	0	64
4466	0	65	0	0	0	65
4467	0	0	0	62	0	62
4468	64	0	0	0	0	64
4469	0	0	1	63	0	64
4470	65	0	0	0	0	65
4471	0	65	0	0	0	65
4472	66	0	0	0	0	66
4473	0	0	63	0	0	63
4474	0	61	0	0	0	61
4475	0	0	60	0	0	60
4476	0	0	0	62	0	62
4477	65	0	0	0	0	65
4478	66	0	0	0	0	66
4479	67	0	0	0	0	67
4480	0	0	0	67	0	67
4481	66	0	0	0	0	66
4482	0	0	0	68	0	68
4483	66	0	0	0	0	66
4484	66	0	0	0	0	66
4485	0	0	63	0	0	63
4486	0	0	64	0	0	64
4487	0	0	62	0	0	62
4488	0	0	0	64	0	64
4489	69	0	0	0	0	69
4490	0	0	0	71	0	71
4491	0	0	0	66	0	66
4492	69	0	0	0	0	69
4493	69	0	0	0	0	69
4494	72	0	0	0	0	72
4495	68	0	0	0	0	68
4496	0	0	0	65	0	65
4497	67	0	0	0	0	67
4498	0	65	0	0	0	65
4499	66	0	0	0	0	66
4500	69	0	0	0	0	69
4501	0	0	62	0	0	62
4502	67	0	0	0	0	67
4503	0	0	61	0	0	61
4504	0	0	64	0	0	64
4505	1	0	63	0	0	64
4506	0	0	0	65	0	65
4507	0	0	66	0	0	66
4508	0	0	0	67	0	67
4509	0	0	69	0	0	69
4510	0	1	65	0	0	66
4511	0	0	0	72	0	72
4512	0	0	0	72	0	72
4513	0	0	68	0	0	68
4514	70	0	0	0	0	70
4515	0	0	0	72	0	72
4516	0	0	0	70	0	70
4517	72	0	0	0	0	72
4518	0	0	0	71	0	71
4519	0	0	67	0	0	67
4520	0	1	65	0	0	66
4521	0	0	0	70	0	70
4522	0	0	69	0	0	69
4523	0	69	0	1	0	70
4524	0	0	0	81	0	81
4525	78	0	0	0	0	78
4526	0	0	77	0	0	77
4527	76	0	0	0	0	76
4528	0	0	0	77	0	77
4529	0	0	0	80	0	80
4530	0	0	0	77	0	77
4531	0	0	0	77	0	77
4532	77	0	0	0	0	77
4533	0	79	0	0	0	79
4534	2	0	0	81	0	83
4535	0	0	2	81	0	83
4536	0	0	0	81	0	81
4537	0	0	0	84	0	84
4538	77	0	0	0	0	77
4539	0	80	0	1	0	81
4540	71	0	0	1	0	72
4541	0	69	0	0	0	69
4542	0	76	0	0	0	76
4543	76	0	0	0	0	76
4544	0	0	77	0	0	77
4545	0	0	0	79	0	79
4546	76	0	0	0	0	76
4547	82	0	0	0	0	82
4548	74	0	0	0	0	74
4549	81	0	0	0	0	81
4550	0	79	0	0	0	79
4551	82	0	0	0	0	82
4552	89	0	0	0	0	89
4553	0	84	0	0	0	84
4554	0	0	0	91	0	91
4555	0	0	91	0	0	91
4556	0	0	0	96	0	96
4557	94	0	0	0	0	94
4558	1	0	88	0	0	89
4559	1	92	0	0	0	93
4560	0	0	87	1	0	88
4561	1	0	0	94	0	95
4562	1	90	0	1	0	92
4563	101	0	0	1	0	102
4564	1	97	0	0	0	98
4565	0	0	0	105	0	105
4566	0	0	0	104	0	104
4567	103	0	0	0	0	103
4568	0	0	0	104	0	104
4569	0	102	0	0	0	102
4570	116	0	0	0	0	116
4571	112	0	0	1	0	113
4572	0	111	0	0	0	111
4573	114	0	0	0	0	114
4574	0	114	0	0	0	114
4575	111	0	0	0	0	111
4576	0	111	0	0	0	111
4577	0	0	0	115	0	115
4578	1	0	0	116	0	117
4579	115	0	0	0	0	115
4580	115	0	0	0	0	115
4581	0	109	0	2	0	111
4582	0	0	108	0	0	108
4583	119	0	0	0	0	119
4584	0	0	0	116	0	116
4585	0	112	0	0	0	112
4586	0	0	0	119	0	119
4587	117	0	0	0	0	117
4588	115	0	0	0	0	115
4589	122	0	0	0	0	122
4590	1	0	0	120	0	121
4591	0	0	119	0	0	119
4592	121	0	0	0	0	121
4593	122	0	0	0	0	122
4594	121	0	0	0	0	121
4595	0	122	0	0	0	122
4596	0	0	0	127	0	127
4597	0	130	0	0	0	130
4598	1	0	0	134	0	135
4599	0	0	0	131	0	131
4600	0	0	133	0	0	133
4601	0	0	1	136	0	137
4602	0	0	0	135	0	135
4603	137	0	0	0	0	137
4604	0	136	0	0	0	136
4605	135	0	0	0	0	135
4606	132	0	0	0	0	132
4607	0	0	0	133	0	133
4608	0	1	134	0	0	135
4609	0	127	0	0	0	127
4610	0	135	0	0	0	135
4611	135	0	0	0	0	135
4612	0	140	0	0	0	140
4613	0	0	0	138	0	138
4614	0	0	0	141	0	141
4615	0	0	136	0	0	136
4616	0	0	131	0	0	131
4617	0	133	0	0	0	133
4618	0	0	0	136	0	136
4619	134	0	0	0	0	134
4620	0	0	0	133	0	133
4621	0	0	134	0	0	134
4622	0	0	0	136	0	136
4623	139	0	0	0	0	139
4624	134	0	0	0	0	134
4625	0	136	0	0	0	136
4626	132	0	0	2	0	134
4627	0	135	0	0	0	135
4628	134	0	0	0	0	134
4629	0	0	0	128	0	128
4630	0	0	127	0	0	127
4631	0	0	119	0	0	119
4632	0	128	0	0	0	128
4633	0	0	0	132	0	132
4634	0	0	0	136	0	136
4635	134	0	0	0	0	134
4636	136	0	0	0	0	136
4637	129	0	0	0	0	129
4638	0	0	0	130	0	130
4639	0	0	0	139	0	139
4640	0	0	0	131	0	131
4641	0	0	129	0	0	129
4642	0	0	118	0	0	118
4643	129	0	0	0	0	129
4644	132	0	0	0	0	132
4645	0	0	128	0	0	128
4646	131	0	0	0	0	131
4647	127	0	0	0	0	127
4648	0	0	123	0	0	123
4649	0	119	0	0	0	119
4650	0	0	0	130	0	130
4651	0	0	130	0	0	130
4652	0	127	0	0	0	127
4653	1	0	0	127	0	128
4654	2	126	0	0	0	128
4655	0	0	124	0	0	124
4656	0	0	124	0	0	124
4657	0	0	0	127	0	127
4658	128	0	0	0	0	128
4659	0	0	0	125	0	125
4660	128	0	0	0	0	128
4661	0	0	0	130	0	130
4662	0	0	119	0	0	119
4663	121	0	0	0	0	121
4664	0	0	122	0	0	122
4665	115	0	0	0	0	115
4666	0	0	0	115	0	115
4667	0	115	0	0	0	115
4668	0	0	0	115	0	115
4669	0	119	0	0	0	119
4670	0	0	0	121	0	121
4671	0	118	0	0	0	118
4672	123	0	0	0	0	123
4673	118	0	0	0	0	118
4674	122	0	0	0	0	122
4675	0	0	120	0	0	120
4676	0	0	0	123	0	123
4677	0	0	120	0	0	120
4678	0	113	0	0	0	113
4679	0	120	0	0	0	120
4680	125	0	0	0	0	125
4681	0	0	117	0	0	117
4682	0	122	0	0	0	122
4683	0	0	0	119	0	119
4684	116	0	0	0	0	116
4685	0	116	0	0	0	116
4686	120	0	0	0	0	120
4687	0	0	117	0	0	117
4688	1	0	0	114	0	115
4689	1	0	0	118	0	119
4690	2	0	0	117	0	119
4691	0	116	0	0	0	116
4692	0	0	0	118	0	118
4693	0	0	109	0	0	109
4694	0	0	0	104	0	104
4695	0	0	0	107	0	107
4696	0	0	0	114	0	114
4697	0	107	0	0	0	107
4698	0	0	0	114	0	114
4699	0	0	0	107	0	107
4700	0	103	0	0	0	103
4701	108	0	0	0	0	108
4702	0	104	0	0	0	104
4703	0	108	0	0	0	108
4704	0	0	0	111	0	111
4705	0	0	109	0	0	109
4706	114	0	0	0	0	114
4707	0	0	0	117	0	117
4708	0	0	108	0	0	108
4709	0	113	0	0	0	113
4710	0	0	0	115	0	115
4711	0	0	118	0	0	118
4712	1	0	0	116	0	117
4713	0	0	0	124	0	124
4714	116	0	0	0	0	116
4715	0	122	0	0	0	122
4716	117	0	0	0	0	117
4717	0	0	117	0	0	117
4718	0	109	0	0	0	109
4719	0	0	118	0	0	118
4720	0	0	0	122	0	122
4721	122	0	0	0	0	122
4722	0	0	0	127	0	127
4723	125	0	0	0	0	125
4724	124	0	0	0	0	124
4725	0	0	0	124	0	124
4726	0	0	129	0	0	129
4727	0	0	122	0	0	122
4728	0	0	0	121	0	121
4729	0	0	0	127	0	127
4730	128	0	0	0	0	128
4731	0	0	0	130	0	130
4732	0	118	0	0	0	118
4733	0	0	1	131	0	132
4734	0	0	0	129	0	129
4735	123	0	0	0	0	123
4736	0	124	0	0	0	124
4737	0	0	0	121	0	121
4738	0	0	0	122	0	122
4739	0	115	0	0	0	115
4740	0	0	0	115	0	115
4741	0	0	0	117	0	117
4742	0	115	0	0	0	115
4743	0	0	0	119	0	119
4744	0	0	0	115	0	115
4745	0	115	0	0	0	115
4746	0	0	0	113	0	113
4747	112	0	0	1	0	113
4748	107	0	0	0	0	107
4749	110	0	0	0	0	110
4750	108	0	0	0	0	108
4751	0	99	0	0	0	99
4752	111	0	0	0	0	111
4753	0	102	0	0	0	102
4754	0	102	0	0	0	102
4755	0	0	0	105	0	105
4756	0	0	106	0	0	106
4757	108	0	0	0	0	108
4758	105	0	0	0	0	105
4759	0	0	102	0	0	102
4760	107	0	0	0	0	107
4761	102	0	0	0	0	102
4762	0	99	0	0	0	99
4763	104	0	0	0	0	104
4764	0	0	0	104	0	104
4765	0	0	0	105	0	105
4766	0	0	0	98	0	98
4767	0	0	0	106	0	106
4768	106	0	0	0	0	106
4769	0	0	0	111	0	111
4770	0	0	0	109	0	109
4771	0	0	106	0	0	106
4772	112	0	0	0	0	112
4773	115	0	0	0	0	115
4774	109	0	0	0	0	109
4775	0	113	0	0	0	113
4776	0	118	0	0	0	118
4777	119	0	0	0	0	119
4778	0	0	0	125	0	125
4779	0	131	0	0	0	131
4780	0	0	0	135	0	135
4781	1	133	0	0	0	134
4782	133	0	0	0	0	133
4783	0	140	0	0	0	140
4784	0	0	0	143	0	143
4785	0	0	0	142	0	142
4786	0	0	134	0	0	134
4787	0	132	0	0	0	132
4788	0	0	0	141	0	141
4789	0	0	132	0	0	132
4790	0	1	121	0	0	122
4791	0	0	0	138	0	138
4792	0	0	0	139	0	139
4793	0	139	0	0	0	139
4794	0	146	0	0	0	146
4795	0	0	0	148	0	148
4796	145	0	0	0	0	145
4797	1	0	0	147	0	148
4798	153	0	0	0	0	153
4799	149	0	0	0	0	149
4800	150	0	0	0	0	150
4801	0	0	150	0	0	150
4802	152	0	0	0	0	152
4803	0	0	0	150	0	150
4804	0	0	0	146	0	146
4805	0	0	139	0	0	139
4806	0	1	131	0	0	132
4807	0	0	0	143	0	143
4808	0	135	0	1	0	136
4809	0	137	0	0	0	137
4810	0	0	0	144	0	144
4811	137	0	0	0	0	137
4812	0	0	0	142	0	142
4813	0	0	0	144	0	144
4814	0	136	0	0	0	136
4815	0	0	0	138	0	138
4816	0	0	134	0	0	134
4817	0	0	128	0	0	128
4818	134	0	0	0	0	134
4819	0	135	0	0	0	135
4820	135	0	0	0	0	135
4821	134	0	0	0	0	134
4822	0	0	0	135	0	135
4823	0	135	0	0	0	135
4824	0	0	0	137	0	137
4825	130	0	0	0	0	130
4826	0	129	0	0	0	129
4827	134	0	0	0	0	134
4828	0	129	0	0	0	129
4829	133	0	0	0	0	133
4830	132	0	0	0	0	132
4831	0	131	0	0	0	131
4832	0	0	0	136	0	136
4833	135	0	0	0	0	135
4834	0	0	126	0	0	126
4835	0	0	129	0	0	129
4836	0	0	0	126	0	126
4837	130	0	0	0	0	130
4838	0	0	0	132	0	132
4839	134	0	0	0	0	134
4840	0	0	129	0	0	129
4841	136	0	0	1	0	137
4842	137	0	0	0	0	137
4843	0	0	0	136	0	136
4844	0	0	0	138	0	138
4845	0	0	0	135	0	135
4846	0	132	0	0	0	132
4847	0	0	0	135	0	135
4848	0	0	0	140	0	140
4849	139	0	0	0	0	139
4850	142	0	0	0	0	142
4851	0	0	135	0	0	135
4852	139	0	0	0	0	139
4853	0	0	133	0	0	133
4854	137	0	0	0	0	137
4855	0	0	135	0	0	135
4856	0	1	127	0	0	128
4857	0	0	0	134	0	134
4858	0	0	134	0	0	134
4859	140	0	0	0	0	140
4860	0	0	0	143	0	143
4861	138	0	0	0	0	138
4862	141	0	0	0	0	141
4863	134	0	0	0	0	134
4864	143	0	0	0	0	143
4865	0	0	134	0	0	134
4866	0	0	0	131	0	131
4867	0	0	131	0	0	131
4868	0	0	0	133	0	133
4869	135	0	0	0	0	135
4870	2	0	0	132	0	134
4871	128	0	2	0	0	130
4872	0	0	0	127	0	127
4873	0	0	0	125	0	125
4874	123	0	0	0	0	123
4875	0	124	0	0	0	124
4876	117	0	0	0	0	117
4877	1	112	1	0	0	114
4878	0	0	0	121	0	121
4879	127	0	0	0	0	127
4880	0	0	126	0	0	126
4881	0	0	0	128	0	128
4882	137	0	0	0	0	137
4883	136	0	0	0	0	136
4884	0	2	0	130	0	132
4885	0	124	0	2	0	126
4886	0	122	0	0	0	122
4887	0	0	0	140	0	140
4888	135	0	0	0	0	135
4889	0	133	0	0	0	133
4890	0	131	1	0	0	132
4891	130	0	0	0	0	130
4892	0	130	0	0	0	130
4893	132	0	0	0	0	132
4894	0	0	0	130	0	130
4895	1	0	0	132	0	133
4896	0	130	0	0	0	130
4897	0	132	0	0	0	132
4898	131	0	0	1	0	132
4899	0	128	0	0	0	128
4900	0	133	0	0	0	133
4901	0	0	0	141	0	141
4902	136	0	0	0	0	136
4903	1	0	132	0	0	133
4904	138	0	0	0	0	138
4905	0	0	0	144	0	144
4906	0	0	133	0	0	133
4907	1	0	137	0	0	138
4908	0	0	0	142	0	142
4909	0	0	133	0	0	133
4910	138	0	0	0	0	138
4911	134	0	0	0	0	134
4912	0	0	131	0	0	131
4913	0	0	0	135	0	135
4914	0	0	0	138	0	138
4915	139	0	0	0	0	139
4916	0	0	0	143	0	143
4917	0	138	0	0	0	138
4918	140	0	0	0	0	140
4919	0	134	0	0	0	134
4920	0	142	0	0	0	142
4921	0	0	0	139	0	139
4922	0	0	0	141	0	141
4923	0	0	0	140	0	140
4924	0	0	139	0	0	139
4925	141	0	0	0	0	141
4926	0	139	0	0	0	139
4927	141	0	0	0	0	141
4928	140	0	0	0	0	140
4929	0	0	0	142	0	142
4930	0	141	0	0	0	141
4931	0	0	0	143	0	143
4932	0	0	0	141	0	141
4933	147	0	0	0	0	147
4934	136	0	0	0	0	136
4935	0	0	132	0	0	132
4936	137	0	0	0	0	137
4937	0	137	0	0	0	137
4938	139	0	0	0	0	139
4939	0	136	0	0	0	136
4940	0	0	0	139	0	139
4941	0	0	0	136	0	136
4942	0	128	0	0	0	128
4943	0	0	0	136	0	136
4944	0	0	0	136	0	136
4945	0	0	0	134	0	134
4946	0	124	0	0	0	124
4947	0	0	0	127	0	127
4948	0	0	0	132	0	132
4949	0	0	0	130	0	130
4950	0	0	133	0	0	133
4951	130	0	0	0	0	130
4952	0	0	129	0	0	129
4953	130	0	0	0	0	130
4954	0	0	126	0	0	126
4955	128	0	0	0	0	128
4956	129	0	0	0	0	129
4957	0	0	122	0	0	122
4958	0	0	0	122	0	122
4959	0	0	121	0	0	121
4960	123	0	0	0	0	123
4961	0	0	122	0	0	122
4962	0	0	113	0	0	113
4963	120	0	0	0	0	120
4964	0	109	0	1	0	110
4965	0	0	0	116	0	116
4966	117	0	0	0	0	117
4967	0	0	0	114	0	114
4968	0	0	0	109	0	109
4969	112	0	0	0	0	112
4970	107	0	0	0	0	107
4971	0	0	96	0	0	96
4972	0	0	90	0	0	90
4973	0	0	0	97	0	97
4974	1	0	97	0	0	98
4975	0	1	1	92	0	94
4976	0	0	1	94	0	95
4977	0	0	0	99	0	99
4978	96	0	0	0	0	96
4979	0	90	0	0	0	90
4980	84	0	0	0	0	84
4981	88	0	0	0	0	88
4982	0	87	0	0	0	87
4983	83	0	0	0	0	83
4984	0	0	86	0	0	86
4985	0	0	0	89	0	89
4986	90	0	0	1	0	91
4987	1	0	82	0	0	83
4988	89	0	0	1	0	90
4989	0	89	0	0	0	89
4990	92	0	0	0	0	92
4991	88	0	0	0	0	88
4992	0	88	0	0	0	88
4993	95	0	0	0	0	95
4994	0	0	0	94	0	94
4995	0	0	0	93	0	93
4996	92	0	0	0	0	92
4997	95	0	0	0	0	95
4998	0	98	0	0	0	98
4999	0	93	0	0	0	93
5000	0	0	0	94	0	94
5001	0	93	0	0	0	93
5002	0	96	0	0	0	96
5003	94	0	0	0	0	94
5004	0	93	0	0	0	93
5005	97	0	0	0	0	97
5006	0	91	0	0	0	91
5007	0	0	85	0	0	85
5008	0	87	0	0	0	87
5009	91	0	0	0	0	91
5010	89	0	0	0	0	89
5011	0	0	89	0	0	89
5012	0	0	0	86	0	86
5013	0	0	0	91	0	91
5014	0	0	86	0	0	86
5015	0	0	0	91	0	91
5016	0	0	87	0	0	87
5017	0	0	81	0	0	81
5018	90	0	0	0	0	90
5019	0	85	0	0	0	85
5020	86	0	0	0	0	86
5021	0	0	0	86	0	86
5022	0	0	87	0	0	87
5023	0	0	0	87	0	87
5024	0	83	0	0	0	83
5025	85	0	0	0	0	85
5026	87	0	0	0	0	87
5027	0	0	0	89	0	89
5028	0	0	81	0	0	81
5029	89	0	0	0	0	89
5030	0	91	0	0	0	91
5031	89	0	0	0	0	89
5032	0	0	0	88	0	88
5033	87	0	0	0	0	87
5034	0	0	0	87	0	87
5035	0	0	85	0	0	85
5036	0	0	83	0	0	83
5037	89	0	0	0	0	89
5038	0	89	0	0	0	89
5039	89	0	0	0	0	89
5040	89	0	0	0	0	89
5041	0	92	0	0	0	92
5042	93	0	0	0	0	93
5043	0	1	88	0	0	89
5044	0	0	0	86	0	86
5045	0	1	0	80	0	81
5046	0	0	0	84	0	84
5047	0	0	84	0	0	84
5048	0	0	82	0	0	82
5049	0	0	0	84	0	84
5050	0	77	0	0	0	77
5051	0	83	0	0	0	83
5052	88	0	0	0	0	88
5053	81	0	0	1	0	82
5054	0	82	0	0	0	82
5055	0	0	0	82	0	82
5056	0	0	0	91	0	91
5057	88	0	0	0	0	88
5058	1	0	0	88	0	89
5059	0	0	0	91	0	91
5060	0	0	0	87	0	87
5061	0	0	89	0	0	89
5062	0	0	85	0	0	85
5063	89	0	0	0	0	89
5064	0	0	0	91	0	91
5065	0	0	88	0	0	88
5066	0	0	82	1	0	83
5067	89	0	0	0	0	89
5068	0	0	101	0	0	101
5069	0	104	1	0	0	105
5070	0	0	0	110	0	110
5071	0	0	110	0	0	110
5072	109	0	0	0	0	109
5073	1	0	0	110	0	111
5074	0	0	112	0	0	112
5075	0	0	0	106	0	106
5076	0	0	0	113	0	113
5077	104	0	0	0	0	104
5078	0	107	0	0	0	107
5079	0	0	0	105	0	105
5080	102	0	0	0	0	102
5081	106	0	0	0	0	106
5082	107	0	0	0	0	107
5083	106	0	0	0	0	106
5084	1	0	0	102	0	103
5085	105	0	0	0	0	105
5086	105	0	0	0	0	105
5087	101	0	0	0	0	101
5088	93	0	1	0	0	94
5089	0	92	0	0	0	92
5090	0	92	0	0	0	92
5091	0	0	0	98	0	98
5092	0	96	0	0	0	96
5093	99	0	0	0	0	99
5094	0	0	0	94	0	94
5095	92	0	0	0	0	92
5096	95	0	0	0	0	95
5097	0	0	1	93	0	94
5098	0	0	0	97	0	97
5099	0	94	0	0	0	94
5100	95	0	0	0	0	95
5101	0	96	0	0	0	96
5102	98	0	0	0	0	98
5103	0	0	0	97	0	97
5104	0	0	91	0	0	91
5105	94	0	0	0	0	94
5106	90	0	0	0	0	90
5107	0	0	84	0	0	84
5108	0	0	86	0	0	86
5109	0	0	0	92	0	92
5110	95	0	0	0	0	95
5111	98	0	0	0	0	98
5112	95	1	0	0	0	96
5113	93	0	0	1	0	94
5114	1	89	0	0	0	90
5115	96	0	0	0	0	96
5116	0	0	0	101	0	101
5117	0	0	0	105	0	105
5118	0	0	1	104	0	105
5119	0	0	0	102	0	102
5120	106	0	0	0	0	106
5121	0	0	0	107	0	107
5122	0	0	95	0	0	95
5123	4	0	0	106	0	110
5124	0	0	3	102	0	105
5125	0	0	0	113	0	113
5126	1	0	0	112	0	113
5127	114	0	0	0	0	114
5128	0	109	0	1	0	110
5129	0	101	0	0	0	101
5130	1	0	0	110	0	111
5131	114	0	0	0	0	114
5132	107	0	0	0	0	107
5133	0	0	0	109	0	109
5134	0	0	110	0	0	110
5135	114	0	0	0	0	114
5136	0	0	0	114	0	114
5137	0	0	124	0	0	124
5138	115	0	0	0	0	115
5139	0	123	0	0	0	123
5140	125	0	0	0	0	125
5141	0	123	0	0	0	123
5142	0	0	0	124	0	124
5143	0	117	2	0	0	119
5144	0	0	1	131	0	132
5145	128	0	0	0	0	128
5146	0	124	0	0	0	124
5147	0	1	129	0	0	130
5148	0	0	0	129	0	129
5149	0	0	123	0	0	123
5150	0	0	0	123	0	123
5151	0	0	0	127	0	127
5152	0	0	122	0	0	122
5153	122	0	0	0	0	122
5154	0	0	119	0	0	119
5155	1	0	117	0	0	118
5156	0	124	0	0	0	124
5157	0	0	0	130	0	130
5158	0	0	0	132	0	132
5159	0	0	0	132	0	132
5160	0	0	0	130	0	130
5161	0	0	113	0	0	113
5162	120	0	0	0	0	120
5163	0	0	117	0	0	117
5164	0	0	0	114	0	114
5165	107	0	0	0	0	107
5166	0	107	0	0	0	107
5167	0	0	0	106	0	106
5168	100	0	0	0	0	100
5169	0	99	0	0	0	99
5170	0	101	0	0	0	101
5171	101	0	0	0	0	101
5172	0	101	0	0	0	101
5173	100	0	0	0	0	100
5174	0	101	0	0	0	101
5175	103	0	0	0	0	103
5176	98	0	0	1	0	99
5177	0	94	0	0	0	94
5178	0	0	0	95	0	95
5179	0	0	99	0	0	99
5180	95	0	0	0	0	95
5181	0	0	0	96	0	96
5182	2	83	0	0	0	85
5183	0	92	0	0	0	92
5184	0	0	0	95	0	95
5185	96	0	0	0	0	96
5186	0	0	86	0	0	86
5187	0	0	0	92	0	92
5188	0	0	0	92	0	92
5189	0	0	0	96	0	96
5190	0	0	0	96	0	96
5191	0	96	0	0	0	96
5192	0	0	0	98	0	98
5193	0	0	92	0	0	92
5194	1	0	85	0	0	86
5195	0	0	91	0	0	91
5196	0	0	0	93	0	93
5197	94	0	0	0	0	94
5198	0	0	86	0	0	86
5199	0	0	85	0	0	85
5200	0	0	0	89	0	89
5201	89	0	0	0	0	89
5202	0	87	0	0	0	87
5203	87	0	0	0	0	87
5204	0	0	0	86	0	86
5205	0	0	85	0	0	85
5206	0	0	0	86	0	86
5207	0	83	0	0	0	83
5208	85	0	0	0	0	85
5209	0	0	82	0	0	82
5210	0	80	0	0	0	80
5211	92	0	0	0	0	92
5212	0	0	0	85	0	85
5213	0	0	0	86	0	86
5214	89	0	0	0	0	89
5215	82	0	0	0	0	82
5216	89	0	0	0	0	89
5217	1	0	0	85	0	86
5218	0	79	0	0	0	79
5219	79	0	0	0	0	79
5220	0	74	1	0	0	75
5221	80	0	0	0	0	80
5222	0	75	0	0	0	75
5223	0	0	0	78	0	78
5224	79	0	0	0	0	79
5225	80	0	0	0	0	80
5226	81	0	0	0	0	81
5227	80	0	0	0	0	80
5228	77	1	0	0	0	78
5229	0	0	73	0	0	73
5230	0	0	0	73	0	73
5231	0	0	77	0	0	77
5232	0	1	70	0	0	71
5233	78	0	0	0	0	78
5234	77	0	0	0	0	77
5235	76	0	0	0	0	76
5236	0	0	0	73	0	73
5237	72	0	0	0	0	72
5238	0	69	0	0	0	69
5239	0	61	0	0	0	61
5240	0	70	0	0	0	70
5241	72	0	0	0	0	72
5242	0	66	0	0	0	66
5243	72	0	0	0	0	72
5244	71	0	0	0	0	71
5245	0	0	70	0	0	70
5246	0	0	0	71	0	71
5247	0	0	0	74	0	74
5248	75	0	0	0	0	75
5249	66	0	1	0	0	67
5250	1	0	0	70	0	71
5251	0	0	68	0	0	68
5252	1	1	60	0	0	62
5253	0	0	0	66	0	66
5254	0	0	1	67	0	68
5255	0	0	0	72	0	72
5256	70	0	0	0	0	70
5257	73	0	0	0	0	73
5258	0	74	0	0	0	74
5259	0	0	0	73	0	73
5260	0	0	0	73	0	73
5261	0	72	0	0	0	72
5262	0	0	0	74	0	74
5263	74	0	0	0	0	74
5264	0	0	0	74	0	74
5265	0	0	0	76	0	76
5266	77	0	0	0	0	77
5267	76	0	0	0	0	76
5268	78	0	0	0	0	78
5269	0	0	0	74	0	74
5270	0	0	73	0	0	73
5271	1	0	66	0	0	67
5272	0	0	70	0	0	70
5273	0	74	0	0	0	74
5274	78	0	0	0	0	78
5275	0	0	77	0	0	77
5276	78	0	2	0	0	80
5277	0	0	0	79	0	79
5278	84	0	0	0	0	84
5279	82	0	0	1	0	83
5280	0	83	0	0	0	83
5281	81	0	0	2	0	83
5282	83	0	0	0	0	83
5283	0	78	0	0	0	78
5284	0	0	0	83	0	83
5285	0	0	83	0	0	83
5286	0	0	0	87	0	87
5287	0	0	0	87	0	87
5288	87	0	0	0	0	87
5289	0	0	0	81	0	81
5290	0	81	0	0	0	81
5291	0	0	0	86	0	86
5292	0	0	0	86	0	86
5293	0	0	86	0	0	86
5294	0	83	0	2	0	85
5295	0	87	0	0	0	87
5296	88	0	0	0	0	88
5297	0	86	0	0	0	86
5298	0	0	0	85	0	85
5299	0	0	89	0	0	89
5300	0	83	0	0	0	83
5301	88	0	0	0	0	88
5302	0	0	0	91	0	91
5303	1	0	0	91	0	92
5304	0	0	88	0	0	88
5305	0	0	0	88	0	88
5306	0	0	0	89	0	89
5307	87	0	0	0	0	87
5308	87	0	0	0	0	87
5309	0	84	0	0	0	84
5310	86	0	0	0	0	86
5311	0	81	0	0	0	81
5312	0	0	0	84	0	84
5313	0	80	0	0	0	80
5314	0	82	0	0	0	82
5315	83	0	0	0	0	83
5316	83	0	0	0	0	83
5317	0	78	0	0	0	78
5318	77	0	0	0	0	77
5319	76	0	0	0	0	76
5320	75	0	0	1	0	76
5321	0	0	0	76	0	76
5322	75	0	0	0	0	75
5323	0	0	69	0	0	69
5324	71	0	0	0	0	71
5325	0	0	72	0	0	72
5326	0	0	0	74	0	74
5327	0	0	0	70	0	70
5328	1	0	65	1	0	67
5329	72	0	0	0	0	72
5330	71	0	0	0	0	71
5331	0	0	73	0	0	73
5332	0	0	0	75	0	75
5333	1	0	0	71	0	72
5334	0	0	0	71	0	71
5335	72	0	0	0	0	72
5336	74	0	0	0	0	74
5337	0	0	0	75	0	75
5338	0	58	0	1	0	59
5339	0	68	0	0	0	68
5340	74	0	0	0	0	74
5341	0	71	0	0	0	71
5342	0	74	0	0	0	74
5343	0	0	0	76	0	76
5344	0	0	76	0	0	76
5345	0	71	0	0	0	71
5346	0	0	0	77	0	77
5347	0	75	0	0	0	75
5348	0	0	0	79	0	79
5349	79	0	0	0	0	79
5350	0	76	0	0	0	76
5351	82	0	0	0	0	82
5352	77	0	0	0	0	77
5353	0	0	78	0	0	78
5354	77	0	0	0	0	77
5355	0	0	0	78	0	78
5356	0	0	77	0	0	77
5357	0	78	0	0	0	78
5358	0	0	0	73	0	73
5359	0	0	0	77	0	77
5360	73	0	0	0	0	73
5361	0	0	0	76	0	76
5362	0	0	0	81	0	81
5363	83	0	0	0	0	83
5364	0	83	0	0	0	83
5365	84	0	0	0	0	84
5366	0	0	83	0	0	83
5367	78	0	0	0	0	78
5368	0	0	83	0	0	83
5369	0	81	0	0	0	81
5370	86	0	0	0	0	86
5371	82	0	0	0	0	82
5372	0	0	79	0	0	79
5373	0	0	76	0	0	76
5374	1	0	72	0	0	73
5375	1	80	0	0	0	81
5376	0	0	0	84	0	84
5377	0	0	83	0	0	83
5378	0	0	82	0	0	82
5379	0	0	0	84	0	84
5380	0	0	87	0	0	87
5381	84	0	0	0	0	84
5382	86	0	0	0	0	86
5383	0	0	86	0	0	86
5384	0	93	0	0	0	93
5385	0	0	0	95	0	95
5386	0	0	90	0	0	90
5387	0	87	0	0	0	87
5388	0	0	0	92	0	92
5389	92	0	0	0	0	92
5390	93	0	0	2	0	95
5391	0	94	0	0	0	94
5392	0	0	0	96	0	96
5393	0	0	0	96	0	96
5394	0	0	0	93	0	93
5395	0	0	0	93	0	93
5396	0	0	95	0	0	95
5397	0	0	0	94	0	94
5398	0	0	92	0	0	92
5399	0	90	0	0	0	90
5400	92	0	0	1	0	93
5401	0	91	0	0	0	91
5402	0	0	0	94	0	94
5403	0	0	0	98	0	98
5404	96	0	0	0	0	96
5405	0	0	0	98	0	98
5406	0	95	0	0	0	95
5407	0	0	0	98	0	98
5408	0	0	0	98	0	98
5409	99	0	0	0	0	99
5410	0	0	87	0	0	87
5411	0	89	0	0	0	89
5412	0	95	0	0	0	95
5413	0	0	0	100	0	100
5414	100	0	0	0	0	100
5415	0	103	0	0	0	103
5416	0	0	0	102	0	102
5417	0	0	102	0	0	102
5418	0	0	0	101	0	101
5419	98	0	0	0	0	98
5420	104	0	0	0	0	104
5421	0	0	0	101	0	101
5422	100	0	0	0	0	100
5423	101	0	0	0	0	101
5424	0	0	99	0	0	99
5425	90	0	0	0	0	90
5426	0	89	0	0	0	89
5427	95	0	0	0	0	95
5428	0	0	96	0	0	96
5429	0	0	0	94	0	94
5430	93	0	0	0	0	93
5431	0	0	87	0	0	87
5432	0	0	96	0	0	96
5433	0	0	0	93	0	93
5434	0	0	96	0	0	96
5435	94	0	0	0	0	94
5436	0	0	92	0	0	92
5437	0	0	0	87	0	87
5438	0	0	0	90	0	90
5439	93	0	0	0	0	93
5440	0	0	82	0	0	82
5441	1	0	86	0	0	87
5442	0	0	0	88	0	88
5443	0	0	87	0	0	87
5444	86	0	0	0	0	86
5445	3	0	0	82	0	85
5446	1	0	80	0	0	81
5447	0	0	0	82	0	82
5448	0	0	0	79	0	79
5449	82	0	0	0	0	82
5450	0	3	77	0	0	80
5451	77	0	0	0	0	77
5452	0	0	80	0	0	80
5453	77	0	0	1	0	78
5454	81	0	0	0	0	81
5455	77	0	0	0	0	77
5456	0	78	0	0	0	78
5457	80	0	0	1	0	81
5458	79	0	0	0	0	79
5459	0	0	0	80	0	80
5460	0	0	78	0	0	78
5461	80	0	0	0	0	80
5462	0	0	78	0	0	78
5463	0	0	0	76	0	76
5464	4	0	0	76	0	80
5465	75	0	0	0	0	75
5466	0	79	0	0	0	79
5467	0	0	0	77	0	77
5468	0	0	0	71	0	71
5469	0	0	74	0	0	74
5470	0	0	1	70	0	71
5471	0	0	0	74	0	74
5472	0	0	0	73	0	73
5473	0	68	0	0	0	68
5474	73	0	0	0	0	73
5475	70	0	0	0	0	70
5476	0	69	0	0	0	69
5477	69	0	0	0	0	69
5478	0	0	0	69	0	69
5479	0	0	63	0	0	63
5480	1	57	0	0	0	58
5481	0	65	0	0	0	65
5482	66	0	0	0	0	66
5483	65	0	0	0	0	65
5484	0	0	0	65	0	65
5485	0	0	0	67	0	67
5486	0	0	0	64	0	64
5487	66	0	0	0	0	66
5488	0	0	62	0	0	62
5489	62	0	0	0	0	62
5490	0	0	0	63	0	63
5491	0	0	0	65	0	65
5492	0	63	0	0	0	63
5493	0	0	0	60	0	60
5494	0	0	0	63	0	63
5495	0	0	59	0	0	59
5496	0	58	0	0	0	58
5497	59	0	0	0	0	59
5498	54	0	0	1	0	55
5499	61	0	0	0	0	61
5500	57	0	0	0	0	57
5501	0	0	53	0	0	53
5502	57	0	0	0	0	57
5503	0	0	58	0	0	58
5504	0	0	0	59	0	59
5505	0	60	0	0	0	60
5506	0	0	0	58	0	58
5507	0	0	0	57	0	57
5508	0	0	58	0	0	58
5509	55	0	0	0	0	55
5510	53	0	0	1	0	54
5511	0	57	0	0	0	57
5512	0	0	54	0	0	54
5513	0	0	0	53	0	53
5514	0	0	56	0	0	56
5515	0	0	55	0	0	55
5516	0	0	0	57	0	57
5517	0	0	57	0	0	57
5518	0	0	0	57	0	57
5519	0	0	58	0	0	58
5520	0	0	0	60	0	60
5521	57	0	0	0	0	57
5522	63	0	0	0	0	63
5523	64	1	0	0	0	65
5524	62	1	0	1	0	64
5525	0	57	0	0	0	57
5526	0	0	0	60	0	60
5527	0	0	0	60	0	60
5528	0	0	63	0	0	63
5529	1	0	0	61	0	62
5530	0	0	65	0	0	65
5531	0	0	59	0	0	59
5532	59	0	0	0	0	59
5533	0	63	0	0	0	63
5534	63	0	0	0	0	63
5535	60	0	0	0	0	60
5536	0	58	0	0	0	58
5537	60	0	0	0	0	60
5538	0	0	58	0	0	58
5539	0	62	0	0	0	62
5540	66	0	0	0	0	66
5541	0	1	57	0	0	58
5542	67	0	0	0	0	67
5543	0	69	0	0	0	69
5544	67	0	0	0	0	67
5545	65	0	0	0	0	65
5546	0	58	0	0	0	58
5547	1	58	0	0	0	59
5548	0	58	0	0	0	58
5549	0	0	0	63	0	63
5550	0	0	0	65	0	65
5551	65	0	0	0	0	65
5552	68	0	0	0	0	68
5553	0	0	61	0	0	61
5554	0	0	58	0	0	58
5555	0	0	60	0	0	60
5556	0	0	0	64	0	64
5557	0	0	64	0	0	64
5558	0	0	0	67	0	67
5559	65	0	0	0	0	65
5560	0	0	66	0	0	66
5561	69	0	0	0	0	69
5562	66	0	0	0	0	66
5563	0	0	60	0	0	60
5564	0	63	0	0	0	63
5565	0	0	0	64	0	64
5566	0	0	63	0	0	63
5567	0	0	0	65	0	65
5568	0	0	0	66	0	66
5569	68	0	0	0	0	68
5570	0	0	0	67	0	67
5571	0	0	66	0	0	66
5572	0	0	0	67	0	67
5573	66	0	0	0	0	66
5574	0	66	0	0	0	66
5575	69	0	0	0	0	69
5576	0	0	0	71	0	71
5577	0	0	71	0	0	71
5578	0	0	61	1	0	62
5579	0	0	64	0	0	64
5580	0	68	0	0	0	68
5581	69	0	0	0	0	69
5582	0	68	0	0	0	68
5583	73	0	0	0	0	73
5584	0	68	0	0	0	68
5585	0	0	0	75	0	75
5586	0	0	0	74	0	74
5587	0	0	0	77	0	77
5588	0	72	1	0	0	73
5589	0	0	0	77	0	77
5590	0	0	0	80	0	80
5591	79	0	0	0	0	79
5592	0	0	0	81	0	81
5593	0	0	79	0	0	79
5594	84	0	0	0	0	84
5595	79	0	0	0	0	79
5596	0	79	0	0	0	79
5597	82	0	0	0	0	82
5598	84	0	0	0	0	84
5599	0	0	0	83	0	83
5600	0	0	0	80	0	80
5601	0	0	0	79	0	79
5602	82	0	0	0	0	82
5603	82	0	0	0	0	82
5604	0	0	82	0	0	82
5605	81	0	0	0	0	81
5606	82	0	0	0	0	82
5607	75	0	0	1	0	76
5608	0	0	73	0	0	73
5609	0	0	69	0	0	69
5610	0	0	0	79	0	79
5611	0	0	75	0	0	75
5612	0	0	0	81	0	81
5613	0	0	0	80	0	80
5614	0	74	0	0	0	74
5615	79	0	0	0	0	79
5616	0	0	77	0	0	77
5617	73	0	0	4	0	77
5618	0	0	0	78	0	78
5619	78	0	0	0	0	78
5620	0	76	0	0	0	76
5621	0	68	0	0	0	68
5622	0	0	0	72	0	72
5623	0	0	0	71	0	71
5624	0	0	74	0	0	74
5625	0	1	0	69	0	70
5626	71	0	0	0	0	71
5627	0	74	0	0	0	74
5628	0	0	77	0	0	77
5629	0	0	0	76	0	76
5630	0	0	76	0	0	76
5631	0	0	0	74	0	74
5632	0	0	70	0	0	70
5633	0	0	67	0	0	67
5634	0	0	0	65	0	65
5635	69	0	0	0	0	69
5636	69	0	0	0	0	69
5637	65	0	0	0	0	65
5638	0	66	0	0	0	66
5639	69	0	0	0	0	69
5640	68	0	0	0	0	68
5641	0	0	62	0	0	62
5642	0	65	0	0	0	65
5643	0	0	0	68	0	68
5644	64	0	0	0	0	64
5645	0	62	0	0	0	62
5646	67	0	0	0	0	67
5647	67	0	0	0	0	67
5648	64	0	0	0	0	64
5649	64	0	0	0	0	64
5650	0	0	0	67	0	67
5651	68	0	0	0	0	68
5652	0	0	0	66	0	66
5653	0	62	0	0	0	62
5654	0	0	0	63	0	63
5655	63	0	0	0	0	63
5656	0	0	64	0	0	64
5657	1	0	0	62	0	63
5658	63	0	0	0	0	63
5659	0	66	0	0	0	66
5660	66	0	0	0	0	66
5661	60	0	0	0	0	60
5662	0	64	0	0	0	64
5663	65	0	0	0	0	65
5664	0	0	62	0	0	62
5665	0	0	63	0	0	63
5666	69	0	0	0	0	69
5667	0	0	68	0	0	68
5668	0	0	0	64	0	64
5669	0	66	0	0	0	66
5670	66	0	0	1	0	67
5671	0	63	0	0	0	63
5672	0	61	0	0	0	61
5673	0	0	0	69	0	69
5674	0	0	0	69	0	69
5675	0	0	0	69	0	69
5676	0	0	0	70	0	70
5677	0	0	71	0	0	71
5678	0	1	0	66	0	67
5679	0	0	0	69	0	69
5680	69	0	0	0	0	69
5681	0	0	0	70	0	70
5682	0	0	68	0	0	68
5683	68	0	0	0	0	68
5684	0	0	0	71	0	71
5685	0	0	69	0	0	69
5686	0	0	0	71	0	71
5687	0	70	0	0	0	70
5688	72	0	0	0	0	72
5689	0	0	70	0	0	70
5690	0	70	0	0	0	70
5691	67	0	0	0	0	67
5692	0	68	0	0	0	68
5693	0	68	0	0	0	68
5694	66	0	0	0	0	66
5695	0	68	0	0	0	68
5696	0	65	0	0	0	65
5697	0	0	0	70	0	70
5698	0	0	69	0	0	69
5699	0	69	0	0	0	69
5700	0	0	0	73	0	73
5701	0	77	0	1	0	78
5702	77	0	0	0	0	77
5703	0	0	77	0	0	77
5704	0	0	0	80	0	80
5705	76	0	0	0	0	76
5706	0	0	0	78	0	78
5707	0	0	78	0	0	78
5708	77	0	0	0	0	77
5709	73	0	0	0	0	73
5710	0	77	0	0	0	77
5711	0	0	0	77	0	77
5712	0	0	0	76	0	76
5713	74	0	0	0	0	74
5714	78	0	0	0	0	78
5715	0	0	74	0	0	74
5716	0	78	0	0	0	78
5717	75	0	0	0	0	75
5718	0	0	0	77	0	77
5719	0	0	70	0	0	70
5720	0	0	73	0	0	73
5721	0	0	0	74	0	74
5722	74	0	0	0	0	74
5723	0	75	0	0	0	75
5724	77	0	1	0	0	78
5725	0	0	0	79	0	79
5726	0	0	0	82	0	82
5727	0	0	0	80	0	80
5728	78	0	0	0	0	78
5729	0	76	0	0	0	76
5730	0	0	0	78	0	78
5731	0	0	0	78	0	78
5732	0	0	75	0	0	75
5733	0	0	0	78	0	78
5734	0	0	78	0	0	78
5735	0	75	0	0	0	75
5736	0	0	0	84	0	84
5737	83	0	0	0	0	83
5738	0	0	80	0	0	80
5739	0	0	0	80	0	80
5740	0	0	80	0	0	80
5741	80	0	0	0	0	80
5742	0	0	80	0	0	80
5743	0	0	0	78	0	78
5744	77	0	0	0	0	77
5745	0	79	0	0	0	79
5746	80	0	0	0	0	80
5747	0	79	0	0	0	79
5748	0	0	0	84	0	84
5749	0	0	79	0	0	79
5750	0	0	83	0	0	83
5751	0	0	0	90	0	90
5752	86	0	0	0	0	86
5753	90	0	0	1	0	91
5754	0	3	0	77	0	80
5755	0	0	0	85	0	85
5756	82	0	0	0	0	82
5757	0	79	0	0	0	79
5758	0	77	0	0	0	77
5759	91	0	0	0	0	91
5760	0	0	81	0	0	81
5761	0	0	0	88	0	88
5762	0	0	83	0	0	83
5763	0	0	0	85	0	85
5764	0	0	78	0	0	78
5765	0	0	75	0	0	75
5766	0	0	0	78	0	78
5767	2	79	0	0	0	81
5768	85	0	0	0	0	85
5769	0	80	0	0	0	80
5770	0	0	0	84	0	84
5771	79	0	0	0	0	79
5772	0	0	0	78	0	78
5773	81	0	0	0	0	81
5774	82	0	0	0	0	82
5775	80	0	0	0	0	80
5776	1	75	0	0	0	76
5777	81	0	0	0	0	81
5778	0	0	1	76	0	77
5779	75	0	0	0	0	75
5780	0	0	0	72	0	72
5781	69	1	0	0	0	70
5782	69	0	0	0	0	69
5783	0	66	0	1	0	67
5784	0	0	0	68	0	68
5785	0	0	0	72	0	72
5786	0	72	1	0	0	73
5787	0	0	0	76	0	76
5788	75	0	0	1	0	76
5789	73	0	0	0	0	73
5790	80	0	0	0	0	80
5791	0	0	74	0	0	74
5792	84	0	0	1	0	85
5793	78	0	0	0	0	78
5794	76	0	0	0	0	76
5795	0	78	0	0	0	78
5796	0	0	0	80	0	80
5797	0	0	0	82	0	82
5798	0	0	0	79	0	79
5799	0	0	78	0	0	78
5800	0	0	0	75	0	75
5801	76	0	0	0	0	76
5802	0	0	0	77	0	77
5803	0	0	0	78	0	78
5804	0	0	72	1	0	73
5805	0	75	0	0	0	75
5806	76	0	0	0	0	76
5807	0	0	0	78	0	78
5808	76	0	0	0	0	76
5809	0	0	75	0	0	75
5810	72	0	0	0	0	72
5811	0	79	0	0	0	79
5812	0	0	75	1	0	76
5813	1	0	81	0	0	82
5814	0	0	0	80	0	80
5815	0	0	81	0	0	81
5816	0	82	0	0	0	82
5817	1	0	0	85	0	86
5818	0	0	0	85	0	85
5819	1	0	0	84	0	85
5820	90	0	0	0	0	90
5821	0	86	0	0	0	86
5822	0	0	0	88	0	88
5823	0	0	0	83	0	83
5824	86	0	0	0	0	86
5825	0	85	0	0	0	85
5826	84	0	0	0	0	84
5827	85	0	0	0	0	85
5828	84	0	0	0	0	84
5829	0	0	79	0	0	79
5830	0	0	0	85	0	85
5831	0	79	0	0	0	79
5832	0	86	0	0	0	86
5833	1	0	0	86	0	87
5834	0	81	0	0	0	81
5835	87	0	0	0	0	87
5836	0	0	85	0	0	85
5837	89	0	0	0	0	89
5838	95	0	0	0	0	95
5839	0	0	0	96	0	96
5840	95	0	0	0	0	95
5841	0	94	0	0	0	94
5842	97	0	0	0	0	97
5843	94	0	0	0	0	94
5844	94	0	0	0	0	94
5845	0	0	93	0	0	93
5846	0	0	91	0	0	91
5847	0	0	0	97	0	97
5848	0	87	0	1	0	88
5849	0	94	0	0	0	94
5850	0	0	0	93	0	93
5851	93	0	0	0	0	93
5852	0	1	0	89	0	90
5853	0	0	0	91	0	91
5854	85	0	0	0	0	85
5855	0	85	0	0	0	85
5856	0	0	83	0	0	83
5857	0	1	85	0	0	86
5858	90	0	0	0	0	90
5859	0	0	0	86	0	86
5860	0	0	91	0	0	91
5861	0	0	0	89	0	89
5862	0	0	0	90	0	90
5863	0	0	0	95	0	95
5864	0	0	0	90	0	90
5865	0	86	0	0	0	86
5866	0	0	0	89	0	89
5867	89	0	0	0	0	89
5868	0	85	0	0	0	85
5869	88	0	0	0	0	88
5870	86	0	0	0	0	86
5871	87	0	0	0	0	87
5872	0	0	85	0	0	85
5873	90	0	0	0	0	90
5874	90	0	0	0	0	90
5875	91	0	0	0	0	91
5876	89	0	0	0	0	89
5877	0	87	0	0	0	87
5878	93	0	0	0	0	93
5879	0	0	95	0	0	95
5880	1	0	0	87	0	88
5881	0	0	0	92	0	92
5882	95	0	0	0	0	95
5883	0	88	0	0	0	88
5884	85	0	0	0	0	85
5885	0	84	0	0	0	84
5886	85	0	0	0	0	85
5887	81	0	0	0	0	81
5888	0	91	0	0	0	91
5889	93	0	0	0	0	93
5890	96	0	0	0	0	96
5891	0	84	0	0	0	84
5892	0	94	0	0	0	94
5893	98	0	0	0	0	98
5894	0	0	0	98	0	98
5895	102	0	0	0	0	102
5896	99	0	0	0	0	99
5897	103	0	0	0	0	103
5898	99	0	0	0	0	99
5899	0	90	0	0	0	90
5900	2	95	0	1	0	98
5901	100	0	0	0	0	100
5902	0	0	97	0	0	97
5903	1	0	0	99	0	100
5904	0	0	0	96	0	96
5905	94	0	0	0	0	94
5906	0	93	0	0	0	93
5907	0	0	0	92	0	92
5908	0	0	0	90	0	90
5909	89	0	0	0	0	89
5910	0	0	0	85	0	85
5911	91	0	0	0	0	91
5912	96	0	0	0	0	96
5913	96	0	0	0	0	96
5914	0	0	0	95	0	95
5915	0	0	0	95	0	95
5916	0	0	104	0	0	104
5917	0	0	100	0	0	100
5918	104	0	0	0	0	104
5919	0	0	0	104	0	104
5920	0	0	101	0	0	101
5921	0	0	99	0	0	99
5922	0	0	0	101	0	101
5923	0	0	109	0	0	109
5924	0	0	0	106	0	106
5925	0	0	0	104	0	104
5926	0	0	105	0	0	105
5927	0	0	0	104	0	104
5928	0	0	0	104	0	104
5929	0	0	0	102	0	102
5930	0	0	98	0	0	98
5931	0	0	0	96	0	96
5932	95	0	0	0	0	95
5933	0	96	0	0	0	96
5934	96	0	0	0	0	96
5935	0	0	95	0	0	95
5936	94	0	0	0	0	94
5937	92	0	0	0	0	92
5938	90	0	0	0	0	90
5939	1	0	0	88	0	89
5940	0	0	0	91	0	91
5941	0	0	88	0	0	88
5942	89	0	0	0	0	89
5943	0	85	0	0	0	85
5944	0	76	0	0	0	76
5945	1	85	0	0	0	86
5946	0	0	0	93	0	93
5947	93	0	0	0	0	93
5948	91	0	0	0	0	91
5949	0	0	92	0	0	92
5950	0	0	0	87	0	87
5951	0	0	0	90	0	90
5952	0	0	90	0	0	90
5953	0	0	80	0	0	80
5954	87	0	0	0	0	87
5955	0	83	0	0	0	83
5956	84	0	0	0	0	84
5957	88	0	0	0	0	88
5958	0	0	0	90	0	90
5959	0	0	0	89	0	89
5960	89	0	0	0	0	89
5961	0	0	0	85	0	85
5962	0	0	0	88	0	88
5963	90	0	0	0	0	90
5964	0	0	0	86	0	86
5965	88	0	0	0	0	88
5966	87	0	0	0	0	87
5967	0	0	85	0	0	85
5968	83	0	0	1	0	84
5969	84	0	0	0	0	84
5970	84	0	0	0	0	84
5971	0	1	67	0	0	68
5972	77	0	0	0	0	77
5973	0	78	0	0	0	78
5974	79	0	0	0	0	79
5975	77	0	0	0	0	77
5976	0	0	1	76	0	77
5977	0	0	0	82	0	82
5978	0	75	0	0	0	75
5979	0	0	0	77	0	77
5980	0	0	0	77	0	77
5981	73	0	0	0	0	73
5982	0	0	0	64	0	64
5983	0	0	0	64	0	64
5984	0	0	0	68	0	68
5985	0	64	0	0	0	64
5986	59	0	0	0	0	59
5987	0	60	0	0	0	60
5988	63	0	0	0	0	63
5989	0	0	62	0	0	62
5990	58	0	0	0	0	58
5991	0	0	60	0	0	60
5992	0	62	0	0	0	62
5993	60	0	0	0	0	60
5994	57	0	0	0	0	57
5995	0	54	0	1	0	55
5996	0	59	0	0	0	59
5997	55	0	0	0	0	55
5998	62	0	0	0	0	62
5999	0	0	0	63	0	63
6000	0	0	0	62	0	62
6001	0	0	60	0	0	60
6002	61	0	0	0	0	61
6003	0	0	0	62	0	62
6004	0	60	0	0	0	60
6005	0	0	0	50	0	50
6006	0	0	0	53	0	53
6007	0	0	48	0	0	48
6008	0	0	0	51	0	51
6009	50	0	0	0	0	50
6010	0	43	0	0	0	43
6011	0	48	0	0	0	48
6012	50	0	0	0	0	50
6013	49	0	0	0	0	49
6014	48	0	0	0	0	48
6015	0	44	0	0	0	44
6016	0	39	0	0	0	39
6017	46	0	0	0	0	46
6018	43	0	0	0	0	43
6019	0	41	0	0	0	41
6020	0	38	0	0	0	38
6021	42	0	0	0	0	42
6022	0	0	0	43	0	43
6023	44	0	0	0	0	44
6024	0	0	0	46	0	46
6025	1	39	0	0	0	40
6026	0	41	0	0	0	41
6027	41	0	0	0	0	41
6028	40	0	0	0	0	40
6029	39	0	0	0	0	39
6030	0	40	0	0	0	40
6031	1	0	38	0	0	39
6032	0	41	0	0	0	41
6033	46	0	0	0	0	46
6034	45	0	0	0	0	45
6035	0	0	42	0	0	42
6036	0	41	0	0	0	41
6037	0	0	0	43	0	43
6038	0	0	0	45	0	45
6039	0	44	0	0	0	44
6040	0	0	47	0	0	47
6041	45	0	0	0	0	45
6042	0	0	0	44	0	44
6043	46	0	0	0	0	46
6044	47	0	0	0	0	47
6045	0	0	0	51	0	51
6046	0	0	0	47	0	47
6047	1	0	0	47	0	48
6048	0	0	0	53	0	53
6049	53	0	0	0	0	53
6050	49	0	0	0	0	49
6051	0	0	46	0	0	46
6052	0	0	0	49	0	49
6053	0	0	0	50	0	50
6054	0	0	0	47	0	47
6055	0	0	45	0	0	45
6056	0	0	0	49	0	49
6057	47	0	0	0	0	47
6058	0	0	0	47	0	47
6059	0	0	47	0	0	47
6060	0	0	0	47	0	47
6061	0	0	49	0	0	49
6062	46	0	0	0	0	46
6063	0	0	0	47	0	47
6064	46	0	0	0	0	46
6065	46	0	0	0	0	46
6066	0	0	0	48	0	48
6067	46	0	0	0	0	46
6068	0	0	0	49	0	49
6069	0	47	0	0	0	47
6070	47	0	0	0	0	47
6071	48	0	0	0	0	48
6072	47	0	0	0	0	47
6073	0	0	0	47	0	47
6074	0	0	0	47	0	47
6075	0	0	0	50	0	50
6076	0	0	47	0	0	47
6077	0	41	0	1	0	42
6078	0	0	0	49	0	49
6079	0	0	46	0	0	46
6080	49	0	0	0	0	49
6081	0	0	0	50	0	50
6082	0	0	47	0	0	47
6083	50	0	0	0	0	50
6084	0	0	0	45	0	45
6085	0	0	0	45	0	45
6086	0	0	0	45	0	45
6087	45	0	1	0	0	46
6088	46	0	0	0	0	46
6089	45	0	0	0	0	45
6090	0	44	0	0	0	44
6091	0	42	0	0	0	42
6092	47	0	0	0	0	47
6093	0	0	46	0	0	46
6094	0	0	0	42	0	42
6095	0	0	0	48	0	48
6096	51	0	0	0	0	51
6097	52	0	0	0	0	52
6098	0	49	0	0	0	49
6099	0	0	0	54	0	54
6100	0	0	53	0	0	53
6101	2	1	44	0	0	47
6102	0	0	0	47	0	47
6103	0	0	0	52	0	52
6104	49	0	0	0	0	49
6105	0	0	0	54	0	54
6106	55	0	0	0	0	55
6107	56	0	0	0	0	56
6108	0	0	56	1	0	57
6109	56	0	0	0	0	56
6110	54	0	0	0	0	54
6111	55	0	0	0	0	55
6112	0	54	0	0	0	54
6113	0	53	0	1	0	54
6114	0	0	0	56	0	56
6115	0	0	54	0	0	54
6116	0	55	0	0	0	55
6117	0	0	0	58	0	58
6118	0	0	0	60	0	60
6119	0	59	0	0	0	59
6120	62	0	0	0	0	62
6121	61	0	0	0	0	61
6122	0	0	58	0	0	58
6123	60	0	0	0	0	60
6124	0	0	57	0	0	57
6125	58	0	0	0	0	58
6126	0	0	58	0	0	58
6127	0	54	0	0	0	54
6128	0	0	0	59	0	59
6129	0	0	0	61	0	61
6130	59	0	0	0	0	59
6131	64	0	0	0	0	64
6132	61	0	0	0	0	61
6133	0	0	65	0	0	65
6134	0	0	0	62	0	62
6135	0	0	0	68	0	68
6136	60	0	0	0	0	60
6137	1	66	0	0	0	67
6138	67	0	0	0	0	67
6139	0	0	0	68	0	68
6140	1	0	0	66	0	67
6141	0	0	0	66	0	66
6142	0	0	0	68	0	68
6143	0	0	0	66	0	66
6144	0	59	0	0	0	59
6145	0	66	0	0	0	66
6146	0	66	0	0	0	66
6147	0	0	0	69	0	69
6148	0	0	74	0	0	74
6149	76	0	0	0	0	76
6150	0	72	0	0	0	72
6151	0	0	0	77	0	77
6152	0	0	0	76	0	76
6153	76	0	0	0	0	76
6154	73	0	0	0	0	73
6155	73	0	0	0	0	73
6156	0	0	0	75	0	75
6157	0	0	75	0	0	75
6158	0	0	72	0	0	72
6159	0	0	0	78	0	78
6160	0	0	76	0	0	76
6161	77	0	0	0	0	77
6162	0	0	0	76	0	76
6163	0	0	76	0	0	76
6164	0	0	0	75	0	75
6165	0	0	75	0	0	75
6166	0	0	68	0	0	68
6167	0	0	0	78	0	78
6168	0	0	74	0	0	74
6169	0	0	73	0	0	73
6170	0	64	0	0	0	64
6171	0	0	0	76	0	76
6172	76	0	0	0	0	76
6173	0	0	0	74	0	74
6174	0	0	0	75	0	75
6175	0	0	72	0	0	72
6176	74	0	0	0	0	74
6177	0	0	1	74	0	75
6178	0	0	0	77	0	77
6179	76	0	0	0	0	76
6180	0	0	0	73	0	73
6181	79	0	0	0	0	79
6182	80	0	0	0	0	80
6183	74	0	0	0	0	74
6184	0	77	0	0	0	77
6185	78	0	0	0	0	78
6186	0	74	0	0	0	74
6187	0	0	0	75	0	75
6188	71	0	0	0	0	71
6189	0	75	0	0	0	75
6190	71	0	0	0	0	71
6191	0	72	0	0	0	72
6192	72	0	0	0	0	72
6193	0	68	0	0	0	68
6194	0	66	0	0	0	66
6195	0	70	0	0	0	70
6196	0	0	0	69	0	69
6197	0	68	0	0	0	68
6198	0	0	0	66	0	66
6199	0	0	0	63	0	63
6200	0	0	0	64	0	64
6201	0	0	0	65	0	65
6202	66	0	0	0	0	66
6203	68	0	0	0	0	68
6204	0	0	68	0	0	68
6205	69	0	0	0	0	69
6206	73	0	0	0	0	73
6207	73	0	0	0	0	73
6208	0	0	63	0	0	63
6209	0	0	66	0	0	66
6210	70	0	0	0	0	70
6211	0	0	63	0	0	63
6212	0	68	0	0	0	68
6213	0	0	0	73	0	73
6214	74	0	0	0	0	74
6215	74	0	0	0	0	74
6216	70	0	0	0	0	70
6217	0	0	0	75	0	75
6218	0	0	0	72	0	72
6219	0	0	76	0	0	76
6220	0	0	0	75	0	75
6221	2	0	0	76	0	78
6222	71	0	0	0	0	71
6223	0	76	0	0	0	76
6224	77	0	0	2	0	79
6225	0	0	0	77	0	77
6226	72	0	0	0	0	72
6227	74	0	0	1	0	75
6228	70	0	0	0	0	70
6229	0	63	0	0	0	63
6230	0	65	0	1	0	66
6231	0	0	0	66	0	66
6232	73	0	0	0	0	73
6233	0	0	0	67	0	67
6234	0	0	0	73	0	73
6235	0	0	72	0	0	72
6236	2	0	0	71	0	73
6237	0	0	0	73	0	73
6238	0	0	0	79	0	79
6239	0	0	75	0	0	75
6240	0	0	65	0	0	65
6241	0	72	0	0	0	72
6242	73	0	0	0	0	73
6243	0	0	0	70	0	70
6244	0	0	70	0	0	70
6245	0	0	0	71	0	71
6246	1	0	0	71	0	72
6247	75	0	0	0	0	75
6248	73	0	0	0	0	73
6249	0	75	0	0	0	75
6250	75	0	0	1	0	76
6251	74	0	0	0	0	74
6252	0	0	0	74	0	74
6253	0	0	73	0	0	73
6254	1	69	0	0	0	70
6255	74	0	0	0	0	74
6256	71	0	0	0	0	71
6257	0	71	0	0	0	71
6258	0	0	0	76	0	76
6259	77	0	0	0	0	77
6260	77	0	0	0	0	77
6261	1	0	0	76	0	77
6262	80	0	0	0	0	80
6263	84	0	0	0	0	84
6264	80	0	0	0	0	80
6265	0	0	82	0	0	82
6266	0	73	0	0	0	73
6267	0	81	0	0	0	81
6268	82	0	0	0	0	82
6269	0	85	0	0	0	85
6270	0	0	82	0	0	82
6271	1	0	0	81	0	82
6272	88	0	0	0	0	88
6273	0	0	0	82	0	82
6274	83	0	0	0	0	83
6275	80	0	0	0	0	80
6276	85	0	0	0	0	85
6277	0	77	0	0	0	77
6278	0	86	0	0	0	86
6279	88	0	0	0	0	88
6280	87	0	0	0	0	87
6281	90	0	0	0	0	90
6282	0	0	0	87	0	87
6283	88	0	0	0	0	88
6284	0	82	0	0	0	82
6285	0	82	0	0	0	82
6286	0	0	0	87	0	87
6287	0	0	82	0	0	82
6288	1	0	83	0	0	84
6289	0	0	0	83	0	83
6290	0	1	86	0	0	87
6291	0	0	0	86	0	86
6292	89	0	0	0	0	89
6293	0	0	0	89	0	89
6294	88	0	0	0	0	88
6295	0	85	0	0	0	85
6296	0	0	81	0	0	81
6297	0	0	0	80	0	80
6298	0	0	0	82	0	82
6299	0	0	76	0	0	76
6300	0	0	0	80	0	80
6301	0	81	0	0	0	81
6302	0	0	0	77	0	77
6303	0	0	0	77	0	77
6304	0	0	0	77	0	77
6305	0	0	74	0	0	74
6306	0	0	68	1	0	69
6307	76	0	0	0	0	76
6308	0	0	74	0	0	74
6309	0	74	0	0	0	74
6310	75	0	0	0	0	75
6311	0	78	0	0	0	78
6312	75	0	0	0	0	75
6313	78	0	0	0	0	78
6314	74	0	0	0	0	74
6315	79	0	0	0	0	79
6316	0	69	0	0	0	69
6317	0	76	0	0	0	76
6318	79	0	0	0	0	79
6319	0	0	76	0	0	76
6320	0	0	0	80	0	80
6321	0	0	0	76	0	76
6322	0	0	75	0	0	75
6323	77	0	0	0	0	77
6324	77	0	0	0	0	77
6325	75	0	0	0	0	75
6326	0	71	0	0	0	71
6327	77	0	0	0	0	77
6328	0	0	0	74	0	74
6329	0	71	0	0	0	71
6330	76	0	0	0	0	76
6331	72	0	0	0	0	72
6332	73	0	0	0	0	73
6333	0	0	0	68	0	68
6334	0	0	0	73	0	73
6335	0	70	0	0	0	70
6336	0	0	76	0	0	76
6337	0	0	1	74	0	75
6338	0	0	0	77	0	77
6339	0	0	0	83	0	83
6340	0	0	79	0	0	79
6341	79	0	0	0	0	79
6342	0	0	0	79	0	79
6343	0	0	77	0	0	77
6344	0	0	0	80	0	80
6345	78	0	0	0	0	78
6346	0	79	0	0	0	79
6347	0	0	0	81	0	81
6348	0	0	80	0	0	80
6349	83	0	0	0	0	83
6350	83	0	0	0	0	83
6351	0	0	80	0	0	80
6352	0	0	0	81	0	81
6353	0	80	0	0	0	80
6354	81	0	0	0	0	81
6355	0	0	78	0	0	78
6356	76	0	0	0	0	76
6357	0	0	74	0	0	74
6358	0	0	68	0	0	68
6359	70	0	0	0	0	70
6360	0	67	0	0	0	67
6361	0	0	65	0	0	65
6362	0	70	0	0	0	70
6363	0	0	66	0	0	66
6364	0	69	0	0	0	69
6365	74	0	0	0	0	74
6366	0	0	73	0	0	73
6367	0	0	66	0	0	66
6368	0	0	67	0	0	67
6369	73	0	0	0	0	73
6370	73	0	0	0	0	73
6371	0	0	0	75	0	75
6372	0	0	72	0	0	72
6373	0	0	76	0	0	76
6374	82	0	0	0	0	82
6375	0	0	0	80	0	80
6376	82	0	0	0	0	82
6377	82	0	0	0	0	82
6378	0	0	0	87	0	87
6379	0	84	0	0	0	84
6380	0	0	0	89	0	89
6381	0	0	0	83	0	83
6382	0	0	83	0	0	83
6383	0	75	0	0	0	75
6384	0	80	0	0	0	80
6385	0	0	0	85	0	85
6386	0	0	83	0	0	83
6387	0	82	0	0	0	82
6388	0	0	86	0	0	86
6389	89	0	0	0	0	89
6390	93	0	0	0	0	93
6391	0	0	91	0	0	91
6392	94	0	0	0	0	94
6393	0	0	0	92	0	92
6394	0	92	0	0	0	92
6395	0	0	0	95	0	95
6396	95	0	0	0	0	95
6397	92	0	0	0	0	92
6398	93	0	0	0	0	93
6399	94	0	0	0	0	94
6400	0	98	0	0	0	98
6401	0	95	0	0	0	95
6402	100	0	0	0	0	100
6403	0	0	103	0	0	103
6404	0	0	0	99	0	99
6405	0	99	0	0	0	99
6406	0	0	0	102	0	102
6407	0	105	0	0	0	105
6408	0	0	0	105	0	105
6409	0	0	105	0	0	105
6410	107	0	0	0	0	107
6411	113	0	0	0	0	113
6412	0	0	111	0	0	111
6413	113	0	0	0	0	113
6414	115	0	0	0	0	115
6415	0	0	115	0	0	115
6416	0	0	1	110	0	111
6417	115	0	0	0	0	115
6418	0	0	113	0	0	113
6419	0	0	0	116	0	116
6420	0	0	116	0	0	116
6421	0	0	118	0	0	118
6422	123	0	0	0	0	123
6423	122	0	0	0	0	122
6424	118	0	0	0	0	118
6425	121	0	0	0	0	121
6426	0	0	0	123	0	123
6427	0	112	0	0	0	112
6428	1	118	0	0	0	119
6429	0	0	0	121	0	121
6430	122	0	0	0	0	122
6431	0	110	0	0	0	110
6432	0	115	0	0	0	115
6433	118	0	0	0	0	118
6434	0	0	0	113	0	113
6435	113	0	0	0	0	113
6436	0	114	0	0	0	114
6437	117	0	0	0	0	117
6438	0	0	115	0	0	115
6439	124	0	0	0	0	124
6440	116	0	0	0	0	116
6441	120	0	0	0	0	120
6442	0	0	109	0	0	109
6443	119	0	0	0	0	119
6444	0	117	0	0	0	117
6445	0	0	116	0	0	116
6446	0	0	0	120	0	120
6447	0	0	0	121	0	121
6448	0	123	0	1	0	124
6449	0	0	0	123	0	123
6450	0	0	0	124	0	124
6451	0	0	123	0	0	123
6452	123	0	0	0	0	123
6453	0	0	125	0	0	125
6454	0	0	0	122	0	122
6455	0	0	131	0	0	131
6456	2	0	0	125	0	127
6457	127	0	0	0	0	127
6458	127	0	0	0	0	127
6459	0	4	0	124	0	128
6460	0	0	121	4	0	125
6461	0	0	0	126	0	126
6462	0	0	126	0	0	126
6463	128	0	0	0	0	128
6464	120	0	0	0	0	120
6465	121	0	0	0	0	121
6466	120	0	0	0	0	120
6467	0	111	0	0	0	111
6468	0	0	0	114	0	114
6469	112	0	0	0	0	112
6470	0	102	0	1	0	103
6471	0	104	0	0	0	104
6472	1	0	104	0	0	105
6473	108	0	0	0	0	108
6474	109	0	0	0	0	109
6475	0	1	108	0	0	109
6476	0	0	0	105	0	105
6477	0	0	0	105	0	105
6478	0	0	107	0	0	107
6479	0	0	0	110	0	110
6480	111	0	0	0	0	111
6481	0	0	102	0	0	102
6482	0	1	106	0	0	107
6483	108	0	0	0	0	108
6484	0	0	103	0	0	103
6485	104	0	0	1	0	105
6486	0	101	0	0	0	101
6487	107	0	0	0	0	107
6488	0	0	0	107	0	107
6489	0	0	0	106	0	106
6490	108	0	0	0	0	108
6491	0	0	1	102	0	103
6492	99	0	0	1	0	100
6493	0	94	0	1	0	95
6494	0	0	0	97	0	97
6495	0	0	0	101	0	101
6496	102	0	0	0	0	102
6497	97	1	0	0	0	98
6498	100	0	0	0	0	100
6499	0	95	0	1	0	96
6500	0	93	0	0	0	93
6501	99	0	0	0	0	99
6502	0	0	95	0	0	95
6503	0	90	0	0	0	90
6504	91	0	0	0	0	91
6505	90	0	0	0	0	90
6506	86	0	0	0	0	86
6507	0	0	0	85	0	85
6508	84	0	0	0	0	84
6509	80	0	0	0	0	80
6510	0	0	0	83	0	83
6511	85	0	0	0	0	85
6512	0	0	84	0	0	84
6513	0	0	0	80	0	80
6514	0	0	0	80	0	80
6515	0	1	0	78	0	79
6516	82	0	0	0	0	82
6517	82	0	0	0	0	82
6518	85	0	0	0	0	85
6519	85	0	0	0	0	85
6520	80	0	1	0	0	81
6521	0	0	0	81	0	81
6522	0	0	0	85	0	85
6523	85	0	0	0	0	85
6524	0	81	0	0	0	81
6525	87	0	0	0	0	87
6526	0	0	84	0	0	84
6527	84	0	0	0	0	84
6528	85	0	0	1	0	86
6529	0	1	82	0	0	83
6530	85	0	0	0	0	85
6531	0	0	78	0	0	78
6532	0	0	79	0	0	79
6533	0	0	0	81	0	81
6534	0	0	0	87	0	87
6535	0	0	81	0	0	81
6536	1	1	81	0	0	83
6537	1	76	0	0	0	77
6538	0	83	0	0	0	83
6539	83	0	0	0	0	83
6540	0	84	0	0	0	84
6541	82	0	0	0	0	82
6542	0	84	0	0	0	84
6543	86	0	0	0	0	86
6544	0	0	82	0	0	82
6545	85	0	0	0	0	85
6546	0	0	0	82	0	82
6547	0	81	1	0	0	82
6548	0	0	0	85	0	85
6549	83	0	0	0	0	83
6550	80	0	0	0	0	80
6551	0	0	0	81	0	81
6552	0	0	80	0	0	80
6553	0	0	75	0	0	75
6554	0	73	0	0	0	73
6555	0	0	0	78	0	78
6556	0	0	72	0	0	72
6557	0	68	0	0	0	68
6558	0	0	0	72	0	72
6559	0	0	0	73	0	73
6560	74	0	0	0	0	74
6561	0	0	0	74	0	74
6562	0	0	72	0	0	72
6563	0	0	0	76	0	76
6564	74	0	0	0	0	74
6565	0	0	67	0	0	67
6566	68	0	0	0	0	68
6567	0	68	0	0	0	68
6568	77	0	0	0	0	77
6569	74	0	0	0	0	74
6570	0	0	0	76	0	76
6571	0	0	0	77	0	77
6572	0	75	0	0	0	75
6573	0	0	0	77	0	77
6574	74	0	0	0	0	74
6575	0	0	76	0	0	76
6576	0	0	0	75	0	75
6577	0	75	0	0	0	75
6578	0	0	0	76	0	76
6579	0	0	0	75	0	75
6580	72	0	0	0	0	72
6581	0	75	0	0	0	75
6582	0	0	0	77	0	77
6583	77	0	0	0	0	77
6584	0	0	1	77	0	78
6585	0	0	0	74	0	74
6586	74	0	0	0	0	74
6587	74	0	0	0	0	74
6588	0	0	66	0	0	66
6589	72	0	0	0	0	72
6590	66	0	0	0	0	66
6591	68	0	0	0	0	68
6592	0	67	0	0	0	67
6593	0	71	0	0	0	71
6594	0	0	0	70	0	70
6595	69	0	0	0	0	69
6596	68	0	0	0	0	68
6597	0	0	0	70	0	70
6598	0	0	61	0	0	61
6599	65	0	0	0	0	65
6600	64	0	0	0	0	64
6601	0	0	0	67	0	67
6602	0	0	0	65	0	65
6603	64	0	0	0	0	64
6604	0	0	0	68	0	68
6605	0	67	0	0	0	67
6606	0	0	0	73	0	73
6607	72	0	0	0	0	72
6608	0	0	66	1	0	67
6609	68	0	0	0	0	68
6610	0	0	62	0	0	62
6611	0	0	0	70	0	70
6612	68	0	0	0	0	68
6613	0	0	0	69	0	69
6614	0	0	0	68	0	68
6615	69	0	0	0	0	69
6616	0	0	66	0	0	66
6617	0	0	63	0	0	63
6618	0	0	0	68	0	68
6619	0	0	0	70	0	70
6620	0	0	0	70	0	70
6621	0	0	63	0	0	63
6622	65	0	0	0	0	65
6623	64	0	0	0	0	64
6624	61	0	0	0	0	61
6625	61	0	0	0	0	61
6626	0	57	0	0	0	57
6627	0	52	0	0	0	52
6628	0	54	0	0	0	54
6629	0	0	0	58	0	58
6630	0	0	0	59	0	59
6631	0	0	57	0	0	57
6632	0	51	0	0	0	51
6633	0	0	0	54	0	54
6634	51	0	0	0	0	51
6635	0	55	0	0	0	55
6636	0	0	0	54	0	54
6637	0	53	0	0	0	53
6638	55	0	0	0	0	55
6639	0	0	0	53	0	53
6640	0	0	50	0	0	50
6641	0	0	51	1	0	52
6642	0	0	0	54	0	54
6643	0	0	0	55	0	55
6644	0	0	0	54	0	54
6645	53	0	0	0	0	53
6646	0	0	46	0	0	46
6647	0	49	0	0	0	49
6648	0	0	0	51	0	51
6649	0	0	49	0	0	49
6650	0	50	0	0	0	50
6651	0	0	0	52	0	52
6652	0	0	51	0	0	51
6653	0	0	0	52	0	52
6654	0	0	0	55	0	55
6655	53	0	0	0	0	53
6656	53	0	0	1	0	54
6657	0	0	0	52	0	52
6658	50	0	0	0	0	50
6659	0	0	48	0	0	48
6660	0	0	0	48	0	48
6661	0	0	43	0	0	43
6662	0	0	0	45	0	45
6663	0	35	2	0	0	37
6664	0	37	0	0	0	37
6665	0	41	0	0	0	41
6666	0	0	0	41	0	41
6667	0	0	0	40	0	40
6668	0	0	37	0	0	37
6669	1	0	37	0	0	38
6670	0	0	37	0	0	37
6671	39	0	0	1	0	40
6672	0	0	0	42	0	42
6673	41	0	0	0	0	41
6674	0	38	0	0	0	38
6675	0	0	0	40	0	40
6676	38	0	0	0	0	38
6677	0	0	0	40	0	40
6678	43	0	0	0	0	43
6679	0	0	43	0	0	43
6680	0	43	0	0	0	43
6681	0	0	0	46	0	46
6682	43	0	0	0	0	43
6683	46	0	0	0	0	46
6684	0	0	0	42	0	42
6685	0	0	0	42	0	42
6686	40	0	0	0	0	40
6687	0	0	0	42	0	42
6688	0	0	42	0	0	42
6689	0	43	0	0	0	43
6690	0	0	0	44	0	44
6691	42	0	0	0	0	42
6692	36	0	0	0	0	36
6693	0	0	41	0	0	41
6694	0	39	0	0	0	39
6695	0	40	0	0	0	40
6696	0	0	0	44	0	44
6697	0	0	0	42	0	42
6698	0	0	0	40	0	40
6699	0	0	0	40	0	40
6700	0	38	0	0	0	38
6701	0	0	0	38	0	38
6702	0	0	0	37	0	37
6703	37	0	0	0	0	37
6704	37	0	0	0	0	37
6705	0	39	0	0	0	39
6706	40	0	0	0	0	40
6707	39	0	0	0	0	39
6708	41	0	0	0	0	41
6709	0	0	40	0	0	40
6710	0	0	0	41	0	41
6711	0	0	0	42	0	42
6712	0	0	42	0	0	42
6713	0	0	0	42	0	42
6714	0	0	0	43	0	43
6715	43	0	0	0	0	43
6716	0	0	44	0	0	44
6717	0	0	0	45	0	45
6718	42	0	0	0	0	42
6719	0	44	0	0	0	44
6720	44	0	0	0	0	44
6721	43	0	0	0	0	43
6722	0	41	0	0	0	41
6723	0	0	0	44	0	44
6724	44	0	0	0	0	44
6725	0	43	0	0	0	43
6726	0	0	0	44	0	44
6727	46	0	0	0	0	46
6728	43	0	0	1	0	44
6729	0	45	0	0	0	45
6730	47	0	0	0	0	47
6731	0	0	0	47	0	47
6732	47	0	0	0	0	47
6733	0	0	43	0	0	43
6734	0	0	0	43	0	43
6735	0	0	0	47	0	47
6736	46	0	0	0	0	46
6737	0	46	0	0	0	46
6738	44	0	0	0	0	44
6739	0	45	0	0	0	45
6740	0	0	44	0	0	44
6741	0	0	43	0	0	43
6742	0	0	0	48	0	48
6743	0	0	43	1	0	44
6744	0	0	0	47	0	47
6745	0	0	0	47	0	47
6746	0	0	0	47	0	47
6747	44	0	0	0	0	44
6748	44	0	0	0	0	44
6749	45	0	0	0	0	45
6750	0	40	0	0	0	40
6751	0	46	0	0	0	46
6752	0	0	46	0	0	46
6753	0	0	0	49	0	49
6754	0	0	53	0	0	53
6755	0	0	0	46	0	46
6756	0	0	0	55	0	55
6757	0	0	0	56	0	56
6758	0	0	56	0	0	56
6759	0	0	0	58	0	58
6760	57	0	0	0	0	57
6761	0	58	0	0	0	58
6762	0	0	0	62	0	62
6763	60	0	0	1	0	61
6764	59	0	0	0	0	59
6765	1	0	0	63	0	64
6766	0	0	0	63	0	63
6767	61	0	0	0	0	61
6768	0	0	0	59	0	59
6769	60	0	0	0	0	60
6770	0	0	0	63	0	63
6771	0	0	61	0	0	61
6772	0	52	0	0	0	52
6773	1	59	0	0	0	60
6774	0	0	0	60	0	60
6775	0	0	0	62	0	62
6776	60	0	0	0	0	60
6777	0	0	0	59	0	59
6778	1	0	0	65	0	66
6779	0	0	0	64	0	64
6780	0	61	0	0	0	61
6781	0	1	0	63	0	64
6782	0	0	0	66	0	66
6783	0	0	0	63	0	63
6784	63	0	0	0	0	63
6785	0	62	0	0	0	62
6786	0	0	0	60	0	60
6787	0	0	0	60	0	60
6788	0	0	0	60	0	60
6789	60	0	0	0	0	60
6790	0	0	0	56	0	56
6791	0	0	0	60	0	60
6792	0	0	57	0	0	57
6793	0	55	0	0	0	55
6794	0	0	0	59	0	59
6795	58	0	0	0	0	58
6796	0	61	0	0	0	61
6797	61	0	0	0	0	61
6798	58	0	0	0	0	58
6799	0	0	0	57	0	57
6800	0	0	0	58	0	58
6801	0	0	56	0	0	56
6802	0	0	0	56	0	56
6803	0	0	57	0	0	57
6804	0	0	0	58	0	58
6805	57	0	0	0	0	57
6806	0	57	0	0	0	57
6807	0	0	0	61	0	61
6808	0	0	0	62	0	62
6809	0	0	0	58	0	58
6810	0	0	0	63	0	63
6811	60	0	0	0	0	60
6812	0	63	0	0	0	63
6813	0	0	0	61	0	61
6814	62	0	0	0	0	62
6815	0	0	59	0	0	59
6816	60	0	0	0	0	60
6817	61	0	0	0	0	61
6818	0	0	61	0	0	61
6819	0	0	0	64	0	64
6820	62	0	0	0	0	62
6821	0	62	0	0	0	62
6822	63	0	0	0	0	63
6823	64	0	0	0	0	64
6824	64	0	0	0	0	64
6825	0	0	0	63	0	63
6826	0	0	0	66	0	66
6827	0	64	0	0	0	64
6828	0	0	0	71	0	71
6829	68	0	0	0	0	68
6830	0	0	65	0	0	65
6831	69	0	0	0	0	69
6832	74	0	0	0	0	74
6833	0	0	0	74	0	74
6834	0	0	0	73	0	73
6835	72	0	0	0	0	72
6836	77	0	0	0	0	77
6837	75	1	0	1	0	77
6838	0	0	70	1	0	71
6839	0	70	0	0	0	70
6840	79	0	0	0	0	79
6841	0	0	0	74	0	74
6842	0	72	0	0	0	72
6843	0	0	0	77	0	77
6844	77	0	0	0	0	77
6845	0	0	0	76	0	76
6846	0	2	64	0	0	66
6847	0	70	0	0	0	70
6848	0	78	0	0	0	78
6849	0	0	73	0	0	73
6850	78	0	0	0	0	78
6851	0	76	0	0	0	76
6852	0	0	0	76	0	76
6853	77	0	0	0	0	77
6854	0	71	0	0	0	71
6855	0	0	0	70	0	70
6856	68	0	0	0	0	68
6857	0	0	0	69	0	69
6858	72	0	0	0	0	72
6859	0	0	69	0	0	69
6860	0	71	0	0	0	71
6861	72	0	0	0	0	72
6862	72	0	0	0	0	72
6863	70	0	0	0	0	70
6864	1	1	61	0	0	63
6865	71	0	0	0	0	71
6866	70	0	0	0	0	70
6867	0	0	0	68	0	68
6868	73	0	0	0	0	73
6869	0	71	0	0	0	71
6870	0	0	0	74	0	74
6871	0	0	70	0	0	70
6872	0	0	0	69	0	69
6873	0	0	0	70	0	70
6874	70	0	0	0	0	70
6875	69	0	0	0	0	69
6876	0	0	65	0	0	65
6877	69	0	0	0	0	69
6878	0	0	71	0	0	71
6879	0	0	0	77	0	77
6880	0	0	76	0	0	76
6881	0	0	0	75	0	75
6882	0	73	0	0	0	73
6883	0	0	79	0	0	79
6884	0	0	74	0	0	74
6885	0	0	0	70	0	70
6886	78	0	0	0	0	78
6887	80	0	0	0	0	80
6888	77	0	0	0	0	77
6889	0	0	0	77	0	77
6890	0	0	0	76	0	76
6891	0	0	0	72	0	72
6892	0	0	0	73	0	73
6893	0	0	75	0	0	75
6894	0	0	0	73	0	73
6895	0	71	0	0	0	71
6896	0	0	0	76	0	76
6897	76	0	0	0	0	76
6898	0	0	72	0	0	72
6899	70	0	0	0	0	70
6900	0	0	65	0	0	65
6901	0	0	63	0	0	63
6902	0	64	0	0	0	64
6903	0	0	0	70	0	70
6904	0	0	0	74	0	74
6905	1	59	0	0	0	60
6906	72	0	0	0	0	72
6907	0	0	0	73	0	73
6908	0	0	0	75	0	75
6909	0	0	0	75	0	75
6910	77	0	0	0	0	77
6911	80	0	0	0	0	80
6912	0	0	0	82	0	82
6913	0	0	0	82	0	82
6914	83	0	0	0	0	83
6915	0	0	0	83	0	83
6916	0	0	0	83	0	83
6917	0	0	0	84	0	84
6918	0	0	80	0	0	80
6919	82	0	0	0	0	82
6920	82	0	0	0	0	82
6921	0	0	72	0	0	72
6922	0	0	0	81	0	81
6923	0	79	0	1	0	80
6924	81	0	0	0	0	81
6925	0	70	0	0	0	70
6926	0	72	0	0	0	72
6927	0	0	0	83	0	83
6928	81	0	0	0	0	81
6929	77	0	0	0	0	77
6930	0	0	0	75	0	75
6931	0	0	0	73	0	73
6932	1	0	0	73	0	74
6933	0	0	0	76	0	76
6934	0	0	0	77	0	77
6935	0	71	0	0	0	71
6936	0	0	1	80	0	81
6937	78	0	0	0	0	78
6938	81	0	0	0	0	81
6939	75	0	0	0	0	75
6940	0	69	1	0	0	70
6941	0	0	0	78	0	78
6942	0	0	73	0	0	73
6943	71	0	0	0	0	71
6944	0	0	0	71	0	71
6945	71	0	0	0	0	71
6946	68	0	0	0	0	68
6947	67	0	0	0	0	67
6948	0	0	0	68	0	68
6949	69	0	0	0	0	69
6950	0	0	0	70	0	70
6951	0	0	0	71	0	71
6952	66	0	0	0	0	66
6953	0	0	0	67	0	67
6954	66	0	0	0	0	66
6955	64	0	0	0	0	64
6956	0	0	0	68	0	68
6957	0	0	0	65	0	65
6958	0	0	0	68	0	68
6959	0	0	61	1	0	62
6960	0	0	61	0	0	61
6961	0	0	0	65	0	65
6962	1	0	0	67	0	68
6963	0	0	1	66	0	67
6964	0	0	0	69	0	69
6965	0	0	0	70	0	70
6966	69	0	0	1	0	70
6967	0	69	0	0	0	69
6968	1	0	0	66	0	67
6969	72	0	0	0	0	72
6970	0	0	0	73	0	73
6971	0	0	0	73	0	73
6972	66	0	0	0	0	66
6973	76	0	0	0	0	76
6974	0	0	67	0	0	67
6975	0	0	0	73	0	73
6976	0	0	66	0	0	66
6977	0	0	0	67	0	67
6978	1	0	0	63	0	64
6979	0	0	0	69	0	69
6980	0	0	69	0	0	69
6981	0	64	0	0	0	64
6982	0	68	0	0	0	68
6983	0	0	0	77	0	77
6984	74	0	0	0	0	74
6985	0	0	71	0	0	71
6986	0	0	70	0	0	70
6987	1	0	0	73	0	74
6988	0	0	0	74	0	74
6989	0	74	0	0	0	74
6990	0	0	0	76	0	76
6991	0	0	0	73	0	73
6992	0	0	0	76	0	76
6993	78	0	0	0	0	78
6994	77	0	0	0	0	77
6995	1	0	0	78	0	79
6996	0	76	0	0	0	76
6997	1	0	0	76	0	77
6998	72	0	0	1	0	73
6999	0	78	0	0	0	78
7000	0	0	0	78	0	78
7001	0	75	0	0	0	75
7002	77	0	0	0	0	77
7003	69	0	0	0	0	69
7004	0	70	1	0	0	71
7005	0	68	0	0	0	68
7006	1	0	69	0	0	70
7007	0	66	0	0	0	66
7008	0	0	0	74	0	74
7009	0	0	67	0	0	67
7010	0	69	0	0	0	69
7011	0	0	0	74	0	74
7012	0	0	0	71	0	71
7013	0	0	0	70	0	70
7014	72	0	0	0	0	72
7015	0	0	68	0	0	68
7016	0	0	67	1	0	68
7017	0	0	0	72	0	72
7018	0	0	69	0	0	69
7019	0	0	0	79	0	79
7020	0	0	0	72	0	72
7021	0	0	0	77	0	77
7022	0	0	0	80	0	80
7023	74	0	0	0	0	74
7024	80	0	0	0	0	80
7025	0	0	0	77	0	77
7026	0	0	77	0	0	77
7027	0	0	0	80	0	80
7028	0	82	0	0	0	82
7029	0	0	0	81	0	81
7030	79	0	0	0	0	79
7031	81	0	0	0	0	81
7032	0	0	0	78	0	78
7033	0	0	0	79	0	79
7034	0	0	0	81	0	81
7035	80	0	0	0	0	80
7036	0	0	76	0	0	76
7037	0	0	78	0	0	78
7038	0	81	0	0	0	81
7039	86	0	0	0	0	86
7040	0	0	0	86	0	86
7041	0	0	87	0	0	87
7042	0	80	0	0	0	80
7043	0	87	0	0	0	87
7044	1	0	0	89	0	90
7045	0	0	0	93	0	93
7046	0	95	0	0	0	95
7047	0	0	0	95	0	95
7048	0	0	0	94	0	94
7049	97	0	0	0	0	97
7050	0	94	1	0	0	95
7051	0	0	0	94	0	94
7052	0	0	92	0	0	92
7053	0	0	0	89	0	89
7054	89	0	0	0	0	89
7055	0	89	0	1	0	90
7056	0	0	0	91	0	91
7057	0	0	90	0	0	90
7058	0	0	89	0	0	89
7059	0	0	0	91	0	91
7060	0	0	0	93	0	93
7061	96	0	0	0	0	96
7062	0	90	0	0	0	90
7063	87	0	0	1	0	88
7064	0	0	87	0	0	87
7065	86	0	0	0	0	86
7066	0	0	85	0	0	85
7067	89	0	0	0	0	89
7068	90	0	0	1	0	91
7069	0	0	88	0	0	88
7070	0	0	83	1	0	84
7071	0	87	0	0	0	87
7072	0	0	0	87	0	87
7073	91	0	0	1	0	92
7074	0	0	0	91	0	91
7075	0	0	0	89	0	89
7076	0	0	0	88	0	88
7077	0	0	88	0	0	88
7078	84	0	0	1	0	85
7079	87	0	0	0	0	87
7080	0	88	0	0	0	88
7081	0	0	0	89	0	89
7082	0	89	0	0	0	89
7083	0	0	0	87	0	87
7084	89	0	0	0	0	89
7085	0	91	0	0	0	91
7086	0	0	0	90	0	90
7087	87	0	0	0	0	87
7088	91	0	0	0	0	91
7089	0	0	0	92	0	92
7090	0	0	91	0	0	91
7091	0	0	0	92	0	92
7092	1	85	0	0	0	86
7093	91	0	0	0	0	91
7094	0	89	0	0	0	89
7095	0	0	0	93	0	93
7096	90	0	0	0	0	90
7097	0	0	0	92	0	92
7098	0	0	0	94	0	94
7099	0	0	91	0	0	91
7100	0	94	0	0	0	94
7101	95	0	0	0	0	95
7102	85	0	0	1	0	86
7103	0	83	0	0	0	83
7104	0	90	0	0	0	90
7105	0	0	0	100	0	100
7106	98	0	0	0	0	98
7107	0	98	0	0	0	98
7108	0	0	0	101	0	101
7109	0	0	97	0	0	97
7110	0	0	0	97	0	97
7111	98	0	0	1	0	99
7112	0	93	0	0	0	93
7113	0	0	0	100	0	100
7114	0	0	88	0	0	88
7115	0	0	80	0	0	80
7116	0	0	0	94	0	94
7117	0	0	0	92	0	92
7118	0	90	0	0	0	90
7119	0	0	0	92	0	92
7120	91	0	0	0	0	91
7121	0	0	0	90	0	90
7122	86	0	0	2	0	88
7123	0	84	0	0	0	84
7124	0	85	0	0	0	85
7125	0	0	0	94	0	94
7126	0	0	0	90	0	90
7127	0	0	85	0	0	85
7128	0	0	0	89	0	89
7129	90	0	0	0	0	90
7130	0	0	87	0	0	87
7131	0	0	0	90	0	90
7132	0	1	90	0	0	91
7133	0	0	0	90	0	90
7134	0	0	2	88	0	90
7135	0	0	0	91	0	91
7136	0	0	85	0	0	85
7137	0	0	0	86	0	86
7138	0	83	0	0	0	83
7139	0	0	0	85	0	85
7140	0	0	0	89	0	89
7141	87	0	0	0	0	87
7142	0	0	86	0	0	86
7143	0	0	0	86	0	86
7144	0	0	80	0	0	80
7145	0	0	71	0	0	71
7146	0	0	0	82	0	82
7147	0	0	0	86	0	86
7148	0	0	0	88	0	88
7149	86	0	0	0	0	86
7150	0	0	85	0	0	85
7151	84	0	0	0	0	84
7152	0	0	0	85	0	85
7153	0	0	0	81	0	81
7154	0	82	0	0	0	82
7155	0	0	0	91	0	91
7156	0	0	0	84	0	84
7157	0	0	0	92	0	92
7158	87	0	0	0	0	87
7159	0	0	84	0	0	84
7160	79	1	0	1	0	81
7161	0	82	0	0	0	82
7162	81	0	0	1	0	82
7163	0	80	0	0	0	80
7164	0	82	0	0	0	82
7165	0	0	0	89	0	89
7166	78	0	0	1	0	79
7167	0	0	0	80	0	80
7168	0	73	0	0	0	73
7169	0	82	0	0	0	82
7170	0	0	0	87	0	87
7171	0	0	0	86	0	86
7172	0	81	0	0	0	81
7173	0	0	0	82	0	82
7174	0	0	0	82	0	82
7175	0	0	0	82	0	82
7176	87	0	0	0	0	87
7177	0	0	80	0	0	80
7178	86	0	0	0	0	86
7179	81	0	0	0	0	81
7180	82	0	0	0	0	82
7181	0	87	0	0	0	87
7182	0	0	0	80	0	80
7183	85	0	0	0	0	85
7184	0	0	0	83	0	83
7185	77	0	0	0	0	77
7186	0	81	0	0	0	81
7187	79	0	0	0	0	79
7188	83	0	0	0	0	83
7189	77	0	3	0	0	80
7190	0	0	0	85	0	85
7191	0	0	0	86	0	86
7192	84	0	0	0	0	84
7193	0	77	0	0	0	77
7194	0	77	0	1	0	78
7195	89	0	0	0	0	89
7196	0	0	0	86	0	86
7197	0	0	0	85	0	85
7198	0	0	0	85	0	85
7199	0	81	0	0	0	81
7200	82	0	0	0	0	82
7201	0	0	0	84	0	84
7202	0	78	0	0	0	78
7203	0	0	0	82	0	82
7204	0	0	0	82	0	82
7205	1	0	0	85	0	86
7206	0	1	0	82	0	83
7207	87	0	0	0	0	87
7208	85	0	0	0	0	85
7209	82	0	0	0	0	82
7210	0	0	0	86	0	86
7211	0	0	81	0	0	81
7212	0	1	67	0	0	68
7213	0	0	80	0	0	80
7214	88	0	0	0	0	88
7215	0	0	0	89	0	89
7216	0	0	4	89	0	93
7217	0	0	0	91	0	91
7218	93	0	0	1	0	94
7219	89	0	0	0	0	89
7220	0	95	0	0	0	95
7221	0	0	0	97	0	97
7222	1	0	89	0	0	90
7223	0	93	0	0	0	93
7224	0	0	0	96	0	96
7225	0	0	0	96	0	96
7226	1	0	0	99	0	100
7227	0	0	0	94	0	94
7228	0	0	96	0	0	96
7229	0	0	83	0	0	83
7230	0	87	0	0	0	87
7231	0	0	0	93	0	93
7232	0	0	0	95	0	95
7233	96	0	0	0	0	96
7234	0	0	94	0	0	94
7235	0	0	0	93	0	93
7236	0	0	0	95	0	95
7237	0	0	89	0	0	89
7238	0	94	0	0	0	94
7239	90	0	0	0	0	90
7240	0	0	92	0	0	92
7241	86	0	0	0	0	86
7242	0	0	85	0	0	85
7243	0	0	0	94	0	94
7244	0	0	88	0	0	88
7245	0	0	85	0	0	85
7246	0	0	0	88	0	88
7247	0	0	0	86	0	86
7248	0	0	0	92	0	92
7249	0	0	0	87	0	87
7250	0	0	0	86	0	86
7251	0	0	90	0	0	90
7252	1	0	81	0	0	82
7253	0	89	1	0	0	90
7254	90	0	0	0	0	90
7255	0	1	0	87	0	88
7256	88	0	0	0	0	88
7257	0	0	0	89	0	89
7258	86	0	0	1	0	87
7259	0	0	0	90	0	90
7260	0	0	0	90	0	90
7261	0	87	0	0	0	87
7262	0	0	0	87	0	87
7263	0	0	0	85	0	85
7264	0	0	0	87	0	87
7265	0	0	0	84	0	84
7266	0	84	0	0	0	84
7267	88	0	0	0	0	88
7268	0	84	0	0	0	84
7269	0	0	0	87	0	87
7270	86	0	0	0	0	86
7271	0	0	85	0	0	85
7272	0	0	92	0	0	92
7273	0	0	0	94	0	94
7274	0	0	0	101	0	101
7275	0	0	0	102	0	102
7276	0	0	0	103	0	103
7277	0	0	0	109	0	109
7278	0	109	0	0	0	109
7279	0	0	0	116	0	116
7280	115	0	0	0	0	115
7281	0	0	0	120	0	120
7282	0	0	124	0	0	124
7283	0	0	0	124	0	124
7284	117	0	0	0	0	117
7285	0	117	0	0	0	117
7286	0	0	0	125	0	125
7287	0	0	0	129	0	129
7288	0	0	123	0	0	123
7289	0	0	119	0	0	119
7290	120	0	0	0	0	120
7291	0	0	0	124	0	124
7292	0	0	0	124	0	124
7293	0	0	129	0	0	129
7294	0	0	125	0	0	125
7295	0	131	0	0	0	131
7296	0	0	0	144	0	144
7297	0	0	139	0	0	139
7298	0	142	0	0	0	142
7299	145	0	0	0	0	145
7300	138	1	0	0	0	139
7301	0	0	0	148	0	148
7302	0	141	0	0	0	141
7303	143	0	0	1	0	144
7304	0	0	0	145	0	145
7305	0	0	134	0	0	134
7306	0	136	0	0	0	136
7307	136	0	0	0	0	136
7308	134	0	0	0	0	134
7309	0	0	0	141	0	141
7310	0	0	0	144	0	144
7311	0	0	142	0	0	142
7312	0	0	0	139	0	139
7313	0	0	0	137	0	137
7314	0	0	0	138	0	138
7315	0	0	0	142	0	142
7316	0	0	0	137	0	137
7317	0	133	0	0	0	133
7318	136	0	0	0	0	136
7319	0	0	127	0	0	127
7320	0	129	0	0	0	129
7321	0	0	0	138	0	138
7322	137	0	0	0	0	137
7323	0	0	0	141	0	141
7324	0	0	0	136	0	136
7325	0	0	0	140	0	140
7326	0	0	0	140	0	140
7327	0	0	125	0	0	125
7328	0	134	0	1	0	135
7329	142	0	0	0	0	142
7330	0	0	135	0	0	135
7331	0	0	0	139	0	139
7332	133	0	0	0	0	133
7333	0	135	0	0	0	135
7334	137	0	0	0	0	137
7335	0	0	0	136	0	136
7336	0	0	0	136	0	136
7337	0	0	0	133	0	133
7338	0	0	0	132	0	132
7339	130	0	0	1	0	131
7340	0	0	0	128	0	128
7341	0	0	0	131	0	131
7342	133	0	0	0	0	133
7343	0	0	132	0	0	132
7344	0	0	0	132	0	132
7345	133	0	0	0	0	133
7346	135	0	0	0	0	135
7347	0	0	0	134	0	134
7348	0	0	0	132	0	132
7349	0	124	0	1	0	125
7350	0	0	0	135	0	135
7351	0	0	0	135	0	135
7352	0	0	131	0	0	131
7353	0	0	116	0	0	116
7354	1	128	0	0	0	129
7355	0	0	0	135	0	135
7356	0	0	0	138	0	138
7357	136	0	0	0	0	136
7358	0	0	0	137	0	137
7359	0	0	134	0	0	134
7360	0	0	0	134	0	134
7361	0	0	127	0	0	127
7362	0	0	131	0	0	131
7363	0	0	0	137	0	137
7364	0	0	0	127	0	127
7365	124	0	0	1	0	125
7366	119	0	0	0	0	119
7367	0	0	0	119	0	119
7368	110	0	0	0	0	110
7369	111	0	0	0	0	111
7370	0	1	0	105	0	106
7371	0	0	0	104	0	104
7372	101	0	0	0	0	101
7373	102	0	0	0	0	102
7374	0	0	0	98	0	98
7375	0	90	0	0	0	90
7376	0	0	0	89	0	89
7377	0	0	0	86	0	86
7378	0	0	87	0	0	87
7379	0	0	0	86	0	86
7380	79	0	0	0	0	79
7381	0	73	0	0	0	73
7382	78	0	0	0	0	78
7383	77	0	0	0	0	77
7384	75	0	0	0	0	75
7385	0	0	0	74	0	74
7386	0	0	68	0	0	68
7387	0	0	60	0	0	60
7388	0	55	0	0	0	55
7389	0	56	0	0	0	56
7390	0	57	0	0	0	57
7391	0	56	0	0	0	56
7392	0	0	59	0	0	59
7393	66	0	0	0	0	66
7394	0	0	0	65	0	65
7395	0	0	0	66	0	66
7396	0	0	0	67	0	67
7397	0	67	0	0	0	67
7398	65	0	0	0	0	65
7399	0	1	61	0	0	62
7400	0	65	0	0	0	65
7401	0	0	0	70	0	70
7402	66	0	0	0	0	66
7403	0	0	0	67	0	67
7404	0	0	64	0	0	64
7405	0	0	61	0	0	61
7406	1	0	0	58	0	59
7407	0	0	0	63	0	63
7408	65	0	0	0	0	65
7409	0	0	64	0	0	64
7410	59	0	0	0	0	59
7411	60	0	0	0	0	60
7412	0	0	0	65	0	65
7413	0	0	63	0	0	63
7414	0	0	0	66	0	66
7415	64	0	0	0	0	64
7416	0	68	0	0	0	68
7417	67	0	0	0	0	67
7418	0	0	0	64	0	64
7419	0	60	0	0	0	60
7420	0	0	0	64	0	64
7421	1	0	0	60	0	61
7422	0	60	0	0	0	60
7423	0	0	0	64	0	64
7424	0	0	0	68	0	68
7425	0	0	0	66	0	66
7426	0	0	66	0	0	66
7427	0	63	0	0	0	63
7428	64	0	0	0	0	64
7429	0	0	0	70	0	70
7430	0	71	0	0	0	71
7431	70	0	0	0	0	70
7432	0	0	0	74	0	74
7433	0	0	0	71	0	71
7434	1	0	0	70	0	71
7435	0	0	0	74	0	74
7436	72	0	0	0	0	72
7437	0	0	0	73	0	73
7438	0	0	0	71	0	71
7439	73	0	0	0	0	73
7440	0	0	0	69	0	69
7441	0	0	66	0	0	66
7442	0	0	0	65	0	65
7443	65	0	1	0	0	66
7444	0	0	0	63	0	63
7445	0	0	63	0	0	63
7446	0	0	55	2	0	57
7447	63	0	0	0	0	63
7448	66	0	0	0	0	66
7449	66	0	0	0	0	66
7450	66	0	0	0	0	66
7451	0	0	66	0	0	66
7452	0	0	0	61	0	61
7453	0	0	0	62	0	62
7454	64	0	0	0	0	64
7455	0	0	0	65	0	65
7456	0	0	63	0	0	63
7457	0	0	0	62	0	62
7458	0	0	59	0	0	59
7459	0	61	0	0	0	61
7460	64	0	0	0	0	64
7461	0	0	0	63	0	63
7462	0	0	56	0	0	56
7463	0	0	0	63	0	63
7464	0	0	0	64	0	64
7465	0	0	56	0	0	56
7466	0	0	0	59	0	59
7467	57	0	0	0	0	57
7468	0	0	52	0	0	52
7469	56	0	0	0	0	56
7470	0	57	0	0	0	57
7471	0	0	53	0	0	53
7472	0	0	51	0	0	51
7473	0	0	0	52	0	52
7474	0	0	0	55	0	55
7475	0	0	55	0	0	55
7476	0	0	0	56	0	56
7477	57	0	0	0	0	57
7478	57	0	0	1	0	58
7479	0	0	0	57	0	57
7480	0	0	0	58	0	58
7481	0	56	0	0	0	56
7482	52	0	0	0	0	52
7483	1	0	0	54	0	55
7484	0	52	0	0	0	52
7485	58	0	0	0	0	58
7486	54	0	0	0	0	54
7487	0	51	0	0	0	51
7488	0	0	0	51	0	51
7489	0	0	0	49	0	49
7490	0	0	50	0	0	50
7491	0	0	0	47	0	47
7492	50	0	0	0	0	50
7493	0	0	0	48	0	48
7494	0	0	50	0	0	50
7495	49	0	0	0	0	49
7496	0	0	0	49	0	49
7497	0	0	47	0	0	47
7498	1	0	0	51	0	52
7499	0	0	55	0	0	55
7500	0	0	0	54	0	54
7501	3	0	0	51	0	54
7502	52	0	0	0	0	52
7503	0	52	0	0	0	52
7504	49	0	0	3	0	52
7505	49	0	0	0	0	49
7506	55	0	0	0	0	55
7507	0	50	0	0	0	50
7508	0	0	46	0	0	46
7509	0	0	0	49	0	49
7510	48	0	0	0	0	48
7511	50	0	0	0	0	50
7512	0	0	1	51	0	52
7513	52	0	0	0	0	52
7514	1	0	49	0	0	50
7515	53	0	0	0	0	53
7516	0	0	48	0	0	48
7517	0	50	0	0	0	50
7518	53	0	0	0	0	53
7519	52	0	0	0	0	52
7520	0	53	0	0	0	53
7521	51	0	0	0	0	51
7522	52	0	0	0	0	52
7523	0	0	47	0	0	47
7524	49	0	0	0	0	49
7525	0	0	48	0	0	48
7526	0	0	0	49	0	49
7527	0	51	0	0	0	51
7528	0	0	50	0	0	50
7529	48	0	0	0	0	48
7530	51	0	0	0	0	51
7531	0	0	0	49	0	49
7532	0	0	47	0	0	47
7533	0	0	0	50	0	50
7534	49	0	0	0	0	49
7535	0	49	0	0	0	49
7536	49	0	0	0	0	49
7537	48	0	0	1	0	49
7538	0	49	0	0	0	49
7539	0	0	0	49	0	49
7540	48	0	0	0	0	48
7541	0	0	0	46	0	46
7542	0	0	0	47	0	47
7543	0	0	49	0	0	49
7544	1	0	0	45	0	46
7545	0	0	0	50	0	50
7546	50	0	0	0	0	50
7547	50	0	0	0	0	50
7548	0	0	0	47	0	47
7549	0	0	46	0	0	46
7550	0	0	41	0	0	41
7551	1	0	0	47	0	48
7552	0	0	52	0	0	52
7553	0	0	0	51	0	51
7554	0	0	0	54	0	54
7555	56	0	0	0	0	56
7556	0	0	54	0	0	54
7557	58	0	0	0	0	58
7558	55	0	0	0	0	55
7559	0	0	53	0	0	53
7560	0	0	51	0	0	51
7561	0	0	0	49	0	49
7562	0	49	0	0	0	49
7563	0	51	0	0	0	51
7564	0	0	0	54	0	54
7565	0	0	0	57	0	57
7566	0	0	0	57	0	57
7567	0	0	0	57	0	57
7568	54	0	0	0	0	54
7569	0	0	0	57	0	57
7570	0	0	55	0	0	55
7571	0	0	0	58	0	58
7572	0	57	0	0	0	57
7573	0	0	0	57	0	57
7574	56	1	0	0	0	57
7575	0	0	0	56	0	56
7576	0	0	57	0	0	57
7577	0	53	0	0	0	53
7578	0	0	0	57	0	57
7579	59	0	0	0	0	59
7580	59	0	0	0	0	59
7581	0	0	0	59	0	59
7582	0	0	61	0	0	61
7583	0	0	52	0	0	52
7584	57	0	0	0	0	57
7585	0	0	57	0	0	57
7586	0	0	60	0	0	60
7587	0	0	0	66	0	66
7588	64	0	0	0	0	64
7589	64	0	0	0	0	64
7590	64	1	0	0	0	65
7591	0	0	66	1	0	67
7592	0	0	65	0	0	65
7593	0	65	0	0	0	65
7594	0	0	0	72	0	72
7595	0	0	1	72	0	73
7596	0	0	0	73	0	73
7597	0	0	0	73	0	73
7598	0	0	70	0	0	70
7599	0	72	0	0	0	72
7600	74	0	0	0	0	74
7601	77	0	0	0	0	77
7602	78	0	0	0	0	78
7603	0	78	0	0	0	78
7604	0	0	0	79	0	79
7605	68	1	0	0	0	69
7606	0	73	0	0	0	73
7607	74	0	0	0	0	74
7608	0	77	0	0	0	77
7609	76	0	0	0	0	76
7610	72	0	0	0	0	72
7611	2	0	0	72	0	74
7612	0	0	0	70	0	70
7613	0	0	72	0	0	72
7614	0	0	68	0	0	68
7615	74	0	0	0	0	74
7616	69	0	0	0	0	69
7617	0	0	0	69	0	69
7618	0	0	0	70	0	70
7619	0	0	70	0	0	70
7620	1	0	0	70	0	71
7621	0	0	66	0	0	66
7622	0	0	0	70	0	70
7623	0	0	0	70	0	70
7624	72	0	0	0	0	72
7625	67	0	0	0	0	67
7626	0	0	0	69	0	69
7627	0	0	0	71	0	71
7628	0	0	69	0	0	69
7629	0	0	0	69	0	69
7630	0	0	69	0	0	69
7631	73	0	0	0	0	73
7632	0	0	0	73	0	73
7633	74	0	0	0	0	74
7634	0	73	0	0	0	73
7635	76	0	0	0	0	76
7636	0	0	0	73	0	73
7637	0	0	0	76	0	76
7638	0	78	0	0	0	78
7639	0	0	0	80	0	80
7640	0	0	80	0	0	80
7641	0	1	0	82	0	83
7642	0	0	89	0	0	89
7643	0	88	0	0	0	88
7644	0	0	0	90	0	90
7645	0	0	85	1	0	86
7646	0	0	83	0	0	83
7647	1	0	0	83	0	84
7648	82	0	0	0	0	82
7649	0	0	77	0	0	77
7650	0	0	0	81	0	81
7651	82	0	0	0	0	82
7652	0	82	0	0	0	82
7653	83	0	0	0	0	83
7654	0	0	0	84	0	84
7655	0	0	0	83	0	83
7656	0	0	0	86	0	86
7657	81	0	0	0	0	81
7658	0	0	0	80	0	80
7659	0	0	0	81	0	81
7660	83	0	0	0	0	83
7661	0	0	82	0	0	82
7662	0	0	0	87	0	87
7663	0	0	83	0	0	83
7664	86	0	0	0	0	86
7665	0	0	0	87	0	87
7666	0	0	90	0	0	90
7667	99	0	0	0	0	99
7668	92	0	0	0	0	92
7669	0	0	91	0	0	91
7670	1	0	0	89	0	90
7671	0	0	0	95	0	95
7672	0	0	97	0	0	97
7673	0	92	1	0	0	93
7674	0	0	101	1	0	102
7675	102	0	0	0	0	102
7676	0	0	100	0	0	100
7677	102	0	0	0	0	102
7678	0	0	100	0	0	100
7679	93	1	0	1	0	95
7680	0	98	0	0	0	98
7681	0	0	0	102	0	102
7682	0	0	0	102	0	102
7683	0	0	101	0	0	101
7684	0	0	0	101	0	101
7685	0	97	0	0	0	97
7686	100	0	0	0	0	100
7687	0	99	0	0	0	99
7688	0	0	0	99	0	99
7689	101	0	0	0	0	101
7690	0	96	0	0	0	96
7691	100	0	0	0	0	100
7692	1	0	94	0	0	95
7693	0	0	0	96	0	96
7694	0	0	0	99	0	99
7695	0	0	0	98	0	98
7696	95	0	0	0	0	95
7697	95	0	0	0	0	95
7698	94	0	0	0	0	94
7699	96	0	0	0	0	96
7700	0	0	94	0	0	94
7701	91	0	0	0	0	91
7702	0	95	0	0	0	95
7703	0	93	0	0	0	93
7704	98	0	0	0	0	98
7705	101	0	0	0	0	101
7706	0	0	0	100	0	100
7707	105	0	0	0	0	105
7708	100	0	0	0	0	100
7709	104	0	0	0	0	104
7710	0	0	0	103	0	103
7711	0	99	0	0	0	99
7712	0	101	0	0	0	101
7713	0	0	0	105	0	105
7714	103	0	0	0	0	103
7715	0	109	0	0	0	109
7716	0	0	0	104	0	104
7717	0	0	102	0	0	102
7718	100	0	0	2	0	102
7719	0	96	0	0	0	96
7720	0	99	0	0	0	99
7721	101	0	0	0	0	101
7722	0	0	99	3	0	102
7723	0	0	0	102	0	102
7724	0	103	0	0	0	103
7725	0	0	0	107	0	107
7726	0	0	0	104	0	104
7727	0	94	1	0	0	95
7728	0	0	0	102	0	102
7729	0	0	0	100	0	100
7730	100	0	0	0	0	100
7731	0	98	0	0	0	98
7732	100	0	0	1	0	101
7733	0	0	0	97	0	97
7734	0	97	0	0	0	97
7735	0	0	92	0	0	92
7736	1	0	0	91	0	92
7737	0	0	0	94	0	94
7738	0	0	93	0	0	93
7739	93	0	0	0	0	93
7740	0	0	0	93	0	93
7741	96	0	0	0	0	96
7742	0	0	92	0	0	92
7743	0	0	0	98	0	98
7744	0	0	93	0	0	93
7745	0	0	0	97	0	97
7746	0	0	0	96	0	96
7747	96	0	0	0	0	96
7748	0	96	0	0	0	96
7749	100	0	0	0	0	100
7750	0	0	99	0	0	99
7751	0	0	0	97	0	97
7752	0	0	94	0	0	94
7753	92	0	0	0	0	92
7754	97	0	0	0	0	97
7755	0	0	97	0	0	97
7756	97	0	0	0	0	97
7757	91	0	0	0	0	91
7758	0	0	0	91	0	91
7759	0	0	80	0	0	80
7760	0	0	77	0	0	77
7761	0	0	0	77	0	77
7762	0	0	1	76	0	77
7763	0	71	0	0	0	71
7764	0	73	0	0	0	73
7765	74	0	0	0	0	74
7766	0	0	0	77	0	77
7767	0	66	0	0	0	66
7768	0	70	0	0	0	70
7769	74	0	0	0	0	74
7770	0	0	0	79	0	79
7771	0	78	0	0	0	78
7772	0	0	0	78	0	78
7773	0	0	0	76	0	76
7774	0	0	0	75	0	75
7775	73	1	0	0	0	74
7776	0	73	0	0	0	73
7777	0	0	0	77	0	77
7778	0	0	0	78	0	78
7779	1	0	0	73	0	74
7780	0	0	75	0	0	75
7781	76	0	0	0	0	76
7782	0	0	0	76	0	76
7783	73	0	0	0	0	73
7784	76	0	0	0	0	76
7785	75	0	0	0	0	75
7786	0	0	73	0	0	73
7787	0	71	0	0	0	71
7788	0	0	0	76	0	76
7789	0	0	73	0	0	73
7790	0	0	70	0	0	70
7791	0	0	0	77	0	77
7792	0	77	0	0	0	77
7793	77	0	0	0	0	77
7794	77	0	0	0	0	77
7795	76	1	0	0	0	77
7796	77	0	0	0	0	77
7797	0	0	77	0	0	77
7798	73	0	0	0	0	73
7799	0	71	0	0	0	71
7800	0	0	0	70	0	70
7801	0	0	0	73	0	73
7802	76	0	0	0	0	76
7803	0	0	0	77	0	77
7804	0	0	72	0	0	72
7805	72	0	0	0	0	72
7806	72	0	0	0	0	72
7807	73	0	0	0	0	73
7808	0	0	68	0	0	68
7809	68	0	0	0	0	68
7810	0	68	0	0	0	68
7811	68	0	0	0	0	68
7812	0	0	0	66	0	66
7813	1	0	0	67	0	68
7814	0	65	0	0	0	65
7815	0	0	0	67	0	67
7816	0	66	0	0	0	66
7817	0	0	0	67	0	67
7818	0	63	0	0	0	63
7819	0	0	0	67	0	67
7820	0	66	0	0	0	66
7821	0	0	0	68	0	68
7822	0	63	0	0	0	63
7823	67	0	0	0	0	67
7824	0	0	0	67	0	67
7825	0	0	0	69	0	69
7826	0	0	0	70	0	70
7827	0	0	0	70	0	70
7828	0	0	66	0	0	66
7829	1	0	0	67	0	68
7830	0	0	0	69	0	69
7831	69	0	0	0	0	69
7832	67	0	0	0	0	67
7833	0	67	0	1	0	68
7834	0	0	0	65	0	65
7835	0	0	0	65	0	65
7836	67	0	0	0	0	67
7837	0	0	60	0	0	60
7838	61	0	0	0	0	61
7839	0	62	0	0	0	62
7840	63	0	0	0	0	63
7841	64	0	0	0	0	64
7842	0	54	0	0	0	54
7843	0	58	0	0	0	58
7844	0	0	0	64	0	64
7845	0	0	60	0	0	60
7846	64	0	0	0	0	64
7847	0	0	61	0	0	61
7848	64	0	0	0	0	64
7849	0	0	66	0	0	66
7850	0	65	0	0	0	65
7851	0	0	0	63	0	63
7852	60	0	0	0	0	60
7853	59	0	1	0	0	60
7854	0	0	0	63	0	63
7855	65	0	0	0	0	65
7856	63	0	0	0	0	63
7857	0	62	0	0	0	62
7858	64	0	0	1	0	65
7859	0	64	0	0	0	64
7860	0	0	0	63	0	63
7861	68	0	0	0	0	68
7862	67	0	0	0	0	67
7863	64	0	0	0	0	64
7864	0	0	63	0	0	63
7865	0	0	61	0	0	61
7866	0	0	0	66	0	66
7867	0	0	0	65	0	65
7868	0	67	0	0	0	67
7869	67	0	0	0	0	67
7870	0	0	0	68	0	68
7871	0	0	0	67	0	67
7872	0	0	66	0	0	66
7873	0	65	0	0	0	65
7874	0	62	0	0	0	62
7875	0	0	0	62	0	62
7876	66	0	0	0	0	66
7877	0	0	1	64	0	65
7878	0	0	0	66	0	66
7879	62	0	0	0	0	62
7880	64	0	0	0	0	64
7881	0	0	0	61	0	61
7882	0	0	61	0	0	61
7883	0	0	0	56	0	56
7884	0	0	0	58	0	58
7885	60	0	0	0	0	60
7886	0	0	0	56	0	56
7887	59	0	0	0	0	59
7888	0	0	57	0	0	57
7889	0	0	0	58	0	58
7890	0	0	0	57	0	57
7891	0	0	0	57	0	57
7892	0	0	0	59	0	59
7893	0	0	0	58	0	58
7894	0	0	54	0	0	54
7895	57	0	0	0	0	57
7896	0	0	0	55	0	55
7897	0	0	56	0	0	56
7898	0	0	56	0	0	56
7899	0	0	0	57	0	57
7900	57	0	0	0	0	57
7901	60	0	0	0	0	60
7902	57	0	0	0	0	57
7903	0	0	0	60	0	60
7904	0	57	0	0	0	57
7905	60	0	0	0	0	60
7906	61	0	0	0	0	61
7907	60	0	0	0	0	60
7908	59	0	0	0	0	59
7909	0	0	0	58	0	58
7910	0	0	55	0	0	55
7911	0	0	0	54	0	54
7912	0	0	58	0	0	58
7913	58	0	0	0	0	58
7914	57	0	0	0	0	57
7915	0	0	58	0	0	58
7916	59	0	0	0	0	59
7917	60	0	0	0	0	60
7918	0	0	0	60	0	60
7919	0	62	0	0	0	62
7920	59	0	0	0	0	59
7921	0	0	0	59	0	59
7922	0	63	0	0	0	63
7923	0	0	0	64	0	64
7924	0	0	60	0	0	60
7925	0	65	0	0	0	65
7926	69	0	0	0	0	69
7927	71	0	0	0	0	71
7928	67	0	0	0	0	67
7929	69	0	0	0	0	69
7930	0	0	0	68	0	68
7931	0	67	0	0	0	67
7932	72	0	0	0	0	72
7933	0	0	70	0	0	70
7934	0	70	0	0	0	70
7935	0	0	66	0	0	66
7936	0	0	0	71	0	71
7937	0	63	0	0	0	63
7938	0	0	0	74	0	74
7939	0	0	73	0	0	73
7940	0	0	0	73	0	73
7941	0	0	0	71	0	71
7942	0	0	0	76	0	76
7943	72	0	0	0	0	72
7944	0	73	0	1	0	74
7945	1	0	0	74	0	75
7946	72	0	0	0	0	72
7947	0	75	0	0	0	75
7948	77	0	0	0	0	77
7949	0	0	73	0	0	73
7950	0	0	0	74	0	74
7951	0	70	0	0	0	70
7952	72	0	0	0	0	72
7953	0	0	72	0	0	72
7954	0	74	0	0	0	74
7955	0	0	0	79	0	79
7956	1	0	1	73	0	75
7957	75	0	0	0	0	75
7958	0	0	0	75	0	75
7959	0	0	72	0	0	72
7960	0	0	0	73	0	73
7961	0	0	72	0	0	72
7962	0	0	0	74	0	74
7963	0	71	0	0	0	71
7964	71	0	0	0	0	71
7965	73	0	0	0	0	73
7966	0	63	0	1	0	64
7967	0	70	0	0	0	70
7968	0	0	0	70	0	70
7969	70	0	0	0	0	70
7970	0	0	0	71	0	71
7971	71	0	0	0	0	71
7972	0	70	0	0	0	70
7973	0	0	0	70	0	70
7974	0	0	69	0	0	69
7975	0	0	0	72	0	72
7976	0	0	0	73	0	73
7977	70	0	0	0	0	70
7978	0	72	0	0	0	72
7979	0	0	0	68	0	68
7980	70	0	0	0	0	70
7981	0	0	69	0	0	69
7982	69	0	0	0	0	69
7983	0	0	0	69	0	69
7984	0	70	0	0	0	70
7985	69	0	0	0	0	69
7986	0	0	70	0	0	70
7987	0	0	69	0	0	69
7988	0	77	0	0	0	77
7989	80	0	0	0	0	80
7990	0	0	0	78	0	78
7991	0	0	0	79	0	79
7992	79	0	0	0	0	79
7993	0	0	79	0	0	79
7994	0	0	0	82	0	82
7995	0	0	79	0	0	79
7996	0	0	0	83	0	83
7997	0	79	0	1	0	80
7998	0	0	0	81	0	81
7999	0	0	83	0	0	83
8000	84	0	0	0	0	84
8001	0	0	0	81	0	81
8002	0	0	83	0	0	83
8003	1	0	0	78	0	79
8004	0	0	0	77	0	77
8005	0	0	79	0	0	79
8006	0	0	76	0	0	76
8007	0	0	0	78	0	78
8008	0	0	79	0	0	79
8009	80	0	0	0	0	80
8010	0	0	0	75	0	75
8011	76	0	0	0	0	76
8012	0	0	78	0	0	78
8013	1	0	0	75	0	76
8014	0	0	75	0	0	75
8015	0	64	0	0	0	64
8016	0	0	75	0	0	75
8017	0	0	71	0	0	71
8018	72	0	0	0	0	72
8019	71	0	0	0	0	71
8020	0	0	69	0	0	69
8021	0	0	0	70	0	70
8022	0	0	0	68	0	68
8023	0	0	69	0	0	69
8024	0	65	0	0	0	65
8025	68	0	0	0	0	68
8026	0	0	67	0	0	67
8027	0	0	0	67	0	67
8028	0	0	0	68	0	68
8029	66	0	0	0	0	66
8030	69	0	0	0	0	69
8031	67	0	0	0	0	67
8032	70	0	0	0	0	70
8033	0	0	0	72	0	72
8034	0	0	68	0	0	68
8035	0	0	0	70	0	70
8036	0	0	0	73	0	73
8037	0	0	0	69	0	69
8038	0	0	70	0	0	70
8039	69	0	0	0	0	69
8040	0	0	0	66	0	66
8041	0	0	58	0	0	58
8042	0	63	0	0	0	63
8043	0	1	0	66	0	67
8044	0	0	0	68	0	68
8045	64	0	0	0	0	64
8046	1	63	0	0	0	64
8047	0	0	59	0	0	59
8048	0	0	0	60	0	60
8049	0	0	0	67	0	67
8050	67	0	0	0	0	67
8051	61	1	0	0	0	62
8052	0	0	0	64	0	64
8053	63	0	0	0	0	63
8054	0	58	0	1	0	59
8055	0	0	59	0	0	59
8056	0	0	0	61	0	61
8057	0	0	0	65	0	65
8058	0	1	0	66	0	67
8059	0	0	0	68	0	68
8060	0	66	0	0	0	66
8061	68	0	0	0	0	68
8062	1	0	1	66	0	68
8063	0	66	0	0	0	66
8064	71	0	0	0	0	71
8065	69	0	0	0	0	69
8066	0	66	0	0	0	66
8067	0	0	0	69	0	69
8068	0	0	0	68	0	68
8069	0	0	1	70	0	71
8070	0	0	0	69	0	69
8071	72	0	0	0	0	72
8072	70	0	0	1	0	71
8073	0	69	0	0	0	69
8074	0	0	66	1	0	67
8075	0	0	0	69	0	69
8076	69	0	0	0	0	69
8077	0	62	0	1	0	63
8078	0	71	0	0	0	71
8079	71	0	0	0	0	71
8080	73	0	0	0	0	73
8081	0	0	0	63	0	63
8082	0	0	65	0	0	65
8083	1	0	61	0	0	62
8084	60	0	0	0	0	60
8085	64	0	0	0	0	64
8086	64	0	0	0	0	64
8087	69	0	0	0	0	69
8088	70	0	0	1	0	71
8089	0	65	0	0	0	65
8090	0	0	0	66	0	66
8091	1	59	1	0	0	61
8092	66	0	0	0	0	66
8093	65	0	0	0	0	65
8094	62	0	0	0	0	62
8095	64	0	0	0	0	64
8096	0	56	0	0	0	56
8097	58	0	0	0	0	58
8098	0	56	1	0	0	57
8099	0	0	0	61	0	61
8100	62	0	0	0	0	62
8101	0	0	60	0	0	60
8102	0	0	0	65	0	65
8103	0	0	0	68	0	68
8104	0	0	63	0	0	63
8105	0	65	0	0	0	65
8106	69	0	0	0	0	69
8107	69	0	0	1	0	70
8108	0	62	0	0	0	62
8109	0	0	0	63	0	63
8110	0	0	59	0	0	59
8111	0	60	0	0	0	60
8112	63	0	0	0	0	63
8113	0	0	61	0	0	61
8114	67	0	0	0	0	67
8115	66	0	0	0	0	66
8116	0	0	67	0	0	67
8117	0	62	0	0	0	62
8118	0	0	0	63	0	63
8119	0	0	64	0	0	64
8120	66	0	0	0	0	66
8121	70	0	0	0	0	70
8122	0	66	0	0	0	66
8123	0	0	0	66	0	66
8124	0	0	0	66	0	66
8125	0	0	62	0	0	62
8126	0	57	0	0	0	57
8127	62	0	0	0	0	62
8128	59	0	0	0	0	59
8129	57	0	0	0	0	57
8130	0	0	54	0	0	54
8131	60	0	0	0	0	60
8132	58	0	0	0	0	58
8133	0	0	0	59	0	59
8134	0	0	53	0	0	53
8135	0	0	0	55	0	55
8136	0	0	55	0	0	55
8137	0	0	0	60	0	60
8138	0	52	0	0	0	52
8139	0	62	0	0	0	62
8140	0	0	0	66	0	66
8141	0	0	0	59	0	59
8142	63	0	0	0	0	63
8143	0	0	61	0	0	61
8144	63	0	0	0	0	63
8145	0	64	0	0	0	64
8146	62	0	0	0	0	62
8147	64	0	0	0	0	64
8148	0	0	0	61	0	61
8149	0	0	56	0	0	56
8150	0	0	0	59	0	59
8151	0	61	0	0	0	61
8152	0	0	0	65	0	65
8153	0	0	0	61	0	61
8154	62	0	0	0	0	62
8155	0	0	0	61	0	61
8156	0	57	0	0	0	57
8157	0	0	0	62	0	62
8158	60	0	0	0	0	60
8159	0	64	0	0	0	64
8160	0	0	0	65	0	65
8161	0	0	0	67	0	67
8162	0	0	0	63	0	63
8163	0	0	0	65	0	65
8164	65	0	0	0	0	65
8165	0	0	0	65	0	65
8166	0	0	0	65	0	65
8167	0	0	0	66	0	66
8168	0	63	0	0	0	63
8169	61	0	0	0	0	61
8170	1	0	60	0	0	61
8171	0	59	0	0	0	59
8172	63	0	0	0	0	63
8173	0	0	57	0	0	57
8174	0	61	0	0	0	61
8175	1	0	0	63	0	64
8176	0	61	0	0	0	61
8177	0	0	57	0	0	57
8178	0	0	56	0	0	56
8179	0	61	0	0	0	61
8180	63	0	0	0	0	63
8181	60	0	0	0	0	60
8182	0	0	62	0	0	62
8183	0	0	60	0	0	60
8184	0	0	57	0	0	57
8185	0	0	0	59	0	59
8186	0	0	0	61	0	61
8187	0	0	0	65	0	65
8188	0	0	61	0	0	61
8189	0	0	0	64	0	64
8190	0	0	0	67	0	67
8191	0	0	65	0	0	65
8192	67	0	0	0	0	67
8193	0	0	0	64	0	64
8194	0	0	0	65	0	65
8195	0	62	0	0	0	62
8196	64	0	0	0	0	64
8197	0	0	61	0	0	61
8198	61	0	0	0	0	61
8199	0	0	0	61	0	61
8200	0	0	62	0	0	62
8201	0	0	0	56	0	56
8202	66	0	0	0	0	66
8203	0	0	66	0	0	66
8204	66	0	0	1	0	67
8205	63	0	0	0	0	63
8206	62	0	0	0	0	62
8207	0	63	0	0	0	63
8208	0	0	0	64	0	64
8209	61	0	0	0	0	61
8210	63	0	0	0	0	63
8211	61	0	0	0	0	61
8212	0	0	60	0	0	60
8213	64	0	0	0	0	64
8214	0	0	0	63	0	63
8215	0	0	62	0	0	62
8216	0	0	0	67	0	67
8217	0	0	0	67	0	67
8218	0	0	68	0	0	68
8219	0	0	0	68	0	68
8220	0	0	0	68	0	68
8221	0	0	73	0	0	73
8222	72	0	0	0	0	72
8223	73	0	0	0	0	73
8224	0	1	0	73	0	74
8225	0	0	73	0	0	73
8226	0	0	0	74	0	74
8227	0	78	0	0	0	78
8228	0	0	0	78	0	78
8229	0	0	0	82	0	82
8230	81	1	0	0	0	82
8231	86	0	0	0	0	86
8232	85	0	0	0	0	85
8233	0	0	1	81	0	82
8234	0	0	0	83	0	83
8235	0	0	79	0	0	79
8236	0	0	0	77	0	77
8237	0	75	0	0	0	75
8238	80	0	0	0	0	80
8239	0	78	0	0	0	78
8240	77	0	0	0	0	77
8241	0	0	0	75	0	75
8242	0	74	0	1	0	75
8243	75	0	0	0	0	75
8244	75	0	0	0	0	75
8245	0	0	0	72	0	72
8246	0	72	0	0	0	72
8247	0	0	0	74	0	74
8248	0	0	78	0	0	78
8249	74	0	0	1	0	75
8250	0	79	0	0	0	79
8251	78	0	0	0	0	78
8252	0	0	0	72	0	72
8253	76	0	0	0	0	76
8254	0	0	73	0	0	73
8255	72	0	0	0	0	72
8256	75	0	0	0	0	75
8257	0	0	74	0	0	74
8258	0	0	0	71	0	71
8259	0	0	0	72	0	72
8260	75	0	0	0	0	75
8261	0	77	0	0	0	77
8262	0	0	0	74	0	74
8263	0	0	74	0	0	74
8264	0	0	71	0	0	71
8265	0	72	0	0	0	72
8266	0	0	71	1	0	72
8267	72	0	0	0	0	72
8268	0	0	0	69	0	69
8269	72	0	0	0	0	72
8270	0	0	70	0	0	70
8271	0	0	0	71	0	71
8272	0	0	0	71	0	71
8273	0	0	69	0	0	69
8274	0	0	0	73	0	73
8275	75	0	0	0	0	75
8276	72	0	0	0	0	72
8277	0	0	0	75	0	75
8278	77	0	0	0	0	77
8279	75	0	0	0	0	75
8280	0	75	0	0	0	75
8281	0	0	0	75	0	75
8282	76	0	0	1	0	77
8283	0	0	0	75	0	75
8284	73	0	0	0	0	73
8285	0	0	0	75	0	75
8286	0	0	70	0	0	70
8287	0	74	0	0	0	74
8288	0	0	0	76	0	76
8289	0	76	0	0	0	76
8290	74	0	0	0	0	74
8291	0	68	0	0	0	68
8292	0	70	0	1	0	71
8293	0	0	0	73	0	73
8294	71	0	0	0	0	71
8295	0	0	0	68	0	68
8296	74	0	0	0	0	74
8297	71	0	0	0	0	71
8298	0	71	0	1	0	72
8299	72	0	0	0	0	72
8300	73	0	0	0	0	73
8301	73	0	0	0	0	73
8302	0	0	75	0	0	75
8303	0	0	0	72	0	72
8304	0	0	0	76	0	76
8305	0	0	70	0	0	70
8306	70	0	0	0	0	70
8307	74	0	0	0	0	74
8308	70	0	0	0	0	70
8309	65	0	0	0	0	65
8310	0	67	0	0	0	67
8311	67	0	0	0	0	67
8312	0	0	0	63	0	63
8313	0	0	61	0	0	61
8314	63	0	0	0	0	63
8315	0	68	0	0	0	68
8316	67	0	0	0	0	67
8317	0	67	0	0	0	67
8318	0	69	0	0	0	69
8319	0	64	0	0	0	64
8320	0	66	0	0	0	66
8321	0	0	67	0	0	67
8322	0	0	0	66	0	66
8323	0	0	66	0	0	66
8324	60	0	0	0	0	60
8325	0	56	0	0	0	56
8326	0	58	0	0	0	58
8327	0	0	0	61	0	61
8328	0	0	0	62	0	62
8329	0	1	61	0	0	62
8330	0	0	62	0	0	62
8331	0	0	0	63	0	63
8332	0	0	65	0	0	65
8333	0	61	0	0	0	61
8334	0	0	0	64	0	64
8335	0	0	0	65	0	65
8336	0	0	66	0	0	66
8337	0	0	0	62	0	62
8338	66	0	0	0	0	66
8339	0	0	0	65	0	65
8340	0	0	0	64	0	64
8341	0	0	58	0	0	58
8342	63	0	0	0	0	63
8343	0	60	0	0	0	60
8344	0	0	0	62	0	62
8345	0	0	65	0	0	65
8346	0	0	0	65	0	65
8347	66	0	0	0	0	66
8348	0	0	67	0	0	67
8349	0	0	0	68	0	68
8350	0	0	68	0	0	68
8351	1	62	0	0	0	63
8352	0	0	61	0	0	61
8353	0	58	1	0	0	59
8354	0	0	63	0	0	63
8355	0	0	0	61	0	61
8356	0	59	1	0	0	60
8357	67	0	0	0	0	67
8358	0	0	0	67	0	67
8359	68	0	0	0	0	68
8360	0	0	0	69	0	69
8361	0	0	0	70	0	70
8362	70	0	0	0	0	70
8363	67	0	0	0	0	67
8364	0	0	0	67	0	67
8365	0	0	66	0	0	66
8366	0	68	0	0	0	68
8367	0	0	66	1	0	67
8368	0	67	0	0	0	67
8369	67	0	0	1	0	68
8370	0	0	64	0	0	64
8371	0	0	62	0	0	62
8372	1	0	0	66	0	67
8373	65	0	0	0	0	65
8374	0	0	63	0	0	63
8375	0	60	0	0	0	60
8376	67	0	0	0	0	67
8377	66	0	0	0	0	66
8378	65	0	0	0	0	65
8379	68	0	0	0	0	68
8380	68	0	0	0	0	68
8381	0	0	67	0	0	67
8382	0	0	0	66	0	66
8383	0	67	0	1	0	68
8384	69	0	0	0	0	69
8385	0	71	0	0	0	71
8386	74	0	0	0	0	74
8387	72	0	0	0	0	72
8388	0	66	0	0	0	66
8389	70	0	0	0	0	70
8390	0	0	0	70	0	70
8391	0	0	0	73	0	73
8392	0	0	71	0	0	71
8393	0	72	0	0	0	72
8394	0	0	0	82	0	82
8395	0	0	0	80	0	80
8396	0	0	0	79	0	79
8397	0	0	74	0	0	74
8398	76	0	0	0	0	76
8399	0	0	0	75	0	75
8400	72	0	0	0	0	72
8401	0	0	0	72	0	72
8402	0	0	66	0	0	66
8403	0	0	65	0	0	65
8404	68	0	0	0	0	68
8405	74	0	0	0	0	74
8406	0	70	0	0	0	70
8407	0	0	67	0	0	67
8408	0	1	0	69	0	70
8409	1	0	0	62	0	63
8410	75	0	0	0	0	75
8411	72	0	0	0	0	72
8412	71	0	0	0	0	71
8413	0	0	73	0	0	73
8414	71	0	0	0	0	71
8415	0	0	0	72	0	72
8416	0	0	0	72	0	72
8417	1	0	0	70	0	71
8418	0	75	0	0	0	75
8419	78	0	0	0	0	78
8420	0	0	0	76	0	76
8421	0	0	76	0	0	76
8422	0	0	0	75	0	75
8423	0	71	0	0	0	71
8424	69	0	0	0	0	69
8425	0	0	0	73	0	73
8426	0	0	0	72	0	72
8427	0	0	73	0	0	73
8428	0	0	0	72	0	72
8429	0	72	0	0	0	72
8430	0	0	0	74	0	74
8431	0	0	72	0	0	72
8432	74	0	0	0	0	74
8433	72	0	0	0	0	72
8434	0	72	0	0	0	72
8435	75	0	0	0	0	75
8436	79	0	0	0	0	79
8437	0	74	0	0	0	74
8438	0	0	0	73	0	73
8439	74	0	0	0	0	74
8440	0	77	0	0	0	77
8441	0	0	74	0	0	74
8442	81	0	0	0	0	81
8443	83	0	0	0	0	83
8444	82	0	0	0	0	82
8445	79	1	0	0	0	80
8446	0	83	0	0	0	83
8447	84	0	0	0	0	84
8448	82	0	0	0	0	82
8449	78	0	0	0	0	78
8450	0	0	0	76	0	76
8451	79	0	0	0	0	79
8452	0	72	0	1	0	73
8453	0	1	70	0	0	71
8454	0	0	0	76	0	76
8455	76	0	0	0	0	76
8456	0	0	70	0	0	70
8457	0	0	0	68	0	68
8458	0	0	73	0	0	73
8459	0	74	0	0	0	74
8460	0	0	0	76	0	76
8461	0	0	69	0	0	69
8462	0	71	0	0	0	71
8463	0	0	0	72	0	72
8464	76	0	0	0	0	76
8465	75	0	0	0	0	75
8466	74	0	0	0	0	74
8467	75	0	0	0	0	75
8468	74	0	0	0	0	74
8469	0	0	70	0	0	70
8470	74	0	0	0	0	74
8471	74	0	0	0	0	74
8472	1	0	0	68	0	69
8473	76	0	0	0	0	76
8474	74	0	0	0	0	74
8475	0	69	0	0	0	69
8476	0	0	0	75	0	75
8477	1	0	0	75	0	76
8478	74	0	0	0	0	74
8479	0	63	0	0	0	63
8480	0	69	0	0	0	69
8481	0	0	0	74	0	74
8482	0	0	0	77	0	77
8483	0	0	0	71	0	71
8484	0	0	0	76	0	76
8485	74	0	0	0	0	74
8486	73	0	0	0	0	73
8487	0	0	69	0	0	69
8488	0	0	0	73	0	73
8489	0	0	0	72	0	72
8490	0	0	65	0	0	65
8491	66	0	0	0	0	66
8492	0	64	0	0	0	64
8493	67	0	0	0	0	67
8494	0	0	0	65	0	65
8495	0	0	68	0	0	68
8496	0	0	0	68	0	68
8497	0	0	67	0	0	67
8498	0	69	0	0	0	69
8499	68	0	0	0	0	68
8500	69	0	0	0	0	69
8501	0	70	0	0	0	70
8502	0	0	0	70	0	70
8503	61	0	0	0	0	61
8504	0	59	0	0	0	59
8505	0	0	0	66	0	66
8506	66	0	0	0	0	66
8507	0	0	66	0	0	66
8508	63	0	0	0	0	63
8509	0	68	0	0	0	68
8510	67	0	0	0	0	67
8511	64	0	0	0	0	64
8512	0	0	62	0	0	62
8513	1	0	0	60	0	61
8514	0	0	0	68	0	68
8515	0	0	64	0	0	64
8516	0	0	0	61	0	61
8517	0	0	0	66	0	66
8518	66	0	0	0	0	66
8519	67	0	0	0	0	67
8520	0	0	0	67	0	67
8521	0	0	67	0	0	67
8522	0	0	0	69	0	69
8523	1	0	0	64	0	65
8524	0	0	66	0	0	66
8525	0	0	0	68	0	68
8526	67	0	0	1	0	68
8527	68	0	0	0	0	68
8528	0	64	0	0	0	64
8529	67	0	0	1	0	68
8530	66	0	0	0	0	66
8531	0	66	0	0	0	66
8532	65	0	0	0	0	65
8533	65	0	0	0	0	65
8534	64	0	0	0	0	64
8535	0	0	60	0	0	60
8536	61	0	0	0	0	61
8537	0	0	0	62	0	62
8538	65	0	0	0	0	65
8539	0	0	60	0	0	60
8540	0	60	1	0	0	61
8541	64	0	0	0	0	64
8542	0	64	0	0	0	64
8543	0	0	0	65	0	65
8544	0	0	0	65	0	65
8545	65	0	0	0	0	65
8546	64	0	0	0	0	64
8547	0	0	60	0	0	60
8548	0	0	55	0	0	55
8549	0	0	62	0	0	62
8550	0	0	0	61	0	61
8551	0	0	64	0	0	64
8552	0	0	58	0	0	58
8553	0	0	0	61	0	61
8554	59	0	0	0	0	59
8555	59	0	0	0	0	59
8556	57	0	0	1	0	58
8557	58	0	0	0	0	58
8558	0	0	0	60	0	60
8559	0	0	0	64	0	64
8560	0	0	63	0	0	63
8561	0	0	0	66	0	66
8562	0	0	0	69	0	69
8563	71	0	0	0	0	71
8564	69	0	0	0	0	69
8565	0	0	0	70	0	70
8566	69	0	0	0	0	69
8567	66	0	0	0	0	66
8568	0	0	0	67	0	67
8569	0	0	0	63	0	63
8570	0	0	65	0	0	65
8571	0	0	62	0	0	62
8572	0	0	0	67	0	67
8573	0	0	0	67	0	67
8574	0	0	66	0	0	66
8575	64	0	0	0	0	64
8576	64	0	0	0	0	64
8577	0	0	67	0	0	67
8578	0	61	0	0	0	61
8579	70	0	0	0	0	70
8580	0	1	68	0	0	69
8581	0	0	0	67	0	67
8582	0	0	0	73	0	73
8583	71	0	0	0	0	71
8584	69	0	0	0	0	69
8585	0	0	0	70	0	70
8586	0	0	0	71	0	71
8587	68	0	0	0	0	68
8588	65	0	0	0	0	65
8589	72	0	0	0	0	72
8590	0	0	70	0	0	70
8591	0	0	0	65	0	65
8592	0	0	0	74	0	74
8593	73	0	0	0	0	73
8594	0	70	0	0	0	70
8595	64	0	0	1	0	65
8596	0	68	0	1	0	69
8597	0	0	0	70	0	70
8598	0	0	0	64	0	64
8599	0	0	65	0	0	65
8600	0	0	0	66	0	66
8601	0	0	63	0	0	63
8602	0	0	0	69	0	69
8603	0	0	0	71	0	71
8604	0	63	0	0	0	63
8605	0	69	0	1	0	70
8606	0	0	0	69	0	69
8607	0	0	0	68	0	68
8608	0	0	0	64	0	64
8609	0	0	0	68	0	68
8610	0	0	0	66	0	66
8611	0	0	64	0	0	64
8612	1	0	0	66	0	67
8613	0	0	0	66	0	66
8614	0	0	63	0	0	63
8615	0	60	0	0	0	60
8616	0	0	0	65	0	65
8617	0	0	64	0	0	64
8618	0	59	0	0	0	59
8619	0	0	0	62	0	62
8620	65	0	0	0	0	65
8621	0	0	0	63	0	63
8622	0	0	0	54	0	54
8623	0	0	0	61	0	61
8624	0	0	0	58	0	58
8625	0	57	0	0	0	57
8626	0	0	0	58	0	58
8627	57	0	0	0	0	57
8628	0	0	0	56	0	56
8629	0	0	0	58	0	58
8630	0	0	0	61	0	61
8631	59	0	0	0	0	59
8632	59	0	1	1	0	61
8633	0	0	0	53	0	53
8634	53	0	0	0	0	53
8635	55	0	0	0	0	55
8636	0	57	0	0	0	57
8637	52	0	0	1	0	53
8638	0	49	0	1	0	50
8639	0	56	0	0	0	56
8640	0	0	0	61	0	61
8641	0	0	59	0	0	59
8642	0	0	0	60	0	60
8643	0	0	0	57	0	57
8644	0	55	0	0	0	55
8645	58	0	0	0	0	58
8646	0	0	0	58	0	58
8647	0	0	55	0	0	55
8648	0	0	0	58	0	58
8649	0	61	0	0	0	61
8650	59	0	0	0	0	59
8651	0	0	0	63	0	63
8652	0	0	58	0	0	58
8653	0	0	0	51	0	51
8654	0	59	0	0	0	59
8655	0	0	0	60	0	60
8656	63	0	0	0	0	63
8657	57	0	0	0	0	57
8658	60	0	0	0	0	60
8659	0	62	0	0	0	62
8660	64	0	0	0	0	64
8661	0	0	0	67	0	67
8662	67	0	0	0	0	67
8663	0	56	0	0	0	56
8664	0	0	0	67	0	67
8665	0	0	63	0	0	63
8666	65	0	0	0	0	65
8667	0	66	0	0	0	66
8668	0	0	0	67	0	67
8669	0	0	0	66	0	66
8670	0	0	0	65	0	65
8671	0	0	0	64	0	64
8672	0	58	0	0	0	58
8673	63	0	0	0	0	63
8674	63	0	0	0	0	63
8675	0	0	63	0	0	63
8676	0	0	0	62	0	62
8677	0	0	61	1	0	62
8678	59	0	0	0	0	59
8679	60	0	0	0	0	60
8680	59	0	0	0	0	59
8681	0	0	0	57	0	57
8682	0	57	0	0	0	57
8683	57	0	0	0	0	57
8684	0	0	0	60	0	60
8685	61	0	0	0	0	61
8686	0	0	59	0	0	59
8687	0	0	57	0	0	57
8688	61	0	0	0	0	61
8689	0	0	0	58	0	58
8690	59	0	0	0	0	59
8691	0	60	0	0	0	60
8692	54	0	0	0	0	54
8693	57	0	0	0	0	57
8694	0	0	57	0	0	57
8695	0	0	49	0	0	49
8696	0	52	0	0	0	52
8697	0	0	0	54	0	54
8698	51	0	0	0	0	51
8699	0	0	0	51	0	51
8700	0	0	0	51	0	51
8701	0	0	49	0	0	49
8702	49	0	0	0	0	49
8703	0	0	0	52	0	52
8704	0	0	52	0	0	52
8705	0	0	51	0	0	51
8706	0	0	0	55	0	55
8707	0	0	52	2	0	54
8708	0	0	56	0	0	56
8709	0	0	0	49	0	49
8710	0	0	58	0	0	58
8711	0	0	0	58	0	58
8712	3	58	0	0	0	61
8713	57	0	0	0	0	57
8714	0	64	0	0	0	64
8715	0	0	0	66	0	66
8716	0	64	0	0	0	64
8717	0	0	66	0	0	66
8718	0	0	0	67	0	67
8719	0	0	68	0	0	68
8720	67	0	0	0	0	67
8721	0	67	0	0	0	67
8722	68	0	0	0	0	68
8723	0	0	0	65	0	65
8724	68	0	0	0	0	68
8725	0	0	70	0	0	70
8726	0	75	0	0	0	75
8727	77	0	0	0	0	77
8728	0	0	0	73	0	73
8729	0	71	0	0	0	71
8730	0	0	0	74	0	74
8731	74	0	0	0	0	74
8732	0	70	0	0	0	70
8733	73	0	0	0	0	73
8734	0	0	70	0	0	70
8735	74	0	0	1	0	75
8736	0	0	0	74	0	74
8737	69	0	0	0	0	69
8738	0	77	0	0	0	77
8739	0	0	0	75	0	75
8740	0	0	0	75	0	75
8741	0	0	71	0	0	71
8742	0	0	0	73	0	73
8743	0	0	0	72	0	72
8744	0	0	0	70	0	70
8745	0	0	0	70	0	70
8746	0	0	69	0	0	69
8747	0	68	2	0	0	70
8748	0	0	0	74	0	74
8749	72	0	0	0	0	72
8750	71	0	0	0	0	71
8751	0	69	0	0	0	69
8752	69	0	0	2	0	71
8753	69	0	0	0	0	69
8754	71	0	0	0	0	71
8755	0	69	0	0	0	69
8756	69	0	0	0	0	69
8757	0	0	0	66	0	66
8758	0	0	62	0	0	62
8759	0	64	0	0	0	64
8760	0	0	0	64	0	64
8761	0	0	66	0	0	66
8762	63	0	0	1	0	64
8763	0	0	0	62	0	62
8764	0	0	0	64	0	64
8765	0	0	0	65	0	65
8766	0	0	0	63	0	63
8767	0	0	61	0	0	61
8768	62	0	0	0	0	62
8769	0	59	0	0	0	59
8770	61	0	0	1	0	62
8771	0	60	0	0	0	60
8772	61	0	0	0	0	61
8773	1	0	0	60	0	61
8774	0	0	59	0	0	59
8775	0	0	60	0	0	60
8776	0	0	0	58	0	58
8777	0	0	0	58	0	58
8778	0	0	0	56	0	56
8779	58	0	0	0	0	58
8780	0	0	53	0	0	53
8781	0	0	0	49	0	49
8782	0	55	0	0	0	55
8783	57	0	0	0	0	57
8784	0	0	52	0	0	52
8785	0	54	0	0	0	54
8786	0	0	60	0	0	60
8787	0	0	0	60	0	60
8788	0	0	58	0	0	58
8789	0	0	52	1	0	53
8790	0	0	0	51	0	51
8791	0	0	51	0	0	51
8792	0	0	51	0	0	51
8793	0	0	0	53	0	53
8794	54	0	0	0	0	54
8795	0	0	51	0	0	51
8796	0	0	0	56	0	56
8797	0	0	1	57	0	58
8798	54	0	0	0	0	54
8799	0	0	0	55	0	55
8800	58	0	0	0	0	58
8801	0	54	0	0	0	54
8802	0	0	0	55	0	55
8803	54	0	0	0	0	54
8804	55	0	0	0	0	55
8805	0	0	0	53	0	53
8806	0	0	58	0	0	58
8807	56	0	0	0	0	56
8808	0	56	0	0	0	56
8809	56	0	0	0	0	56
8810	56	0	0	0	0	56
8811	59	0	0	0	0	59
8812	0	0	57	0	0	57
8813	0	56	0	0	0	56
8814	0	0	0	61	0	61
8815	0	0	0	59	0	59
8816	0	0	61	0	0	61
8817	0	56	0	0	0	56
8818	0	56	0	0	0	56
8819	0	53	0	0	0	53
8820	54	0	0	0	0	54
8821	0	0	0	56	0	56
8822	0	0	0	56	0	56
8823	0	0	55	0	0	55
8824	55	0	0	0	0	55
8825	0	0	0	55	0	55
8826	0	0	0	56	0	56
8827	0	0	54	0	0	54
8828	0	50	0	0	0	50
8829	0	0	0	54	0	54
8830	0	0	50	0	0	50
8831	0	52	0	0	0	52
8832	55	0	0	0	0	55
8833	0	0	54	0	0	54
8834	0	0	0	51	0	51
8835	0	54	0	0	0	54
8836	53	0	2	0	0	55
8837	0	0	0	55	0	55
8838	53	0	0	0	0	53
8839	58	0	0	0	0	58
8840	0	57	0	0	0	57
8841	58	0	0	2	0	60
8842	55	0	0	0	0	55
8843	0	0	54	0	0	54
8844	57	0	0	0	0	57
8845	0	0	60	0	0	60
8846	60	0	0	0	0	60
8847	57	0	0	0	0	57
8848	0	0	57	0	0	57
8849	0	0	0	57	0	57
8850	1	0	53	0	0	54
8851	0	0	57	0	0	57
8852	0	0	58	0	0	58
8853	0	0	0	57	0	57
8854	0	0	0	59	0	59
8855	0	0	0	60	0	60
8856	0	0	0	61	0	61
8857	0	0	59	0	0	59
8858	0	0	0	61	0	61
8859	0	57	0	0	0	57
8860	0	0	61	0	0	61
8861	0	0	0	64	0	64
8862	0	0	61	0	0	61
8863	0	64	0	0	0	64
8864	0	63	0	0	0	63
8865	0	0	0	66	0	66
8866	0	0	60	0	0	60
8867	0	0	64	0	0	64
8868	0	0	0	68	0	68
8869	0	0	1	64	0	65
8870	0	0	0	68	0	68
8871	0	0	66	0	0	66
8872	1	63	0	0	0	64
8873	0	65	0	0	0	65
8874	0	0	0	65	0	65
8875	0	0	64	0	0	64
8876	1	0	59	0	0	60
8877	0	61	0	0	0	61
8878	63	0	0	0	0	63
8879	0	65	0	0	0	65
8880	0	0	64	1	0	65
8881	66	0	0	0	0	66
8882	0	0	0	66	0	66
8883	64	0	0	0	0	64
8884	0	0	0	67	0	67
8885	0	0	0	66	0	66
8886	68	0	0	0	0	68
8887	0	65	0	0	0	65
8888	0	0	68	0	0	68
8889	0	69	0	0	0	69
8890	72	0	0	0	0	72
8891	0	67	0	0	0	67
8892	75	0	0	0	0	75
8893	77	0	0	0	0	77
8894	0	78	0	0	0	78
8895	0	0	0	79	0	79
8896	80	0	0	0	0	80
8897	75	0	0	0	0	75
8898	0	0	0	80	0	80
8899	0	0	71	0	0	71
8900	0	0	70	0	0	70
8901	0	0	0	77	0	77
8902	0	0	70	0	0	70
8903	75	0	0	1	0	76
8904	0	61	0	0	0	61
8905	0	0	0	69	0	69
8906	0	0	0	64	0	64
8907	0	0	2	67	0	69
8908	0	0	0	70	0	70
8909	0	0	0	69	0	69
8910	0	0	65	0	0	65
8911	0	67	0	0	0	67
8912	70	0	0	0	0	70
8913	0	0	0	69	0	69
8914	0	0	0	66	0	66
8915	0	0	0	67	0	67
8916	0	66	0	0	0	66
8917	0	0	0	66	0	66
8918	0	0	0	64	0	64
8919	65	0	0	0	0	65
8920	0	62	0	0	0	62
8921	0	62	0	0	0	62
8922	0	0	0	65	0	65
8923	64	0	0	0	0	64
8924	0	0	62	0	0	62
8925	62	0	0	0	0	62
8926	0	0	63	0	0	63
8927	1	0	0	63	0	64
8928	0	0	0	66	0	66
8929	0	0	0	67	0	67
8930	0	0	0	69	0	69
8931	0	0	0	67	0	67
8932	67	0	0	0	0	67
8933	0	0	66	0	0	66
8934	0	0	0	69	0	69
8935	0	0	69	0	0	69
8936	0	60	0	0	0	60
8937	66	0	0	1	0	67
8938	0	0	62	0	0	62
8939	0	0	0	65	0	65
8940	0	0	0	66	0	66
8941	1	0	61	0	0	62
8942	0	0	59	0	0	59
8943	0	0	0	59	0	59
8944	62	0	0	0	0	62
8945	60	0	0	0	0	60
8946	0	63	0	0	0	63
8947	56	0	0	3	0	59
8948	0	0	0	60	0	60
8949	0	58	0	0	0	58
8950	0	0	0	59	0	59
8951	0	0	58	0	0	58
8952	0	0	0	58	0	58
8953	0	0	0	65	0	65
8954	61	0	0	0	0	61
8955	0	67	0	0	0	67
8956	61	0	0	0	0	61
8957	0	68	0	0	0	68
8958	64	0	0	0	0	64
8959	0	65	0	0	0	65
8960	0	67	0	0	0	67
8961	65	0	0	0	0	65
8962	0	0	0	64	0	64
8963	0	63	0	0	0	63
8964	62	0	0	0	0	62
8965	62	0	0	0	0	62
8966	59	0	0	0	0	59
8967	61	0	0	0	0	61
8968	1	63	0	0	0	64
8969	0	0	0	65	0	65
8970	0	0	0	62	0	62
8971	57	0	0	0	0	57
8972	0	0	0	63	0	63
8973	61	0	0	0	0	61
8974	0	0	54	0	0	54
8975	58	0	0	0	0	58
8976	0	0	56	0	0	56
8977	0	0	0	59	0	59
8978	57	0	0	0	0	57
8979	0	55	0	0	0	55
8980	57	0	0	0	0	57
8981	0	54	0	0	0	54
8982	0	0	0	56	0	56
8983	0	0	55	0	0	55
8984	53	0	0	0	0	53
8985	0	53	0	0	0	53
8986	0	0	0	54	0	54
8987	0	0	0	56	0	56
8988	0	0	0	55	0	55
8989	0	0	53	0	0	53
8990	0	54	0	0	0	54
8991	54	0	0	0	0	54
8992	53	0	0	1	0	54
8993	1	52	0	0	0	53
8994	54	0	0	0	0	54
8995	0	0	0	56	0	56
8996	0	50	0	0	0	50
8997	56	0	0	0	0	56
8998	0	0	54	0	0	54
8999	0	55	0	0	0	55
9000	0	0	0	59	0	59
9001	0	0	0	59	0	59
9002	0	0	59	0	0	59
9003	0	0	0	57	0	57
9004	0	0	58	0	0	58
9005	1	0	0	57	0	58
9006	1	0	0	57	0	58
9007	0	0	0	59	0	59
9008	0	0	0	57	0	57
9009	0	0	57	0	0	57
9010	0	0	52	0	0	52
9011	0	55	0	0	0	55
9012	0	0	0	65	0	65
9013	0	0	65	0	0	65
9014	0	63	0	0	0	63
9015	0	0	0	71	0	71
9016	0	0	69	0	0	69
9017	71	0	0	0	0	71
9018	70	0	0	0	0	70
9019	0	0	0	72	0	72
9020	0	0	72	0	0	72
9021	0	0	0	74	0	74
9022	68	0	0	0	0	68
9023	0	70	0	0	0	70
9024	69	0	0	0	0	69
9025	70	0	0	0	0	70
9026	0	0	0	69	0	69
9027	0	0	0	73	0	73
9028	0	0	0	73	0	73
9029	0	0	0	75	0	75
9030	0	0	0	76	0	76
9031	71	0	0	0	0	71
9032	75	0	0	0	0	75
9033	77	0	0	0	0	77
9034	0	0	72	0	0	72
9035	78	0	0	0	0	78
9036	0	0	0	79	0	79
9037	0	0	73	0	0	73
9038	0	71	0	0	0	71
9039	0	0	0	79	0	79
9040	0	0	0	79	0	79
9041	0	72	0	0	0	72
9042	0	0	0	82	0	82
9043	0	0	78	0	0	78
9044	0	0	78	0	0	78
9045	0	0	0	84	0	84
9046	79	0	0	0	0	79
9047	79	0	0	0	0	79
9048	0	0	80	0	0	80
9049	0	76	0	0	0	76
9050	0	77	0	0	0	77
9051	78	0	0	0	0	78
9052	0	0	78	0	0	78
9053	0	0	0	75	0	75
9054	82	0	0	0	0	82
9055	0	75	0	0	0	75
9056	0	75	0	0	0	75
9057	78	0	0	0	0	78
9058	0	0	0	79	0	79
9059	79	0	0	0	0	79
9060	0	0	0	81	0	81
9061	0	0	0	84	0	84
9062	0	0	83	0	0	83
9063	0	0	0	80	0	80
9064	0	0	0	84	0	84
9065	85	0	0	0	0	85
9066	0	0	0	88	0	88
9067	0	0	89	0	0	89
9068	90	0	0	0	0	90
9069	0	0	0	94	0	94
9070	89	0	0	0	0	89
9071	0	85	0	0	0	85
9072	0	83	0	0	0	83
9073	94	0	0	0	0	94
9074	91	0	0	0	0	91
9075	0	0	0	89	0	89
9076	0	0	88	0	0	88
9077	0	0	0	91	0	91
9078	89	0	0	0	0	89
9079	0	86	0	0	0	86
9080	0	0	0	92	0	92
9081	92	0	0	0	0	92
9082	0	0	89	0	0	89
9083	88	0	0	0	0	88
9084	92	0	0	0	0	92
9085	0	0	84	0	0	84
9086	2	2	78	0	0	82
9087	0	0	0	85	0	85
9088	0	0	0	89	0	89
9089	0	90	0	0	0	90
9090	0	0	0	90	0	90
9091	0	0	92	0	0	92
9092	1	0	0	90	0	91
9093	0	0	0	91	0	91
9094	0	0	90	0	0	90
9095	0	97	0	0	0	97
9096	0	0	0	97	0	97
9097	1	0	0	92	0	93
9098	97	0	0	0	0	97
9099	0	0	0	94	0	94
9100	0	0	96	0	0	96
9101	97	0	0	0	0	97
9102	101	0	0	0	0	101
9103	99	0	0	0	0	99
9104	0	0	94	0	0	94
9105	0	0	0	96	0	96
9106	0	0	0	92	0	92
9107	0	0	0	92	0	92
9108	87	0	0	0	0	87
9109	0	85	0	0	0	85
9110	0	0	82	0	0	82
9111	0	78	0	0	0	78
9112	0	80	0	0	0	80
9113	0	81	0	0	0	81
9114	0	0	0	88	0	88
9115	0	0	89	0	0	89
9116	87	0	0	0	0	87
9117	0	88	0	0	0	88
9118	85	0	0	0	0	85
9119	0	87	0	0	0	87
9120	81	0	0	0	0	81
9121	1	79	0	0	0	80
9122	0	0	79	0	0	79
9123	1	0	0	78	0	79
9124	0	0	0	82	0	82
9125	81	0	0	0	0	81
9126	0	1	0	78	0	79
9127	0	0	79	0	0	79
9128	0	0	0	77	0	77
9129	0	0	74	0	0	74
9130	0	72	0	0	0	72
9131	0	0	0	78	0	78
9132	0	77	0	0	0	77
9133	76	0	0	0	0	76
9134	0	0	0	78	0	78
9135	0	0	78	0	0	78
9136	0	0	72	0	0	72
9137	71	0	0	0	0	71
9138	0	0	0	72	0	72
9139	0	0	70	0	0	70
9140	0	0	62	0	0	62
9141	0	64	0	1	0	65
9142	0	0	0	68	0	68
9143	0	67	0	0	0	67
9144	0	0	0	68	0	68
9145	63	0	0	0	0	63
9146	0	0	0	68	0	68
9147	0	0	0	67	0	67
9148	67	0	0	0	0	67
9149	0	0	0	66	0	66
9150	0	0	0	68	0	68
9151	0	66	0	0	0	66
9152	67	0	0	0	0	67
9153	69	0	0	1	0	70
9154	0	0	0	64	0	64
9155	0	0	0	67	0	67
9156	0	0	0	66	0	66
9157	0	66	0	0	0	66
9158	0	65	1	0	0	66
9159	0	0	0	64	0	64
9160	64	0	0	0	0	64
9161	58	1	0	0	0	59
9162	0	65	0	0	0	65
9163	61	0	0	2	0	63
9164	0	60	0	1	0	61
9165	0	65	0	0	0	65
9166	1	0	0	64	0	65
9167	60	0	0	0	0	60
9168	1	61	0	0	0	62
9169	0	60	0	0	0	60
9170	0	0	0	62	0	62
9171	0	0	0	63	0	63
9172	0	0	63	0	0	63
9173	61	0	0	0	0	61
9174	63	0	0	0	0	63
9175	0	0	60	0	0	60
9176	0	0	62	0	0	62
9177	0	0	0	63	0	63
9178	0	0	0	65	0	65
9179	0	63	0	0	0	63
9180	1	0	0	62	0	63
9181	0	0	64	0	0	64
9182	0	0	0	64	0	64
9183	0	0	0	64	0	64
9184	62	0	0	0	0	62
9185	0	1	56	0	0	57
9186	56	0	0	0	0	56
9187	0	0	56	0	0	56
9188	0	0	0	59	0	59
9189	0	0	56	0	0	56
9190	0	0	55	0	0	55
9191	0	0	0	56	0	56
9192	54	0	0	0	0	54
9193	51	0	0	0	0	51
9194	0	51	0	0	0	51
9195	50	0	0	1	0	51
9196	50	0	0	0	0	50
9197	0	50	0	0	0	50
9198	0	0	0	51	0	51
9199	0	0	0	50	0	50
9200	0	0	0	49	0	49
9201	0	0	0	47	0	47
9202	0	0	48	0	0	48
9203	48	0	0	0	0	48
9204	0	0	0	48	0	48
9205	0	0	0	47	0	47
9206	0	45	0	0	0	45
9207	0	0	0	46	0	46
9208	0	0	44	0	0	44
9209	44	0	0	0	0	44
9210	0	0	44	0	0	44
9211	0	0	0	44	0	44
9212	41	0	0	0	0	41
9213	0	41	0	0	0	41
9214	0	0	0	44	0	44
9215	0	0	45	0	0	45
9216	0	0	0	45	0	45
9217	46	0	0	0	0	46
9218	1	0	41	0	0	42
9219	0	0	46	0	0	46
9220	0	43	0	0	0	43
9221	45	0	0	0	0	45
9222	0	43	0	0	0	43
9223	0	0	45	0	0	45
9224	0	0	44	0	0	44
9225	0	45	0	0	0	45
9226	46	0	0	0	0	46
9227	0	48	0	0	0	48
9228	0	0	0	47	0	47
9229	0	0	0	48	0	48
9230	0	0	49	0	0	49
9231	0	0	0	51	0	51
9232	0	0	51	0	0	51
9233	53	0	0	0	0	53
9234	53	0	0	0	0	53
9235	50	0	0	0	0	50
9236	0	0	51	0	0	51
9237	49	0	0	0	0	49
9238	0	0	0	59	0	59
9239	0	53	0	0	0	53
9240	59	0	0	0	0	59
9241	0	0	56	0	0	56
9242	58	0	0	0	0	58
9243	59	0	0	0	0	59
9244	0	0	59	0	0	59
9245	0	57	0	0	0	57
9246	0	0	0	57	0	57
9247	0	0	56	0	0	56
9248	0	1	52	0	0	53
9249	0	0	0	60	0	60
9250	0	0	54	0	0	54
9251	0	0	0	54	0	54
9252	0	0	0	54	0	54
9253	0	0	0	54	0	54
9254	0	0	50	0	0	50
9255	0	0	0	57	0	57
9256	0	0	55	0	0	55
9257	0	0	0	56	0	56
9258	54	0	0	0	0	54
9259	2	0	0	56	0	58
9260	0	60	0	0	0	60
9261	0	0	0	55	0	55
9262	55	0	0	0	0	55
9263	0	54	1	0	0	55
9264	0	0	0	58	0	58
9265	58	0	0	0	0	58
9266	0	0	57	0	0	57
9267	0	0	0	54	0	54
9268	0	0	58	0	0	58
9269	0	0	52	0	0	52
9270	0	0	0	57	0	57
9271	59	0	0	0	0	59
9272	0	0	59	0	0	59
9273	59	0	0	0	0	59
9274	0	0	0	63	0	63
9275	0	0	61	0	0	61
9276	0	0	52	0	0	52
9277	0	0	57	0	0	57
9278	0	0	0	57	0	57
9279	63	0	0	0	0	63
9280	0	63	0	0	0	63
9281	0	0	0	66	0	66
9282	0	0	0	66	0	66
9283	68	0	0	0	0	68
9284	65	0	0	1	0	66
9285	0	66	0	0	0	66
9286	66	0	0	1	0	67
9287	70	0	0	0	0	70
9288	0	0	0	71	0	71
9289	1	0	70	0	0	71
9290	70	0	0	0	0	70
9291	0	0	0	68	0	68
9292	0	0	0	71	0	71
9293	71	0	0	0	0	71
9294	0	0	0	75	0	75
9295	0	0	0	76	0	76
9296	72	0	0	0	0	72
9297	0	74	0	0	0	74
9298	76	0	0	0	0	76
9299	0	0	78	0	0	78
9300	79	0	0	0	0	79
9301	0	0	0	81	0	81
9302	0	79	0	0	0	79
9303	0	0	0	84	0	84
9304	0	0	0	83	0	83
9305	0	0	0	85	0	85
9306	80	0	0	0	0	80
9307	0	77	0	0	0	77
9308	0	83	0	0	0	83
9309	84	0	0	0	0	84
9310	0	0	83	0	0	83
9311	0	1	81	1	0	83
9312	85	0	0	0	0	85
9313	1	0	83	0	0	84
9314	0	0	0	85	0	85
9315	0	0	0	83	0	83
9316	0	0	0	86	0	86
9317	0	0	0	85	0	85
9318	0	83	0	0	0	83
9319	0	0	0	86	0	86
9320	0	0	88	0	0	88
9321	0	0	0	86	0	86
9322	0	0	86	0	0	86
9323	0	0	78	0	0	78
9324	0	0	0	84	0	84
9325	0	0	87	0	0	87
9326	0	0	0	82	0	82
9327	85	0	0	0	0	85
9328	0	0	87	0	0	87
9329	86	0	0	0	0	86
9330	0	0	0	85	0	85
9331	1	0	80	0	0	81
9332	0	81	0	1	0	82
9333	0	0	0	86	0	86
9334	0	0	86	0	0	86
9335	0	0	0	88	0	88
9336	89	0	0	0	0	89
9337	86	0	0	1	0	87
9338	84	1	0	0	0	85
9339	0	0	1	82	0	83
9340	0	0	1	85	0	86
9341	1	0	0	86	0	87
9342	85	0	0	0	0	85
9343	0	84	0	0	0	84
9344	0	0	0	85	0	85
9345	0	0	0	85	0	85
9346	85	0	0	0	0	85
9347	0	88	0	1	0	89
9348	0	0	0	94	0	94
9349	89	0	0	0	0	89
9350	90	0	0	0	0	90
9351	0	0	0	95	0	95
9352	95	0	0	0	0	95
9353	0	0	0	98	0	98
9354	0	0	98	0	0	98
9355	0	0	0	101	0	101
9356	0	0	0	96	0	96
9357	0	0	0	93	0	93
9358	92	0	0	0	0	92
9359	0	93	0	0	0	93
9360	92	0	0	0	0	92
9361	0	89	0	0	0	89
9362	0	100	0	0	0	100
9363	99	0	0	0	0	99
9364	0	95	0	0	0	95
9365	0	0	0	101	0	101
9366	100	0	0	0	0	100
9367	92	0	0	0	0	92
9368	0	0	0	99	0	99
9369	0	0	0	95	0	95
9370	0	98	0	0	0	98
9371	101	0	0	0	0	101
9372	96	0	0	1	0	97
9373	0	95	0	0	0	95
9374	0	96	0	0	0	96
9375	0	0	0	100	0	100
9376	100	0	0	0	0	100
9377	0	0	0	101	0	101
9378	0	0	0	96	0	96
9379	0	0	93	0	0	93
9380	1	0	87	0	0	88
9381	0	0	0	98	0	98
9382	0	0	95	0	0	95
9383	0	101	0	0	0	101
9384	0	0	0	99	0	99
9385	0	0	0	97	0	97
9386	0	0	0	101	0	101
9387	0	0	97	0	0	97
9388	0	0	90	0	0	90
9389	96	0	0	0	0	96
9390	0	100	0	0	0	100
9391	97	0	0	0	0	97
9392	0	0	0	95	0	95
9393	96	0	0	0	0	96
9394	0	0	0	95	0	95
9395	1	94	0	0	0	95
9396	98	0	0	0	0	98
9397	0	0	97	0	0	97
9398	0	93	0	0	0	93
9399	97	0	0	0	0	97
9400	0	0	0	95	0	95
9401	0	96	0	0	0	96
9402	0	0	0	96	0	96
9403	93	0	0	0	0	93
9404	0	0	0	92	0	92
9405	93	0	0	0	0	93
9406	0	0	92	0	0	92
9407	0	0	0	92	0	92
9408	91	0	0	0	0	91
9409	2	0	83	0	0	85
9410	0	97	0	0	0	97
9411	0	0	0	98	0	98
9412	0	0	90	1	0	91
9413	0	0	90	0	0	90
9414	0	0	0	99	0	99
9415	0	0	99	0	0	99
9416	0	0	101	0	0	101
9417	0	0	0	105	0	105
9418	105	0	0	0	0	105
9419	0	0	0	105	0	105
9420	0	0	0	109	0	109
9421	0	0	110	0	0	110
9422	0	0	0	109	0	109
9423	108	0	0	0	0	108
9424	0	0	108	0	0	108
9425	0	106	0	0	0	106
9426	0	0	0	106	0	106
9427	101	0	0	0	0	101
9428	0	0	0	105	0	105
9429	1	101	0	0	0	102
9430	0	0	106	0	0	106
9431	0	0	0	105	0	105
9432	104	0	0	0	0	104
9433	0	0	105	0	0	105
9434	0	0	0	109	0	109
9435	109	0	0	0	0	109
9436	108	0	0	0	0	108
9437	0	107	0	0	0	107
9438	107	0	0	2	0	109
9439	0	0	0	110	0	110
9440	0	0	102	1	0	103
9441	0	94	0	1	0	95
9442	0	106	0	0	0	106
9443	0	0	0	106	0	106
9444	0	0	0	99	0	99
9445	0	0	102	0	0	102
9446	0	98	0	0	0	98
9447	0	97	0	1	0	98
9448	0	0	0	100	0	100
9449	99	0	0	0	0	99
9450	0	99	0	0	0	99
9451	0	0	0	100	0	100
9452	97	0	0	0	0	97
9453	0	0	0	100	0	100
9454	1	0	0	94	0	95
9455	0	0	0	94	0	94
9456	0	0	0	94	0	94
9457	94	0	0	0	0	94
9458	0	0	0	94	0	94
9459	0	0	89	0	0	89
9460	90	0	0	0	0	90
9461	0	0	84	0	0	84
9462	0	0	87	0	0	87
9463	0	0	0	94	0	94
9464	0	0	0	89	0	89
9465	0	0	0	91	0	91
9466	94	0	0	0	0	94
9467	0	0	92	0	0	92
9468	92	0	0	0	0	92
9469	92	0	0	0	0	92
9470	1	0	82	0	0	83
9471	88	0	0	0	0	88
9472	0	0	85	0	0	85
9473	0	80	0	0	0	80
9474	0	0	0	90	0	90
9475	0	0	0	89	0	89
9476	0	0	0	89	0	89
9477	0	0	0	90	0	90
9478	0	0	56	34	0	90
9479	0	0	87	1	0	88
9480	0	0	0	97	0	97
9481	0	0	98	0	0	98
9482	99	0	0	0	0	99
9483	101	0	0	0	0	101
9484	0	0	0	105	0	105
9485	98	0	0	1	0	99
9486	0	106	0	0	0	106
9487	111	0	0	0	0	111
9488	0	0	107	0	0	107
9489	0	0	0	110	0	110
9490	0	98	0	2	0	100
9491	108	0	0	1	0	109
9492	0	0	0	107	0	107
9493	0	0	105	0	0	105
9494	0	0	0	106	0	106
9495	110	0	0	0	0	110
9496	0	0	108	0	0	108
9497	0	0	0	114	0	114
9498	0	0	0	111	0	111
9499	1	0	108	0	0	109
9500	0	95	0	1	0	96
9501	0	100	0	1	0	101
9502	0	0	0	119	0	119
9503	0	0	0	120	0	120
9504	0	0	0	119	0	119
9505	118	0	0	0	0	118
9506	112	0	0	0	0	112
9507	0	0	0	118	0	118
9508	101	0	0	0	0	101
9509	7	109	0	0	0	116
9510	0	0	6	110	0	116
9511	0	0	0	116	0	116
9512	0	0	0	115	0	115
9513	109	0	0	0	0	109
9514	0	108	0	0	0	108
9515	0	0	0	101	0	101
9516	98	0	0	0	0	98
9517	0	48	0	53	0	101
9518	0	0	0	105	0	105
9519	0	91	0	0	0	91
9520	0	97	0	0	0	97
9521	0	0	0	107	0	107
9522	0	0	0	103	0	103
9523	101	0	0	0	0	101
9524	0	0	0	104	0	104
9525	0	0	100	0	0	100
9526	1	0	0	100	0	101
9527	1	98	0	0	0	99
9528	102	1	0	0	0	103
9529	1	0	0	104	0	105
9530	0	0	0	105	0	105
9531	0	103	0	0	0	103
9532	98	0	0	0	0	98
9533	0	98	0	0	0	98
9534	0	0	0	101	0	101
9535	1	0	95	0	0	96
9536	0	0	0	98	0	98
9537	93	0	0	0	0	93
9538	0	96	0	0	0	96
9539	0	0	0	103	0	103
9540	0	98	0	0	0	98
9541	1	0	0	101	0	102
9542	0	0	98	0	0	98
9543	0	0	0	99	0	99
9544	0	0	0	101	0	101
9545	0	0	0	100	0	100
9546	97	1	0	0	0	98
9547	95	0	0	0	0	95
9548	0	98	0	0	0	98
9549	93	0	0	1	0	94
9550	0	89	0	2	0	91
9551	0	94	0	0	0	94
9552	100	0	0	0	0	100
9553	0	0	98	0	0	98
9554	0	0	0	102	0	102
9555	0	0	0	101	0	101
9556	0	0	0	101	0	101
9557	100	0	0	0	0	100
9558	0	95	0	0	0	95
9559	0	0	0	98	0	98
9560	0	93	0	0	0	93
9561	94	0	0	1	0	95
9562	0	0	0	95	0	95
9563	1	0	0	99	0	100
9564	0	96	1	0	0	97
9565	0	0	0	101	0	101
9566	0	0	0	102	0	102
9567	98	0	0	0	0	98
9568	0	90	0	0	0	90
9569	0	94	0	0	0	94
9570	0	0	0	101	0	101
9571	0	0	86	0	0	86
9572	0	0	82	1	0	83
9573	0	0	0	92	0	92
9574	0	0	90	0	0	90
9575	0	0	0	93	0	93
9576	0	0	0	95	0	95
9577	1	0	0	93	0	94
9578	92	0	0	0	0	92
9579	0	0	0	91	0	91
9580	0	0	0	93	0	93
9581	0	82	1	1	0	84
9582	1	0	0	87	0	88
9583	0	0	89	0	0	89
9584	0	0	0	95	0	95
9585	0	0	0	93	0	93
9586	95	0	0	0	0	95
9587	0	0	0	94	0	94
9588	0	0	0	95	0	95
9589	1	0	0	104	0	105
9590	95	0	0	0	0	95
9591	0	98	0	0	0	98
9592	0	0	0	100	0	100
9593	0	0	0	101	0	101
9594	0	0	92	0	0	92
9595	0	0	0	99	0	99
9596	97	0	0	1	0	98
9597	0	96	0	0	0	96
9598	0	0	0	104	0	104
9599	0	0	0	107	0	107
9600	0	0	97	1	0	98
9601	103	0	0	0	0	103
9602	0	95	0	0	0	95
9603	98	0	0	0	0	98
9604	0	0	0	99	0	99
9605	0	0	0	92	0	92
9606	0	0	0	101	0	101
9607	0	0	0	101	0	101
9608	98	0	0	0	0	98
9609	0	0	0	99	0	99
9610	0	89	0	0	0	89
9611	0	0	0	97	0	97
9612	0	0	0	101	0	101
9613	95	0	1	0	0	96
9614	0	97	0	0	0	97
9615	1	0	0	96	0	97
9616	96	0	0	0	0	96
9617	92	0	0	1	0	93
9618	0	0	0	94	0	94
9619	0	0	89	0	0	89
9620	93	0	0	0	0	93
9621	0	0	0	92	0	92
9622	0	0	91	0	0	91
9623	0	0	0	89	0	89
9624	0	0	0	95	0	95
9625	0	0	0	91	0	91
9626	0	93	0	0	0	93
9627	0	0	0	99	0	99
9628	0	0	0	97	0	97
9629	0	0	0	96	0	96
9630	0	0	0	97	0	97
9631	0	0	0	100	0	100
9632	0	0	0	97	0	97
9633	98	0	0	0	0	98
9634	1	0	91	0	0	92
9635	0	94	0	0	0	94
9636	99	0	0	0	0	99
9637	0	101	0	0	0	101
9638	103	0	0	0	0	103
9639	0	0	0	104	0	104
9640	105	0	0	0	0	105
9641	0	0	0	104	0	104
9642	0	0	0	105	0	105
9643	0	102	0	0	0	102
9644	108	0	0	0	0	108
9645	0	0	106	0	0	106
9646	0	0	0	109	0	109
9647	0	0	103	0	0	103
9648	0	0	101	0	0	101
9649	107	0	0	0	0	107
9650	0	0	0	107	0	107
9651	0	0	107	0	0	107
9652	0	0	107	0	0	107
9653	0	0	0	104	0	104
9654	0	0	0	99	0	99
9655	102	0	0	0	0	102
9656	0	0	0	112	0	112
9657	0	0	109	0	0	109
9658	0	0	0	112	0	112
9659	0	0	0	114	0	114
9660	0	114	0	0	0	114
9661	111	0	0	0	0	111
9662	0	112	0	0	0	112
9663	115	0	0	0	0	115
9664	0	112	0	0	0	112
9665	0	114	0	1	0	115
9666	1	0	0	119	0	120
9667	0	0	0	121	0	121
9668	0	0	0	119	0	119
9669	121	0	0	0	0	121
9670	0	0	114	0	0	114
9671	0	0	0	119	0	119
9672	118	0	0	0	0	118
9673	0	119	0	0	0	119
9674	0	124	0	0	0	124
9675	0	0	0	129	0	129
9676	0	0	0	127	0	127
9677	0	0	0	122	0	122
9678	0	126	0	0	0	126
9679	0	0	0	125	0	125
9680	0	0	127	0	0	127
9681	0	0	114	0	0	114
9682	130	0	0	0	0	130
9683	0	0	0	125	0	125
9684	117	0	0	0	0	117
9685	114	0	0	0	0	114
9686	0	115	0	0	0	115
9687	119	0	0	0	0	119
9688	111	0	0	0	0	111
9689	0	0	0	115	0	115
9690	0	0	0	114	0	114
9691	0	1	104	0	0	105
9692	1	106	0	2	0	109
9693	0	0	1	117	0	118
9694	0	0	0	119	0	119
9695	119	0	0	0	0	119
9696	0	0	0	115	0	115
9697	118	0	0	0	0	118
9698	0	0	0	120	0	120
9699	0	110	0	0	0	110
9700	119	0	0	0	0	119
9701	0	0	0	121	0	121
9702	0	0	0	120	0	120
9703	0	0	0	121	0	121
9704	0	0	115	0	0	115
9705	0	0	0	118	0	118
9706	124	0	0	0	0	124
9707	0	0	0	127	0	127
9708	0	0	0	122	0	122
9709	0	0	0	128	0	128
9710	1	117	0	0	0	118
9711	0	121	0	0	0	121
9712	123	0	0	1	0	124
9713	0	122	0	0	0	122
9714	131	0	0	0	0	131
9715	132	0	0	0	0	132
9716	138	0	0	0	0	138
9717	0	2	126	0	0	128
9718	0	136	1	0	0	137
9719	136	0	0	0	0	136
9720	0	0	0	131	0	131
9721	0	0	0	139	0	139
9722	0	0	0	139	0	139
9723	0	137	0	0	0	137
9724	0	0	0	142	0	142
9725	140	0	0	0	0	140
9726	0	0	0	140	0	140
9727	0	0	0	148	0	148
9728	0	0	131	0	0	131
9729	0	0	123	1	0	124
9730	0	0	0	140	0	140
9731	0	0	0	144	0	144
9732	0	140	0	0	0	140
9733	0	0	0	153	0	153
9734	0	0	0	152	0	152
9735	0	0	0	153	0	153
9736	150	0	0	0	0	150
9737	0	0	142	0	0	142
9738	0	1	0	154	0	155
9739	156	0	0	0	0	156
9740	159	0	0	0	0	159
9741	0	0	0	158	0	158
9742	1	0	0	161	0	162
9743	160	0	0	0	0	160
9744	0	158	0	1	0	159
9745	0	150	0	0	0	150
9746	0	0	0	163	0	163
9747	162	0	0	0	0	162
9748	160	0	0	0	0	160
9749	150	0	0	0	0	150
9750	0	0	146	0	0	146
9751	149	0	0	0	0	149
9752	0	0	147	0	0	147
9753	147	0	0	2	0	149
9754	0	151	0	0	0	151
9755	0	0	149	0	0	149
9756	0	0	0	147	0	147
9757	0	2	141	0	0	143
9758	0	0	0	148	0	148
9759	149	0	0	0	0	149
9760	0	0	156	0	0	156
9761	0	0	0	155	0	155
9762	0	155	0	0	0	155
9763	0	0	0	159	0	159
9764	0	0	0	157	0	157
9765	0	0	0	156	0	156
9766	153	0	0	0	0	153
9767	156	0	0	0	0	156
9768	0	0	0	152	0	152
9769	0	0	153	0	0	153
9770	0	0	142	0	0	142
9771	0	0	0	155	0	155
9772	1	0	149	0	0	150
9773	0	0	0	149	0	149
9774	0	0	0	152	0	152
9775	0	0	0	151	0	151
9776	0	145	0	1	0	146
9777	0	149	0	1	0	150
9778	0	0	0	159	0	159
9779	0	0	0	160	0	160
9780	0	0	0	161	0	161
9781	159	0	0	0	0	159
9782	0	0	153	0	0	153
9783	0	0	0	159	0	159
9784	149	0	0	0	0	149
9785	0	143	0	1	0	144
9786	0	0	0	148	0	148
9787	0	0	0	148	0	148
9788	0	0	0	147	0	147
9789	0	0	0	149	0	149
9790	0	0	150	0	0	150
9791	150	0	0	0	0	150
9792	155	0	0	0	0	155
9793	0	1	143	0	0	144
9794	145	0	0	0	0	145
9795	149	0	0	0	0	149
9796	0	0	146	0	0	146
9797	0	146	0	0	0	146
9798	0	0	0	151	0	151
9799	0	0	141	0	0	141
9800	0	140	0	0	0	140
9801	0	0	144	0	0	144
9802	0	147	0	0	0	147
9803	0	0	0	156	0	156
9804	0	0	149	0	0	149
9805	0	0	0	154	0	154
9806	0	0	147	0	0	147
9807	0	151	0	0	0	151
9808	146	0	0	2	0	148
9809	0	139	0	0	0	139
9810	0	145	0	0	0	145
9811	0	0	0	151	0	151
9812	0	0	0	154	0	154
9813	0	0	0	152	0	152
9814	0	0	0	158	0	158
9815	2	0	0	158	0	160
9816	0	0	157	0	0	157
9817	0	0	0	161	0	161
9818	0	0	0	157	0	157
9819	159	0	0	2	0	161
9820	154	1	0	0	0	155
9821	156	0	0	1	0	157
9822	0	0	0	146	0	146
9823	158	0	0	0	0	158
9824	154	0	0	0	0	154
9825	159	0	0	0	0	159
9826	1	0	146	0	0	147
9827	154	0	0	0	0	154
9828	149	0	0	0	0	149
9829	150	0	0	0	0	150
9830	0	0	0	150	0	150
9831	0	0	153	0	0	153
9832	0	0	0	158	0	158
9833	159	0	0	0	0	159
9834	0	0	0	161	0	161
9835	0	156	0	0	0	156
9836	0	0	0	162	0	162
9837	167	0	0	0	0	167
9838	167	0	0	0	0	167
9839	165	0	0	0	0	165
9840	0	0	163	0	0	163
9841	1	0	0	157	0	158
9842	0	0	0	166	0	166
9843	0	0	159	0	0	159
9844	0	157	0	0	0	157
9845	0	0	158	0	0	158
9846	0	0	0	163	0	163
9847	166	0	0	0	0	166
9848	0	0	162	0	0	162
9849	0	0	0	162	0	162
9850	0	0	156	0	0	156
9851	164	0	0	0	0	164
9852	0	0	0	160	0	160
9853	0	0	159	2	0	161
9854	0	0	0	163	0	163
9855	0	0	156	0	0	156
9856	0	153	0	0	0	153
9857	0	0	0	162	0	162
9858	156	0	0	1	0	157
9859	0	0	0	159	0	159
9860	0	0	0	154	0	154
9861	147	0	0	0	0	147
9862	0	144	0	0	0	144
9863	0	140	0	0	0	140
9864	0	0	0	149	0	149
9865	0	142	0	0	0	142
9866	0	0	0	147	0	147
9867	0	0	0	143	0	143
9868	149	0	0	0	0	149
9869	0	140	0	0	0	140
9870	0	0	130	0	0	130
9871	0	138	0	0	0	138
9872	143	0	0	0	0	143
9873	145	0	0	0	0	145
9874	0	0	0	148	0	148
9875	144	0	0	0	0	144
9876	0	0	0	144	0	144
9877	142	0	0	0	0	142
9878	140	0	0	0	0	140
9879	0	0	0	143	0	143
9880	145	0	0	0	0	145
9881	0	0	143	0	0	143
9882	140	0	0	1	0	141
9883	0	0	0	143	0	143
9884	139	0	0	0	0	139
9885	0	137	0	0	0	137
9886	1	0	0	135	0	136
9887	0	0	0	133	0	133
9888	135	0	0	0	0	135
9889	0	0	136	0	0	136
9890	0	130	0	0	0	130
9891	1	0	0	132	0	133
9892	0	127	0	0	0	127
9893	0	0	0	135	0	135
9894	0	0	0	136	0	136
9895	0	0	0	136	0	136
9896	134	0	0	0	0	134
9897	0	0	0	131	0	131
9898	126	0	0	0	0	126
9899	131	0	0	0	0	131
9900	0	0	0	129	0	129
9901	124	0	0	0	0	124
9902	131	0	0	0	0	131
9903	0	0	128	0	0	128
9904	0	0	0	134	0	134
9905	129	0	0	0	0	129
9906	0	123	0	0	0	123
9907	129	0	0	0	0	129
9908	122	0	0	0	0	122
9909	0	0	119	0	0	119
9910	0	0	0	118	0	118
9911	126	0	0	0	0	126
9912	0	0	0	122	0	122
9913	0	0	0	145	0	145
9914	0	0	0	148	0	148
9915	0	0	0	145	0	145
9916	141	0	0	0	0	141
9917	0	0	150	0	0	150
9918	0	0	0	166	0	166
9919	0	0	165	0	0	165
9920	0	0	168	0	0	168
9921	172	0	0	0	0	172
9922	0	0	174	0	0	174
9923	0	170	0	1	0	171
9924	181	0	0	0	0	181
9925	168	0	0	0	0	168
9926	0	0	0	169	0	169
9927	0	0	165	0	0	165
9928	0	0	160	0	0	160
9929	163	0	0	0	0	163
9930	0	0	0	159	0	159
9931	161	0	0	0	0	161
9932	0	160	0	0	0	160
9933	159	1	0	0	0	160
9934	153	1	0	0	0	154
9935	0	152	0	0	0	152
9936	0	0	0	151	0	151
9937	150	0	0	0	0	150
9938	0	0	149	0	0	149
9939	1	143	0	1	0	145
9940	0	0	0	149	0	149
9941	146	0	0	0	0	146
9942	0	145	0	0	0	145
9943	148	0	0	0	0	148
9944	0	0	143	0	0	143
9945	144	0	0	0	0	144
9946	0	0	139	0	0	139
9947	140	0	0	0	0	140
9948	141	0	0	0	0	141
9949	0	0	130	0	0	130
9950	0	135	0	0	0	135
9951	0	0	0	140	0	140
9952	0	0	139	0	0	139
9953	0	137	0	0	0	137
9954	0	0	0	145	0	145
9955	0	0	0	144	0	144
9956	0	0	141	0	0	141
9957	0	0	0	139	0	139
9958	0	0	0	139	0	139
9959	0	0	136	0	0	136
9960	0	0	0	141	0	141
9961	0	138	0	0	0	138
9962	144	0	0	0	0	144
9963	0	0	0	141	0	141
9964	0	138	0	0	0	138
9965	0	0	0	144	0	144
9966	0	137	0	0	0	137
9967	0	0	142	0	0	142
9968	0	137	0	0	0	137
9969	150	0	0	0	0	150
9970	149	0	0	0	0	149
9971	151	0	0	0	0	151
9972	0	0	146	0	0	146
9973	0	0	132	0	0	132
9974	0	140	0	0	0	140
9975	0	0	0	146	0	146
9976	0	148	0	0	0	148
9977	0	0	0	153	0	153
9978	0	151	0	0	0	151
9979	161	0	0	0	0	161
9980	155	0	0	0	0	155
9981	0	0	0	161	0	161
9982	0	0	151	0	0	151
9983	158	0	0	0	0	158
9984	0	158	0	0	0	158
9985	1	0	0	158	0	159
9986	0	0	0	157	0	157
9987	0	152	0	1	0	153
9988	163	0	0	0	0	163
9989	0	0	153	0	0	153
9990	0	0	0	164	0	164
9991	154	0	0	1	0	155
9992	155	0	0	0	0	155
9993	0	153	3	0	0	156
9994	0	0	0	163	0	163
9995	0	152	0	0	0	152
9996	155	0	0	0	0	155
9997	0	0	149	0	0	149
9998	0	0	144	0	0	144
9999	0	0	0	154	0	154
10000	0	0	0	152	0	152
10001	0	144	0	1	0	145
10002	0	0	0	155	0	155
10003	0	0	147	0	0	147
10004	146	0	0	0	0	146
10005	0	0	0	143	0	143
10006	0	0	120	0	0	120
10007	0	0	0	122	0	122
10008	0	0	0	122	0	122
10009	1	111	0	0	0	112
10010	0	0	1	100	0	101
10011	0	0	0	98	0	98
10012	0	0	0	103	0	103
10013	92	0	0	0	0	92
10014	0	89	0	0	0	89
10015	0	73	0	0	0	73
10016	73	0	2	0	0	75
10017	72	0	0	0	0	72
10018	0	68	0	0	0	68
10019	0	69	2	0	0	71
10020	69	0	0	0	0	69
10021	0	68	0	0	0	68
10022	0	68	0	0	0	68
10023	67	0	0	0	0	67
10024	0	69	0	0	0	69
10025	69	0	0	0	0	69
10026	62	0	0	0	0	62
10027	63	0	0	0	0	63
10028	0	62	0	0	0	62
10029	0	64	0	0	0	64
10030	0	0	0	66	0	66
10031	0	65	0	0	0	65
10032	0	0	0	68	0	68
10033	66	0	0	0	0	66
10034	0	0	0	69	0	69
10035	0	66	0	0	0	66
10036	66	0	0	0	0	66
10037	0	57	0	0	0	57
10038	0	60	0	0	0	60
10039	0	0	0	62	0	62
10040	0	61	0	0	0	61
10041	64	0	0	0	0	64
10042	0	0	58	0	0	58
10043	0	61	1	0	0	62
10044	0	0	0	67	0	67
10045	0	0	65	0	0	65
10046	0	0	0	61	0	61
10047	0	0	0	58	0	58
10048	0	0	0	63	0	63
10049	0	0	0	58	0	58
10050	0	0	59	0	0	59
10051	0	57	0	0	0	57
10052	66	0	0	0	0	66
10053	0	0	63	0	0	63
10054	61	0	1	0	0	62
10055	0	0	62	0	0	62
10056	0	0	0	62	0	62
10057	0	0	60	0	0	60
10058	0	0	56	0	0	56
10059	0	0	0	60	0	60
10060	0	0	0	60	0	60
10061	0	0	0	60	0	60
10062	0	0	0	59	0	59
10063	60	0	0	0	0	60
10064	0	0	62	0	0	62
10065	65	0	0	0	0	65
10066	63	0	0	0	0	63
10067	63	0	0	0	0	63
10068	64	0	0	0	0	64
10069	61	0	0	0	0	61
10070	0	0	0	59	0	59
10071	0	0	55	0	0	55
10072	0	0	49	0	0	49
10073	0	56	1	0	0	57
10074	54	0	0	0	0	54
10075	0	0	0	54	0	54
10076	0	0	0	59	0	59
10077	1	53	0	0	0	54
10078	0	53	0	0	0	53
10079	0	52	0	0	0	52
10080	56	0	0	0	0	56
10081	0	0	0	55	0	55
10082	0	51	0	0	0	51
10083	0	0	0	56	0	56
10084	0	0	52	0	0	52
10085	0	0	53	0	0	53
10086	0	0	0	56	0	56
10087	58	0	0	0	0	58
10088	56	0	0	0	0	56
10089	58	0	0	0	0	58
10090	0	0	55	0	0	55
10091	0	0	0	54	0	54
10092	0	0	0	57	0	57
10093	0	0	61	0	0	61
10094	59	0	0	0	0	59
10095	0	0	58	0	0	58
10096	0	0	59	0	0	59
10097	0	0	58	0	0	58
10098	0	0	0	62	0	62
10099	0	0	0	62	0	62
10100	0	0	63	0	0	63
10101	0	0	0	61	0	61
10102	63	0	0	0	0	63
10103	0	0	0	66	0	66
10104	0	0	64	0	0	64
10105	0	0	61	0	0	61
10106	0	0	0	64	0	64
10107	59	0	0	0	0	59
10108	0	59	0	0	0	59
10109	59	0	0	0	0	59
10110	60	0	0	0	0	60
10111	0	0	55	0	0	55
10112	0	0	0	57	0	57
10113	55	0	0	2	0	57
10114	54	0	0	0	0	54
10115	0	59	0	0	0	59
10116	0	0	0	59	0	59
10117	0	0	0	55	0	55
10118	0	0	53	0	0	53
10119	2	0	0	55	0	57
10120	0	0	56	0	0	56
10121	0	0	51	2	0	53
10122	0	0	0	56	0	56
10123	57	0	0	0	0	57
10124	0	56	0	0	0	56
10125	52	0	0	0	0	52
10126	53	0	0	0	0	53
10127	0	51	0	0	0	51
10128	0	0	0	56	0	56
10129	54	0	0	0	0	54
10130	0	60	0	0	0	60
10131	54	0	0	0	0	54
10132	0	60	0	0	0	60
10133	0	0	0	61	0	61
10134	0	0	0	65	0	65
10135	61	0	0	0	0	61
10136	59	0	0	1	0	60
10137	0	61	0	0	0	61
10138	0	0	60	0	0	60
10139	0	0	61	0	0	61
10140	0	0	0	61	0	61
10141	0	64	0	0	0	64
10142	0	0	0	63	0	63
10143	1	0	0	65	0	66
10144	0	0	0	67	0	67
10145	0	0	66	0	0	66
10146	0	0	62	0	0	62
10147	0	66	0	0	0	66
10148	0	0	0	72	0	72
10149	0	0	0	68	0	68
10150	0	0	72	0	0	72
10151	71	0	0	1	0	72
10152	0	0	0	75	0	75
10153	0	0	72	0	0	72
10154	75	0	0	0	0	75
10155	0	68	0	0	0	68
10156	0	0	69	1	0	70
10157	1	0	0	73	0	74
10158	73	0	0	0	0	73
10159	1	0	72	0	0	73
10160	0	0	1	72	0	73
10161	0	0	0	73	0	73
10162	0	0	0	81	0	81
10163	77	0	0	0	0	77
10164	0	80	0	0	0	80
10165	0	0	0	79	0	79
10166	0	0	77	0	0	77
10167	1	0	0	74	0	75
10168	0	77	0	0	0	77
10169	0	80	0	0	0	80
10170	82	0	0	0	0	82
10171	83	0	0	0	0	83
10172	1	0	80	0	0	81
10173	80	0	0	0	0	80
10174	1	80	0	0	0	81
10175	82	0	0	0	0	82
10176	0	0	0	81	0	81
10177	0	0	81	0	0	81
10178	0	0	0	81	0	81
10179	0	0	76	0	0	76
10180	79	0	0	0	0	79
10181	0	0	0	76	0	76
10182	0	75	0	0	0	75
10183	0	0	0	75	0	75
10184	0	0	76	0	0	76
10185	0	75	0	1	0	76
10186	78	0	0	0	0	78
10187	0	72	0	2	0	74
10188	0	77	0	1	0	78
10189	0	0	0	82	0	82
10190	0	80	0	0	0	80
10191	0	0	0	84	0	84
10192	0	0	84	0	0	84
10193	82	0	0	0	0	82
10194	79	0	0	0	0	79
10195	0	0	77	0	0	77
10196	75	0	0	0	0	75
10197	0	79	0	0	0	79
10198	78	0	0	0	0	78
10199	0	0	0	80	0	80
10200	0	0	75	0	0	75
10201	0	80	0	0	0	80
10202	0	0	1	83	0	84
10203	0	0	0	86	0	86
10204	81	0	0	0	0	81
10205	84	0	0	0	0	84
10206	0	75	0	1	0	76
10207	0	74	0	1	0	75
10208	0	77	0	0	0	77
10209	0	0	0	84	0	84
10210	85	0	0	0	0	85
10211	87	0	0	0	0	87
10212	0	0	0	87	0	87
10213	0	0	0	88	0	88
10214	86	0	0	0	0	86
10215	0	0	0	85	0	85
10216	0	0	85	0	0	85
10217	88	0	0	0	0	88
10218	87	0	0	0	0	87
10219	0	0	84	0	0	84
10220	91	0	0	0	0	91
10221	0	0	0	88	0	88
10222	0	0	0	88	0	88
10223	0	0	0	85	0	85
10224	89	0	0	0	0	89
10225	0	86	0	0	0	86
10226	0	0	0	81	0	81
10227	0	82	0	0	0	82
10228	85	0	0	0	0	85
10229	0	0	0	83	0	83
10230	0	0	0	80	0	80
10231	0	82	0	0	0	82
10232	0	0	80	0	0	80
10233	0	0	0	84	0	84
10234	80	0	0	0	0	80
10235	78	0	0	0	0	78
10236	0	0	73	0	0	73
10237	0	0	0	76	0	76
10238	0	77	0	0	0	77
10239	0	0	0	77	0	77
10240	76	0	0	0	0	76
10241	75	0	0	0	0	75
10242	0	0	0	83	0	83
10243	0	80	0	0	0	80
10244	84	0	0	0	0	84
10245	0	0	0	82	0	82
10246	81	0	0	0	0	81
10247	83	0	0	0	0	83
10248	0	0	0	83	0	83
10249	0	0	0	78	0	78
10250	0	0	0	82	0	82
10251	0	82	0	0	0	82
10252	0	0	0	83	0	83
10253	0	0	0	82	0	82
10254	0	0	74	1	0	75
10255	1	0	72	0	0	73
10256	0	0	0	77	0	77
10257	71	0	0	0	0	71
10258	0	73	0	0	0	73
10259	73	0	0	0	0	73
10260	0	0	72	0	0	72
10261	0	0	65	0	0	65
10262	0	69	0	0	0	69
10263	0	0	0	71	0	71
10264	0	0	71	0	0	71
10265	0	0	71	0	0	71
10266	0	0	0	71	0	71
10267	69	0	0	0	0	69
10268	69	0	0	0	0	69
10269	0	1	0	69	0	70
10270	0	0	71	1	0	72
10271	0	0	0	71	0	71
10272	0	0	0	69	0	69
10273	0	71	0	0	0	71
10274	70	0	0	0	0	70
10275	71	0	0	0	0	71
10276	0	72	0	0	0	72
10277	0	0	0	74	0	74
10278	0	73	0	0	0	73
10279	73	0	0	0	0	73
10280	0	0	70	0	0	70
10281	2	0	65	0	0	67
10282	0	0	65	0	0	65
10283	0	0	0	65	0	65
10284	0	0	0	66	0	66
10285	67	0	0	0	0	67
10286	0	1	0	67	0	68
10287	0	0	0	69	0	69
10288	0	0	68	0	0	68
10289	0	0	68	0	0	68
10290	75	0	0	0	0	75
10291	0	70	0	0	0	70
10292	75	0	0	0	0	75
10293	0	0	0	78	0	78
10294	0	0	0	72	0	72
10295	0	69	0	0	0	69
10296	0	0	0	73	0	73
10297	74	0	0	0	0	74
10298	0	0	0	75	0	75
10299	0	0	72	0	0	72
10300	0	73	0	3	0	76
10301	75	0	0	0	0	75
10302	72	0	0	0	0	72
10303	75	0	0	0	0	75
10304	73	0	0	0	0	73
10305	0	0	0	74	0	74
10306	0	0	0	71	0	71
10307	0	0	71	0	0	71
10308	0	0	0	73	0	73
10309	0	0	70	0	0	70
10310	0	0	0	72	0	72
10311	72	0	0	0	0	72
10312	0	72	0	0	0	72
10313	0	0	0	69	0	69
10314	0	0	0	69	0	69
10315	69	0	0	0	0	69
10316	67	0	0	0	0	67
10317	0	0	65	1	0	66
10318	0	67	0	0	0	67
10319	0	0	0	71	0	71
10320	0	0	0	72	0	72
10321	73	0	0	0	0	73
10322	71	0	0	0	0	71
10323	0	0	71	1	0	72
10324	0	0	68	0	0	68
10325	0	0	0	72	0	72
10326	0	0	0	71	0	71
10327	0	0	70	0	0	70
10328	70	0	0	0	0	70
10329	0	0	0	72	0	72
10330	70	0	0	0	0	70
10331	0	73	0	0	0	73
10332	74	0	0	0	0	74
10333	0	0	68	0	0	68
10334	0	72	0	0	0	72
10335	0	69	0	0	0	69
10336	72	0	0	1	0	73
10337	73	0	0	0	0	73
10338	0	0	0	72	0	72
10339	0	68	0	0	0	68
10340	0	69	0	0	0	69
10341	0	0	0	72	0	72
10342	73	0	0	0	0	73
10343	75	0	0	0	0	75
10344	0	0	71	0	0	71
10345	76	0	0	0	0	76
10346	0	77	0	0	0	77
10347	82	0	0	0	0	82
10348	0	78	0	1	0	79
10349	0	80	0	1	0	81
10350	0	0	0	84	0	84
10351	84	0	0	0	0	84
10352	81	0	0	0	0	81
10353	0	0	82	1	0	83
10354	0	0	0	84	0	84
10355	89	0	0	0	0	89
10356	0	0	0	94	0	94
10357	93	0	0	0	0	93
10358	91	0	0	0	0	91
10359	0	0	92	0	0	92
10360	0	0	0	90	0	90
10361	0	0	0	91	0	91
10362	0	0	0	90	0	90
10363	0	0	87	0	0	87
10364	0	0	0	93	0	93
10365	0	0	0	87	0	87
10366	0	93	0	0	0	93
10367	0	0	91	0	0	91
10368	0	96	0	0	0	96
10369	93	0	0	0	0	93
10370	0	0	0	91	0	91
10371	0	0	0	96	0	96
10372	0	94	0	0	0	94
10373	96	0	0	0	0	96
10374	95	0	0	0	0	95
10375	0	96	0	0	0	96
10376	0	99	0	0	0	99
10377	98	0	0	0	0	98
10378	0	0	96	0	0	96
10379	0	1	92	0	0	93
10380	94	0	0	0	0	94
10381	0	98	0	0	0	98
10382	98	0	0	0	0	98
10383	0	0	94	0	0	94
10384	97	0	0	0	0	97
10385	0	97	0	0	0	97
10386	0	0	0	99	0	99
10387	0	0	0	101	0	101
10388	0	0	0	101	0	101
10389	0	0	0	99	0	99
10390	0	0	0	99	0	99
10391	0	99	0	0	0	99
10392	98	0	0	0	0	98
10393	0	0	100	0	0	100
10394	0	0	0	101	0	101
10395	0	0	96	0	0	96
10396	0	0	0	96	0	96
10397	0	0	0	98	0	98
10398	102	0	0	0	0	102
10399	0	0	96	2	0	98
10400	1	98	0	0	0	99
10401	0	0	0	102	0	102
10402	0	0	0	100	0	100
10403	0	0	101	0	0	101
10404	0	0	0	101	0	101
10405	0	0	0	104	0	104
10406	96	1	0	0	0	97
10407	0	103	0	0	0	103
10408	99	0	0	0	0	99
10409	98	0	0	0	0	98
10410	0	0	0	100	0	100
10411	0	0	93	0	0	93
10412	0	0	95	0	0	95
10413	0	0	0	100	0	100
10414	0	0	0	96	0	96
10415	0	98	0	0	0	98
10416	99	0	0	0	0	99
10417	0	91	0	0	0	91
10418	0	93	0	0	0	93
10419	99	0	0	0	0	99
10420	0	0	0	99	0	99
10421	0	99	0	0	0	99
10422	0	0	0	96	0	96
10423	0	0	97	0	0	97
10424	0	0	91	0	0	91
10425	0	0	0	95	0	95
10426	0	0	95	0	0	95
10427	0	0	0	98	0	98
10428	0	0	0	99	0	99
10429	0	0	0	99	0	99
10430	98	0	0	0	0	98
10431	0	91	1	0	0	92
10432	0	91	0	0	0	91
10433	92	0	0	0	0	92
10434	100	0	0	0	0	100
10435	0	0	0	91	0	91
10436	0	0	92	0	0	92
10437	0	0	0	90	0	90
10438	0	0	88	0	0	88
10439	0	81	0	0	0	81
10440	0	0	0	89	0	89
10441	89	0	0	0	0	89
10442	0	0	0	87	0	87
10443	0	0	81	0	0	81
10444	88	0	0	0	0	88
10445	0	0	81	0	0	81
10446	0	0	81	0	0	81
10447	0	75	0	1	0	76
10448	0	66	0	1	0	67
10449	0	72	0	0	0	72
10450	73	0	0	0	0	73
10451	72	0	0	0	0	72
10452	0	0	0	70	0	70
10453	0	0	0	67	0	67
10454	0	0	0	68	0	68
10455	0	70	0	0	0	70
10456	73	0	0	0	0	73
10457	0	69	0	0	0	69
10458	0	0	0	69	0	69
10459	65	0	0	0	0	65
10460	0	0	0	65	0	65
10461	0	0	0	67	0	67
10462	66	0	0	0	0	66
10463	67	0	0	0	0	67
10464	0	0	66	0	0	66
10465	0	0	61	0	0	61
10466	0	0	62	0	0	62
10467	0	0	0	63	0	63
10468	0	0	0	60	0	60
10469	0	61	0	0	0	61
10470	61	0	0	0	0	61
10471	1	0	0	55	0	56
10472	0	0	0	58	0	58
10473	0	56	0	0	0	56
10474	0	57	0	0	0	57
10475	0	0	0	60	0	60
10476	0	0	0	60	0	60
10477	61	0	0	1	0	62
10478	56	0	0	0	0	56
10479	0	0	0	58	0	58
10480	1	0	55	0	0	56
10481	0	0	52	0	0	52
10482	0	0	0	55	0	55
10483	0	0	1	56	0	57
10484	0	58	0	0	0	58
10485	60	0	0	0	0	60
10486	0	0	0	58	0	58
10487	0	0	57	0	0	57
10488	0	0	0	56	0	56
10489	0	0	54	0	0	54
10490	0	0	51	0	0	51
10491	0	0	0	54	0	54
10492	52	0	0	0	0	52
10493	0	0	51	0	0	51
10494	0	0	0	53	0	53
10495	0	0	55	0	0	55
10496	0	0	0	52	0	52
10497	0	0	0	56	0	56
10498	0	0	56	0	0	56
10499	0	0	55	0	0	55
10500	0	0	0	53	0	53
10501	0	0	0	55	0	55
10502	0	0	0	54	0	54
10503	0	0	0	54	0	54
10504	54	0	0	0	0	54
10505	51	0	0	0	0	51
10506	0	53	0	0	0	53
10507	53	0	0	0	0	53
10508	0	0	0	53	0	53
10509	52	0	0	0	0	52
10510	0	0	52	0	0	52
10511	50	0	0	0	0	50
10512	0	0	0	52	0	52
10513	0	0	0	53	0	53
10514	53	0	0	0	0	53
10515	0	0	0	54	0	54
10516	0	0	56	0	0	56
10517	52	0	0	0	0	52
10518	0	53	0	0	0	53
10519	0	0	0	56	0	56
10520	0	0	56	0	0	56
10521	0	0	0	58	0	58
10522	0	0	56	0	0	56
10523	0	0	0	55	0	55
10524	0	53	0	0	0	53
10525	0	0	0	55	0	55
10526	0	56	0	0	0	56
10527	0	0	0	57	0	57
10528	0	0	0	56	0	56
10529	0	0	0	55	0	55
10530	0	0	0	57	0	57
10531	0	0	0	56	0	56
10532	0	0	56	0	0	56
10533	0	0	0	49	0	49
10534	0	0	0	49	0	49
10535	44	0	0	0	0	44
10536	0	49	0	0	0	49
10537	48	0	0	0	0	48
10538	0	0	0	48	0	48
10539	0	0	45	0	0	45
10540	0	47	0	0	0	47
10541	45	0	0	0	0	45
10542	0	42	0	0	0	42
10543	0	44	0	0	0	44
10544	44	0	0	0	0	44
10545	0	0	0	47	0	47
10546	44	0	0	0	0	44
10547	0	0	0	44	0	44
10548	0	0	47	0	0	47
10549	0	0	49	0	0	49
10550	49	0	0	0	0	49
10551	48	0	0	0	0	48
10552	0	0	0	47	0	47
10553	0	0	0	48	0	48
10554	48	0	0	0	0	48
10555	0	46	0	0	0	46
10556	0	47	0	0	0	47
10557	50	0	0	0	0	50
10558	49	0	0	0	0	49
10559	0	46	1	0	0	47
10560	0	0	0	50	0	50
10561	0	0	52	0	0	52
10562	1	0	47	0	0	48
10563	49	0	0	2	0	51
10564	0	0	50	0	0	50
10565	0	0	0	50	0	50
10566	0	0	0	51	0	51
10567	0	53	0	0	0	53
10568	50	0	0	0	0	50
10569	0	0	0	51	0	51
10570	0	0	47	0	0	47
10571	0	44	0	0	0	44
10572	0	0	0	49	0	49
10573	0	0	45	0	0	45
10574	0	0	43	0	0	43
10575	0	45	0	0	0	45
10576	48	0	0	0	0	48
10577	0	47	0	0	0	47
10578	50	0	0	0	0	50
10579	0	0	49	0	0	49
10580	48	0	0	0	0	48
10581	0	50	0	0	0	50
10582	0	0	0	50	0	50
10583	0	0	0	50	0	50
10584	52	0	0	0	0	52
10585	0	0	49	0	0	49
10586	48	0	0	0	0	48
10587	49	0	0	0	0	49
10588	0	0	48	0	0	48
10589	0	0	45	0	0	45
10590	0	0	0	47	0	47
10591	51	0	0	0	0	51
10592	49	0	0	0	0	49
10593	0	47	0	0	0	47
10594	0	0	0	52	0	52
10595	0	0	0	51	0	51
10596	0	0	0	51	0	51
10597	0	0	0	47	0	47
10598	49	0	0	0	0	49
10599	0	0	0	48	0	48
10600	0	0	49	0	0	49
10601	0	0	47	0	0	47
10602	46	0	0	0	0	46
10603	0	46	0	0	0	46
10604	0	49	0	0	0	49
10605	0	0	0	52	0	52
10606	0	0	0	51	0	51
10607	0	0	0	50	0	50
10608	0	0	0	52	0	52
10609	0	0	48	0	0	48
10610	0	0	0	45	0	45
10611	0	0	0	46	0	46
10612	0	0	44	0	0	44
10613	42	0	0	0	0	42
10614	0	39	0	0	0	39
10615	44	0	0	0	0	44
10616	0	0	41	0	0	41
10617	0	0	40	0	0	40
10618	0	43	0	0	0	43
10619	43	0	0	0	0	43
10620	42	0	0	0	0	42
10621	41	0	0	0	0	41
10622	0	41	0	0	0	41
10623	42	0	0	0	0	42
10624	0	0	42	0	0	42
10625	0	43	0	0	0	43
10626	44	0	0	0	0	44
10627	0	47	0	0	0	47
10628	50	0	0	0	0	50
10629	48	0	0	1	0	49
10630	0	0	47	0	0	47
10631	0	47	0	0	0	47
10632	52	0	0	0	0	52
10633	0	0	50	0	0	50
10634	0	51	0	0	0	51
10635	0	0	0	52	0	52
10636	0	0	50	0	0	50
10637	1	0	50	0	0	51
10638	0	0	0	50	0	50
10639	49	0	0	0	0	49
10640	0	49	0	0	0	49
10641	0	0	46	0	0	46
10642	0	0	47	0	0	47
10643	49	0	0	0	0	49
10644	0	49	0	0	0	49
10645	50	0	0	0	0	50
10646	0	50	0	0	0	50
10647	48	0	0	0	0	48
10648	51	0	0	0	0	51
10649	0	49	0	0	0	49
10650	0	0	0	48	0	48
10651	48	0	0	0	0	48
10652	0	0	0	47	0	47
10653	0	0	0	44	0	44
10654	45	0	0	0	0	45
10655	0	43	0	0	0	43
10656	43	0	0	0	0	43
10657	0	0	45	0	0	45
10658	0	0	0	41	0	41
10659	0	0	0	45	0	45
10660	43	0	0	0	0	43
10661	44	0	0	0	0	44
10662	0	0	0	44	0	44
10663	0	0	44	0	0	44
10664	0	0	0	43	0	43
10665	0	0	0	44	0	44
10666	0	0	0	45	0	45
10667	0	0	0	44	0	44
10668	42	0	0	0	0	42
10669	0	0	38	0	0	38
10670	0	43	0	0	0	43
10671	0	0	0	44	0	44
10672	0	0	0	46	0	46
10673	0	0	41	0	0	41
10674	0	0	38	0	0	38
10675	0	0	0	40	0	40
10676	0	0	0	43	0	43
10677	0	0	43	0	0	43
10678	0	0	0	43	0	43
10679	45	0	0	0	0	45
10680	0	46	0	0	0	46
10681	0	0	42	0	0	42
10682	0	45	0	0	0	45
10683	0	0	0	45	0	45
10684	0	0	42	0	0	42
10685	0	41	0	0	0	41
10686	0	0	0	45	0	45
10687	0	0	45	0	0	45
10688	0	0	0	42	0	42
10689	0	0	0	42	0	42
10690	44	0	0	0	0	44
10691	0	0	0	42	0	42
10692	44	0	0	0	0	44
10693	41	0	0	0	0	41
10694	43	0	0	0	0	43
10695	0	0	0	43	0	43
10696	0	0	39	0	0	39
10697	0	0	37	0	0	37
10698	39	0	0	0	0	39
10699	0	0	38	0	0	38
10700	37	0	0	0	0	37
10701	0	36	0	0	0	36
10702	38	0	0	0	0	38
10703	0	0	39	0	0	39
10704	0	0	38	0	0	38
10705	0	0	0	33	0	33
10706	0	0	39	0	0	39
10707	0	1	37	0	0	38
10708	0	0	0	39	0	39
10709	0	0	0	38	0	38
10710	0	0	0	38	0	38
10711	0	39	0	0	0	39
10712	0	0	0	40	0	40
10713	0	40	0	0	0	40
10714	40	0	0	0	0	40
10715	39	0	0	0	0	39
10716	0	0	0	45	0	45
10717	0	39	0	0	0	39
10718	1	0	36	0	0	37
10719	43	0	0	0	0	43
10720	0	0	5	36	0	41
10721	0	0	0	40	0	40
10722	0	0	0	44	0	44
10723	37	0	0	0	0	37
10724	0	42	0	0	0	42
10725	0	36	0	0	0	36
10726	38	0	0	0	0	38
10727	0	39	0	0	0	39
10728	38	0	0	0	0	38
10729	38	0	0	0	0	38
10730	0	37	0	0	0	37
10731	0	0	0	39	0	39
10732	0	38	0	0	0	38
10733	0	0	0	40	0	40
10734	0	0	0	40	0	40
10735	38	0	0	0	0	38
10736	36	0	0	0	0	36
10737	0	0	0	37	0	37
10738	0	0	38	0	0	38
10739	37	0	0	0	0	37
10740	0	40	0	0	0	40
10741	0	0	0	44	0	44
10742	0	0	0	43	0	43
10743	0	0	0	41	0	41
10744	41	0	0	0	0	41
10745	40	0	1	0	0	41
10746	0	41	0	0	0	41
10747	0	40	0	0	0	40
10748	0	0	0	44	0	44
10749	0	0	0	44	0	44
10750	0	0	42	0	0	42
10751	0	0	0	42	0	42
10752	0	0	44	0	0	44
10753	0	0	40	0	0	40
10754	0	38	0	0	0	38
10755	0	0	0	43	0	43
10756	40	0	0	0	0	40
10757	0	0	0	42	0	42
10758	0	0	43	0	0	43
10759	40	0	0	0	0	40
10760	42	0	0	0	0	42
10761	0	0	41	0	0	41
10762	0	0	0	43	0	43
10763	39	0	0	0	0	39
10764	0	40	0	0	0	40
10765	41	0	0	0	0	41
10766	42	0	0	0	0	42
10767	0	0	0	40	0	40
10768	0	0	0	37	0	37
10769	39	0	0	0	0	39
10770	0	0	0	40	0	40
10771	0	0	37	0	0	37
10772	39	0	0	0	0	39
10773	36	0	0	1	0	37
10774	0	38	0	0	0	38
10775	0	35	0	0	0	35
10776	0	0	0	39	0	39
10777	0	39	0	0	0	39
10778	0	0	0	40	0	40
10779	42	0	0	0	0	42
10780	41	0	0	0	0	41
10781	0	42	0	0	0	42
10782	40	0	0	1	0	41
10783	0	42	0	0	0	42
10784	43	0	0	0	0	43
10785	39	0	0	0	0	39
10786	0	0	41	0	0	41
10787	39	0	0	0	0	39
10788	0	41	0	0	0	41
10789	0	40	0	0	0	40
10790	43	0	0	0	0	43
10791	0	0	0	42	0	42
10792	0	0	41	0	0	41
10793	0	0	0	39	0	39
10794	0	0	0	44	0	44
10795	0	0	42	0	0	42
10796	40	0	1	0	0	41
10797	0	39	0	0	0	39
10798	41	0	0	0	0	41
10799	0	0	0	40	0	40
10800	40	0	0	0	0	40
10801	0	40	0	0	0	40
10802	0	0	0	41	0	41
10803	41	0	0	0	0	41
10804	0	0	43	0	0	43
10805	0	1	39	0	0	40
10806	42	0	0	0	0	42
10807	0	43	0	0	0	43
10808	0	41	0	0	0	41
10809	0	0	0	44	0	44
10810	0	40	0	0	0	40
10811	0	0	0	39	0	39
10812	0	0	0	37	0	37
10813	0	0	0	39	0	39
10814	0	39	0	0	0	39
10815	0	0	0	37	0	37
10816	0	0	32	0	0	32
10817	0	30	0	0	0	30
10818	0	0	0	33	0	33
10819	0	33	0	0	0	33
10820	34	0	0	0	0	34
10821	32	0	0	0	0	32
10822	34	0	0	0	0	34
10823	0	35	0	0	0	35
10824	0	0	0	34	0	34
10825	0	0	36	0	0	36
10826	0	0	35	0	0	35
10827	37	0	0	0	0	37
10828	33	0	0	0	0	33
10829	0	0	0	35	0	35
10830	0	0	0	35	0	35
10831	0	0	35	0	0	35
10832	0	33	0	0	0	33
10833	0	31	0	0	0	31
10834	0	0	30	0	0	30
10835	0	0	0	34	0	34
10836	0	0	0	36	0	36
10837	0	0	0	39	0	39
10838	0	0	0	40	0	40
10839	40	0	0	0	0	40
10840	0	0	38	0	0	38
10841	40	0	0	0	0	40
10842	0	0	0	42	0	42
10843	40	0	0	0	0	40
10844	0	0	0	43	0	43
10845	0	0	45	0	0	45
10846	0	0	0	44	0	44
10847	0	0	42	0	0	42
10848	0	0	0	44	0	44
10849	0	0	44	0	0	44
10850	0	41	0	0	0	41
10851	0	0	0	43	0	43
10852	0	0	0	43	0	43
10853	0	43	0	0	0	43
10854	42	0	0	0	0	42
10855	0	0	0	43	0	43
10856	0	0	0	43	0	43
10857	41	0	0	0	0	41
10858	41	0	0	0	0	41
10859	41	0	0	0	0	41
10860	41	0	0	0	0	41
10861	0	0	41	0	0	41
10862	42	0	0	0	0	42
10863	41	0	0	0	0	41
10864	0	0	0	42	0	42
10865	0	0	0	42	0	42
10866	42	0	0	0	0	42
10867	0	43	0	0	0	43
10868	0	0	0	42	0	42
10869	0	0	44	0	0	44
10870	0	44	0	0	0	44
10871	45	0	0	0	0	45
10872	42	0	0	0	0	42
10873	42	0	0	1	0	43
10874	45	0	0	0	0	45
10875	0	0	0	46	0	46
10876	0	0	46	0	0	46
10877	0	0	40	0	0	40
10878	0	0	0	48	0	48
10879	47	0	0	0	0	47
10880	0	0	0	47	0	47
10881	0	0	45	0	0	45
10882	45	0	0	0	0	45
10883	45	0	0	0	0	45
10884	0	0	0	45	0	45
10885	0	0	51	0	0	51
10886	1	0	45	0	0	46
10887	52	0	0	1	0	53
10888	0	45	0	0	0	45
10889	0	0	47	0	0	47
10890	1	0	0	49	0	50
10891	53	0	0	0	0	53
10892	0	48	0	0	0	48
10893	0	50	0	0	0	50
10894	53	0	0	0	0	53
10895	0	0	0	51	0	51
10896	51	0	0	0	0	51
10897	0	0	1	45	0	46
10898	0	0	0	48	0	48
10899	0	0	42	0	0	42
10900	0	0	39	0	0	39
10901	0	0	42	0	0	42
10902	0	0	0	47	0	47
10903	50	0	0	0	0	50
10904	0	0	49	0	0	49
10905	0	0	0	49	0	49
10906	0	0	47	0	0	47
10907	0	47	0	0	0	47
10908	0	0	0	49	0	49
10909	0	0	0	47	0	47
10910	0	0	0	48	0	48
10911	50	0	0	0	0	50
10912	0	0	0	52	0	52
10913	0	0	0	49	0	49
10914	50	0	0	0	0	50
10915	0	0	49	0	0	49
10916	48	0	0	0	0	48
10917	49	0	0	0	0	49
10918	0	0	47	0	0	47
10919	49	0	0	0	0	49
10920	0	0	1	48	0	49
10921	0	0	48	0	0	48
10922	50	0	0	0	0	50
10923	50	0	0	0	0	50
10924	0	0	1	47	0	48
10925	0	0	0	51	0	51
10926	0	0	0	50	0	50
10927	50	0	0	0	0	50
10928	0	47	0	0	0	47
10929	47	0	0	0	0	47
10930	0	45	0	0	0	45
10931	0	43	0	0	0	43
10932	0	0	0	48	0	48
10933	0	0	0	47	0	47
10934	0	0	0	45	0	45
10935	0	0	0	45	0	45
10936	0	0	45	0	0	45
10937	45	0	0	0	0	45
10938	0	0	0	42	0	42
10939	0	0	43	0	0	43
10940	0	0	0	42	0	42
10941	0	0	0	40	0	40
10942	0	0	42	0	0	42
10943	0	0	0	42	0	42
10944	0	0	0	42	0	42
10945	44	0	0	0	0	44
10946	0	0	47	0	0	47
10947	45	1	0	0	0	46
10948	0	49	0	0	0	49
10949	48	0	0	0	0	48
10950	49	0	0	0	0	49
10951	0	0	0	45	0	45
10952	0	0	44	0	0	44
10953	0	48	0	0	0	48
10954	1	0	0	48	0	49
10955	0	49	0	0	0	49
10956	48	0	0	0	0	48
10957	0	0	43	0	0	43
10958	0	0	44	1	0	45
10959	0	0	0	44	0	44
10960	0	0	46	0	0	46
10961	0	0	0	46	0	46
10962	0	0	0	39	0	39
10963	43	0	0	0	0	43
10964	0	40	0	0	0	40
10965	0	0	0	40	0	40
10966	0	0	0	44	0	44
10967	0	0	0	45	0	45
10968	1	43	0	0	0	44
10969	0	47	0	0	0	47
10970	48	0	0	0	0	48
10971	45	0	0	0	0	45
10972	46	0	0	0	0	46
10973	0	0	47	0	0	47
10974	0	0	0	46	0	46
10975	0	0	43	0	0	43
10976	0	43	0	0	0	43
10977	47	0	0	0	0	47
10978	0	0	42	0	0	42
10979	0	0	0	42	0	42
10980	0	0	43	0	0	43
10981	43	0	0	0	0	43
10982	47	0	0	0	0	47
10983	44	0	0	0	0	44
10984	44	0	0	0	0	44
10985	0	0	45	1	0	46
10986	45	0	0	0	0	45
10987	42	0	0	0	0	42
10988	0	46	0	0	0	46
10989	46	0	0	0	0	46
10990	46	0	0	0	0	46
10991	0	0	0	47	0	47
10992	0	46	0	0	0	46
10993	45	0	0	0	0	45
10994	47	0	0	0	0	47
10995	0	0	47	0	0	47
10996	0	0	41	0	0	41
10997	0	0	44	0	0	44
10998	0	0	0	48	0	48
10999	47	0	0	0	0	47
11000	0	50	0	0	0	50
11001	46	0	0	1	0	47
11002	0	48	0	0	0	48
11003	48	0	0	0	0	48
11004	0	44	0	0	0	44
11005	0	44	0	0	0	44
11006	46	0	0	0	0	46
11007	0	49	0	0	0	49
11008	0	0	0	50	0	50
11009	0	0	46	0	0	46
11010	0	1	41	0	0	42
11011	0	0	0	49	0	49
11012	0	0	0	51	0	51
11013	0	0	53	0	0	53
11014	0	0	0	53	0	53
11015	1	0	0	53	0	54
11016	51	0	0	0	0	51
11017	0	54	0	0	0	54
11018	0	0	0	53	0	53
11019	0	55	0	0	0	55
11020	52	0	0	0	0	52
11021	0	55	0	0	0	55
11022	56	0	0	0	0	56
11023	55	0	0	0	0	55
11024	0	0	0	53	0	53
11025	0	0	0	55	0	55
11026	0	0	0	56	0	56
11027	0	0	0	55	0	55
11028	0	0	51	0	0	51
11029	54	0	0	0	0	54
11030	0	56	0	0	0	56
11031	0	0	0	55	0	55
11032	0	0	0	56	0	56
11033	0	54	0	0	0	54
11034	56	0	0	0	0	56
11035	0	54	0	0	0	54
11036	0	0	0	59	0	59
11037	0	0	0	59	0	59
11038	0	0	0	59	0	59
11039	0	0	0	53	0	53
11040	54	0	0	0	0	54
11041	0	0	52	0	0	52
11042	0	0	0	51	0	51
11043	0	0	0	53	0	53
11044	1	0	0	47	0	48
11045	0	0	0	47	0	47
11046	46	0	0	0	0	46
11047	0	0	45	0	0	45
11048	0	0	0	45	0	45
11049	0	43	0	0	0	43
11050	0	45	0	0	0	45
11051	41	0	0	0	0	41
11052	0	0	43	0	0	43
11053	44	0	0	0	0	44
11054	0	0	44	0	0	44
11055	0	0	0	47	0	47
11056	41	0	0	1	0	42
11057	0	45	0	0	0	45
11058	0	0	0	43	0	43
11059	0	41	0	0	0	41
11060	39	0	0	0	0	39
11061	41	0	0	0	0	41
11062	0	0	0	40	0	40
11063	0	0	38	0	0	38
11064	0	0	36	0	0	36
11065	0	0	0	36	0	36
11066	0	37	0	0	0	37
11067	0	0	0	40	0	40
11068	0	0	0	40	0	40
11069	0	0	0	43	0	43
11070	0	0	37	0	0	37
11071	1	0	0	41	0	42
11072	0	0	0	42	0	42
11073	0	32	0	0	0	32
11074	0	0	0	40	0	40
11075	0	0	0	40	0	40
11076	0	0	0	40	0	40
11077	0	0	0	41	0	41
11078	1	0	0	39	0	40
11079	0	0	0	36	0	36
11080	0	0	0	39	0	39
11081	0	0	0	36	0	36
11082	0	0	35	0	0	35
11083	0	0	0	38	0	38
11084	35	0	0	0	0	35
11085	0	0	0	38	0	38
11086	0	0	36	0	0	36
11087	35	0	0	0	0	35
11088	39	0	0	0	0	39
11089	37	0	1	0	0	38
11090	38	0	0	1	0	39
11091	0	0	0	39	0	39
11092	0	0	40	1	0	41
11093	0	31	0	1	0	32
11094	0	42	0	0	0	42
11095	0	0	0	46	0	46
11096	1	0	0	46	0	47
11097	0	0	0	53	0	53
11098	0	0	0	50	0	50
11099	0	0	0	50	0	50
11100	45	0	0	2	0	47
11101	0	44	0	0	0	44
11102	0	45	0	1	0	46
11103	0	0	0	51	0	51
11104	0	0	0	52	0	52
11105	0	0	0	50	0	50
11106	0	0	0	51	0	51
11107	0	0	44	0	0	44
11108	0	42	0	0	0	42
11109	0	0	0	43	0	43
11110	46	0	0	0	0	46
11111	0	0	0	48	0	48
11112	0	0	45	0	0	45
11113	0	0	39	0	0	39
11114	0	0	40	0	0	40
11115	0	0	0	46	0	46
11116	43	0	0	0	0	43
11117	0	0	0	44	0	44
11118	0	1	0	45	0	46
11119	44	0	0	0	0	44
11120	0	0	0	42	0	42
11121	0	0	0	45	0	45
11122	0	0	41	0	0	41
11123	0	40	0	1	0	41
11124	0	0	0	42	0	42
11125	42	0	0	1	0	43
11126	0	0	0	46	0	46
11127	0	0	43	0	0	43
11128	0	0	0	42	0	42
11129	0	41	0	0	0	41
11130	0	0	0	43	0	43
11131	0	0	42	0	0	42
11132	0	44	0	1	0	45
11133	0	0	0	47	0	47
11134	0	0	0	47	0	47
11135	0	0	0	49	0	49
11136	0	0	0	48	0	48
11137	0	0	43	0	0	43
11138	0	48	0	0	0	48
11139	49	0	0	0	0	49
11140	47	0	0	0	0	47
11141	0	0	0	47	0	47
11142	0	0	47	0	0	47
11143	51	0	0	0	0	51
11144	0	0	0	50	0	50
11145	0	0	51	0	0	51
11146	0	0	0	49	0	49
11147	0	0	0	55	0	55
11148	0	0	0	50	0	50
11149	0	0	53	0	0	53
11150	0	0	0	54	0	54
11151	0	54	0	0	0	54
11152	60	0	0	0	0	60
11153	58	0	0	0	0	58
11154	59	0	0	0	0	59
11155	0	55	0	0	0	55
11156	57	0	0	0	0	57
11157	0	0	0	60	0	60
11158	60	0	0	0	0	60
11159	59	0	0	1	0	60
11160	0	0	59	0	0	59
11161	0	56	0	0	0	56
11162	60	0	0	0	0	60
11163	0	0	0	60	0	60
11164	0	0	51	0	0	51
11165	0	53	0	0	0	53
11166	55	0	0	1	0	56
11167	0	0	0	57	0	57
11168	0	0	0	61	0	61
11169	0	0	0	56	0	56
11170	0	59	0	0	0	59
11171	0	0	0	61	0	61
11172	0	58	0	0	0	58
11173	0	0	0	63	0	63
11174	0	0	60	0	0	60
11175	0	0	0	62	0	62
11176	0	0	0	64	0	64
11177	0	0	0	65	0	65
11178	0	0	62	0	0	62
11179	0	0	0	61	0	61
11180	0	0	0	61	0	61
11181	0	0	0	59	0	59
11182	0	0	0	53	0	53
11183	5	0	0	57	0	62
11184	0	0	59	0	0	59
11185	0	0	0	57	0	57
11186	0	0	0	53	0	53
11187	53	0	0	0	0	53
11188	0	48	0	0	0	48
11189	0	45	0	0	0	45
11190	0	0	0	47	0	47
11191	0	0	0	45	0	45
11192	0	44	0	0	0	44
11193	0	0	0	48	0	48
11194	0	45	0	0	0	45
11195	0	0	0	50	0	50
11196	0	0	0	50	0	50
11197	0	0	50	0	0	50
11198	0	47	0	0	0	47
11199	0	46	0	1	0	47
11200	48	0	0	1	0	49
11201	0	46	0	0	0	46
11202	0	0	0	53	0	53
11203	0	0	53	0	0	53
11204	0	0	0	55	0	55
11205	54	0	0	0	0	54
11206	0	0	54	0	0	54
11207	0	56	0	0	0	56
11208	0	0	0	57	0	57
11209	0	0	1	59	0	60
11210	60	0	0	0	0	60
11211	0	0	0	62	0	62
11212	0	0	0	63	0	63
11213	0	0	0	63	0	63
11214	0	0	0	63	0	63
11215	64	0	0	0	0	64
11216	63	0	0	1	0	64
11217	0	0	0	64	0	64
11218	63	0	0	0	0	63
11219	0	0	0	64	0	64
11220	0	0	63	0	0	63
11221	0	0	58	0	0	58
11222	0	0	0	68	0	68
11223	0	65	0	0	0	65
11224	0	0	0	68	0	68
11225	66	0	0	0	0	66
11226	0	0	0	68	0	68
11227	66	0	0	0	0	66
11228	0	0	0	68	0	68
11229	0	0	66	0	0	66
11230	0	59	0	0	0	59
11231	0	68	0	0	0	68
11232	0	0	0	70	0	70
11233	0	0	69	0	0	69
11234	0	68	0	0	0	68
11235	0	0	0	67	0	67
11236	68	0	0	0	0	68
11237	0	0	70	0	0	70
11238	0	0	0	70	0	70
11239	0	0	0	75	0	75
11240	0	0	69	0	0	69
11241	0	0	65	0	0	65
11242	0	0	66	0	0	66
11243	0	0	0	69	0	69
11244	1	0	67	0	0	68
11245	68	0	0	0	0	68
11246	0	0	0	66	0	66
11247	0	0	67	0	0	67
11248	0	61	0	0	0	61
11249	1	0	63	0	0	64
11250	0	0	0	66	0	66
11251	69	0	0	0	0	69
11252	0	0	0	68	0	68
11253	1	0	0	65	0	66
11254	69	0	0	0	0	69
11255	0	0	0	72	0	72
11256	0	0	71	0	0	71
11257	69	0	0	0	0	69
11258	0	70	0	0	0	70
11259	72	0	0	0	0	72
11260	0	0	0	71	0	71
11261	0	0	65	1	0	66
11262	0	0	70	0	0	70
11263	0	0	0	72	0	72
11264	0	0	0	71	0	71
11265	0	0	69	0	0	69
11266	0	0	68	0	0	68
11267	71	0	0	0	0	71
11268	0	0	0	65	0	65
11269	70	0	0	0	0	70
11270	0	0	0	73	0	73
11271	0	0	66	0	0	66
11272	0	0	72	0	0	72
11273	0	0	0	78	0	78
11274	0	0	0	75	0	75
11275	0	0	74	0	0	74
11276	75	0	0	0	0	75
11277	0	0	0	78	0	78
11278	77	0	0	0	0	77
11279	0	71	0	0	0	71
11280	0	0	0	74	0	74
11281	75	0	0	0	0	75
11282	0	0	72	0	0	72
11283	0	0	0	75	0	75
11284	0	0	0	74	0	74
11285	0	0	0	75	0	75
11286	0	0	71	0	0	71
11287	0	0	0	70	0	70
11288	0	66	0	0	0	66
11289	0	0	0	71	0	71
11290	0	0	68	0	0	68
11291	0	0	72	0	0	72
11292	0	0	0	75	0	75
11293	0	0	0	75	0	75
11294	0	0	0	72	0	72
11295	0	0	0	74	0	74
11296	74	0	0	0	0	74
11297	76	0	0	0	0	76
11298	0	0	72	0	0	72
11299	0	71	0	0	0	71
11300	0	0	0	72	0	72
11301	72	0	0	0	0	72
11302	68	0	0	0	0	68
11303	72	0	0	0	0	72
11304	71	0	0	0	0	71
11305	0	0	68	0	0	68
11306	74	0	0	0	0	74
11307	0	74	0	0	0	74
11308	0	0	0	83	0	83
11309	0	0	76	0	0	76
11310	0	0	0	83	0	83
11311	0	0	79	0	0	79
11312	0	0	0	79	0	79
11313	0	0	0	85	0	85
11314	82	0	0	0	0	82
11315	0	0	0	83	0	83
11316	0	0	79	0	0	79
11317	0	0	0	83	0	83
11318	86	0	0	0	0	86
11319	0	0	0	83	0	83
11320	0	0	85	0	0	85
11321	0	84	0	0	0	84
11322	83	0	0	0	0	83
11323	0	0	0	85	0	85
11324	0	81	0	0	0	81
11325	87	0	0	0	0	87
11326	0	0	83	0	0	83
11327	0	87	0	0	0	87
11328	0	0	0	93	0	93
11329	0	0	94	0	0	94
11330	0	0	0	100	0	100
11331	100	0	0	0	0	100
11332	0	0	95	0	0	95
11333	3	0	0	96	0	99
11334	0	0	96	0	0	96
11335	0	0	0	100	0	100
11336	1	0	0	100	0	101
11337	97	0	0	1	0	98
11338	0	105	0	0	0	105
11339	0	0	0	102	0	102
11340	100	0	0	0	0	100
11341	103	0	0	0	0	103
11342	0	0	0	104	0	104
11343	0	99	0	0	0	99
11344	0	100	0	0	0	100
11345	0	0	0	105	0	105
11346	1	0	0	107	0	108
11347	107	0	0	0	0	107
11348	0	0	0	105	0	105
11349	0	0	105	0	0	105
11350	101	0	0	0	0	101
11351	0	103	0	0	0	103
11352	103	0	0	0	0	103
11353	0	0	102	0	0	102
11354	0	104	0	0	0	104
11355	111	0	0	0	0	111
11356	108	0	0	0	0	108
11357	0	0	108	0	0	108
11358	111	0	0	0	0	111
11359	111	0	0	0	0	111
11360	0	108	0	0	0	108
11361	0	0	0	115	0	115
11362	1	0	113	0	0	114
11363	0	0	0	113	0	113
11364	0	0	110	0	0	110
11365	0	0	0	109	0	109
11366	109	0	0	0	0	109
11367	0	0	1	112	0	113
11368	0	0	105	0	0	105
11369	109	0	0	0	0	109
11370	0	0	0	106	0	106
11371	0	0	104	0	0	104
11372	107	0	0	0	0	107
11373	0	0	0	103	0	103
11374	0	0	102	0	0	102
11375	0	0	99	0	0	99
11376	0	0	0	107	0	107
11377	0	0	107	0	0	107
11378	0	103	0	0	0	103
11379	0	0	0	108	0	108
11380	110	0	0	0	0	110
11381	0	0	104	0	0	104
11382	0	0	102	0	0	102
11383	102	0	0	0	0	102
11384	0	0	100	0	0	100
11385	95	0	0	0	0	95
11386	0	0	95	0	0	95
11387	0	0	0	94	0	94
11388	0	0	96	0	0	96
11389	0	0	0	97	0	97
11390	0	0	100	0	0	100
11391	0	0	94	0	0	94
11392	99	0	0	0	0	99
11393	0	99	0	0	0	99
11394	99	0	0	0	0	99
11395	0	102	0	0	0	102
11396	0	0	0	100	0	100
11397	0	0	0	108	0	108
11398	101	0	0	0	0	101
11399	0	0	0	107	0	107
11400	0	0	108	0	0	108
11401	98	0	0	0	0	98
11402	99	0	0	0	0	99
11403	0	0	0	100	0	100
11404	0	0	100	0	0	100
11405	0	0	0	100	0	100
11406	0	102	0	0	0	102
11407	0	0	0	101	0	101
11408	0	0	0	104	0	104
11409	0	0	104	0	0	104
11410	105	0	0	0	0	105
11411	0	103	0	0	0	103
11412	99	0	0	0	0	99
11413	0	97	0	0	0	97
11414	0	0	0	100	0	100
11415	0	91	0	0	0	91
11416	0	0	94	1	0	95
11417	0	1	0	98	0	99
11418	0	0	0	99	0	99
11419	0	0	0	104	0	104
11420	94	0	0	0	0	94
11421	0	0	0	94	0	94
11422	85	0	0	0	0	85
11423	85	0	0	0	0	85
11424	89	0	0	0	0	89
11425	0	0	84	0	0	84
11426	0	0	0	84	0	84
11427	0	0	0	86	0	86
11428	0	0	0	86	0	86
11429	82	0	0	0	0	82
11430	0	0	0	88	0	88
11431	0	0	0	87	0	87
11432	83	0	0	0	0	83
11433	0	0	0	78	0	78
11434	0	0	74	0	0	74
11435	0	0	78	0	0	78
11436	0	0	0	78	0	78
11437	76	0	0	0	0	76
11438	74	0	0	0	0	74
11439	0	0	0	68	0	68
11440	0	0	69	0	0	69
11441	0	74	0	0	0	74
11442	0	0	0	74	0	74
11443	0	0	0	74	0	74
11444	0	0	0	71	0	71
11445	73	0	0	0	0	73
11446	0	0	71	0	0	71
11447	71	0	0	0	0	71
11448	0	0	0	68	0	68
11449	0	69	0	0	0	69
11450	69	0	0	0	0	69
11451	66	0	0	0	0	66
11452	0	0	64	0	0	64
11453	0	57	0	0	0	57
11454	0	65	0	0	0	65
11455	68	0	0	0	0	68
11456	0	0	0	70	0	70
11457	0	0	1	65	0	66
11458	0	0	0	69	0	69
11459	0	67	0	0	0	67
11460	0	64	0	0	0	64
11461	67	0	0	0	0	67
11462	0	0	0	66	0	66
11463	0	0	63	0	0	63
11464	0	0	0	68	0	68
11465	0	0	67	0	0	67
11466	0	0	62	0	0	62
11467	0	0	64	0	0	64
11468	0	63	0	0	0	63
11469	0	0	0	67	0	67
11470	0	63	0	0	0	63
11471	1	0	0	66	0	67
11472	0	0	0	64	0	64
11473	65	0	0	0	0	65
11474	0	0	0	63	0	63
11475	66	0	0	0	0	66
11476	64	1	0	0	0	65
11477	0	0	0	68	0	68
11478	0	63	0	0	0	63
11479	0	0	0	66	0	66
11480	0	64	0	0	0	64
11481	1	0	0	68	0	69
11482	0	0	63	0	0	63
11483	0	0	0	63	0	63
11484	0	0	0	62	0	62
11485	61	0	0	0	0	61
11486	0	66	0	0	0	66
11487	0	0	0	60	0	60
11488	0	0	0	62	0	62
11489	0	58	1	0	0	59
11490	0	0	0	62	0	62
11491	61	0	0	0	0	61
11492	57	0	0	0	0	57
11493	0	59	0	0	0	59
11494	0	0	0	60	0	60
11495	58	0	0	0	0	58
11496	0	59	0	0	0	59
11497	0	0	0	62	0	62
11498	0	60	0	0	0	60
11499	59	0	0	0	0	59
11500	1	0	57	0	0	58
11501	1	0	52	0	0	53
11502	0	0	0	54	0	54
11503	0	0	54	0	0	54
11504	0	0	0	53	0	53
11505	57	0	0	0	0	57
11506	0	0	53	0	0	53
11507	0	0	0	56	0	56
11508	1	0	0	54	0	55
11509	52	0	0	0	0	52
11510	0	50	0	1	0	51
11511	50	0	0	1	0	51
11512	51	0	0	0	0	51
11513	0	50	0	0	0	50
11514	0	0	0	50	0	50
11515	0	0	54	0	0	54
11516	0	0	0	58	0	58
11517	0	55	0	0	0	55
11518	57	0	0	0	0	57
11519	0	0	0	58	0	58
11520	0	0	59	0	0	59
11521	0	0	0	58	0	58
11522	0	0	0	58	0	58
11523	0	0	0	59	0	59
11524	0	0	0	58	0	58
11525	0	0	0	62	0	62
11526	0	0	53	0	0	53
11527	0	0	53	0	0	53
11528	0	53	0	0	0	53
11529	0	58	0	1	0	59
11530	59	0	0	0	0	59
11531	0	0	55	0	0	55
11532	58	0	0	0	0	58
11533	0	0	52	0	0	52
11534	0	0	49	0	0	49
11535	0	0	0	56	0	56
11536	56	0	0	0	0	56
11537	0	0	0	58	0	58
11538	0	0	0	59	0	59
11539	0	0	57	0	0	57
11540	0	0	0	57	0	57
11541	1	0	0	53	0	54
11542	0	0	0	56	0	56
11543	0	0	0	59	0	59
11544	0	0	0	60	0	60
11545	60	0	0	0	0	60
11546	0	0	0	59	0	59
11547	0	0	54	0	0	54
11548	0	0	0	55	0	55
11549	0	0	51	0	0	51
11550	0	0	0	53	0	53
11551	0	0	45	0	0	45
11552	0	0	0	47	0	47
11553	0	0	0	47	0	47
11554	0	0	44	0	0	44
11555	46	0	0	0	0	46
11556	0	0	43	0	0	43
11557	0	0	0	47	0	47
11558	44	0	0	0	0	44
11559	0	0	0	43	0	43
11560	0	0	0	42	0	42
11561	0	0	39	0	0	39
11562	0	36	0	1	0	37
11563	0	40	0	0	0	40
11564	0	44	0	0	0	44
11565	0	0	0	48	0	48
11566	46	0	0	0	0	46
11567	0	0	0	46	0	46
11568	0	0	0	46	0	46
11569	0	0	0	53	0	53
11570	0	0	0	47	0	47
11571	0	48	0	0	0	48
11572	0	0	0	51	0	51
11573	0	0	0	56	0	56
11574	0	52	0	0	0	52
11575	56	0	1	0	0	57
11576	1	0	0	59	0	60
11577	63	0	0	0	0	63
11578	59	0	0	0	0	59
11579	0	57	0	0	0	57
11580	0	0	0	62	0	62
11581	0	0	58	0	0	58
11582	0	1	54	0	0	55
11583	0	0	0	61	0	61
11584	61	0	0	0	0	61
11585	65	0	0	0	0	65
11586	0	0	0	62	0	62
11587	61	0	0	0	0	61
11588	0	63	0	0	0	63
11589	60	0	0	0	0	60
11590	0	62	0	0	0	62
11591	0	0	0	63	0	63
11592	0	0	0	64	0	64
11593	0	60	0	0	0	60
11594	63	0	0	0	0	63
11595	0	0	61	0	0	61
11596	0	0	0	64	0	64
11597	0	0	63	0	0	63
11598	0	0	0	65	0	65
11599	66	0	0	0	0	66
11600	0	0	0	69	0	69
11601	67	0	0	0	0	67
11602	68	0	0	0	0	68
11603	0	0	0	71	0	71
11604	0	0	69	0	0	69
11605	0	69	1	0	0	70
11606	0	0	0	72	0	72
11607	71	0	0	0	0	71
11608	0	0	63	0	0	63
11609	0	0	0	69	0	69
11610	0	0	0	69	0	69
11611	0	0	0	69	0	69
11612	67	0	0	0	0	67
11613	1	0	0	62	0	63
11614	5	0	0	65	0	70
11615	0	0	64	0	0	64
11616	0	0	0	70	0	70
11617	0	0	0	69	0	69
11618	5	0	0	67	0	72
11619	0	70	0	0	0	70
11620	0	0	0	65	0	65
11621	0	0	0	65	0	65
11622	64	0	0	0	0	64
11623	0	0	64	0	0	64
11624	0	0	58	0	0	58
11625	0	67	0	0	0	67
11626	0	0	0	66	0	66
11627	69	0	0	0	0	69
11628	0	0	0	69	0	69
11629	0	0	0	72	0	72
11630	0	0	0	74	0	74
11631	0	0	0	72	0	72
11632	0	0	0	71	0	71
11633	0	0	72	0	0	72
11634	0	0	0	74	0	74
11635	70	0	0	0	0	70
11636	0	77	0	0	0	77
11637	0	0	0	78	0	78
11638	0	0	0	75	0	75
11639	0	0	70	0	0	70
11640	0	0	0	74	0	74
11641	0	0	0	74	0	74
11642	72	0	0	0	0	72
11643	0	73	0	0	0	73
11644	0	0	0	75	0	75
11645	0	0	0	79	0	79
11646	0	0	0	75	0	75
11647	0	0	73	0	0	73
11648	0	0	61	0	0	61
11649	0	70	0	0	0	70
11650	0	78	0	0	0	78
11651	0	0	0	83	0	83
11652	0	82	0	0	0	82
11653	0	0	0	84	0	84
11654	0	0	0	86	0	86
11655	0	0	0	88	0	88
11656	0	0	0	88	0	88
11657	0	0	81	0	0	81
11658	0	0	0	81	0	81
11659	0	0	0	79	0	79
11660	0	0	0	82	0	82
11661	84	0	0	0	0	84
11662	0	86	0	0	0	86
11663	0	0	0	90	0	90
11664	0	85	0	0	0	85
11665	82	0	0	0	0	82
11666	75	0	0	0	0	75
11667	0	79	0	0	0	79
11668	0	76	0	1	0	77
11669	0	0	76	1	0	77
11670	0	77	0	0	0	77
11671	0	0	0	80	0	80
11672	77	0	0	0	0	77
11673	0	77	0	0	0	77
11674	0	0	0	76	0	76
11675	0	0	0	79	0	79
11676	0	0	0	78	0	78
11677	76	0	0	0	0	76
11678	0	0	79	0	0	79
11679	75	0	0	0	0	75
11680	0	76	0	0	0	76
11681	0	0	0	76	0	76
11682	0	0	76	0	0	76
11683	74	0	0	0	0	74
11684	0	75	0	0	0	75
11685	0	0	0	76	0	76
11686	0	76	0	0	0	76
11687	0	0	0	78	0	78
11688	0	0	0	78	0	78
11689	0	0	72	1	0	73
11690	0	0	71	0	0	71
11691	0	0	0	77	0	77
11692	0	0	74	0	0	74
11693	0	0	0	77	0	77
11694	0	0	0	76	0	76
11695	0	0	0	77	0	77
11696	69	0	0	0	0	69
11697	0	0	0	72	0	72
11698	1	0	68	0	0	69
11699	68	0	1	0	0	69
11700	0	0	0	72	0	72
11701	0	0	0	72	0	72
11702	68	0	0	0	0	68
11703	0	69	0	0	0	69
11704	0	0	0	70	0	70
11705	0	0	0	71	0	71
11706	70	0	0	0	0	70
11707	0	0	66	0	0	66
11708	0	0	1	67	0	68
11709	0	0	0	68	0	68
11710	0	0	0	66	0	66
11711	0	59	0	0	0	59
11712	0	0	0	64	0	64
11713	63	0	0	1	0	64
11714	0	62	0	0	0	62
11715	61	0	0	0	0	61
11716	0	56	0	0	0	56
11717	59	0	0	0	0	59
11718	0	0	59	0	0	59
11719	0	0	55	0	0	55
11720	60	0	0	0	0	60
11721	0	0	57	0	0	57
11722	0	0	0	56	0	56
11723	0	0	0	53	0	53
11724	0	0	0	54	0	54
11725	53	0	0	0	0	53
11726	0	0	51	0	0	51
11727	53	0	0	0	0	53
11728	0	0	0	56	0	56
11729	59	0	0	0	0	59
11730	0	0	0	59	0	59
11731	59	0	0	0	0	59
11732	0	0	0	57	0	57
11733	0	0	59	0	0	59
11734	59	0	0	0	0	59
11735	57	0	0	0	0	57
11736	0	0	0	59	0	59
11737	0	0	0	58	0	58
11738	0	54	0	0	0	54
11739	54	0	0	0	0	54
11740	0	51	1	0	0	52
11741	50	0	0	0	0	50
11742	0	0	48	0	0	48
11743	1	1	42	0	0	44
11744	0	0	40	0	0	40
11745	43	0	0	0	0	43
11746	0	40	0	0	0	40
11747	0	0	0	39	0	39
11748	42	0	0	0	0	42
11749	0	39	0	0	0	39
11750	0	0	0	40	0	40
11751	0	34	0	0	0	34
11752	0	34	0	0	0	34
11753	0	34	0	0	0	34
11754	32	0	0	0	0	32
11755	0	24	0	0	0	24
11756	0	23	0	0	0	23
11757	0	25	0	0	0	25
11758	26	0	0	0	0	26
11759	26	0	0	0	0	26
11760	0	0	23	0	0	23
11761	24	0	0	0	0	24
11762	25	0	0	0	0	25
11763	0	0	0	26	0	26
11764	28	0	0	0	0	28
11765	0	0	29	0	0	29
11766	0	27	0	0	0	27
11767	28	0	0	0	0	28
11768	0	0	0	27	0	27
11769	28	0	0	0	0	28
11770	0	0	25	0	0	25
11771	25	0	0	1	0	26
11772	0	0	0	27	0	27
11773	0	0	28	0	0	28
11774	0	23	0	0	0	23
11775	0	26	0	0	0	26
11776	0	0	0	35	0	35
11777	0	0	0	35	0	35
11778	0	32	0	0	0	32
11779	34	0	0	0	0	34
11780	33	0	0	0	0	33
11781	35	0	0	0	0	35
11782	0	34	0	0	0	34
11783	0	0	0	36	0	36
11784	0	36	0	0	0	36
11785	36	0	0	0	0	36
11786	36	0	0	0	0	36
11787	0	36	0	0	0	36
11788	39	0	0	0	0	39
11789	0	0	0	43	0	43
11790	0	0	0	42	0	42
11791	46	0	0	0	0	46
11792	44	0	0	0	0	44
11793	46	0	0	0	0	46
11794	0	0	0	47	0	47
11795	0	0	0	45	0	45
11796	0	0	45	0	0	45
11797	0	0	0	46	0	46
11798	0	0	0	47	0	47
11799	0	0	46	0	0	46
11800	0	0	43	0	0	43
11801	0	0	46	0	0	46
11802	0	0	0	49	0	49
11803	0	0	49	0	0	49
11804	0	0	0	47	0	47
11805	0	0	0	46	0	46
11806	0	0	47	0	0	47
11807	0	0	47	0	0	47
11808	0	0	0	48	0	48
11809	0	0	45	0	0	45
11810	0	0	46	0	0	46
11811	0	47	0	0	0	47
11812	50	0	0	0	0	50
11813	50	0	0	0	0	50
11814	45	0	0	0	0	45
11815	0	46	0	0	0	46
11816	0	49	0	0	0	49
11817	0	0	0	51	0	51
11818	0	0	0	52	0	52
11819	0	0	50	0	0	50
11820	0	0	0	49	0	49
11821	53	0	0	0	0	53
11822	0	0	0	48	0	48
11823	0	47	0	0	0	47
11824	47	0	0	0	0	47
11825	51	0	0	0	0	51
11826	48	0	0	0	0	48
11827	0	0	49	0	0	49
11828	0	0	0	46	0	46
11829	50	0	0	0	0	50
11830	0	0	48	0	0	48
11831	0	49	0	0	0	49
11832	0	49	0	0	0	49
11833	50	0	0	0	0	50
11834	0	49	0	0	0	49
11835	0	0	0	52	0	52
11836	0	0	50	0	0	50
11837	0	0	0	48	0	48
11838	54	0	0	0	0	54
11839	0	53	0	0	0	53
11840	52	0	0	0	0	52
11841	0	0	53	0	0	53
11842	0	0	0	54	0	54
11843	0	55	0	0	0	55
11844	0	0	0	56	0	56
11845	58	0	0	0	0	58
11846	60	0	0	0	0	60
11847	55	0	0	0	0	55
11848	60	0	0	0	0	60
11849	0	0	0	60	0	60
11850	0	0	60	0	0	60
11851	0	0	0	57	0	57
11852	0	60	0	0	0	60
11853	62	0	0	0	0	62
11854	0	0	61	0	0	61
11855	64	0	0	0	0	64
11856	1	0	0	62	0	63
11857	0	0	63	0	0	63
11858	0	0	0	61	0	61
11859	64	0	0	0	0	64
11860	66	0	0	0	0	66
11861	62	4	0	0	0	66
11862	0	0	57	4	0	61
11863	0	0	0	60	0	60
11864	0	0	65	0	0	65
11865	0	67	0	0	0	67
11866	67	0	0	1	0	68
11867	0	65	0	0	0	65
11868	67	0	0	0	0	67
11869	0	0	0	59	0	59
11870	0	61	0	0	0	61
11871	56	0	0	0	0	56
11872	0	0	64	0	0	64
11873	0	0	0	60	0	60
11874	61	0	0	0	0	61
11875	0	0	57	0	0	57
11876	0	0	0	58	0	58
11877	0	55	0	0	0	55
11878	0	0	0	54	0	54
11879	0	0	0	58	0	58
11880	58	0	0	0	0	58
11881	0	54	0	0	0	54
11882	0	0	0	57	0	57
11883	0	53	0	0	0	53
11884	0	0	0	49	0	49
11885	0	51	0	0	0	51
11886	52	0	0	0	0	52
11887	0	0	50	0	0	50
11888	0	0	0	51	0	51
11889	0	0	0	50	0	50
11890	0	0	0	49	0	49
11891	0	0	0	52	0	52
11892	0	0	48	0	0	48
11893	0	49	0	0	0	49
11894	51	0	0	0	0	51
11895	49	0	0	0	0	49
11896	0	52	0	0	0	52
11897	50	0	0	0	0	50
11898	52	0	0	0	0	52
11899	1	52	0	0	0	53
11900	0	0	0	54	0	54
11901	0	56	0	0	0	56
11902	54	0	0	0	0	54
11903	0	0	50	0	0	50
11904	57	0	0	0	0	57
11905	0	0	55	0	0	55
11906	0	0	0	55	0	55
11907	55	0	0	0	0	55
11908	0	0	54	0	0	54
11909	54	0	0	0	0	54
11910	52	0	0	1	0	53
11911	0	0	0	56	0	56
11912	0	52	0	0	0	52
11913	54	0	0	0	0	54
11914	0	0	0	50	0	50
11915	0	50	0	0	0	50
11916	49	0	0	0	0	49
11917	0	0	0	51	0	51
11918	0	50	0	0	0	50
11919	0	0	0	53	0	53
11920	50	0	0	0	0	50
11921	47	0	0	0	0	47
11922	48	0	0	0	0	48
11923	0	0	0	48	0	48
11924	0	0	0	52	0	52
11925	0	0	48	0	0	48
11926	0	0	0	52	0	52
11927	0	0	54	0	0	54
11928	0	0	49	0	0	49
11929	0	0	51	0	0	51
11930	0	57	0	0	0	57
11931	0	0	0	54	0	54
11932	0	54	0	0	0	54
11933	56	0	0	0	0	56
11934	55	0	0	1	0	56
11935	0	0	0	55	0	55
11936	0	0	55	0	0	55
11937	0	0	0	55	0	55
11938	0	0	51	0	0	51
11939	0	0	0	52	0	52
11940	1	48	0	0	0	49
11941	0	47	0	0	0	47
11942	53	0	0	0	0	53
11943	0	0	47	0	0	47
11944	0	0	0	49	0	49
11945	0	0	0	50	0	50
11946	52	0	0	0	0	52
11947	0	51	0	0	0	51
11948	51	0	0	0	0	51
11949	0	50	0	0	0	50
11950	51	0	0	0	0	51
11951	48	0	0	0	0	48
11952	0	0	0	48	0	48
11953	0	0	45	0	0	45
11954	46	0	0	0	0	46
11955	0	48	0	0	0	48
11956	48	0	0	0	0	48
11957	0	0	0	46	0	46
11958	0	0	0	47	0	47
11959	0	49	0	0	0	49
11960	0	0	0	49	0	49
11961	0	47	0	0	0	47
11962	0	0	0	44	0	44
11963	0	0	0	46	0	46
11964	47	0	0	0	0	47
11965	0	0	46	0	0	46
11966	0	43	0	0	0	43
11967	0	0	0	46	0	46
11968	47	0	0	0	0	47
11969	47	0	0	0	0	47
11970	49	0	0	0	0	49
11971	0	0	50	0	0	50
11972	52	0	0	0	0	52
11973	0	0	0	50	0	50
11974	54	0	0	0	0	54
11975	0	59	0	0	0	59
11976	0	0	0	59	0	59
11977	54	0	0	0	0	54
11978	0	60	0	0	0	60
11979	0	0	0	61	0	61
11980	0	0	56	0	0	56
11981	57	0	0	0	0	57
11982	60	0	0	0	0	60
11983	0	0	61	0	0	61
11984	0	55	0	0	0	55
11985	0	59	0	0	0	59
11986	0	0	0	63	0	63
11987	0	0	0	62	0	62
11988	0	0	0	66	0	66
11989	0	0	66	0	0	66
11990	66	0	0	0	0	66
11991	64	0	0	0	0	64
11992	62	0	0	0	0	62
11993	65	0	0	0	0	65
11994	65	0	0	0	0	65
11995	65	0	0	1	0	66
11996	0	0	0	66	0	66
11997	0	0	63	0	0	63
11998	0	0	63	0	0	63
11999	0	0	0	69	0	69
12000	0	0	0	62	0	62
12001	1	0	0	67	0	68
12002	0	64	0	1	0	65
12003	63	0	0	0	0	63
12004	0	65	0	0	0	65
12005	0	0	0	67	0	67
12006	66	0	0	0	0	66
12007	0	66	0	0	0	66
12008	0	0	0	69	0	69
12009	0	0	0	65	0	65
12010	0	0	0	69	0	69
12011	0	65	0	0	0	65
12012	0	0	0	67	0	67
12013	0	0	67	0	0	67
12014	0	0	0	68	0	68
12015	0	0	0	70	0	70
12016	0	0	0	73	0	73
12017	0	0	0	68	0	68
12018	0	0	68	0	0	68
12019	0	62	0	0	0	62
12020	0	0	0	64	0	64
12021	0	0	0	64	0	64
12022	0	0	0	65	0	65
12023	0	63	0	0	0	63
12024	0	63	0	0	0	63
12025	66	0	0	0	0	66
12026	0	0	0	63	0	63
12027	0	0	63	0	0	63
12028	0	64	0	0	0	64
12029	63	0	0	0	0	63
12030	0	0	61	0	0	61
12031	0	0	62	0	0	62
12032	0	0	65	0	0	65
12033	1	0	0	62	0	63
12034	0	0	64	0	0	64
12035	0	65	0	0	0	65
12036	0	0	0	65	0	65
12037	0	0	64	0	0	64
12038	0	0	0	65	0	65
12039	63	0	0	0	0	63
12040	0	0	62	0	0	62
12041	63	0	0	1	0	64
12042	0	62	0	0	0	62
12043	60	0	0	0	0	60
12044	0	0	0	64	0	64
12045	69	0	0	0	0	69
12046	70	0	0	0	0	70
12047	65	0	0	0	0	65
12048	0	72	0	0	0	72
12049	71	0	0	0	0	71
12050	70	0	0	0	0	70
12051	0	0	71	0	0	71
12052	0	68	0	0	0	68
12053	0	0	0	70	0	70
12054	0	0	0	72	0	72
12055	0	0	0	74	0	74
12056	0	0	70	0	0	70
12057	0	0	0	72	0	72
12058	0	0	70	0	0	70
12059	76	0	0	0	0	76
12060	73	0	0	0	0	73
12061	0	0	71	1	0	72
12062	71	0	0	0	0	71
12063	74	0	0	0	0	74
12064	72	0	0	0	0	72
12065	0	0	0	73	0	73
12066	0	0	76	0	0	76
12067	0	73	0	0	0	73
12068	0	0	0	68	0	68
12069	0	0	70	0	0	70
12070	0	0	70	0	0	70
12071	67	0	0	0	0	67
12072	0	73	0	0	0	73
12073	72	0	0	0	0	72
12074	70	0	0	0	0	70
12075	0	68	0	0	0	68
12076	71	0	0	0	0	71
12077	0	0	67	0	0	67
12078	0	0	56	0	0	56
12079	0	0	61	0	0	61
12080	0	70	0	0	0	70
12081	67	0	0	0	0	67
12082	62	0	0	0	0	62
12083	0	60	0	0	0	60
12084	0	62	0	0	0	62
12085	0	0	0	64	0	64
12086	0	0	0	63	0	63
12087	63	0	0	0	0	63
12088	0	63	0	0	0	63
12089	63	0	0	0	0	63
12090	66	0	0	0	0	66
12091	0	0	60	0	0	60
12092	0	60	0	0	0	60
12093	0	0	0	66	0	66
12094	64	0	0	0	0	64
12095	0	0	0	64	0	64
12096	68	0	0	0	0	68
12097	0	0	66	0	0	66
12098	0	56	0	0	0	56
12099	0	63	0	1	0	64
12100	0	0	0	64	0	64
12101	0	64	0	0	0	64
12102	64	0	0	0	0	64
12103	0	0	65	0	0	65
12104	65	0	0	0	0	65
12105	0	0	60	0	0	60
12106	0	0	0	60	0	60
12107	0	0	0	56	0	56
12108	0	0	0	64	0	64
12109	62	0	0	0	0	62
12110	0	0	60	0	0	60
12111	0	0	0	63	0	63
12112	0	0	0	63	0	63
12113	0	62	1	0	0	63
12114	1	60	0	0	0	61
12115	0	57	0	1	0	58
12116	0	0	0	62	0	62
12117	0	0	0	62	0	62
12118	0	58	0	0	0	58
12119	0	59	0	0	0	59
12120	62	0	0	0	0	62
12121	0	0	0	64	0	64
12122	0	61	0	0	0	61
12123	66	0	0	0	0	66
12124	0	1	0	61	0	62
12125	66	0	0	0	0	66
12126	0	0	0	63	0	63
12127	0	0	67	0	0	67
12128	0	67	0	0	0	67
12129	65	0	0	0	0	65
12130	0	0	65	0	0	65
12131	0	65	0	0	0	65
12132	0	0	0	71	0	71
12133	0	0	0	70	0	70
12134	0	0	1	65	0	66
12135	2	0	0	70	0	72
12136	0	0	76	0	0	76
12137	0	68	0	2	0	70
12138	0	0	0	70	0	70
12139	63	0	0	0	0	63
12140	0	65	0	0	0	65
12141	1	0	0	66	0	67
12142	0	0	66	0	0	66
12143	0	65	0	0	0	65
12144	0	0	0	63	0	63
12145	0	62	0	0	0	62
12146	66	0	0	0	0	66
12147	64	0	0	0	0	64
12148	0	1	68	0	0	69
12149	70	0	0	0	0	70
12150	70	0	0	0	0	70
12151	0	0	69	0	0	69
12152	0	67	0	0	0	67
12153	0	0	0	71	0	71
12154	0	0	0	71	0	71
12155	68	0	0	0	0	68
12156	0	0	0	72	0	72
12157	0	0	69	0	0	69
12158	66	0	0	0	0	66
12159	0	0	65	0	0	65
12160	0	68	0	0	0	68
12161	68	0	0	0	0	68
12162	0	0	62	0	0	62
12163	0	0	61	1	0	62
12164	0	67	0	0	0	67
12165	0	0	0	68	0	68
12166	0	0	66	0	0	66
12167	0	1	0	70	0	71
12168	0	0	0	72	0	72
12169	1	0	70	0	0	71
12170	0	66	0	0	0	66
12171	0	0	0	69	0	69
12172	69	0	0	0	0	69
12173	67	0	0	0	0	67
12174	0	0	0	67	0	67
12175	0	0	69	0	0	69
12176	0	0	65	0	0	65
12177	0	0	0	72	0	72
12178	0	0	72	0	0	72
12179	73	0	0	0	0	73
12180	0	0	0	70	0	70
12181	0	0	0	69	0	69
12182	0	70	0	0	0	70
12183	0	0	0	72	0	72
12184	0	0	71	0	0	71
12185	71	0	0	0	0	71
12186	71	0	0	0	0	71
12187	0	0	70	0	0	70
12188	0	0	0	70	0	70
12189	0	0	0	67	0	67
12190	0	0	67	0	0	67
12191	0	0	0	67	0	67
12192	0	0	0	67	0	67
12193	0	71	0	0	0	71
12194	0	0	0	78	0	78
12195	1	0	1	90	0	92
12196	94	0	0	0	0	94
12197	95	0	0	1	0	96
12198	95	0	0	0	0	95
12199	96	0	0	0	0	96
12200	96	0	0	0	0	96
12201	0	0	91	0	0	91
12202	0	0	0	95	0	95
12203	0	0	0	95	0	95
12204	1	0	96	0	0	97
12205	97	0	0	0	0	97
12206	97	0	0	0	0	97
12207	0	0	98	0	0	98
12208	97	0	0	0	0	97
12209	97	0	0	0	0	97
12210	0	0	96	0	0	96
12211	0	0	0	95	0	95
12212	0	97	0	0	0	97
12213	0	0	0	99	0	99
12214	0	0	0	100	0	100
12215	0	0	0	98	0	98
12216	0	0	97	0	0	97
12217	99	0	0	0	0	99
12218	98	0	0	0	0	98
12219	0	0	0	97	0	97
12220	0	0	88	0	0	88
12221	0	0	0	89	0	89
12222	0	0	88	0	0	88
12223	0	0	82	1	0	83
12224	0	88	0	0	0	88
12225	0	0	0	93	0	93
12226	88	0	0	0	0	88
12227	92	0	0	1	0	93
12228	91	0	0	0	0	91
12229	0	0	0	97	0	97
12230	0	96	0	0	0	96
12231	0	0	0	96	0	96
12232	0	0	95	0	0	95
12233	96	0	0	0	0	96
12234	93	0	0	0	0	93
12235	0	0	0	92	0	92
12236	0	0	0	92	0	92
12237	0	0	0	96	0	96
12238	0	0	95	0	0	95
12239	96	0	0	0	0	96
12240	0	95	0	0	0	95
12241	0	96	0	0	0	96
12242	0	0	98	0	0	98
12243	0	0	0	96	0	96
12244	0	0	94	0	0	94
12245	93	0	0	0	0	93
12246	0	0	0	97	0	97
12247	0	0	96	0	0	96
12248	0	97	0	0	0	97
12249	96	0	0	0	0	96
12250	0	0	92	0	0	92
12251	0	89	0	0	0	89
12252	0	94	0	0	0	94
12253	101	0	0	0	0	101
12254	0	0	0	99	0	99
12255	0	0	98	0	0	98
12256	0	100	0	0	0	100
12257	98	0	0	0	0	98
12258	96	0	0	0	0	96
12259	0	96	0	0	0	96
12260	0	0	101	0	0	101
12261	0	0	0	106	0	106
12262	111	0	0	0	0	111
12263	109	0	0	0	0	109
12264	0	3	105	0	0	108
12265	0	0	0	106	0	106
12266	0	0	0	110	0	110
12267	0	0	105	0	0	105
12268	0	0	98	0	0	98
12269	109	0	0	0	0	109
12270	112	0	0	0	0	112
12271	108	0	0	0	0	108
12272	109	0	0	0	0	109
12273	0	0	104	0	0	104
12274	108	0	0	0	0	108
12275	0	0	0	112	0	112
12276	0	0	112	0	0	112
12277	0	0	103	0	0	103
12278	1	110	0	0	0	111
12279	0	0	0	112	0	112
12280	0	0	109	0	0	109
12281	110	0	0	0	0	110
12282	0	0	0	112	0	112
12283	0	113	0	0	0	113
12284	118	0	0	0	0	118
12285	115	0	0	0	0	115
12286	0	0	116	1	0	117
12287	0	103	0	0	0	103
12288	0	0	2	93	0	95
12289	105	0	0	0	0	105
12290	0	2	0	90	0	92
12291	0	0	87	0	0	87
12292	85	0	0	1	0	86
12293	0	78	0	0	0	78
12294	0	78	0	1	0	79
12295	0	83	0	0	0	83
12296	83	0	0	0	0	83
12297	83	0	0	0	0	83
12298	85	0	0	0	0	85
12299	0	0	0	83	0	83
12300	0	1	81	0	0	82
12301	0	0	0	83	0	83
12302	82	0	0	0	0	82
12303	0	0	0	77	0	77
12304	83	0	0	0	0	83
12305	80	0	0	0	0	80
12306	78	0	0	1	0	79
12307	0	77	0	0	0	77
12308	83	0	0	0	0	83
12309	0	0	76	0	0	76
12310	0	0	76	0	0	76
12311	0	78	0	0	0	78
12312	0	0	0	84	0	84
12313	86	0	0	0	0	86
12314	0	0	83	0	0	83
12315	83	0	0	0	0	83
12316	0	0	0	83	0	83
12317	0	78	0	0	0	78
12318	0	0	0	78	0	78
12319	0	0	79	0	0	79
12320	74	0	0	0	0	74
12321	0	0	72	0	0	72
12322	0	0	68	0	0	68
12323	70	0	0	0	0	70
12324	0	72	0	0	0	72
12325	72	0	0	0	0	72
12326	77	0	0	0	0	77
12327	0	0	72	0	0	72
12328	74	0	0	0	0	74
12329	0	0	72	0	0	72
12330	0	0	62	0	0	62
12331	0	0	64	0	0	64
12332	0	68	0	0	0	68
12333	63	0	0	0	0	63
12334	66	0	0	0	0	66
12335	65	0	0	0	0	65
12336	72	0	0	0	0	72
12337	0	0	69	0	0	69
12338	0	0	0	70	0	70
12339	2	0	0	69	0	71
12340	75	0	0	0	0	75
12341	0	73	0	0	0	73
12342	0	0	0	65	0	65
12343	64	0	0	1	0	65
12344	0	0	61	0	0	61
12345	0	0	0	63	0	63
12346	0	0	59	0	0	59
12347	0	59	0	0	0	59
12348	0	0	0	56	0	56
12349	56	0	0	0	0	56
12350	0	0	0	57	0	57
12351	0	0	58	0	0	58
12352	0	61	0	0	0	61
12353	64	0	0	0	0	64
12354	0	0	61	0	0	61
12355	61	0	0	0	0	61
12356	0	60	0	0	0	60
12357	62	0	0	0	0	62
12358	59	0	0	0	0	59
12359	0	0	0	65	0	65
12360	0	0	64	0	0	64
12361	0	69	0	0	0	69
12362	0	0	0	73	0	73
12363	0	0	0	75	0	75
12364	0	0	0	75	0	75
12365	0	0	0	75	0	75
12366	0	78	0	0	0	78
12367	75	0	0	0	0	75
12368	0	73	0	0	0	73
12369	0	0	0	71	0	71
12370	71	0	0	0	0	71
12371	0	0	0	71	0	71
12372	0	0	69	0	0	69
12373	0	68	0	0	0	68
12374	0	0	0	72	0	72
12375	0	0	0	71	0	71
12376	73	0	0	0	0	73
12377	0	0	71	0	0	71
12378	74	0	0	0	0	74
12379	69	0	0	0	0	69
12380	72	0	0	0	0	72
12381	0	0	71	0	0	71
12382	0	0	0	68	0	68
12383	0	0	0	73	0	73
12384	1	0	71	0	0	72
12385	0	0	67	0	0	67
12386	68	0	0	0	0	68
12387	0	0	0	70	0	70
12388	65	1	0	0	0	66
12389	70	0	0	0	0	70
12390	0	0	0	71	0	71
12391	0	0	75	0	0	75
12392	76	0	0	1	0	77
12393	0	0	0	75	0	75
12394	0	0	72	0	0	72
12395	0	74	0	0	0	74
12396	72	0	0	0	0	72
12397	0	77	0	0	0	77
12398	0	0	0	79	0	79
12399	0	78	0	0	0	78
12400	79	0	0	0	0	79
12401	78	0	0	0	0	78
12402	0	79	1	0	0	80
12403	80	0	0	1	0	81
12404	80	0	0	0	0	80
12405	0	82	0	0	0	82
12406	82	0	0	0	0	82
12407	0	0	0	80	0	80
12408	0	0	0	81	0	81
12409	82	0	0	0	0	82
12410	0	0	0	79	0	79
12411	0	82	0	0	0	82
12412	84	0	0	0	0	84
12413	82	0	0	0	0	82
12414	0	82	0	0	0	82
12415	84	0	0	0	0	84
12416	81	0	0	0	0	81
12417	0	0	0	79	0	79
12418	0	0	79	0	0	79
12419	0	79	0	0	0	79
12420	82	0	0	0	0	82
12421	81	0	0	0	0	81
12422	0	0	79	0	0	79
12423	80	0	0	0	0	80
12424	0	0	77	0	0	77
12425	79	0	0	0	0	79
12426	0	0	0	78	0	78
12427	0	0	77	0	0	77
12428	0	0	74	0	0	74
12429	0	0	0	75	0	75
12430	0	0	0	77	0	77
12431	0	0	76	0	0	76
12432	1	0	0	77	0	78
12433	0	0	76	0	0	76
12434	0	0	0	77	0	77
12435	0	0	0	78	0	78
12436	1	77	0	0	0	78
12437	0	75	0	1	0	76
12438	0	78	0	0	0	78
12439	0	0	0	77	0	77
12440	0	0	0	75	0	75
12441	0	1	77	0	0	78
12442	78	0	0	0	0	78
12443	79	0	0	0	0	79
12444	0	76	0	0	0	76
12445	70	0	0	0	0	70
12446	0	0	0	71	0	71
12447	69	0	0	0	0	69
12448	69	0	0	0	0	69
12449	0	0	0	68	0	68
12450	70	0	0	0	0	70
12451	0	62	0	0	0	62
12452	0	66	0	0	0	66
12453	0	0	0	62	0	62
12454	0	61	0	0	0	61
12455	0	0	0	58	0	58
12456	0	0	0	55	0	55
12457	58	0	0	0	0	58
12458	0	59	0	0	0	59
12459	53	0	0	0	0	53
12460	56	0	0	0	0	56
12461	0	56	0	0	0	56
12462	56	0	0	0	0	56
12463	0	0	51	0	0	51
12464	0	54	0	0	0	54
12465	57	0	0	0	0	57
12466	0	0	57	0	0	57
12467	0	57	0	0	0	57
12468	0	56	0	0	0	56
12469	58	0	0	0	0	58
12470	59	0	0	1	0	60
12471	59	0	0	0	0	59
12472	0	57	1	0	0	58
12473	0	0	0	60	0	60
12474	63	0	0	0	0	63
12475	55	0	0	0	0	55
12476	0	0	0	55	0	55
12477	0	0	58	0	0	58
12478	0	0	56	0	0	56
12479	0	0	0	59	0	59
12480	0	0	0	58	0	58
12481	0	0	62	0	0	62
12482	0	0	0	59	0	59
12483	0	63	0	0	0	63
12484	62	0	0	0	0	62
12485	0	0	0	62	0	62
12486	62	0	0	0	0	62
12487	0	60	0	0	0	60
12488	0	63	0	0	0	63
12489	68	0	0	0	0	68
12490	0	1	63	0	0	64
12491	66	0	0	0	0	66
12492	0	64	0	0	0	64
12493	0	0	0	65	0	65
12494	67	0	0	0	0	67
12495	0	0	0	62	0	62
12496	65	0	0	0	0	65
12497	66	0	0	0	0	66
12498	0	67	0	0	0	67
12499	69	0	0	0	0	69
12500	0	64	0	0	0	64
12501	67	0	0	0	0	67
12502	0	1	0	62	0	63
12503	67	1	0	0	0	68
12504	0	0	0	71	0	71
12505	71	0	0	1	0	72
12506	70	0	0	0	0	70
12507	71	0	0	0	0	71
12508	71	0	0	0	0	71
12509	72	1	0	0	0	73
12510	0	0	0	73	0	73
12511	73	0	0	0	0	73
12512	0	69	0	0	0	69
12513	0	0	71	0	0	71
12514	0	0	0	73	0	73
12515	0	0	75	0	0	75
12516	0	0	0	73	0	73
12517	0	0	76	0	0	76
12518	74	0	0	0	0	74
12519	1	0	0	77	0	78
12520	0	0	73	0	0	73
12521	0	0	71	1	0	72
12522	0	0	0	82	0	82
12523	78	1	0	0	0	79
12524	0	80	0	0	0	80
12525	82	0	0	0	0	82
12526	82	0	0	0	0	82
12527	0	77	0	1	0	78
12528	84	0	0	0	0	84
12529	0	0	0	81	0	81
12530	1	0	0	80	0	81
12531	0	0	0	81	0	81
12532	84	0	0	0	0	84
12533	0	83	0	0	0	83
12534	1	0	0	84	0	85
12535	0	0	0	83	0	83
12536	89	0	0	0	0	89
12537	0	0	0	88	0	88
12538	0	0	86	0	0	86
12539	0	89	0	0	0	89
12540	90	0	0	0	0	90
12541	0	0	0	93	0	93
12542	0	94	0	0	0	94
12543	99	0	0	0	0	99
12544	0	0	94	0	0	94
12545	0	94	0	0	0	94
12546	94	0	0	0	0	94
12547	0	0	0	96	0	96
12548	0	0	0	93	0	93
12549	0	0	95	0	0	95
12550	0	0	0	93	0	93
12551	0	0	95	0	0	95
12552	0	0	88	0	0	88
12553	0	0	95	0	0	95
12554	100	0	0	0	0	100
12555	98	0	0	0	0	98
12556	90	0	0	0	0	90
12557	0	0	0	95	0	95
12558	0	87	0	0	0	87
12559	0	92	0	0	0	92
12560	98	0	0	0	0	98
12561	97	0	0	0	0	97
12562	0	94	0	0	0	94
12563	95	0	0	0	0	95
12564	0	0	91	0	0	91
12565	0	0	95	0	0	95
12566	0	0	0	91	0	91
12567	0	0	0	95	0	95
12568	0	0	96	0	0	96
12569	0	0	0	96	0	96
12570	97	0	0	0	0	97
12571	0	0	95	0	0	95
12572	96	0	0	0	0	96
12573	0	0	0	97	0	97
12574	0	0	91	0	0	91
12575	1	88	0	0	0	89
12576	97	0	0	0	0	97
12577	1	0	94	0	0	95
12578	94	0	0	1	0	95
12579	0	0	0	92	0	92
12580	94	0	0	0	0	94
12581	1	0	89	0	0	90
12582	0	0	0	89	0	89
12583	94	0	0	0	0	94
12584	92	0	0	0	0	92
12585	90	1	0	0	0	91
12586	94	0	0	1	0	95
12587	0	0	0	87	0	87
12588	0	0	0	90	0	90
12589	0	0	91	0	0	91
12590	0	0	0	90	0	90
12591	0	0	0	87	0	87
12592	0	89	0	0	0	89
12593	91	0	0	0	0	91
12594	90	0	0	0	0	90
12595	0	85	0	0	0	85
12596	0	0	0	86	0	86
12597	0	0	0	84	0	84
12598	83	0	0	0	0	83
12599	0	0	78	0	0	78
12600	0	0	0	84	0	84
12601	0	0	82	1	0	83
12602	83	0	0	0	0	83
12603	82	0	0	0	0	82
12604	85	0	0	0	0	85
12605	0	0	0	76	0	76
12606	0	0	0	81	0	81
12607	82	0	0	0	0	82
12608	0	0	84	0	0	84
12609	0	0	0	81	0	81
12610	81	0	0	0	0	81
12611	0	0	0	81	0	81
12612	0	0	87	0	0	87
12613	0	0	75	0	0	75
12614	88	0	0	0	0	88
12615	0	87	0	0	0	87
12616	88	0	0	0	0	88
12617	89	0	0	0	0	89
12618	0	0	0	88	0	88
12619	0	0	0	87	0	87
12620	1	87	0	0	0	88
12621	82	0	0	0	0	82
12622	0	85	0	0	0	85
12623	0	89	0	0	0	89
12624	0	0	0	93	0	93
12625	91	0	0	0	0	91
12626	87	0	0	0	0	87
12627	0	0	0	79	0	79
12628	0	0	0	77	0	77
12629	0	0	0	79	0	79
12630	81	0	0	0	0	81
12631	0	0	76	0	0	76
12632	0	75	0	0	0	75
12633	81	0	0	0	0	81
12634	0	0	0	80	0	80
12635	0	0	77	0	0	77
12636	0	0	66	0	0	66
12637	0	75	0	0	0	75
12638	0	75	0	0	0	75
12639	0	0	0	78	0	78
12640	0	74	0	0	0	74
12641	0	0	0	75	0	75
12642	0	0	0	76	0	76
12643	78	0	0	0	0	78
12644	0	0	0	77	0	77
12645	0	0	0	74	0	74
12646	0	0	73	0	0	73
12647	0	0	0	75	0	75
12648	78	0	0	0	0	78
12649	73	0	0	0	0	73
12650	0	74	0	0	0	74
12651	72	0	0	3	0	75
12652	0	0	69	0	0	69
12653	0	73	0	0	0	73
12654	0	0	0	76	0	76
12655	0	0	0	82	0	82
12656	0	0	0	82	0	82
12657	80	0	0	0	0	80
12658	80	0	0	0	0	80
12659	0	1	74	0	0	75
12660	0	0	66	0	0	66
12661	0	0	67	0	0	67
12662	0	72	0	0	0	72
12663	0	75	0	0	0	75
12664	79	0	0	0	0	79
12665	77	0	0	0	0	77
12666	0	0	0	75	0	75
12667	0	0	0	81	0	81
12668	0	77	0	0	0	77
12669	0	0	0	79	0	79
12670	0	0	79	0	0	79
12671	0	76	0	0	0	76
12672	0	0	0	77	0	77
12673	0	0	85	0	0	85
12674	0	0	0	81	0	81
12675	0	86	0	0	0	86
12676	88	0	0	0	0	88
12677	91	0	0	0	0	91
12678	90	0	0	0	0	90
12679	0	0	0	93	0	93
12680	0	0	0	97	0	97
12681	94	0	0	1	0	95
12682	0	92	0	0	0	92
12683	99	0	0	0	0	99
12684	1	0	91	0	0	92
12685	99	0	0	0	0	99
12686	103	0	0	0	0	103
12687	0	0	0	99	0	99
12688	106	0	0	0	0	106
12689	106	0	0	1	0	107
12690	0	0	0	107	0	107
12691	1	0	105	0	0	106
12692	108	0	0	0	0	108
12693	0	0	105	0	0	105
12694	0	104	0	1	0	105
12695	0	0	0	109	0	109
12696	0	0	0	110	0	110
12697	107	0	0	0	0	107
12698	0	0	105	0	0	105
12699	0	0	0	106	0	106
12700	0	102	0	0	0	102
12701	0	108	0	0	0	108
12702	0	0	0	110	0	110
12703	0	0	109	0	0	109
12704	0	0	0	108	0	108
12705	0	0	0	102	0	102
12706	0	0	99	0	0	99
12707	0	102	0	0	0	102
12708	102	0	0	0	0	102
12709	0	99	0	0	0	99
12710	0	0	0	99	0	99
12711	95	0	0	0	0	95
12712	0	97	0	0	0	97
12713	0	0	96	0	0	96
12714	88	0	0	0	0	88
12715	0	92	0	0	0	92
12716	98	0	0	0	0	98
12717	0	0	92	0	0	92
12718	100	0	0	0	0	100
12719	0	0	0	103	0	103
12720	0	0	99	0	0	99
12721	0	0	0	102	0	102
12722	0	107	0	0	0	107
12723	0	0	0	107	0	107
12724	0	0	0	109	0	109
12725	0	0	104	0	0	104
12726	0	0	0	106	0	106
12727	0	1	93	0	0	94
12728	0	104	0	0	0	104
12729	0	0	0	110	0	110
12730	0	0	108	0	0	108
12731	0	101	0	0	0	101
12732	0	106	2	0	0	108
12733	0	0	109	0	0	109
12734	0	0	110	0	0	110
12735	0	0	0	110	0	110
12736	116	0	0	0	0	116
12737	0	115	0	0	0	115
12738	2	1	0	112	0	115
12739	118	0	0	0	0	118
12740	0	118	0	0	0	118
12741	110	0	0	0	0	110
12742	0	112	0	1	0	113
12743	112	0	0	0	0	112
12744	114	0	0	0	0	114
12745	116	0	0	0	0	116
12746	0	120	0	0	0	120
12747	0	0	0	124	0	124
12748	1	0	115	1	0	117
12749	0	114	0	0	0	114
12750	0	0	0	120	0	120
12751	0	0	0	122	0	122
12752	0	0	115	0	0	115
12753	0	112	0	0	0	112
12754	118	0	0	0	0	118
12755	0	110	0	0	0	110
12756	0	0	0	118	0	118
12757	0	0	114	0	0	114
12758	115	0	0	0	0	115
12759	0	0	0	119	0	119
12760	0	0	113	0	0	113
12761	115	0	0	0	0	115
12762	0	106	0	0	0	106
12763	117	0	0	0	0	117
12764	110	0	0	1	0	111
12765	0	0	0	113	0	113
12766	0	0	103	0	0	103
12767	5	96	0	1	0	102
12768	0	0	106	0	0	106
12769	0	0	0	111	0	111
12770	0	0	0	109	0	109
12771	99	0	0	0	0	99
12772	11	4	88	0	0	103
12773	0	86	11	0	0	97
12774	0	0	0	99	0	99
12775	0	0	0	97	0	97
12776	93	0	0	0	0	93
12777	0	96	0	0	0	96
12778	0	0	0	81	0	81
12779	79	0	0	0	0	79
12780	0	81	0	0	0	81
12781	82	0	0	0	0	82
12782	79	0	0	0	0	79
12783	0	77	0	0	0	77
12784	72	0	0	0	0	72
12785	0	75	0	0	0	75
12786	72	0	0	0	0	72
12787	71	0	0	0	0	71
12788	0	68	0	0	0	68
12789	74	0	0	0	0	74
12790	75	0	0	0	0	75
12791	72	0	0	0	0	72
12792	1	0	66	0	0	67
12793	0	0	59	0	0	59
12794	0	0	68	0	0	68
12795	71	0	0	0	0	71
12796	0	0	64	0	0	64
12797	0	0	73	0	0	73
12798	0	0	0	68	0	68
12799	72	0	0	0	0	72
12800	0	0	69	0	0	69
12801	0	0	69	0	0	69
12802	0	0	0	71	0	71
12803	0	0	0	75	0	75
12804	1	0	0	78	0	79
12805	0	0	77	0	0	77
12806	0	0	0	81	0	81
12807	77	0	0	0	0	77
12808	0	80	0	0	0	80
12809	0	0	0	75	0	75
12810	0	0	0	78	0	78
12811	0	0	77	0	0	77
12812	0	75	0	0	0	75
12813	77	0	0	0	0	77
12814	0	73	0	0	0	73
12815	0	0	0	73	0	73
12816	0	0	70	0	0	70
12817	0	0	0	74	0	74
12818	0	0	0	74	0	74
12819	75	0	0	0	0	75
12820	0	0	0	74	0	74
12821	0	65	0	0	0	65
12822	0	70	0	0	0	70
12823	1	0	68	0	0	69
12824	66	0	0	0	0	66
12825	0	0	1	66	0	67
12826	0	0	0	71	0	71
12827	0	0	0	69	0	69
12828	67	0	0	0	0	67
12829	0	69	0	0	0	69
12830	68	0	0	0	0	68
12831	0	0	66	0	0	66
12832	0	0	66	0	0	66
12833	69	0	0	0	0	69
12834	0	0	0	70	0	70
12835	0	0	0	71	0	71
12836	0	0	0	69	0	69
12837	0	0	66	0	0	66
12838	69	0	0	0	0	69
12839	65	0	0	0	0	65
12840	66	0	0	0	0	66
12841	0	0	0	66	0	66
12842	0	0	64	0	0	64
12843	0	0	60	0	0	60
12844	0	0	62	0	0	62
12845	0	67	0	0	0	67
12846	0	0	0	71	0	71
12847	72	0	0	0	0	72
12848	0	0	69	0	0	69
12849	71	0	0	0	0	71
12850	0	0	0	67	0	67
12851	0	0	0	69	0	69
12852	0	63	0	0	0	63
12853	0	58	0	0	0	58
12854	0	67	0	0	0	67
12855	0	0	0	69	0	69
12856	68	0	0	0	0	68
12857	69	0	0	0	0	69
12858	0	0	69	0	0	69
12859	71	0	0	0	0	71
12860	0	0	68	0	0	68
12861	0	0	0	65	0	65
12862	0	0	66	0	0	66
12863	71	0	0	0	0	71
12864	0	0	0	70	0	70
12865	0	0	68	0	0	68
12866	0	0	67	0	0	67
12867	70	0	0	0	0	70
12868	70	0	0	0	0	70
12869	0	72	0	0	0	72
12870	1	0	0	74	0	75
12871	0	0	72	0	0	72
12872	0	0	65	1	0	66
12873	0	0	0	72	0	72
12874	71	0	0	0	0	71
12875	1	64	0	0	0	65
12876	0	0	0	66	0	66
12877	68	0	0	0	0	68
12878	0	0	0	66	0	66
12879	0	67	0	0	0	67
12880	0	0	0	70	0	70
12881	70	0	0	0	0	70
12882	0	0	0	67	0	67
12883	72	0	0	0	0	72
12884	0	65	1	0	0	66
12885	69	0	0	0	0	69
12886	0	0	71	0	0	71
12887	75	0	0	0	0	75
12888	76	0	0	0	0	76
12889	0	71	0	0	0	71
12890	0	0	0	68	0	68
12891	0	0	67	0	0	67
12892	0	0	63	0	0	63
12893	67	0	0	0	0	67
12894	67	0	0	0	0	67
12895	0	66	0	0	0	66
12896	0	66	0	0	0	66
12897	70	0	0	0	0	70
12898	0	61	0	0	0	61
12899	0	61	0	1	0	62
12900	0	0	0	66	0	66
12901	0	0	0	68	0	68
12902	0	0	62	0	0	62
12903	0	0	0	65	0	65
12904	68	0	0	0	0	68
12905	0	0	63	0	0	63
12906	0	0	64	0	0	64
12907	0	0	0	71	0	71
12908	1	0	0	70	0	71
12909	0	0	0	72	0	72
12910	0	0	74	0	0	74
12911	0	0	0	74	0	74
12912	1	0	0	74	0	75
12913	77	0	0	0	0	77
12914	0	73	0	0	0	73
12915	71	0	0	0	0	71
12916	0	0	68	0	0	68
12917	64	0	0	0	0	64
12918	0	71	0	0	0	71
12919	72	0	0	0	0	72
12920	0	71	0	0	0	71
12921	73	0	0	1	0	74
12922	0	73	0	0	0	73
12923	0	72	0	0	0	72
12924	0	0	0	76	0	76
12925	75	0	0	0	0	75
12926	74	0	0	0	0	74
12927	76	0	0	0	0	76
12928	0	1	67	0	0	68
12929	1	0	68	0	0	69
12930	1	0	0	75	0	76
12931	0	72	0	0	0	72
12932	0	75	0	0	0	75
12933	0	0	0	79	0	79
12934	80	0	0	0	0	80
12935	79	0	0	0	0	79
12936	77	0	0	0	0	77
12937	0	0	72	0	0	72
12938	0	0	0	74	0	74
12939	0	0	68	0	0	68
12940	71	0	0	0	0	71
12941	72	0	0	0	0	72
12942	0	0	73	0	0	73
12943	0	0	0	70	0	70
12944	74	0	0	0	0	74
12945	0	0	0	78	0	78
12946	0	0	0	75	0	75
12947	0	0	0	73	0	73
12948	76	0	0	0	0	76
12949	0	0	0	81	0	81
12950	78	0	0	1	0	79
12951	0	80	0	0	0	80
12952	0	0	0	83	0	83
12953	0	0	0	81	0	81
12954	0	0	0	84	0	84
12955	80	0	0	0	0	80
12956	1	0	0	79	0	80
12957	0	0	0	84	0	84
12958	80	0	0	0	0	80
12959	84	0	0	0	0	84
12960	84	0	0	0	0	84
12961	0	0	82	0	0	82
12962	0	0	79	0	0	79
12963	85	0	0	0	0	85
12964	0	0	0	88	0	88
12965	0	0	0	89	0	89
12966	91	0	0	0	0	91
12967	87	0	0	0	0	87
12968	91	0	0	0	0	91
12969	0	87	0	0	0	87
12970	87	0	0	1	0	88
12971	81	0	0	0	0	81
12972	0	87	0	0	0	87
12973	1	85	0	0	0	86
12974	0	0	0	89	0	89
12975	94	0	0	0	0	94
12976	94	0	0	0	0	94
12977	96	0	0	0	0	96
12978	0	0	0	99	0	99
12979	95	0	0	0	0	95
12980	0	0	95	0	0	95
12981	98	0	0	0	0	98
12982	1	0	89	0	0	90
12983	1	1	92	0	0	94
12984	0	0	0	94	0	94
12985	97	0	0	0	0	97
12986	0	0	0	98	0	98
12987	0	0	95	0	0	95
12988	0	0	85	0	0	85
12989	0	0	0	100	0	100
12990	93	0	0	0	0	93
12991	0	98	0	0	0	98
12992	0	0	0	99	0	99
12993	0	0	0	100	0	100
12994	0	0	98	0	0	98
12995	0	0	88	0	0	88
12996	0	0	0	95	0	95
12997	99	0	0	0	0	99
12998	0	0	95	0	0	95
12999	0	0	1	84	0	85
13000	0	0	0	91	0	91
13001	0	0	0	95	0	95
13002	94	0	0	0	0	94
13003	0	0	63	1	0	64
13004	0	84	0	0	0	84
13005	0	0	0	86	0	86
13006	0	0	85	0	0	85
13007	0	79	0	0	0	79
13008	0	89	0	0	0	89
13009	83	0	0	0	0	83
13010	0	84	0	0	0	84
13011	83	0	0	0	0	83
13012	0	0	82	0	0	82
13013	0	0	0	85	0	85
13014	85	0	0	0	0	85
13015	0	80	0	0	0	80
13016	1	0	82	0	0	83
13017	1	0	0	78	0	79
13018	0	80	0	0	0	80
13019	0	0	0	84	0	84
13020	81	0	0	1	0	82
13021	0	87	0	0	0	87
13022	87	0	0	0	0	87
13023	91	0	0	0	0	91
13024	0	0	87	0	0	87
13025	0	84	0	0	0	84
13026	0	0	0	89	0	89
13027	0	0	84	0	0	84
13028	0	0	84	0	0	84
13029	0	0	0	86	0	86
13030	93	0	0	0	0	93
13031	90	0	0	0	0	90
13032	0	0	0	96	0	96
13033	1	0	91	0	0	92
13034	0	90	0	0	0	90
13035	93	0	0	0	0	93
13036	93	0	0	0	0	93
13037	0	97	0	0	0	97
13038	98	0	0	0	0	98
13039	0	0	95	0	0	95
13040	97	0	0	0	0	97
13041	98	0	0	0	0	98
13042	0	0	87	0	0	87
13043	0	0	0	94	0	94
13044	0	0	87	0	0	87
13045	0	82	0	0	0	82
13046	0	86	0	0	0	86
13047	0	0	0	84	0	84
13048	0	0	83	0	0	83
13049	0	78	0	0	0	78
13050	0	82	0	0	0	82
13051	83	0	0	0	0	83
13052	78	0	0	0	0	78
13053	0	0	0	77	0	77
13054	0	0	0	80	0	80
13055	0	70	0	0	0	70
13056	75	0	0	0	0	75
13057	67	0	0	0	0	67
13058	0	72	0	0	0	72
13059	0	0	0	71	0	71
13060	0	0	69	0	0	69
13061	0	0	0	67	0	67
13062	71	0	0	0	0	71
13063	0	0	0	70	0	70
13064	0	0	0	69	0	69
13065	65	0	0	1	0	66
13066	0	0	0	65	0	65
13067	0	62	0	0	0	62
13068	0	0	0	60	0	60
13069	0	0	0	63	0	63
13070	0	0	0	58	0	58
13071	0	57	0	1	0	58
13072	0	0	0	58	0	58
13073	0	0	57	0	0	57
13074	0	0	0	59	0	59
13075	0	0	54	0	0	54
13076	0	54	0	0	0	54
13077	0	0	0	57	0	57
13078	0	0	0	58	0	58
13079	0	0	0	56	0	56
13080	0	0	0	55	0	55
13081	0	0	55	0	0	55
13082	0	49	0	0	0	49
13083	0	0	0	54	0	54
13084	0	0	53	0	0	53
13085	0	0	0	53	0	53
13086	56	0	0	0	0	56
13087	0	0	52	0	0	52
13088	53	0	0	0	0	53
13089	0	0	0	51	0	51
13090	0	0	52	0	0	52
13091	0	50	0	0	0	50
13092	0	0	0	57	0	57
13093	0	0	51	0	0	51
13094	0	57	0	0	0	57
13095	0	0	0	62	0	62
13096	60	0	0	1	0	61
13097	62	0	0	0	0	62
13098	64	0	0	0	0	64
13099	0	0	59	0	0	59
13100	0	56	0	0	0	56
13101	0	0	0	58	0	58
13102	1	0	0	59	0	60
13103	62	0	0	0	0	62
13104	0	57	0	0	0	57
13105	61	0	0	0	0	61
13106	57	0	0	0	0	57
13107	59	0	0	0	0	59
13108	0	0	56	0	0	56
13109	54	0	0	0	0	54
13110	0	0	0	57	0	57
13111	0	0	0	59	0	59
13112	59	0	0	0	0	59
13113	0	0	0	57	0	57
13114	0	50	0	0	0	50
13115	0	0	0	54	0	54
13116	50	0	0	0	0	50
13117	0	0	49	0	0	49
13118	0	44	0	1	0	45
13119	0	0	0	49	0	49
13120	51	0	0	0	0	51
13121	0	0	49	0	0	49
13122	0	0	0	48	0	48
13123	0	0	47	0	0	47
13124	0	0	40	1	0	41
13125	2	0	39	0	0	41
13126	0	0	40	0	0	40
13127	0	0	43	0	0	43
13128	45	0	0	0	0	45
13129	0	46	0	0	0	46
13130	45	0	0	0	0	45
13131	45	0	0	0	0	45
13132	0	44	0	0	0	44
13133	0	43	0	0	0	43
13134	43	0	0	0	0	43
13135	45	0	0	0	0	45
13136	0	0	0	45	0	45
13137	0	45	0	0	0	45
13138	46	0	0	0	0	46
13139	0	44	0	0	0	44
13140	0	0	0	44	0	44
13141	44	0	0	0	0	44
13142	46	0	0	0	0	46
13143	0	0	0	48	0	48
13144	0	0	0	48	0	48
13145	0	0	50	0	0	50
13146	0	0	0	52	0	52
13147	0	0	50	0	0	50
13148	0	0	0	55	0	55
13149	0	0	0	58	0	58
13150	61	0	0	0	0	61
13151	62	0	0	0	0	62
13152	0	0	63	0	0	63
13153	62	0	0	0	0	62
13154	0	0	0	65	0	65
13155	0	0	58	0	0	58
13156	1	0	0	69	0	70
13157	0	0	0	70	0	70
13158	0	0	71	0	0	71
13159	0	0	0	72	0	72
13160	0	0	72	0	0	72
13161	0	0	0	72	0	72
13162	71	0	0	0	0	71
13163	0	77	0	0	0	77
13164	77	0	0	0	0	77
13165	0	78	0	0	0	78
13166	79	0	0	0	0	79
13167	0	82	0	0	0	82
13168	85	0	0	0	0	85
13169	0	86	0	0	0	86
13170	0	0	0	84	0	84
13171	0	0	84	0	0	84
13172	0	0	83	0	0	83
13173	0	0	0	87	0	87
13174	88	0	0	0	0	88
13175	0	88	0	0	0	88
13176	0	0	0	88	0	88
13177	0	0	89	0	0	89
13178	0	0	87	0	0	87
13179	0	0	0	85	0	85
13180	0	89	0	0	0	89
13181	89	0	0	0	0	89
13182	0	0	85	0	0	85
13183	0	0	84	0	0	84
13184	0	87	0	0	0	87
13185	90	0	0	0	0	90
13186	94	0	0	0	0	94
13187	0	0	0	91	0	91
13188	92	0	0	0	0	92
13189	87	0	0	0	0	87
13190	0	87	0	0	0	87
13191	90	0	0	0	0	90
13192	0	0	88	0	0	88
13193	0	0	0	90	0	90
13194	1	0	0	90	0	91
13195	89	0	0	0	0	89
13196	0	86	0	0	0	86
13197	86	0	0	1	0	87
13198	0	83	0	0	0	83
13199	1	83	0	0	0	84
13200	0	0	91	0	0	91
13201	0	0	87	0	0	87
13202	92	0	0	0	0	92
13203	95	0	0	0	0	95
13204	0	0	90	0	0	90
13205	0	80	0	0	0	80
13206	0	95	0	0	0	95
13207	94	0	0	0	0	94
13208	95	0	0	0	0	95
13209	0	0	0	97	0	97
13210	94	0	0	0	0	94
13211	1	0	0	97	0	98
13212	0	0	96	0	0	96
13213	0	0	87	0	0	87
13214	97	0	0	0	0	97
13215	0	0	0	98	0	98
13216	0	96	0	0	0	96
13217	98	0	0	0	0	98
13218	102	0	0	0	0	102
13219	0	1	97	0	0	98
13220	98	0	0	0	0	98
13221	100	0	0	0	0	100
13222	0	0	0	103	0	103
13223	0	96	0	0	0	96
13224	0	96	0	0	0	96
13225	0	0	0	104	0	104
13226	0	0	0	106	0	106
13227	0	0	0	108	0	108
13228	0	0	96	0	0	96
13229	1	0	93	0	0	94
13230	0	0	0	101	0	101
13231	0	0	98	0	0	98
13232	0	0	101	0	0	101
13233	0	0	0	102	0	102
13234	0	0	95	0	0	95
13235	0	94	0	0	0	94
13236	94	0	1	0	0	95
13237	0	0	0	100	0	100
13238	0	89	0	0	0	89
13239	0	0	95	0	0	95
13240	0	0	0	92	0	92
13241	0	1	92	1	0	94
13242	0	0	0	90	0	90
13243	0	0	0	89	0	89
13244	0	0	86	0	0	86
13245	0	0	0	82	0	82
13246	0	76	0	0	0	76
13247	0	0	0	82	0	82
13248	0	0	83	0	0	83
13249	0	0	0	84	0	84
13250	79	1	0	0	0	80
13251	0	80	0	0	0	80
13252	0	0	0	77	0	77
13253	1	0	74	0	0	75
13254	0	69	0	0	0	69
13255	1	72	0	0	0	73
13256	0	0	75	0	0	75
13257	0	0	0	72	0	72
13258	0	0	0	75	0	75
13259	1	0	73	0	0	74
13260	1	67	0	0	0	68
13261	0	70	0	0	0	70
13262	69	0	0	0	0	69
13263	0	73	0	0	0	73
13264	73	0	0	0	0	73
13265	0	0	0	74	0	74
13266	77	0	0	0	0	77
13267	0	0	76	0	0	76
13268	72	0	0	0	0	72
13269	0	0	0	70	0	70
13270	0	69	0	0	0	69
13271	73	0	0	0	0	73
13272	0	0	0	75	0	75
13273	0	70	0	0	0	70
13274	0	69	0	0	0	69
13275	78	0	0	0	0	78
13276	75	0	0	0	0	75
13277	77	0	0	1	0	78
13278	0	0	0	78	0	78
13279	0	69	0	0	0	69
13280	0	70	0	0	0	70
13281	0	0	0	76	0	76
13282	73	0	0	1	0	74
13283	73	0	0	0	0	73
13284	75	0	0	0	0	75
13285	0	0	69	1	0	70
13286	0	0	67	0	0	67
13287	74	0	0	0	0	74
13288	0	0	0	71	0	71
13289	1	0	0	69	0	70
13290	0	0	0	71	0	71
13291	1	0	0	69	0	70
13292	0	1	68	0	0	69
13293	0	0	0	73	0	73
13294	3	0	69	1	0	73
13295	75	0	0	0	0	75
13296	0	73	0	0	0	73
13297	0	0	0	75	0	75
13298	0	0	0	72	0	72
13299	76	0	0	0	0	76
13300	76	0	0	0	0	76
13301	73	0	0	0	0	73
13302	72	0	0	0	0	72
13303	0	0	67	0	0	67
13304	0	0	70	0	0	70
13305	0	0	0	70	0	70
13306	70	0	0	0	0	70
13307	70	0	0	0	0	70
13308	0	0	68	0	0	68
13309	0	0	0	71	0	71
13310	65	0	0	0	0	65
13311	0	0	0	66	0	66
13312	0	0	68	0	0	68
13313	0	0	0	70	0	70
13314	66	0	0	0	0	66
13315	0	67	0	0	0	67
13316	68	0	0	0	0	68
13317	67	0	0	0	0	67
13318	65	0	0	0	0	65
13319	0	0	0	68	0	68
13320	69	0	0	0	0	69
13321	0	68	0	0	0	68
13322	0	68	0	0	0	68
13323	0	0	0	75	0	75
13324	69	0	0	0	0	69
13325	0	69	0	0	0	69
13326	68	0	0	0	0	68
13327	70	0	0	0	0	70
13328	0	71	0	0	0	71
13329	0	0	0	75	0	75
13330	0	0	0	78	0	78
13331	0	0	77	0	0	77
13332	0	0	0	78	0	78
13333	0	0	83	0	0	83
13334	0	89	0	0	0	89
13335	0	0	0	93	0	93
13336	91	0	0	0	0	91
13337	90	0	0	0	0	90
13338	0	0	0	92	0	92
13339	0	0	92	1	0	93
13340	93	0	0	0	0	93
13341	0	91	0	0	0	91
13342	0	93	0	0	0	93
13343	0	94	0	0	0	94
13344	0	0	0	96	0	96
13345	0	0	96	0	0	96
13346	0	0	0	92	0	92
13347	0	0	93	0	0	93
13348	0	0	89	0	0	89
13349	0	0	96	0	0	96
13350	0	0	0	95	0	95
13351	0	0	0	93	0	93
13352	0	0	0	96	0	96
13353	0	0	0	96	0	96
13354	97	0	0	0	0	97
13355	0	97	0	0	0	97
13356	94	0	0	0	0	94
13357	0	94	0	0	0	94
13358	0	0	0	97	0	97
13359	0	0	0	101	0	101
13360	99	0	0	0	0	99
13361	96	0	0	0	0	96
13362	96	0	0	0	0	96
13363	104	0	0	0	0	104
13364	98	0	0	0	0	98
13365	0	101	0	0	0	101
13366	100	0	0	0	0	100
13367	0	103	0	0	0	103
13368	95	0	0	0	0	95
13369	0	0	92	0	0	92
13370	0	0	0	94	0	94
13371	0	89	0	0	0	89
13372	0	0	0	92	0	92
13373	0	0	91	0	0	91
13374	0	0	0	92	0	92
13375	82	0	0	0	0	82
13376	1	85	1	0	0	87
13377	0	85	0	0	0	85
13378	0	0	88	1	0	89
13379	0	0	0	89	0	89
13380	0	80	1	0	0	81
13381	0	0	0	93	0	93
13382	0	0	94	0	0	94
13383	0	88	0	0	0	88
13384	0	0	92	0	0	92
13385	0	0	94	0	0	94
13386	0	0	0	95	0	95
13387	95	0	0	1	0	96
13388	0	0	0	96	0	96
13389	0	0	92	1	0	93
13390	0	0	0	95	0	95
13391	0	0	95	0	0	95
13392	0	0	94	0	0	94
13393	98	0	0	0	0	98
13394	98	0	0	0	0	98
13395	96	0	0	0	0	96
13396	0	0	97	0	0	97
13397	0	0	95	0	0	95
13398	0	0	0	98	0	98
13399	0	0	0	97	0	97
13400	96	0	0	0	0	96
13401	0	0	0	95	0	95
13402	0	0	92	0	0	92
13403	0	0	90	0	0	90
13404	0	96	0	0	0	96
13405	0	0	0	96	0	96
13406	0	0	93	0	0	93
13407	0	0	0	93	0	93
13408	94	0	0	0	0	94
13409	0	0	96	0	0	96
13410	0	0	0	95	0	95
13411	0	0	0	92	0	92
13412	0	0	93	0	0	93
13413	1	0	0	89	0	90
13414	0	0	91	0	0	91
13415	90	0	0	0	0	90
13416	0	0	0	84	0	84
13417	0	88	0	0	0	88
13418	90	0	0	0	0	90
13419	89	0	0	0	0	89
13420	0	89	0	0	0	89
13421	0	1	0	86	0	87
13422	0	81	0	0	0	81
13423	0	84	0	0	0	84
13424	0	0	81	0	0	81
13425	0	70	0	0	0	70
13426	0	0	69	0	0	69
13427	73	0	0	0	0	73
13428	69	0	0	0	0	69
13429	0	66	0	0	0	66
13430	0	61	0	0	0	61
13431	0	66	0	0	0	66
13432	62	0	0	0	0	62
13433	0	0	0	64	0	64
13434	0	0	62	0	0	62
13435	0	66	0	0	0	66
13436	0	0	0	69	0	69
13437	0	0	0	66	0	66
13438	0	69	0	0	0	69
13439	71	0	0	0	0	71
13440	0	0	72	0	0	72
13441	0	0	0	75	0	75
13442	0	71	0	1	0	72
13443	72	0	0	0	0	72
13444	0	0	71	0	0	71
13445	0	68	0	0	0	68
13446	0	0	0	71	0	71
13447	0	0	73	0	0	73
13448	70	0	0	0	0	70
13449	0	0	0	71	0	71
13450	0	0	68	0	0	68
13451	0	67	0	0	0	67
13452	69	0	0	0	0	69
13453	0	66	0	0	0	66
13454	64	0	0	0	0	64
13455	63	0	0	0	0	63
13456	0	0	0	63	0	63
13457	0	64	0	2	0	66
13458	0	0	66	0	0	66
13459	0	0	0	64	0	64
13460	0	0	0	62	0	62
13461	0	0	0	63	0	63
13462	0	0	0	64	0	64
13463	0	0	0	68	0	68
13464	66	0	0	0	0	66
13465	67	0	0	0	0	67
13466	64	1	0	0	0	65
13467	0	67	0	0	0	67
13468	0	0	65	0	0	65
13469	0	0	60	0	0	60
13470	0	0	64	0	0	64
13471	0	0	0	67	0	67
13472	0	0	0	65	0	65
13473	0	0	0	68	0	68
13474	0	0	64	0	0	64
13475	0	63	0	0	0	63
13476	0	0	63	0	0	63
13477	0	0	65	0	0	65
13478	0	0	0	63	0	63
13479	0	0	65	0	0	65
13480	0	0	0	62	0	62
13481	63	0	0	0	0	63
13482	65	0	1	0	0	66
13483	0	0	68	0	0	68
13484	0	0	0	68	0	68
13485	0	0	63	0	0	63
13486	0	63	0	0	0	63
13487	64	0	0	0	0	64
13488	0	0	64	0	0	64
13489	0	59	0	0	0	59
13490	0	54	0	1	0	55
13491	0	64	0	0	0	64
13492	0	0	64	0	0	64
13493	0	0	0	65	0	65
13494	0	65	0	0	0	65
13495	0	0	0	64	0	64
13496	0	0	0	62	0	62
13497	64	0	0	0	0	64
13498	0	64	0	0	0	64
13499	61	0	0	1	0	62
13500	0	63	0	1	0	64
13501	0	65	0	0	0	65
13502	0	0	64	0	0	64
13503	0	0	0	65	0	65
13504	0	0	64	0	0	64
13505	0	61	0	0	0	61
13506	0	0	59	0	0	59
13507	0	0	57	0	0	57
13508	0	59	0	0	0	59
13509	60	0	0	0	0	60
13510	0	61	0	0	0	61
13511	61	0	0	0	0	61
13512	0	0	60	0	0	60
13513	0	0	54	0	0	54
13514	0	58	0	0	0	58
13515	59	0	0	0	0	59
13516	0	56	0	0	0	56
13517	0	0	0	58	0	58
13518	59	1	0	0	0	60
13519	0	0	62	0	0	62
13520	0	0	0	58	0	58
13521	61	0	0	0	0	61
13522	0	61	0	0	0	61
13523	0	0	0	62	0	62
13524	0	0	63	0	0	63
13525	61	0	0	0	0	61
13526	0	0	0	61	0	61
13527	0	0	58	0	0	58
13528	0	0	0	56	0	56
13529	0	56	0	1	0	57
13530	0	0	54	0	0	54
13531	0	0	0	57	0	57
13532	55	0	0	0	0	55
13533	0	0	0	51	0	51
13534	50	0	0	0	0	50
13535	0	51	0	0	0	51
13536	49	0	0	0	0	49
13537	0	0	53	0	0	53
13538	0	0	52	0	0	52
13539	0	0	53	0	0	53
13540	0	53	0	0	0	53
13541	0	0	0	61	0	61
13542	0	0	0	62	0	62
13543	0	0	0	63	0	63
13544	0	0	0	66	0	66
13545	0	0	61	0	0	61
13546	61	0	0	0	0	61
13547	0	62	0	0	0	62
13548	61	0	0	0	0	61
13549	0	0	0	59	0	59
13550	0	61	0	0	0	61
13551	0	0	0	59	0	59
13552	62	0	0	0	0	62
13553	0	63	0	0	0	63
13554	62	0	0	0	0	62
13555	62	0	0	0	0	62
13556	0	0	0	59	0	59
13557	0	0	61	0	0	61
13558	62	0	0	0	0	62
13559	0	0	0	58	0	58
13560	61	0	0	0	0	61
13561	58	0	0	0	0	58
13562	63	0	0	0	0	63
13563	0	0	63	0	0	63
13564	0	0	0	62	0	62
13565	63	0	0	0	0	63
13566	0	0	64	0	0	64
13567	0	63	0	0	0	63
13568	0	0	0	65	0	65
13569	0	0	61	0	0	61
13570	1	0	60	0	0	61
13571	0	0	0	65	0	65
13572	0	0	0	64	0	64
13573	0	0	0	65	0	65
13574	0	0	0	65	0	65
13575	0	0	66	0	0	66
13576	0	61	0	1	0	62
13577	0	0	0	64	0	64
13578	66	0	0	0	0	66
13579	61	0	0	0	0	61
13580	65	0	0	0	0	65
13581	0	0	0	59	0	59
13582	0	0	0	65	0	65
13583	0	59	0	0	0	59
13584	0	61	1	0	0	62
13585	0	0	0	65	0	65
13586	66	0	0	0	0	66
13587	64	0	0	0	0	64
13588	65	0	0	0	0	65
13589	63	0	0	0	0	63
13590	65	0	0	0	0	65
13591	0	60	0	0	0	60
13592	0	0	0	65	0	65
13593	66	0	0	0	0	66
13594	63	0	0	0	0	63
13595	0	0	0	68	0	68
13596	0	0	0	68	0	68
13597	0	0	68	0	0	68
13598	0	0	0	68	0	68
13599	0	0	0	69	0	69
13600	0	0	67	0	0	67
13601	0	0	0	70	0	70
13602	0	71	0	0	0	71
13603	0	0	71	0	0	71
13604	0	72	0	0	0	72
13605	0	0	0	75	0	75
13606	0	0	0	73	0	73
13607	0	65	0	0	0	65
13608	0	72	0	0	0	72
13609	73	0	0	0	0	73
13610	76	0	0	0	0	76
13611	0	0	72	0	0	72
13612	75	0	0	0	0	75
13613	69	0	0	0	0	69
13614	67	0	0	0	0	67
13615	68	0	0	0	0	68
13616	0	0	70	0	0	70
13617	1	0	65	0	0	66
13618	74	0	0	0	0	74
13619	0	70	0	0	0	70
13620	0	0	72	0	0	72
13621	78	0	0	0	0	78
13622	74	0	0	0	0	74
13623	0	0	73	0	0	73
13624	75	0	0	0	0	75
13625	0	0	0	74	0	74
13626	0	0	73	0	0	73
13627	75	0	0	0	0	75
13628	0	76	0	0	0	76
13629	72	0	0	0	0	72
13630	67	0	0	0	0	67
13631	0	0	0	70	0	70
13632	0	0	0	67	0	67
13633	0	0	0	68	0	68
13634	60	0	0	0	0	60
13635	68	0	0	0	0	68
13636	0	0	0	63	0	63
13637	1	0	0	60	0	61
13638	0	0	60	0	0	60
13639	61	0	0	1	0	62
13640	0	0	0	60	0	60
13641	0	0	0	61	0	61
13642	0	58	0	0	0	58
13643	0	0	0	62	0	62
13644	0	0	0	62	0	62
13645	63	0	0	0	0	63
13646	0	62	0	0	0	62
13647	0	0	0	59	0	59
13648	1	0	0	59	0	60
13649	0	0	0	58	0	58
13650	0	0	56	0	0	56
13651	0	0	0	59	0	59
13652	57	0	0	0	0	57
13653	0	0	59	0	0	59
13654	0	0	0	55	0	55
13655	0	0	0	58	0	58
13656	58	0	0	0	0	58
13657	58	0	0	0	0	58
13658	0	0	55	0	0	55
13659	57	0	0	0	0	57
13660	0	0	57	0	0	57
13661	55	0	0	0	0	55
13662	0	57	0	0	0	57
13663	58	0	0	0	0	58
13664	0	55	0	0	0	55
13665	56	0	0	0	0	56
13666	0	57	0	0	0	57
13667	0	0	0	58	0	58
13668	0	0	0	59	0	59
13669	0	0	0	55	0	55
13670	0	55	0	0	0	55
13671	0	0	0	58	0	58
13672	0	56	0	0	0	56
13673	0	0	0	58	0	58
13674	55	0	0	0	0	55
13675	56	0	0	0	0	56
13676	0	55	0	0	0	55
13677	0	0	0	53	0	53
13678	56	0	0	0	0	56
13679	0	52	0	0	0	52
13680	0	52	0	0	0	52
13681	55	0	0	0	0	55
13682	53	0	0	0	0	53
13683	0	53	0	0	0	53
13684	54	0	0	0	0	54
13685	0	0	0	52	0	52
13686	0	0	51	0	0	51
13687	52	0	0	0	0	52
13688	51	0	0	0	0	51
13689	0	0	54	0	0	54
13690	53	0	0	0	0	53
13691	54	0	0	0	0	54
13692	49	0	0	2	0	51
13693	0	50	0	0	0	50
13694	56	0	0	0	0	56
13695	51	0	0	0	0	51
13696	0	0	0	52	0	52
13697	0	0	0	51	0	51
13698	0	0	0	51	0	51
13699	48	0	0	0	0	48
13700	0	0	0	52	0	52
13701	53	0	0	0	0	53
13702	51	0	0	0	0	51
13703	0	0	0	51	0	51
13704	0	0	0	53	0	53
13705	0	0	0	53	0	53
13706	54	0	0	0	0	54
13707	0	50	0	0	0	50
13708	0	0	0	52	0	52
13709	0	0	0	52	0	52
13710	52	0	0	0	0	52
13711	51	0	0	0	0	51
13712	0	0	46	0	0	46
13713	0	0	44	0	0	44
13714	49	0	0	0	0	49
13715	0	0	0	55	0	55
13716	0	0	0	51	0	51
13717	0	0	50	0	0	50
13718	0	0	0	51	0	51
13719	0	50	0	0	0	50
13720	0	54	0	0	0	54
13721	50	0	0	0	0	50
13722	0	0	52	0	0	52
13723	0	55	0	0	0	55
13724	0	0	0	56	0	56
13725	0	0	58	0	0	58
13726	0	0	0	63	0	63
13727	0	0	0	59	0	59
13728	0	0	58	0	0	58
13729	0	58	0	0	0	58
13730	0	0	0	64	0	64
13731	64	0	0	0	0	64
13732	65	0	0	0	0	65
13733	63	0	0	0	0	63
13734	0	65	0	0	0	65
13735	67	0	0	0	0	67
13736	0	0	0	67	0	67
13737	0	0	64	0	0	64
13738	68	0	0	0	0	68
13739	0	62	0	1	0	63
13740	0	0	0	64	0	64
13741	0	0	0	65	0	65
13742	0	67	0	0	0	67
13743	0	0	0	70	0	70
13744	0	0	0	69	0	69
13745	0	0	0	70	0	70
13746	64	0	0	0	0	64
13747	67	0	0	0	0	67
13748	0	0	68	0	0	68
13749	0	0	0	67	0	67
13750	0	0	0	69	0	69
13751	1	0	0	70	0	71
13752	71	0	0	0	0	71
13753	0	0	68	0	0	68
13754	72	0	0	0	0	72
13755	67	0	0	0	0	67
13756	0	0	0	66	0	66
13757	69	0	0	0	0	69
13758	0	0	72	0	0	72
13759	71	0	0	0	0	71
13760	0	69	0	0	0	69
13761	0	0	67	0	0	67
13762	0	0	68	0	0	68
13763	0	0	0	73	0	73
13764	0	0	74	0	0	74
13765	74	0	0	0	0	74
13766	0	73	0	0	0	73
13767	76	0	0	0	0	76
13768	0	0	0	79	0	79
13769	0	0	78	0	0	78
13770	0	0	76	0	0	76
13771	0	0	0	80	0	80
13772	78	0	0	0	0	78
13773	0	79	0	0	0	79
13774	0	78	0	0	0	78
13775	84	0	0	0	0	84
13776	0	85	0	0	0	85
13777	89	0	0	0	0	89
13778	0	0	0	89	0	89
13779	90	0	0	0	0	90
13780	0	0	0	89	0	89
13781	85	0	0	0	0	85
13782	0	0	0	87	0	87
13783	0	86	0	0	0	86
13784	86	0	0	0	0	86
13785	0	86	1	0	0	87
13786	0	0	81	0	0	81
13787	0	0	0	82	0	82
13788	0	89	0	0	0	89
13789	87	0	0	0	0	87
13790	85	0	0	0	0	85
13791	0	87	0	0	0	87
13792	0	0	86	0	0	86
13793	0	0	0	89	0	89
13794	0	87	0	0	0	87
13795	0	0	0	91	0	91
13796	0	0	0	94	0	94
13797	91	0	0	0	0	91
13798	0	91	0	0	0	91
13799	0	0	0	93	0	93
13800	85	0	0	0	0	85
13801	88	0	0	0	0	88
13802	88	0	0	0	0	88
13803	1	0	0	88	0	89
13804	87	1	0	0	0	88
13805	0	84	0	0	0	84
13806	84	0	0	0	0	84
13807	0	85	0	0	0	85
13808	87	0	0	0	0	87
13809	89	0	0	0	0	89
13810	0	0	0	85	0	85
13811	0	0	85	0	0	85
13812	0	0	79	0	0	79
13813	0	83	0	0	0	83
13814	82	0	0	0	0	82
13815	0	1	84	0	0	85
13816	79	0	1	0	0	80
13817	0	79	0	0	0	79
13818	0	82	0	0	0	82
13819	0	0	0	85	0	85
13820	0	83	0	0	0	83
13821	0	0	79	0	0	79
13822	1	0	0	79	0	80
13823	0	81	0	0	0	81
13824	0	0	0	85	0	85
13825	84	0	0	0	0	84
13826	0	0	0	84	0	84
13827	0	0	84	0	0	84
13828	0	83	0	0	0	83
13829	0	0	0	84	0	84
13830	0	0	0	82	0	82
13831	0	0	0	84	0	84
13832	84	0	0	0	0	84
13833	83	0	0	0	0	83
13834	0	0	83	0	0	83
13835	0	0	79	0	0	79
13836	0	77	0	0	0	77
13837	81	0	0	0	0	81
13838	0	0	0	80	0	80
13839	0	0	0	85	0	85
13840	0	0	0	81	0	81
13841	0	0	0	83	0	83
13842	0	0	79	0	0	79
13843	84	0	0	0	0	84
13844	0	0	0	83	0	83
13845	0	0	79	0	0	79
13846	82	0	0	0	0	82
13847	85	0	0	0	0	85
13848	0	0	81	0	0	81
13849	0	0	75	0	0	75
13850	0	0	0	82	0	82
13851	87	0	0	0	0	87
13852	86	0	0	0	0	86
13853	0	0	0	82	0	82
13854	0	0	0	81	0	81
13855	1	1	78	0	0	80
13856	0	0	0	85	0	85
13857	0	0	75	0	0	75
13858	77	0	0	0	0	77
13859	0	78	0	0	0	78
13860	78	0	0	0	0	78
13861	0	76	0	0	0	76
13862	78	0	0	0	0	78
13863	0	0	0	77	0	77
13864	0	0	0	76	0	76
13865	79	0	0	0	0	79
13866	79	0	0	0	0	79
13867	80	0	0	1	0	81
13868	79	0	0	0	0	79
13869	0	0	77	0	0	77
13870	82	0	0	0	0	82
13871	82	0	0	0	0	82
13872	75	0	0	0	0	75
13873	0	0	0	79	0	79
13874	78	0	0	0	0	78
13875	0	75	0	0	0	75
13876	0	0	0	76	0	76
13877	1	0	0	77	0	78
13878	0	0	73	0	0	73
13879	0	0	0	68	0	68
13880	0	69	0	1	0	70
13881	70	0	0	0	0	70
13882	0	66	0	0	0	66
13883	71	0	0	1	0	72
13884	0	0	0	72	0	72
13885	70	0	0	0	0	70
13886	0	70	0	0	0	70
13887	71	0	0	0	0	71
13888	69	0	0	0	0	69
13889	0	0	0	70	0	70
13890	0	0	0	67	0	67
13891	0	0	69	0	0	69
13892	0	0	0	68	0	68
13893	0	0	0	68	0	68
13894	1	0	68	0	0	69
13895	0	0	0	69	0	69
13896	1	0	63	0	0	64
13897	69	0	0	0	0	69
13898	0	0	0	68	0	68
13899	0	0	66	0	0	66
13900	69	0	0	0	0	69
13901	0	0	0	66	0	66
13902	0	0	65	0	0	65
13903	69	0	0	0	0	69
13904	0	0	0	71	0	71
13905	0	0	0	68	0	68
13906	72	0	0	0	0	72
13907	0	0	0	73	0	73
13908	2	0	0	67	0	69
13909	0	0	0	69	0	69
13910	0	70	0	0	0	70
13911	71	0	0	0	0	71
13912	73	0	0	0	0	73
13913	0	0	0	70	0	70
13914	73	0	0	0	0	73
13915	72	0	0	0	0	72
13916	70	0	0	0	0	70
13917	67	0	0	0	0	67
13918	71	0	0	0	0	71
13919	1	1	61	0	0	63
13920	2	0	53	0	0	55
13921	64	0	0	0	0	64
13922	0	66	0	0	0	66
13923	0	0	0	69	0	69
13924	0	0	68	0	0	68
13925	0	0	66	0	0	66
13926	0	0	0	67	0	67
13927	71	0	0	0	0	71
13928	0	0	0	66	0	66
13929	0	0	64	0	0	64
13930	67	0	0	0	0	67
13931	0	0	0	64	0	64
13932	0	0	0	67	0	67
13933	0	0	0	69	0	69
13934	0	0	0	65	0	65
13935	0	0	65	0	0	65
13936	0	0	0	64	0	64
13937	67	0	0	0	0	67
13938	0	0	60	0	0	60
13939	62	0	0	0	0	62
13940	61	0	0	0	0	61
13941	61	0	0	0	0	61
13942	59	0	0	0	0	59
13943	0	59	0	0	0	59
13944	0	52	0	0	0	52
13945	0	58	0	0	0	58
13946	59	0	0	0	0	59
13947	0	0	55	0	0	55
13948	60	0	0	0	0	60
13949	0	0	0	55	0	55
13950	59	0	0	0	0	59
13951	0	0	0	58	0	58
13952	59	0	0	0	0	59
13953	1	0	0	59	0	60
13954	0	0	0	59	0	59
13955	57	0	0	0	0	57
13956	0	62	0	0	0	62
13957	0	0	66	0	0	66
13958	0	63	0	0	0	63
13959	0	0	64	0	0	64
13960	0	0	0	64	0	64
13961	68	0	0	0	0	68
13962	0	0	0	69	0	69
13963	61	0	0	0	0	61
13964	0	63	0	0	0	63
13965	0	0	67	0	0	67
13966	0	65	0	0	0	65
13967	0	70	0	0	0	70
13968	70	0	0	0	0	70
13969	69	0	0	0	0	69
13970	0	73	0	0	0	73
13971	1	0	0	70	0	71
13972	0	0	0	76	0	76
13973	80	0	0	0	0	80
13974	0	0	77	1	0	78
13975	0	0	77	1	0	78
13976	0	0	0	83	0	83
13977	0	0	82	0	0	82
13978	81	0	0	0	0	81
13979	77	1	0	0	0	78
13980	0	79	0	0	0	79
13981	0	0	78	0	0	78
13982	0	0	0	77	0	77
13983	0	0	84	0	0	84
13984	0	0	0	85	0	85
13985	84	0	0	0	0	84
13986	0	83	0	0	0	83
13987	1	0	89	0	0	90
13988	0	87	0	0	0	87
13989	0	94	0	0	0	94
13990	93	0	0	0	0	93
13991	92	0	0	0	0	92
13992	0	0	87	0	0	87
13993	0	82	0	0	0	82
13994	0	0	0	89	0	89
13995	0	0	0	93	0	93
13996	0	0	0	91	0	91
13997	0	0	91	0	0	91
13998	1	0	0	81	0	82
13999	0	0	1	89	0	90
14000	88	0	0	0	0	88
14001	90	0	0	0	0	90
14002	94	0	0	1	0	95
14003	98	0	0	0	0	98
14004	92	1	0	0	0	93
14005	0	96	0	0	0	96
14006	98	0	0	0	0	98
14007	0	0	93	0	0	93
14008	0	0	0	98	0	98
14009	95	0	0	0	0	95
14010	0	99	0	0	0	99
14011	100	0	0	0	0	100
14012	101	0	0	0	0	101
14013	0	0	0	101	0	101
14014	0	0	0	99	0	99
14015	0	97	0	0	0	97
14016	0	0	0	104	0	104
14017	0	0	104	0	0	104
14018	0	0	0	107	0	107
14019	0	0	103	0	0	103
14020	109	0	0	0	0	109
14021	0	0	0	109	0	109
14022	0	0	109	0	0	109
14023	0	103	0	0	0	103
14024	0	103	0	0	0	103
14025	111	0	0	0	0	111
14026	0	0	0	113	0	113
14027	0	0	108	0	0	108
14028	0	103	0	0	0	103
14029	0	0	107	0	0	107
14030	105	0	0	0	0	105
14031	106	1	0	0	0	107
14032	108	0	0	0	0	108
14033	0	0	0	103	0	103
14034	0	0	105	0	0	105
14035	0	107	0	0	0	107
14036	0	0	0	110	0	110
14037	0	0	107	0	0	107
14038	0	0	110	1	0	111
14039	0	0	0	112	0	112
14040	111	0	0	0	0	111
14041	0	0	0	112	0	112
14042	0	0	0	114	0	114
14043	0	0	113	0	0	113
14044	0	0	0	110	0	110
14045	0	0	0	113	0	113
14046	0	0	114	1	0	115
14047	0	0	112	0	0	112
14048	0	1	0	115	0	116
14049	0	0	113	0	0	113
14050	0	0	0	111	0	111
14051	114	0	0	0	0	114
14052	0	116	0	0	0	116
14053	0	0	0	117	0	117
14054	0	0	111	0	0	111
14055	109	0	0	0	0	109
14056	0	115	0	0	0	115
14057	111	0	0	0	0	111
14058	0	0	0	108	0	108
14059	0	0	0	109	0	109
14060	110	0	1	0	0	111
14061	0	0	110	0	0	110
14062	112	0	0	0	0	112
14063	0	0	0	110	0	110
14064	114	0	0	0	0	114
14065	109	0	0	0	0	109
14066	0	0	0	107	0	107
14067	0	108	0	0	0	108
14068	110	0	0	0	0	110
14069	105	0	0	0	0	105
14070	0	0	104	0	0	104
14071	105	0	0	1	0	106
14072	0	0	0	104	0	104
14073	0	103	0	0	0	103
14074	0	0	0	103	0	103
14075	0	104	0	0	0	104
14076	106	0	0	0	0	106
14077	103	0	0	0	0	103
14078	0	0	0	109	0	109
14079	0	0	110	0	0	110
14080	0	0	95	0	0	95
14081	2	0	0	96	0	98
14082	104	0	0	0	0	104
14083	100	0	0	0	0	100
14084	0	100	0	0	0	100
14085	0	0	0	105	0	105
14086	0	0	96	0	0	96
14087	0	0	91	0	0	91
14088	0	0	0	98	0	98
14089	103	0	0	0	0	103
14090	0	0	0	103	0	103
14091	0	0	101	0	0	101
14092	103	0	0	0	0	103
14093	0	0	0	99	0	99
14094	0	0	0	90	0	90
14095	0	0	0	97	0	97
14096	0	89	0	0	0	89
14097	0	0	88	1	0	89
14098	0	0	88	0	0	88
14099	0	0	0	93	0	93
14100	0	0	93	0	0	93
14101	96	0	0	0	0	96
14102	0	0	0	92	0	92
14103	0	0	0	91	0	91
14104	0	0	0	93	0	93
14105	0	90	0	0	0	90
14106	93	0	0	0	0	93
14107	0	0	0	91	0	91
14108	90	0	0	0	0	90
14109	0	91	1	0	0	92
14110	88	0	0	0	0	88
14111	86	0	0	0	0	86
14112	84	0	0	0	0	84
14113	0	79	0	0	0	79
14114	0	82	0	0	0	82
14115	81	0	0	0	0	81
14116	0	85	0	0	0	85
14117	0	0	87	0	0	87
14118	1	77	1	1	0	80
14119	0	84	0	0	0	84
14120	81	0	0	0	0	81
14121	0	1	79	0	0	80
14122	0	0	79	0	0	79
14123	0	0	0	78	0	78
14124	76	0	0	0	0	76
14125	0	0	79	0	0	79
14126	0	0	0	78	0	78
14127	0	0	71	0	0	71
14128	1	0	74	0	0	75
14129	76	0	0	0	0	76
14130	0	0	72	0	0	72
14131	0	0	0	70	0	70
14132	0	0	0	75	0	75
14133	1	66	0	0	0	67
14134	0	70	0	1	0	71
14135	0	0	0	73	0	73
14136	0	0	73	0	0	73
14137	1	0	0	69	0	70
14138	0	0	0	73	0	73
14139	0	0	68	0	0	68
14140	0	0	0	72	0	72
14141	69	0	0	0	0	69
14142	0	0	70	0	0	70
14143	72	0	0	0	0	72
14144	0	0	0	68	0	68
14145	0	0	0	69	0	69
14146	0	69	0	0	0	69
14147	1	0	0	72	0	73
14148	0	0	0	68	0	68
14149	71	0	0	0	0	71
14150	0	0	0	73	0	73
14151	0	0	0	72	0	72
14152	71	0	0	1	0	72
14153	0	0	0	73	0	73
14154	0	0	0	70	0	70
14155	0	70	0	0	0	70
14156	71	0	0	1	0	72
14157	0	0	0	71	0	71
14158	1	0	0	69	0	70
14159	0	0	69	0	0	69
14160	0	0	0	75	0	75
14161	0	0	0	79	0	79
14162	78	0	0	0	0	78
14163	76	1	0	0	0	77
14164	0	0	0	79	0	79
14165	0	0	70	0	0	70
14166	0	68	0	0	0	68
14167	0	76	0	0	0	76
14168	0	0	0	76	0	76
14169	74	0	0	0	0	74
14170	0	0	0	71	0	71
14171	71	0	0	0	0	71
14172	0	0	0	68	0	68
14173	0	0	0	67	0	67
14174	70	0	0	1	0	71
14175	70	0	0	0	0	70
14176	0	67	0	0	0	67
14177	0	70	0	0	0	70
14178	0	0	0	68	0	68
14179	0	0	0	71	0	71
14180	0	0	69	0	0	69
14181	67	0	0	0	0	67
14182	0	62	0	0	0	62
14183	0	66	0	0	0	66
14184	67	0	0	0	0	67
14185	0	0	65	0	0	65
14186	0	0	66	0	0	66
14187	0	0	56	1	0	57
14188	0	67	0	0	0	67
14189	0	0	0	68	0	68
14190	0	0	0	67	0	67
14191	0	0	0	62	0	62
14192	64	0	0	0	0	64
14193	61	0	0	0	0	61
14194	0	57	0	0	0	57
14195	0	0	0	63	0	63
14196	0	0	62	0	0	62
14197	0	65	0	0	0	65
14198	65	0	0	1	0	66
14199	0	0	66	0	0	66
14200	65	0	0	0	0	65
14201	0	0	68	0	0	68
14202	0	0	0	67	0	67
14203	2	67	0	0	0	69
14204	65	0	0	0	0	65
14205	0	70	0	0	0	70
14206	64	0	0	2	0	66
14207	0	0	0	69	0	69
14208	0	0	71	0	0	71
14209	0	0	0	74	0	74
14210	0	0	0	74	0	74
14211	0	0	72	0	0	72
14212	75	0	0	0	0	75
14213	0	77	0	0	0	77
14214	79	0	0	0	0	79
14215	0	77	0	0	0	77
14216	0	0	0	83	0	83
14217	0	0	83	0	0	83
14218	80	0	0	0	0	80
14219	0	82	0	0	0	82
14220	0	0	0	81	0	81
14221	0	0	0	83	0	83
14222	84	0	0	0	0	84
14223	83	0	0	0	0	83
14224	0	82	0	0	0	82
14225	87	0	0	0	0	87
14226	85	0	0	0	0	85
14227	84	0	0	0	0	84
14228	0	0	77	0	0	77
14229	0	73	0	0	0	73
14230	0	77	0	0	0	77
14231	0	0	0	81	0	81
14232	0	0	0	85	0	85
14233	81	0	0	0	0	81
14234	0	82	0	0	0	82
14235	82	0	0	0	0	82
14236	0	0	0	83	0	83
14237	0	0	0	82	0	82
14238	81	0	0	0	0	81
14239	80	0	0	0	0	80
14240	0	0	79	0	0	79
14241	0	0	0	79	0	79
14242	0	0	78	0	0	78
14243	0	0	73	0	0	73
14244	0	0	74	0	0	74
14245	78	0	0	0	0	78
14246	0	0	0	77	0	77
14247	0	0	0	78	0	78
14248	0	0	0	81	0	81
14249	0	0	84	0	0	84
14250	0	0	0	82	0	82
14251	0	0	0	83	0	83
14252	88	0	0	0	0	88
14253	87	0	0	0	0	87
14254	81	0	0	0	0	81
14255	82	0	0	0	0	82
14256	0	0	0	81	0	81
14257	80	0	0	0	0	80
14258	0	0	0	80	0	80
14259	0	0	67	0	0	67
14260	75	0	0	0	0	75
14261	0	76	0	0	0	76
14262	0	0	0	78	0	78
14263	0	0	0	78	0	78
14264	0	79	0	0	0	79
14265	76	0	0	1	0	77
14266	0	67	0	0	0	67
14267	0	0	76	0	0	76
14268	0	0	75	1	0	76
14269	80	0	0	0	0	80
14270	78	0	0	0	0	78
14271	0	0	77	0	0	77
14272	78	0	0	0	0	78
14273	0	0	76	0	0	76
14274	78	0	0	0	0	78
14275	0	0	74	0	0	74
14276	0	0	77	0	0	77
14277	1	0	0	77	0	78
14278	1	0	0	79	0	80
14279	86	0	0	0	0	86
14280	82	0	0	0	0	82
14281	88	0	0	0	0	88
14282	88	0	0	0	0	88
14283	0	87	0	0	0	87
14284	0	0	0	92	0	92
14285	0	84	1	0	0	85
14286	0	0	0	96	0	96
14287	0	0	0	89	0	89
14288	0	0	0	92	0	92
14289	0	0	88	0	0	88
14290	85	0	0	0	0	85
14291	0	74	1	0	0	75
14292	0	79	0	0	0	79
14293	0	0	83	0	0	83
14294	0	0	0	85	0	85
14295	0	0	0	85	0	85
14296	84	0	0	0	0	84
14297	0	0	0	86	0	86
14298	0	0	0	88	0	88
14299	0	0	0	91	0	91
14300	0	0	0	92	0	92
14301	92	0	0	0	0	92
14302	90	0	0	0	0	90
14303	86	0	0	0	0	86
14304	0	0	0	86	0	86
14305	78	0	0	0	0	78
14306	0	0	0	83	0	83
14307	0	0	0	78	0	78
14308	0	0	75	0	0	75
14309	1	0	68	0	0	69
14310	0	0	73	0	0	73
14311	75	0	0	0	0	75
14312	0	0	0	72	0	72
14313	0	76	0	0	0	76
14314	75	0	0	0	0	75
14315	0	0	71	0	0	71
14316	69	0	0	0	0	69
14317	0	66	0	0	0	66
14318	69	0	0	0	0	69
14319	0	0	0	68	0	68
14320	70	0	0	0	0	70
14321	0	68	0	0	0	68
14322	0	66	0	0	0	66
14323	67	0	0	0	0	67
14324	0	59	0	0	0	59
14325	0	58	0	0	0	58
14326	0	66	0	0	0	66
14327	69	0	0	0	0	69
14328	68	0	0	1	0	69
14329	65	0	0	0	0	65
14330	0	0	0	68	0	68
14331	0	0	0	69	0	69
14332	0	0	65	0	0	65
14333	0	0	0	66	0	66
14334	0	0	69	0	0	69
14335	0	0	0	71	0	71
14336	0	0	0	70	0	70
14337	71	0	0	0	0	71
14338	72	0	0	0	0	72
14339	0	69	0	0	0	69
14340	0	0	0	73	0	73
14341	0	0	66	0	0	66
14342	0	0	0	67	0	67
14343	0	0	0	63	0	63
14344	0	0	0	65	0	65
14345	0	0	63	0	0	63
14346	0	0	59	0	0	59
14347	63	0	0	0	0	63
14348	0	0	0	63	0	63
14349	0	0	63	0	0	63
14350	64	0	0	0	0	64
14351	0	61	0	0	0	61
14352	63	0	0	0	0	63
14353	0	0	62	0	0	62
14354	62	0	0	0	0	62
14355	0	0	0	60	0	60
14356	0	0	56	0	0	56
14357	0	56	0	0	0	56
14358	58	0	0	0	0	58
14359	0	0	0	59	0	59
14360	0	0	0	58	0	58
14361	0	59	0	0	0	59
14362	0	0	0	57	0	57
14363	0	0	54	0	0	54
14364	0	56	0	0	0	56
14365	57	0	0	0	0	57
14366	0	0	0	60	0	60
14367	0	0	0	63	0	63
14368	0	0	61	0	0	61
14369	0	0	0	60	0	60
14370	0	0	58	0	0	58
14371	0	56	0	0	0	56
14372	57	0	0	0	0	57
14373	57	0	0	0	0	57
14374	54	0	0	0	0	54
14375	0	50	0	0	0	50
14376	1	0	0	50	0	51
14377	0	0	0	49	0	49
14378	0	0	0	49	0	49
14379	49	0	0	0	0	49
14380	44	0	0	0	0	44
14381	0	0	0	46	0	46
14382	0	0	46	0	0	46
14383	0	0	0	46	0	46
14384	0	0	0	45	0	45
14385	0	0	0	49	0	49
14386	0	0	0	44	0	44
14387	44	0	0	0	0	44
14388	0	0	0	46	0	46
14389	0	0	0	47	0	47
14390	0	43	0	0	0	43
14391	0	0	0	46	0	46
14392	0	44	0	0	0	44
14393	0	0	0	46	0	46
14394	43	0	0	0	0	43
14395	0	42	0	0	0	42
14396	42	0	0	0	0	42
14397	0	0	43	0	0	43
14398	0	0	0	42	0	42
14399	0	0	42	0	0	42
14400	0	0	0	43	0	43
14401	0	0	0	41	0	41
14402	0	36	0	0	0	36
14403	1	36	0	0	0	37
14404	0	40	0	0	0	40
14405	40	0	0	0	0	40
14406	0	41	0	0	0	41
14407	0	39	0	0	0	39
14408	0	1	0	40	0	41
14409	41	0	0	0	0	41
14410	0	40	0	0	0	40
14411	47	0	0	0	0	47
14412	46	0	0	0	0	46
14413	0	0	43	0	0	43
14414	0	0	0	48	0	48
14415	0	0	0	52	0	52
14416	0	0	0	47	0	47
14417	0	0	0	53	0	53
14418	0	0	46	0	0	46
14419	1	0	38	0	0	39
14420	49	0	0	0	0	49
14421	0	52	0	1	0	53
14422	0	49	0	0	0	49
14423	51	0	0	0	0	51
14424	0	51	0	0	0	51
14425	0	0	0	53	0	53
14426	54	0	0	0	0	54
14427	0	0	49	0	0	49
14428	0	0	0	50	0	50
14429	0	1	50	0	0	51
14430	53	0	0	0	0	53
14431	0	0	50	0	0	50
14432	53	0	0	0	0	53
14433	52	0	0	0	0	52
14434	54	0	0	0	0	54
14435	55	0	0	0	0	55
14436	55	0	0	0	0	55
14437	0	0	0	55	0	55
14438	51	0	0	0	0	51
14439	0	0	0	56	0	56
14440	0	0	0	57	0	57
14441	0	0	0	56	0	56
14442	0	0	52	1	0	53
14443	0	0	0	52	0	52
14444	0	0	0	52	0	52
14445	0	0	53	0	0	53
14446	53	0	0	0	0	53
14447	0	0	0	54	0	54
14448	0	0	56	0	0	56
14449	0	0	52	0	0	52
14450	0	0	0	57	0	57
14451	0	0	56	0	0	56
14452	0	0	0	59	0	59
14453	0	0	0	60	0	60
14454	0	57	0	1	0	58
14455	0	59	0	0	0	59
14456	59	0	0	0	0	59
14457	0	0	0	59	0	59
14458	0	0	0	58	0	58
14459	0	0	0	60	0	60
14460	0	0	58	0	0	58
14461	0	0	0	59	0	59
14462	60	0	0	0	0	60
14463	0	0	57	0	0	57
14464	0	0	0	62	0	62
14465	0	0	0	60	0	60
14466	1	0	0	60	0	61
14467	0	62	0	0	0	62
14468	59	0	1	0	0	60
14469	58	0	0	0	0	58
14470	0	63	0	0	0	63
14471	0	0	0	66	0	66
14472	2	0	60	0	0	62
14473	1	0	57	0	0	58
14474	62	0	0	1	0	63
14475	0	0	0	61	0	61
14476	64	0	0	0	0	64
14477	0	65	0	0	0	65
14478	0	63	0	0	0	63
14479	62	0	0	0	0	62
14480	0	63	0	0	0	63
14481	0	0	0	62	0	62
14482	0	0	0	67	0	67
14483	0	63	0	0	0	63
14484	66	0	0	0	0	66
14485	0	0	64	0	0	64
14486	66	0	0	0	0	66
14487	0	0	65	0	0	65
14488	65	0	0	0	0	65
14489	0	0	64	0	0	64
14490	0	62	0	0	0	62
14491	0	0	0	62	0	62
14492	65	0	0	0	0	65
14493	0	0	62	0	0	62
14494	0	0	56	2	0	58
14495	0	0	0	63	0	63
14496	0	0	63	0	0	63
14497	0	0	0	66	0	66
14498	0	0	0	64	0	64
14499	0	0	63	0	0	63
14500	0	0	0	65	0	65
14501	64	0	0	0	0	64
14502	0	64	0	0	0	64
14503	63	0	0	0	0	63
14504	0	0	0	62	0	62
14505	63	0	0	0	0	63
14506	58	0	0	0	0	58
14507	0	0	0	59	0	59
14508	0	57	0	0	0	57
14509	60	0	0	0	0	60
14510	0	0	58	0	0	58
14511	0	0	58	0	0	58
14512	57	0	0	0	0	57
14513	0	0	0	62	0	62
14514	0	0	60	0	0	60
14515	0	0	0	68	0	68
14516	70	0	0	0	0	70
14517	69	0	0	0	0	69
14518	65	0	0	0	0	65
14519	0	66	0	0	0	66
14520	0	0	0	66	0	66
14521	0	0	0	67	0	67
14522	66	0	0	0	0	66
14523	0	63	0	0	0	63
14524	69	0	0	0	0	69
14525	0	0	0	69	0	69
14526	69	0	0	0	0	69
14527	0	0	58	0	0	58
14528	0	62	0	0	0	62
14529	0	0	0	68	0	68
14530	0	66	0	0	0	66
14531	0	0	0	69	0	69
14532	74	0	0	0	0	74
14533	0	0	71	0	0	71
14534	72	0	0	0	0	72
14535	0	75	0	0	0	75
14536	0	0	0	75	0	75
14537	0	0	0	73	0	73
14538	78	0	0	0	0	78
14539	0	0	72	0	0	72
14540	0	0	0	72	0	72
14541	0	0	0	74	0	74
14542	0	0	0	74	0	74
14543	0	0	0	74	0	74
14544	69	0	0	0	0	69
14545	69	0	0	0	0	69
14546	0	0	63	0	0	63
14547	0	0	57	0	0	57
14548	63	0	0	0	0	63
14549	63	0	0	0	0	63
14550	0	0	0	65	0	65
14551	0	0	0	61	0	61
14552	64	0	0	0	0	64
14553	0	69	0	0	0	69
14554	0	0	0	69	0	69
14555	0	0	0	70	0	70
14556	0	0	68	0	0	68
14557	0	0	0	66	0	66
14558	0	0	67	0	0	67
14559	0	0	0	72	0	72
14560	68	0	0	0	0	68
14561	0	0	0	71	0	71
14562	0	0	63	0	0	63
14563	0	62	0	0	0	62
14564	0	0	0	65	0	65
14565	0	0	66	0	0	66
14566	0	64	0	0	0	64
14567	0	0	0	69	0	69
14568	0	0	69	0	0	69
14569	64	0	0	0	0	64
14570	0	68	0	0	0	68
14571	0	70	0	0	0	70
14572	0	73	0	0	0	73
14573	0	0	0	75	0	75
14574	0	0	77	0	0	77
14575	0	73	0	0	0	73
14576	0	0	0	78	0	78
14577	74	0	0	0	0	74
14578	0	0	0	73	0	73
14579	0	0	72	0	0	72
14580	0	74	0	0	0	74
14581	74	0	0	0	0	74
14582	0	75	0	0	0	75
14583	0	0	78	0	0	78
14584	0	82	0	0	0	82
14585	0	0	0	86	0	86
14586	0	0	86	0	0	86
14587	0	87	0	0	0	87
14588	0	0	0	92	0	92
14589	0	0	0	90	0	90
14590	0	95	0	0	0	95
14591	0	0	0	97	0	97
14592	0	0	94	0	0	94
14593	0	0	95	0	0	95
14594	0	0	0	97	0	97
14595	96	0	0	0	0	96
14596	92	0	0	0	0	92
14597	0	0	0	92	0	92
14598	0	90	0	0	0	90
14599	2	0	0	92	0	94
14600	91	0	2	0	0	93
14601	0	0	0	94	0	94
14602	0	0	0	93	0	93
14603	94	0	0	0	0	94
14604	0	92	0	0	0	92
14605	0	0	0	90	0	90
14606	87	0	0	0	0	87
14607	0	0	85	0	0	85
14608	84	0	0	0	0	84
14609	0	0	0	84	0	84
14610	83	0	0	0	0	83
14611	85	0	0	0	0	85
14612	81	0	0	0	0	81
14613	0	82	0	0	0	82
14614	0	0	84	0	0	84
14615	0	89	0	1	0	90
14616	88	0	0	0	0	88
14617	0	89	0	0	0	89
14618	0	0	0	89	0	89
14619	89	0	0	0	0	89
14620	0	91	0	0	0	91
14621	0	0	87	0	0	87
14622	0	0	0	88	0	88
14623	0	0	87	0	0	87
14624	0	85	0	0	0	85
14625	0	0	0	83	0	83
14626	0	0	0	84	0	84
14627	0	0	0	81	0	81
14628	0	0	0	85	0	85
14629	0	82	0	0	0	82
14630	84	0	0	0	0	84
14631	0	0	82	0	0	82
14632	0	0	0	83	0	83
14633	80	0	0	0	0	80
14634	0	0	79	0	0	79
14635	0	81	0	0	0	81
14636	0	0	0	83	0	83
14637	0	0	76	1	0	77
14638	0	82	0	0	0	82
14639	80	0	0	0	0	80
14640	0	83	0	0	0	83
14641	0	1	0	83	0	84
14642	0	0	0	83	0	83
14643	81	0	0	0	0	81
14644	0	78	0	1	0	79
14645	0	0	0	84	0	84
14646	83	0	0	0	0	83
14647	81	0	0	1	0	82
14648	0	82	0	0	0	82
14649	83	0	0	0	0	83
14650	77	0	0	0	0	77
14651	0	0	0	81	0	81
14652	0	0	76	0	0	76
14653	0	0	0	79	0	79
14654	0	0	0	80	0	80
14655	0	0	73	0	0	73
14656	0	78	0	0	0	78
14657	0	0	0	81	0	81
14658	0	0	0	82	0	82
14659	0	0	0	78	0	78
14660	0	0	0	79	0	79
14661	0	82	0	0	0	82
14662	79	0	0	0	0	79
14663	72	0	0	0	0	72
14664	76	0	0	0	0	76
14665	0	67	0	0	0	67
14666	0	0	0	72	0	72
14667	0	0	70	0	0	70
14668	0	0	0	71	0	71
14669	0	70	0	0	0	70
14670	73	0	0	0	0	73
14671	73	0	0	0	0	73
14672	70	0	0	0	0	70
14673	0	70	0	0	0	70
14674	0	60	0	0	0	60
14675	0	69	0	0	0	69
14676	0	0	61	1	0	62
14677	0	0	58	0	0	58
14678	0	0	0	66	0	66
14679	64	0	0	0	0	64
14680	64	0	0	0	0	64
14681	0	1	0	58	0	59
14682	0	0	0	61	0	61
14683	0	0	0	56	0	56
14684	0	0	0	54	0	54
14685	57	0	0	0	0	57
14686	56	0	0	0	0	56
14687	0	58	0	0	0	58
14688	61	0	0	0	0	61
14689	62	0	0	0	0	62
14690	64	0	0	0	0	64
14691	0	0	54	0	0	54
14692	69	0	0	0	0	69
14693	0	70	0	0	0	70
14694	1	0	0	72	0	73
14695	0	0	0	73	0	73
14696	0	67	0	0	0	67
14697	0	0	0	73	0	73
14698	72	0	0	0	0	72
14699	0	0	0	73	0	73
14700	0	0	67	0	0	67
14701	71	0	0	1	0	72
14702	0	74	0	0	0	74
14703	0	0	0	75	0	75
14704	0	0	0	74	0	74
14705	0	0	0	74	0	74
14706	0	0	66	1	0	67
14707	0	61	0	0	0	61
14708	1	0	0	69	0	70
14709	0	0	65	0	0	65
14710	0	0	0	63	0	63
14711	0	0	63	1	0	64
14712	0	0	0	60	0	60
14713	0	60	1	0	0	61
14714	0	0	0	66	0	66
14715	62	0	0	0	0	62
14716	65	0	0	0	0	65
14717	0	0	62	0	0	62
14718	0	0	56	1	0	57
14719	0	0	69	0	0	69
14720	0	0	0	75	0	75
14721	0	0	0	74	0	74
14722	0	0	0	79	0	79
14723	0	76	0	0	0	76
14724	0	0	0	84	0	84
14725	0	0	0	84	0	84
14726	0	0	0	83	0	83
14727	81	0	0	0	0	81
14728	80	0	0	0	0	80
14729	0	0	80	0	0	80
14730	1	1	75	0	0	77
14731	82	0	0	0	0	82
14732	82	0	0	0	0	82
14733	0	0	75	0	0	75
14734	0	0	77	0	0	77
14735	83	0	0	0	0	83
14736	85	0	0	0	0	85
14737	0	0	83	0	0	83
14738	0	0	0	83	0	83
14739	0	0	0	83	0	83
14740	0	79	0	0	0	79
14741	0	0	0	83	0	83
14742	0	0	83	0	0	83
14743	0	0	0	83	0	83
14744	0	0	0	88	0	88
14745	0	0	88	0	0	88
14746	89	0	0	0	0	89
14747	89	0	0	1	0	90
14748	0	0	0	91	0	91
14749	0	0	0	89	0	89
14750	89	0	0	0	0	89
14751	88	0	0	0	0	88
14752	89	0	0	0	0	89
14753	87	0	0	0	0	87
14754	0	91	0	0	0	91
14755	94	0	0	0	0	94
14756	0	92	0	0	0	92
14757	0	0	0	100	0	100
14758	0	0	0	97	0	97
14759	0	98	0	0	0	98
14760	0	0	0	99	0	99
14761	0	0	0	100	0	100
14762	0	103	0	0	0	103
14763	0	0	0	104	0	104
14764	0	0	0	99	0	99
14765	0	0	0	100	0	100
14766	0	0	96	0	0	96
14767	0	94	0	0	0	94
14768	0	0	0	92	0	92
14769	0	94	0	0	0	94
14770	94	0	0	0	0	94
14771	0	0	93	0	0	93
14772	0	0	87	0	0	87
14773	92	0	0	0	0	92
14774	0	0	0	94	0	94
14775	0	0	96	0	0	96
14776	0	0	96	0	0	96
14777	0	0	0	98	0	98
14778	99	0	0	0	0	99
14779	100	0	0	0	0	100
14780	0	0	0	93	0	93
14781	0	0	95	0	0	95
14782	0	95	0	0	0	95
14783	0	0	0	98	0	98
14784	0	0	96	0	0	96
14785	0	91	0	0	0	91
14786	0	0	0	91	0	91
14787	93	0	0	0	0	93
14788	0	0	0	93	0	93
14789	0	91	0	0	0	91
14790	93	0	0	0	0	93
14791	0	0	96	0	0	96
14792	0	93	0	0	0	93
14793	0	0	93	0	0	93
14794	97	0	0	0	0	97
14795	0	0	0	97	0	97
14796	1	0	0	95	0	96
14797	100	0	0	0	0	100
14798	0	0	0	101	0	101
14799	0	0	96	0	0	96
14800	100	0	0	1	0	101
14801	0	99	0	0	0	99
14802	0	0	0	102	0	102
14803	100	0	0	0	0	100
14804	0	104	0	0	0	104
14805	0	1	1	102	0	104
14806	105	0	0	0	0	105
14807	0	0	0	101	0	101
14808	3	94	0	0	0	97
14809	0	0	97	0	0	97
14810	0	0	1	98	0	99
14811	0	0	0	96	0	96
14812	94	0	0	0	0	94
14813	0	3	0	92	0	95
14814	94	0	0	0	0	94
14815	101	0	0	0	0	101
14816	0	0	0	92	0	92
14817	0	93	0	0	0	93
14818	0	0	0	95	0	95
14819	94	0	0	0	0	94
14820	0	91	0	1	0	92
14821	0	95	0	0	0	95
14822	101	0	0	0	0	101
14823	100	0	0	0	0	100
14824	0	96	0	0	0	96
14825	99	0	0	0	0	99
14826	100	0	0	0	0	100
14827	0	0	0	100	0	100
14828	0	0	98	0	0	98
14829	0	0	0	103	0	103
14830	0	0	99	0	0	99
14831	0	0	0	100	0	100
14832	0	0	102	0	0	102
14833	105	0	0	0	0	105
14834	1	0	0	101	0	102
14835	103	0	0	0	0	103
14836	0	0	0	101	0	101
14837	0	100	0	0	0	100
14838	101	0	0	0	0	101
14839	0	0	94	0	0	94
14840	94	0	0	0	0	94
14841	0	95	0	0	0	95
14842	97	0	0	0	0	97
14843	96	0	0	0	0	96
14844	0	95	0	0	0	95
14845	0	0	0	97	0	97
14846	97	0	0	0	0	97
14847	0	95	0	0	0	95
14848	0	0	0	99	0	99
14849	96	0	0	0	0	96
14850	0	1	0	94	0	95
14851	0	0	0	91	0	91
14852	0	0	0	90	0	90
14853	0	0	88	0	0	88
14854	1	0	0	85	0	86
14855	88	0	0	0	0	88
14856	0	0	87	0	0	87
14857	0	0	0	90	0	90
14858	0	0	0	95	0	95
14859	0	0	92	0	0	92
14860	92	0	0	0	0	92
14861	96	0	0	0	0	96
14862	0	0	92	0	0	92
14863	0	0	0	95	0	95
14864	0	0	0	98	0	98
14865	0	0	92	0	0	92
14866	1	0	0	92	0	93
14867	0	0	0	99	0	99
14868	0	0	98	0	0	98
14869	100	0	0	0	0	100
14870	0	0	0	102	0	102
14871	107	0	0	0	0	107
14872	107	0	0	0	0	107
14873	0	0	102	0	0	102
14874	0	0	0	103	0	103
14875	103	0	0	0	0	103
14876	0	99	0	0	0	99
14877	0	0	1	98	0	99
14878	1	0	0	96	0	97
14879	0	0	0	99	0	99
14880	1	0	96	0	0	97
14881	96	0	1	0	0	97
14882	0	0	0	97	0	97
14883	1	0	0	98	0	99
14884	0	0	99	0	0	99
14885	0	0	0	97	0	97
14886	0	0	0	103	0	103
14887	101	0	0	0	0	101
14888	0	99	0	0	0	99
14889	0	1	95	0	0	96
14890	97	0	0	0	0	97
14891	0	0	0	96	0	96
14892	0	0	98	0	0	98
14893	0	0	90	0	0	90
14894	0	0	0	92	0	92
14895	0	0	93	0	0	93
14896	0	0	95	0	0	95
14897	0	88	0	0	0	88
14898	0	0	0	95	0	95
14899	0	0	95	0	0	95
14900	0	0	1	91	0	92
14901	96	0	0	0	0	96
14902	0	0	0	98	0	98
14903	0	0	0	95	0	95
14904	97	1	0	0	0	98
14905	98	0	0	0	0	98
14906	0	0	0	98	0	98
14907	0	0	99	0	0	99
14908	0	98	0	0	0	98
14909	0	0	0	96	0	96
14910	96	0	0	0	0	96
14911	100	0	0	0	0	100
14912	0	98	0	0	0	98
14913	0	99	0	0	0	99
14914	96	0	0	0	0	96
14915	96	0	0	0	0	96
14916	0	0	91	0	0	91
14917	0	0	0	98	0	98
14918	0	95	0	0	0	95
14919	100	0	0	0	0	100
14920	0	0	0	101	0	101
14921	0	95	0	0	0	95
14922	0	0	97	0	0	97
14923	0	0	0	98	0	98
14924	0	95	0	0	0	95
14925	93	0	0	0	0	93
14926	94	0	0	0	0	94
14927	0	98	0	0	0	98
14928	96	0	0	0	0	96
14929	91	0	0	1	0	92
14930	0	93	0	0	0	93
14931	0	89	0	1	0	90
14932	0	0	0	95	0	95
14933	97	0	0	0	0	97
14934	0	0	95	0	0	95
14935	92	0	0	0	0	92
14936	0	93	0	1	0	94
14937	98	0	0	0	0	98
14938	97	0	0	1	0	98
14939	98	0	0	0	0	98
14940	0	0	0	95	0	95
14941	0	93	0	1	0	94
14942	96	0	0	0	0	96
14943	0	0	87	0	0	87
14944	0	91	0	0	0	91
14945	0	0	0	97	0	97
14946	0	0	91	1	0	92
14947	0	0	93	0	0	93
14948	0	0	0	92	0	92
14949	0	0	0	94	0	94
14950	0	0	0	94	0	94
14951	0	1	0	87	0	88
14952	0	86	0	0	0	86
14953	0	93	0	0	0	93
14954	96	0	0	0	0	96
14955	0	0	0	95	0	95
14956	0	0	0	94	0	94
14957	0	0	0	91	0	91
14958	95	0	0	0	0	95
14959	90	0	0	2	0	92
14960	0	0	0	90	0	90
14961	95	0	0	0	0	95
14962	92	0	0	0	0	92
14963	91	0	0	0	0	91
14964	1	0	0	91	0	92
14965	0	0	89	0	0	89
14966	0	0	82	0	0	82
14967	1	0	80	0	0	81
14968	0	0	92	1	0	93
14969	0	0	0	95	0	95
14970	94	0	0	0	0	94
14971	95	0	0	0	0	95
14972	1	0	91	0	0	92
14973	0	0	87	1	0	88
14974	0	87	0	0	0	87
14975	0	0	0	88	0	88
14976	95	0	0	0	0	95
14977	0	0	92	0	0	92
14978	89	0	0	0	0	89
14979	0	80	0	0	0	80
14980	0	0	0	82	0	82
14981	0	0	0	83	0	83
14982	0	0	0	83	0	83
14983	86	0	0	0	0	86
14984	0	0	0	88	0	88
14985	0	0	0	84	0	84
14986	90	0	0	0	0	90
14987	0	0	0	85	0	85
14988	0	0	84	0	0	84
14989	87	0	0	0	0	87
14990	0	0	0	84	0	84
14991	0	0	0	84	0	84
14992	0	83	0	0	0	83
14993	84	0	0	0	0	84
14994	81	0	0	0	0	81
14995	0	0	0	87	0	87
14996	0	0	86	0	0	86
14997	84	3	0	0	0	87
14998	0	0	88	0	0	88
14999	1	0	0	85	0	86
15000	3	0	0	84	0	87
15001	83	0	0	0	0	83
15002	0	0	0	88	0	88
15003	0	0	86	0	0	86
15004	86	0	0	0	0	86
15005	0	0	84	0	0	84
15006	1	0	78	0	0	79
15007	86	0	0	0	0	86
15008	0	0	0	84	0	84
15009	1	81	0	0	0	82
15010	85	0	0	0	0	85
15011	86	0	0	0	0	86
15012	0	0	86	0	0	86
15013	87	0	0	0	0	87
15014	0	0	0	84	0	84
15015	0	0	81	0	0	81
15016	0	80	0	0	0	80
15017	86	0	0	0	0	86
15018	0	85	0	0	0	85
15019	0	0	0	89	0	89
15020	0	0	0	90	0	90
15021	0	0	0	88	0	88
15022	0	0	0	89	0	89
15023	0	88	0	0	0	88
15024	0	0	89	0	0	89
15025	0	90	0	0	0	90
15026	89	0	0	0	0	89
15027	0	0	0	90	0	90
15028	89	0	0	0	0	89
15029	1	0	0	90	0	91
15030	94	0	0	0	0	94
15031	0	92	0	0	0	92
15032	95	0	0	0	0	95
15033	91	1	0	0	0	92
15034	94	0	0	0	0	94
15035	95	0	0	0	0	95
15036	0	92	0	0	0	92
15037	0	0	91	0	0	91
15038	0	0	0	94	0	94
15039	95	0	0	0	0	95
15040	94	0	0	0	0	94
15041	0	1	0	90	0	91
15042	0	0	87	1	0	88
15043	0	0	0	86	0	86
15044	0	90	0	0	0	90
15045	90	0	0	0	0	90
15046	0	0	0	90	0	90
15047	0	78	0	0	0	78
15048	0	88	0	0	0	88
15049	0	91	0	0	0	91
15050	0	0	0	92	0	92
15051	90	0	0	0	0	90
15052	0	92	0	0	0	92
15053	0	0	0	93	0	93
15054	92	0	1	0	0	93
15055	0	0	0	93	0	93
15056	91	0	0	0	0	91
15057	94	0	0	0	0	94
15058	0	92	0	0	0	92
15059	0	0	0	91	0	91
15060	0	93	0	0	0	93
15061	94	0	0	0	0	94
15062	93	0	0	0	0	93
15063	90	0	0	0	0	90
15064	0	0	0	92	0	92
15065	0	0	88	0	0	88
15066	89	0	0	0	0	89
15067	88	0	0	0	0	88
15068	0	0	0	88	0	88
15069	0	89	0	0	0	89
15070	0	0	0	94	0	94
15071	0	0	0	91	0	91
15072	92	0	0	0	0	92
15073	93	0	0	0	0	93
15074	0	0	86	0	0	86
15075	0	0	0	91	0	91
15076	92	0	0	0	0	92
15077	0	0	0	91	0	91
15078	0	0	91	0	0	91
15079	0	86	0	0	0	86
15080	0	88	0	0	0	88
15081	95	0	0	0	0	95
15082	0	0	0	94	0	94
15083	0	0	0	99	0	99
15084	104	0	0	0	0	104
15085	0	0	100	0	0	100
15086	0	0	0	103	0	103
15087	0	0	101	0	0	101
15088	0	103	0	0	0	103
15089	106	0	0	0	0	106
15090	105	0	0	0	0	105
15091	101	0	0	0	0	101
15092	0	0	102	0	0	102
15093	104	0	0	0	0	104
15094	105	0	0	0	0	105
15095	0	0	0	98	0	98
15096	99	0	0	0	0	99
15097	0	0	94	0	0	94
15098	100	0	0	0	0	100
15099	0	0	95	0	0	95
15100	0	102	0	0	0	102
15101	0	0	0	103	0	103
15102	0	98	0	0	0	98
15103	0	0	101	0	0	101
15104	1	101	0	0	0	102
15105	102	0	0	0	0	102
15106	0	97	0	0	0	97
15107	0	96	0	0	0	96
15108	0	0	94	0	0	94
15109	0	0	0	98	0	98
15110	99	0	0	0	0	99
15111	0	0	96	0	0	96
15112	0	98	0	0	0	98
15113	0	0	0	100	0	100
15114	0	0	98	0	0	98
15115	0	0	89	0	0	89
15116	0	0	0	94	0	94
15117	0	0	94	0	0	94
15118	0	0	0	95	0	95
15119	0	87	0	0	0	87
15120	0	0	0	97	0	97
15121	0	97	0	0	0	97
15122	0	0	0	96	0	96
15123	87	0	0	0	0	87
15124	0	0	0	90	0	90
15125	0	92	0	0	0	92
15126	0	0	0	95	0	95
15127	0	0	92	0	0	92
15128	0	0	0	93	0	93
15129	95	0	0	0	0	95
15130	0	0	93	0	0	93
15131	0	0	0	89	0	89
15132	94	0	0	0	0	94
15133	0	93	0	0	0	93
15134	0	0	0	91	0	91
15135	92	0	0	0	0	92
15136	0	0	0	94	0	94
15137	0	0	86	0	0	86
15138	90	0	0	0	0	90
15139	0	84	0	0	0	84
15140	0	91	0	0	0	91
15141	93	0	0	0	0	93
15142	91	0	0	0	0	91
15143	0	0	0	92	0	92
15144	94	0	0	0	0	94
15145	0	0	86	0	0	86
15146	88	0	0	0	0	88
15147	1	86	0	0	0	87
15148	86	0	0	0	0	86
15149	0	0	86	0	0	86
15150	0	0	0	81	0	81
15151	0	0	0	86	0	86
15152	0	0	0	82	0	82
15153	0	78	0	0	0	78
15154	82	0	0	0	0	82
15155	0	0	0	81	0	81
15156	0	82	0	0	0	82
15157	86	0	0	0	0	86
15158	89	0	0	0	0	89
15159	85	0	0	1	0	86
15160	87	0	0	0	0	87
15161	82	0	0	0	0	82
15162	0	0	0	75	0	75
15163	0	0	0	73	0	73
15164	79	0	0	0	0	79
15165	0	0	1	78	0	79
15166	0	0	0	85	0	85
15167	0	0	81	0	0	81
15168	85	0	0	0	0	85
15169	89	0	0	0	0	89
15170	84	0	0	0	0	84
15171	0	0	0	85	0	85
15172	0	87	0	0	0	87
15173	89	0	0	0	0	89
15174	90	0	0	0	0	90
15175	0	0	0	89	0	89
15176	79	0	0	0	0	79
15177	0	1	58	0	0	59
15178	0	77	0	0	0	77
15179	0	83	0	0	0	83
15180	0	0	80	0	0	80
15181	0	79	0	0	0	79
15182	0	86	0	0	0	86
15183	86	0	0	0	0	86
15184	0	83	0	0	0	83
15185	0	0	0	86	0	86
15186	82	0	0	0	0	82
15187	0	0	79	0	0	79
15188	82	0	0	0	0	82
15189	0	0	76	0	0	76
15190	1	0	72	0	0	73
15191	83	0	0	0	0	83
15192	0	0	79	0	0	79
15193	0	81	0	0	0	81
15194	0	0	0	81	0	81
15195	83	0	0	0	0	83
15196	0	77	0	0	0	77
15197	0	0	0	83	0	83
15198	0	0	84	0	0	84
15199	0	0	0	83	0	83
15200	85	0	0	0	0	85
15201	0	0	86	0	0	86
15202	0	0	0	86	0	86
15203	87	0	0	0	0	87
15204	86	0	0	0	0	86
15205	0	2	0	86	0	88
15206	0	0	0	87	0	87
15207	1	0	89	0	0	90
15208	0	0	85	4	0	89
15209	95	0	0	0	0	95
15210	93	0	0	1	0	94
15211	0	96	0	0	0	96
15212	93	0	0	4	0	97
15213	93	0	0	0	0	93
15214	0	0	98	0	0	98
15215	0	97	0	1	0	98
15216	103	0	0	0	0	103
15217	99	0	0	0	0	99
15218	97	0	0	0	0	97
15219	0	0	0	101	0	101
15220	0	0	0	101	0	101
15221	0	100	0	0	0	100
15222	0	0	0	101	0	101
15223	104	0	0	0	0	104
15224	0	0	0	105	0	105
15225	0	0	107	0	0	107
15226	0	0	101	0	0	101
15227	0	0	0	107	0	107
15228	0	0	103	0	0	103
15229	0	0	102	1	0	103
15230	1	0	0	103	0	104
15231	0	0	0	108	0	108
15232	0	1	103	0	0	104
15233	0	0	97	0	0	97
15234	0	105	1	0	0	106
15235	112	0	0	0	0	112
15236	0	106	0	0	0	106
15237	111	0	1	0	0	112
15238	109	0	0	0	0	109
15239	0	110	0	0	0	110
15240	113	0	0	0	0	113
15241	0	0	0	110	0	110
15242	0	0	108	0	0	108
15243	0	0	0	117	0	117
15244	0	0	0	122	0	122
15245	126	0	0	0	0	126
15246	127	0	0	0	0	127
15247	135	0	0	0	0	135
15248	137	1	0	0	0	138
15249	131	0	0	0	0	131
15250	0	126	0	0	0	126
15251	0	0	0	134	0	134
15252	0	0	133	0	0	133
15253	0	0	0	129	0	129
15254	0	0	0	133	0	133
15255	0	0	0	134	0	134
15256	129	0	0	0	0	129
15257	0	0	0	127	0	127
15258	132	0	0	0	0	132
15259	0	0	118	0	0	118
15260	0	0	0	127	0	127
15261	1	0	122	0	0	123
15262	126	1	0	0	0	127
15263	0	0	0	126	0	126
15264	0	0	127	0	0	127
15265	0	0	0	134	0	134
15266	133	0	0	1	0	134
15267	0	0	133	0	0	133
15268	140	0	0	0	0	140
15269	145	0	0	0	0	145
15270	134	0	0	0	0	134
15271	130	0	0	0	0	130
15272	0	131	0	0	0	131
15273	1	117	0	0	0	118
15274	0	119	0	0	0	119
15275	0	0	0	136	0	136
15276	0	132	0	0	0	132
15277	134	0	0	1	0	135
15278	0	124	0	0	0	124
15279	0	132	0	0	0	132
15280	0	0	0	139	0	139
15281	0	0	0	136	0	136
15282	138	0	0	0	0	138
15283	0	0	0	139	0	139
15284	0	0	129	0	0	129
15285	0	0	119	0	0	119
15286	0	0	132	0	0	132
15287	0	0	0	130	0	130
15288	1	0	0	134	0	135
15289	0	0	133	0	0	133
15290	0	1	125	0	0	126
15291	0	0	132	0	0	132
15292	137	0	0	0	0	137
15293	0	0	0	140	0	140
15294	0	0	0	141	0	141
15295	138	0	0	0	0	138
15296	0	0	0	133	0	133
15297	0	134	0	0	0	134
15298	0	135	0	0	0	135
15299	0	0	0	144	0	144
15300	142	0	0	0	0	142
15301	136	0	0	0	0	136
15302	142	0	0	0	0	142
15303	0	0	0	141	0	141
15304	0	0	139	0	0	139
15305	1	0	0	140	0	141
15306	0	0	141	0	0	141
15307	139	0	0	0	0	139
15308	0	0	0	137	0	137
15309	129	0	0	0	0	129
15310	0	0	134	0	0	134
15311	133	0	0	0	0	133
15312	0	0	136	0	0	136
15313	0	128	0	0	0	128
15314	0	136	0	0	0	136
15315	137	0	0	0	0	137
15316	0	0	0	138	0	138
15317	0	0	128	0	0	128
15318	0	132	0	0	0	132
15319	0	131	2	0	0	133
15320	0	0	0	131	0	131
15321	129	0	0	0	0	129
15322	127	0	0	1	0	128
15323	0	130	0	0	0	130
15324	132	0	0	0	0	132
15325	0	0	0	130	0	130
15326	0	1	128	0	0	129
15327	0	131	0	0	0	131
15328	0	0	0	132	0	132
15329	0	0	0	127	0	127
15330	131	0	0	0	0	131
15331	0	1	129	0	0	130
15332	131	0	0	0	0	131
15333	127	0	0	0	0	127
15334	0	0	0	135	0	135
15335	0	0	0	127	0	127
15336	128	0	0	0	0	128
15337	0	0	0	130	0	130
15338	0	0	122	0	0	122
15339	0	0	114	0	0	114
15340	0	112	0	0	0	112
15341	0	112	0	0	0	112
15342	0	0	0	115	0	115
15343	0	110	0	0	0	110
15344	119	0	0	0	0	119
15345	0	115	0	0	0	115
15346	0	0	0	120	0	120
15347	0	0	0	120	0	120
15348	0	0	118	0	0	118
15349	0	0	0	122	0	122
15350	0	0	0	123	0	123
15351	0	119	0	0	0	119
15352	0	0	0	120	0	120
15353	0	0	0	123	0	123
15354	0	0	117	0	0	117
15355	0	113	0	0	0	113
15356	0	0	0	119	0	119
15357	0	120	0	0	0	120
15358	1	0	111	0	0	112
15359	0	111	0	0	0	111
15360	113	0	0	0	0	113
15361	106	0	0	0	0	106
15362	111	0	1	0	0	112
15363	0	111	0	0	0	111
15364	119	0	0	0	0	119
15365	0	0	0	121	0	121
15366	114	0	0	0	0	114
15367	0	118	0	0	0	118
15368	119	0	0	0	0	119
15369	115	0	0	0	0	115
15370	0	113	0	1	0	114
15371	0	0	114	0	0	114
15372	0	0	0	113	0	113
15373	0	0	113	0	0	113
15374	0	0	0	112	0	112
15375	0	0	0	113	0	113
15376	0	0	116	0	0	116
15377	0	0	0	113	0	113
15378	114	0	0	0	0	114
15379	0	0	116	0	0	116
15380	0	121	0	0	0	121
15381	0	0	0	120	0	120
15382	1	0	0	121	0	122
15383	0	0	121	0	0	121
15384	0	0	0	119	0	119
15385	0	123	0	1	0	124
15386	122	0	0	0	0	122
15387	0	123	0	0	0	123
15388	122	0	0	0	0	122
15389	0	118	0	0	0	118
15390	0	115	0	0	0	115
15391	0	0	116	0	0	116
15392	0	0	0	117	0	117
15393	0	0	0	114	0	114
15394	0	0	0	114	0	114
15395	0	115	0	0	0	115
15396	0	0	0	116	0	116
15397	110	0	0	0	0	110
15398	1	0	0	109	0	110
15399	110	0	0	0	0	110
15400	0	0	110	0	0	110
15401	108	0	0	0	0	108
15402	0	0	0	107	0	107
15403	0	0	0	112	0	112
15404	110	0	0	0	0	110
15405	0	0	106	0	0	106
15406	0	108	0	0	0	108
15407	0	0	0	110	0	110
15408	111	0	0	0	0	111
15409	112	0	0	0	0	112
15410	0	0	0	114	0	114
15411	0	0	110	0	0	110
15412	112	1	0	1	0	114
15413	0	0	111	0	0	111
15414	1	0	0	119	0	120
15415	1	0	116	0	0	117
15416	0	0	0	115	0	115
15417	0	0	112	0	0	112
15418	0	113	0	0	0	113
15419	1	0	0	116	0	117
15420	0	121	0	0	0	121
15421	120	0	0	0	0	120
15422	120	0	0	0	0	120
15423	0	0	117	0	0	117
15424	0	0	0	113	0	113
15425	112	0	0	2	0	114
15426	0	0	0	112	0	112
15427	0	0	0	115	0	115
15428	0	0	118	0	0	118
15429	117	0	0	0	0	117
15430	0	0	118	0	0	118
15431	0	0	0	115	0	115
15432	0	0	118	0	0	118
15433	115	0	0	0	0	115
15434	117	0	0	0	0	117
15435	114	0	0	1	0	115
15436	0	0	0	118	0	118
15437	0	0	109	1	0	110
15438	0	0	119	0	0	119
15439	0	0	0	117	0	117
15440	0	112	0	0	0	112
15441	112	0	0	0	0	112
15442	0	0	0	111	0	111
15443	0	0	115	0	0	115
15444	0	0	0	114	0	114
15445	1	0	117	0	0	118
15446	0	0	0	121	0	121
15447	0	0	115	0	0	115
15448	0	0	115	1	0	116
15449	0	108	0	0	0	108
15450	0	0	108	0	0	108
15451	0	0	108	0	0	108
15452	0	0	0	105	0	105
15453	0	2	0	112	0	114
15454	0	111	0	0	0	111
15455	110	0	0	0	0	110
15456	0	104	0	0	0	104
15457	0	0	0	105	0	105
15458	109	0	0	0	0	109
15459	0	0	1	103	0	104
15460	105	0	0	0	0	105
15461	0	0	0	108	0	108
15462	0	0	109	0	0	109
15463	0	0	0	106	0	106
15464	0	0	0	106	0	106
15465	113	0	0	0	0	113
15466	111	0	0	0	0	111
15467	113	0	0	0	0	113
15468	0	102	0	0	0	102
15469	0	111	0	0	0	111
15470	113	0	0	0	0	113
15471	0	0	115	0	0	115
15472	0	0	111	0	0	111
15473	0	0	0	113	0	113
15474	0	0	110	0	0	110
15475	0	0	107	0	0	107
15476	112	0	0	0	0	112
15477	109	0	0	0	0	109
15478	0	104	0	0	0	104
15479	0	105	0	0	0	105
15480	0	0	0	111	0	111
15481	0	110	0	0	0	110
15482	109	0	0	0	0	109
15483	0	0	0	111	0	111
15484	0	111	0	0	0	111
15485	112	0	0	0	0	112
15486	0	0	108	0	0	108
15487	0	0	108	0	0	108
15488	109	0	0	0	0	109
15489	1	0	95	0	0	96
15490	112	0	0	0	0	112
15491	0	0	0	110	0	110
15492	0	0	112	0	0	112
15493	0	102	0	1	0	103
15494	0	111	0	0	0	111
15495	111	0	0	0	0	111
15496	0	117	0	0	0	117
15497	116	0	0	0	0	116
15498	114	0	0	1	0	115
15499	0	112	0	0	0	112
15500	0	0	0	115	0	115
15501	0	0	113	0	0	113
15502	0	113	0	0	0	113
15503	0	0	0	118	0	118
15504	0	0	0	118	0	118
15505	115	0	0	0	0	115
15506	0	0	0	115	0	115
15507	0	0	106	0	0	106
15508	0	106	0	0	0	106
15509	0	0	0	114	0	114
15510	110	0	0	0	0	110
15511	110	0	0	0	0	110
15512	0	0	0	111	0	111
15513	109	0	0	0	0	109
15514	0	0	107	0	0	107
15515	0	0	0	106	0	106
15516	0	0	109	0	0	109
15517	0	0	0	106	0	106
15518	0	0	0	108	0	108
15519	0	0	0	105	0	105
15520	0	0	0	107	0	107
15521	0	0	0	103	0	103
15522	107	0	0	0	0	107
15523	103	0	0	0	0	103
15524	0	102	0	0	0	102
15525	105	0	0	0	0	105
15526	0	0	0	104	0	104
15527	1	0	0	103	0	104
15528	0	0	0	104	0	104
15529	0	0	101	0	0	101
15530	0	0	0	95	0	95
15531	0	95	0	0	0	95
15532	97	0	0	0	0	97
15533	101	0	0	0	0	101
15534	0	0	94	0	0	94
15535	0	97	0	0	0	97
15536	1	0	0	99	0	100
15537	0	0	97	0	0	97
15538	0	0	0	100	0	100
15539	0	90	0	1	0	91
15540	94	0	0	0	0	94
15541	0	94	0	0	0	94
15542	0	0	92	1	0	93
15543	0	0	91	0	0	91
15544	1	82	0	2	0	85
15545	1	96	0	0	0	97
15546	100	0	0	0	0	100
15547	97	0	0	0	0	97
15548	2	0	0	95	0	97
15549	0	0	96	0	0	96
15550	0	0	0	95	0	95
15551	0	0	0	94	0	94
15552	95	0	0	0	0	95
15553	90	2	0	0	0	92
15554	0	0	0	96	0	96
15555	0	0	93	0	0	93
15556	0	89	0	0	0	89
15557	94	0	0	1	0	95
15558	0	88	0	0	0	88
15559	0	0	1	93	0	94
15560	0	0	0	91	0	91
15561	0	0	0	93	0	93
15562	0	0	0	92	0	92
15563	91	0	0	0	0	91
15564	0	0	0	90	0	90
15565	0	83	0	0	0	83
15566	0	0	0	81	0	81
15567	85	0	0	0	0	85
15568	0	86	0	0	0	86
15569	0	0	0	88	0	88
15570	0	0	86	0	0	86
15571	88	0	0	0	0	88
15572	0	0	0	87	0	87
15573	0	0	83	0	0	83
15574	0	0	82	0	0	82
15575	0	0	0	85	0	85
15576	81	0	0	0	0	81
15577	82	0	0	0	0	82
15578	0	82	0	0	0	82
15579	82	0	0	0	0	82
15580	81	0	0	0	0	81
15581	80	0	0	1	0	81
15582	81	0	0	0	0	81
15583	0	0	0	85	0	85
15584	0	0	0	86	0	86
15585	0	0	81	0	0	81
15586	0	75	0	0	0	75
15587	0	77	0	0	0	77
15588	0	0	80	0	0	80
15589	83	0	0	0	0	83
15590	0	0	0	83	0	83
15591	84	0	0	0	0	84
15592	81	0	0	0	0	81
15593	0	0	86	0	0	86
15594	0	0	0	82	0	82
15595	86	0	0	0	0	86
15596	0	0	0	81	0	81
15597	0	0	82	0	0	82
15598	0	0	0	83	0	83
15599	0	84	0	0	0	84
15600	0	80	0	1	0	81
15601	0	0	78	0	0	78
15602	0	85	0	0	0	85
15603	94	0	0	0	0	94
15604	91	0	0	0	0	91
15605	0	0	0	87	0	87
15606	0	0	0	86	0	86
15607	0	0	0	93	0	93
15608	91	0	0	0	0	91
15609	0	92	0	0	0	92
15610	94	0	0	0	0	94
15611	91	0	0	0	0	91
15612	0	93	0	0	0	93
15613	93	0	0	0	0	93
15614	0	95	0	0	0	95
15615	92	0	0	0	0	92
15616	0	1	93	0	0	94
15617	97	0	0	0	0	97
15618	0	96	0	0	0	96
15619	0	0	0	100	0	100
15620	0	0	0	100	0	100
15621	0	0	0	100	0	100
15622	99	0	0	0	0	99
15623	0	0	0	101	0	101
15624	0	0	92	0	0	92
15625	98	0	0	0	0	98
15626	0	0	98	0	0	98
15627	0	0	0	99	0	99
15628	0	1	97	0	0	98
15629	0	0	0	98	0	98
15630	0	97	0	0	0	97
15631	0	0	0	102	0	102
15632	0	100	0	0	0	100
15633	0	0	0	100	0	100
15634	105	0	0	0	0	105
15635	0	0	0	103	0	103
15636	102	0	0	0	0	102
15637	0	0	94	0	0	94
15638	104	0	0	0	0	104
15639	101	0	0	0	0	101
15640	101	0	0	0	0	101
15641	0	0	0	108	0	108
15642	107	0	0	1	0	108
15643	0	0	109	0	0	109
15644	108	0	0	0	0	108
15645	0	0	109	0	0	109
15646	113	0	0	0	0	113
15647	0	0	0	110	0	110
15648	0	0	112	0	0	112
15649	0	0	0	114	0	114
15650	0	0	0	116	0	116
15651	0	0	109	0	0	109
15652	107	0	0	0	0	107
15653	1	115	0	0	0	116
15654	120	0	0	0	0	120
15655	0	119	0	0	0	119
15656	121	0	1	0	0	122
15657	0	0	116	1	0	117
15658	121	0	0	0	0	121
15659	0	121	0	0	0	121
15660	1	0	0	122	0	123
15661	0	0	0	122	0	122
15662	0	0	0	118	0	118
15663	0	0	122	0	0	122
15664	0	0	0	118	0	118
15665	2	0	115	0	0	117
15666	123	0	0	0	0	123
15667	120	0	0	0	0	120
15668	0	0	0	118	0	118
15669	0	0	117	0	0	117
15670	118	0	0	0	0	118
15671	0	0	118	0	0	118
15672	0	0	0	115	0	115
15673	0	0	0	122	0	122
15674	0	0	0	126	0	126
15675	0	0	0	127	0	127
15676	125	0	0	0	0	125
15677	0	122	0	0	0	122
15678	0	0	121	0	0	121
15679	0	131	0	0	0	131
15680	129	0	0	0	0	129
15681	1	0	0	132	0	133
15682	124	0	0	0	0	124
15683	0	0	0	133	0	133
15684	1	0	0	130	0	131
15685	0	0	0	137	0	137
15686	0	0	129	0	0	129
15687	1	126	0	1	0	128
15688	1	0	131	0	0	132
15689	0	0	0	131	0	131
15690	131	0	0	0	0	131
15691	131	0	0	0	0	131
15692	125	0	0	0	0	125
15693	0	124	0	0	0	124
15694	120	0	0	0	0	120
15695	0	0	0	125	0	125
15696	0	0	0	127	0	127
15697	0	0	0	124	0	124
15698	0	121	0	0	0	121
15699	0	0	0	124	0	124
15700	0	123	0	0	0	123
15701	125	0	0	0	0	125
15702	129	0	1	0	0	130
15703	0	0	0	133	0	133
15704	0	0	127	0	0	127
15705	128	0	0	0	0	128
15706	1	0	0	127	0	128
15707	0	0	128	0	0	128
15708	127	0	0	1	0	128
15709	0	0	0	130	0	130
15710	127	0	0	1	0	128
15711	0	128	0	0	0	128
15712	1	0	0	123	0	124
15713	0	123	0	0	0	123
15714	0	0	0	125	0	125
15715	0	120	0	0	0	120
15716	0	0	0	124	0	124
15717	0	0	125	0	0	125
15718	124	0	0	0	0	124
15719	0	126	0	0	0	126
15720	0	0	120	0	0	120
15721	126	0	0	0	0	126
15722	0	0	0	130	0	130
15723	0	0	121	0	0	121
15724	0	122	0	0	0	122
15725	0	0	0	129	0	129
15726	0	0	125	0	0	125
15727	0	0	0	124	0	124
15728	0	0	0	122	0	122
15729	0	0	124	0	0	124
15730	0	0	0	122	0	122
15731	0	0	121	0	0	121
15732	1	0	0	123	0	124
15733	0	0	122	0	0	122
15734	0	0	0	119	0	119
15735	0	0	0	118	0	118
15736	1	0	0	118	0	119
15737	0	119	0	0	0	119
15738	116	0	0	0	0	116
15739	116	0	0	0	0	116
15740	1	0	0	113	0	114
15741	111	0	0	0	0	111
15742	0	0	112	0	0	112
15743	0	108	0	0	0	108
15744	108	0	0	0	0	108
15745	0	110	1	0	0	111
15746	0	0	0	110	0	110
15747	0	0	0	102	0	102
15748	103	0	0	0	0	103
15749	0	0	0	102	0	102
15750	0	0	102	0	0	102
15751	0	105	0	0	0	105
15752	103	0	0	0	0	103
15753	0	0	0	101	0	101
15754	0	102	0	0	0	102
15755	0	0	0	103	0	103
15756	0	100	0	0	0	100
15757	100	0	0	0	0	100
15758	102	0	0	0	0	102
15759	0	0	97	0	0	97
15760	0	0	98	0	0	98
15761	0	0	0	100	0	100
15762	0	98	0	0	0	98
15763	0	0	0	100	0	100
15764	101	0	0	0	0	101
15765	0	0	103	0	0	103
15766	0	0	0	102	0	102
15767	0	0	96	0	0	96
15768	0	0	94	1	0	95
15769	0	94	0	0	0	94
15770	0	0	0	104	0	104
15771	103	0	0	0	0	103
15772	0	0	94	0	0	94
15773	0	94	0	0	0	94
15774	97	0	0	0	0	97
15775	0	0	0	102	0	102
15776	94	0	0	0	0	94
15777	102	0	0	1	0	103
15778	96	0	0	0	0	96
15779	0	0	93	0	0	93
15780	96	0	0	0	0	96
15781	97	0	0	0	0	97
15782	0	99	0	0	0	99
15783	0	0	0	99	0	99
15784	0	0	0	101	0	101
15785	0	0	0	102	0	102
15786	97	0	0	0	0	97
15787	98	0	0	0	0	98
15788	0	0	92	0	0	92
15789	0	0	0	98	0	98
15790	0	93	0	1	0	94
15791	101	0	0	0	0	101
15792	0	0	93	0	0	93
15793	0	0	0	98	0	98
15794	0	0	0	103	0	103
15795	0	97	0	0	0	97
15796	0	0	0	94	0	94
15797	0	0	0	101	0	101
15798	0	0	0	102	0	102
15799	102	0	0	0	0	102
15800	0	0	0	98	0	98
15801	0	0	0	98	0	98
15802	98	0	0	0	0	98
15803	0	0	0	97	0	97
15804	0	96	0	0	0	96
15805	105	0	0	0	0	105
15806	98	0	0	1	0	99
15807	96	0	0	0	0	96
15808	99	0	0	0	0	99
15809	0	101	0	0	0	101
15810	111	0	0	0	0	111
15811	115	0	0	0	0	115
15812	0	0	0	123	0	123
15813	0	0	124	0	0	124
15814	0	0	0	127	0	127
15815	0	0	0	128	0	128
15816	0	0	0	128	0	128
15817	0	0	0	134	0	134
15818	0	0	0	132	0	132
15819	134	0	0	0	0	134
15820	0	0	0	130	0	130
15821	0	0	129	0	0	129
15822	0	0	0	134	0	134
15823	0	137	0	0	0	137
15824	0	0	0	139	0	139
15825	0	0	140	0	0	140
15826	130	0	0	0	0	130
15827	138	0	1	0	0	139
15828	0	0	136	0	0	136
15829	0	136	0	1	0	137
15830	143	0	0	0	0	143
15831	144	0	1	0	0	145
15832	139	0	0	0	0	139
15833	145	0	0	0	0	145
15834	0	0	0	143	0	143
15835	0	0	143	0	0	143
15836	0	0	0	144	0	144
15837	0	0	0	146	0	146
15838	0	0	148	0	0	148
15839	0	0	135	0	0	135
15840	151	0	0	0	0	151
15841	0	152	0	0	0	152
15842	0	0	0	151	0	151
15843	0	0	149	0	0	149
15844	150	0	0	1	0	151
15845	0	0	149	0	0	149
15846	152	0	0	0	0	152
15847	0	154	0	0	0	154
15848	0	0	0	154	0	154
15849	0	0	150	0	0	150
15850	153	0	0	0	0	153
15851	0	147	0	0	0	147
15852	0	143	0	0	0	143
15853	0	0	0	157	0	157
15854	0	0	0	152	0	152
15855	156	0	0	0	0	156
15856	0	152	0	0	0	152
15857	0	0	0	162	0	162
15858	158	0	0	0	0	158
15859	159	0	0	0	0	159
15860	154	0	0	0	0	154
15861	0	0	150	0	0	150
15862	0	0	142	0	0	142
15863	149	0	0	0	0	149
15864	0	145	0	0	0	145
15865	0	151	0	1	0	152
15866	0	0	0	157	0	157
15867	0	155	0	0	0	155
15868	158	0	0	0	0	158
15869	0	0	0	156	0	156
15870	0	0	154	1	0	155
15871	152	0	0	0	0	152
15872	151	0	0	0	0	151
15873	0	0	1	147	0	148
15874	0	0	0	141	0	141
15875	0	0	0	148	0	148
15876	0	0	0	153	0	153
15877	1	1	145	0	0	147
15878	0	145	0	0	0	145
15879	0	0	0	146	0	146
15880	0	144	0	1	0	145
15881	0	0	0	148	0	148
15882	0	144	0	0	0	144
15883	146	0	0	0	0	146
15884	143	0	0	0	0	143
15885	0	142	0	0	0	142
15886	141	0	0	0	0	141
15887	0	0	0	132	0	132
15888	136	0	0	0	0	136
15889	0	132	0	0	0	132
15890	135	0	0	0	0	135
15891	133	0	0	0	0	133
15892	0	0	0	135	0	135
15893	0	0	134	0	0	134
15894	0	133	0	0	0	133
15895	0	0	0	137	0	137
15896	131	0	0	0	0	131
15897	0	0	132	0	0	132
15898	0	0	1	129	0	130
15899	1	0	0	132	0	133
15900	128	0	0	0	0	128
15901	128	0	0	0	0	128
15902	127	0	0	0	0	127
15903	0	114	1	0	0	115
15904	116	0	0	0	0	116
15905	0	0	112	0	0	112
15906	1	0	102	0	0	103
15907	0	0	109	1	0	110
15908	0	0	0	113	0	113
15909	0	0	106	0	0	106
15910	103	0	0	0	0	103
15911	0	0	0	107	0	107
15912	0	0	101	0	0	101
15913	104	0	0	0	0	104
15914	0	0	0	102	0	102
15915	0	0	0	101	0	101
15916	98	0	0	0	0	98
15917	0	0	0	102	0	102
15918	0	0	98	0	0	98
15919	0	2	0	103	0	105
15920	0	0	106	0	0	106
15921	0	0	0	103	0	103
15922	100	0	0	0	0	100
15923	0	96	0	1	0	97
15924	0	109	0	0	0	109
15925	0	0	0	113	0	113
15926	0	0	0	118	0	118
15927	0	109	0	0	0	109
15928	0	114	0	0	0	114
15929	0	0	0	116	0	116
15930	0	0	0	117	0	117
15931	117	0	0	0	0	117
15932	0	110	0	0	0	110
15933	0	108	1	0	0	109
15934	0	115	0	0	0	115
15935	118	0	0	0	0	118
15936	0	0	113	0	0	113
15937	118	0	0	0	0	118
15938	0	0	0	118	0	118
15939	0	112	1	0	0	113
15940	0	119	0	1	0	120
15941	122	0	0	0	0	122
15942	0	0	0	116	0	116
15943	0	118	0	0	0	118
15944	117	0	0	0	0	117
15945	119	0	0	0	0	119
15946	0	1	119	0	0	120
15947	118	0	0	0	0	118
15948	118	0	0	0	0	118
15949	0	0	0	118	0	118
15950	0	112	0	0	0	112
15951	0	114	0	0	0	114
15952	0	0	0	115	0	115
15953	119	0	0	0	0	119
15954	0	0	108	0	0	108
15955	0	0	110	0	0	110
15956	1	0	108	0	0	109
15957	0	0	112	1	0	113
15958	0	106	0	0	0	106
15959	0	109	0	0	0	109
15960	0	0	111	0	0	111
15961	0	0	97	0	0	97
15962	0	104	0	0	0	104
15963	0	0	0	116	0	116
15964	0	0	114	0	0	114
15965	0	0	0	116	0	116
15966	0	0	0	116	0	116
15967	0	0	0	116	0	116
15968	0	0	0	121	0	121
15969	0	0	114	0	0	114
15970	0	0	0	117	0	117
15971	114	0	0	0	0	114
15972	0	0	113	0	0	113
15973	112	0	0	0	0	112
15974	0	0	0	108	0	108
15975	0	0	107	0	0	107
15976	112	0	0	0	0	112
15977	0	0	0	112	0	112
15978	108	0	1	0	0	109
15979	0	0	0	113	0	113
15980	0	105	0	0	0	105
15981	0	0	111	0	0	111
15982	0	0	0	110	0	110
15983	118	0	0	0	0	118
15984	111	0	0	0	0	111
15985	115	0	0	0	0	115
15986	117	0	0	0	0	117
15987	112	0	0	0	0	112
15988	0	110	0	0	0	110
15989	110	0	0	0	0	110
15990	0	0	107	0	0	107
15991	111	0	0	0	0	111
15992	0	0	1	114	0	115
15993	0	1	114	0	0	115
15994	0	0	108	0	0	108
15995	0	0	0	113	0	113
15996	116	0	0	0	0	116
15997	0	107	0	0	0	107
15998	116	0	0	0	0	116
15999	0	100	0	0	0	100
16000	0	0	0	110	0	110
16001	0	0	0	114	0	114
16002	116	0	0	0	0	116
16003	0	0	0	113	0	113
16004	0	0	106	0	0	106
16005	109	0	0	0	0	109
16006	0	0	0	113	0	113
16007	0	0	0	113	0	113
16008	0	0	111	0	0	111
16009	115	0	0	0	0	115
16010	117	0	0	0	0	117
16011	0	114	0	0	0	114
16012	0	0	108	0	0	108
16013	1	0	102	1	0	104
16014	2	0	0	114	0	116
16015	0	0	1	116	0	117
16016	0	113	0	1	0	114
16017	0	0	107	0	0	107
16018	0	0	0	108	0	108
16019	1	0	105	0	0	106
16020	0	0	0	110	0	110
16021	0	108	0	0	0	108
16022	0	0	0	112	0	112
16023	0	0	0	107	0	107
16024	0	0	0	118	0	118
16025	115	0	0	0	0	115
16026	0	0	113	0	0	113
16027	0	111	0	0	0	111
16028	0	0	0	106	0	106
16029	105	0	0	1	0	106
16030	0	0	0	108	0	108
16031	114	0	0	0	0	114
16032	0	0	109	0	0	109
16033	111	0	0	0	0	111
16034	0	0	0	113	0	113
16035	2	0	105	1	0	108
16036	0	111	1	0	0	112
16037	0	0	0	112	0	112
16038	0	0	0	112	0	112
16039	113	0	0	0	0	113
16040	0	105	0	0	0	105
16041	0	103	0	0	0	103
16042	1	106	0	1	0	108
16043	108	0	0	0	0	108
16044	0	113	1	0	0	114
16045	0	0	0	120	0	120
16046	0	0	0	120	0	120
16047	120	0	0	0	0	120
16048	0	116	0	0	0	116
16049	0	0	0	118	0	118
16050	115	0	0	0	0	115
16051	116	0	0	0	0	116
16052	114	0	0	0	0	114
16053	0	114	0	0	0	114
16054	113	0	1	0	0	114
16055	0	0	0	115	0	115
16056	0	114	0	0	0	114
16057	0	114	0	1	0	115
16058	0	0	0	116	0	116
16059	117	0	0	0	0	117
16060	119	0	0	0	0	119
16061	0	0	0	120	0	120
16062	0	123	0	0	0	123
16063	125	0	0	0	0	125
16064	0	0	125	0	0	125
16065	0	1	112	0	0	113
16066	132	0	0	0	0	132
16067	0	0	126	0	0	126
16068	0	0	0	129	0	129
16069	132	0	0	0	0	132
16070	0	0	0	137	0	137
16071	0	0	131	0	0	131
16072	1	131	0	0	0	132
16073	0	0	0	141	0	141
16074	0	0	129	0	0	129
16075	142	0	0	0	0	142
16076	0	0	0	139	0	139
16077	0	0	133	0	0	133
16078	0	0	0	140	0	140
16079	0	137	0	0	0	137
16080	0	0	0	148	0	148
16081	0	0	0	139	0	139
16082	0	0	0	145	0	145
16083	0	146	0	0	0	146
16084	146	0	0	0	0	146
16085	0	0	0	150	0	150
16086	0	0	0	148	0	148
16087	0	0	0	149	0	149
16088	0	0	147	0	0	147
16089	0	0	0	147	0	147
16090	149	0	0	0	0	149
16091	0	144	0	0	0	144
16092	0	0	0	148	0	148
16093	0	0	0	149	0	149
16094	147	0	0	0	0	147
16095	0	144	0	0	0	144
16096	149	0	0	0	0	149
16097	146	0	0	0	0	146
16098	0	0	0	149	0	149
16099	147	0	0	0	0	147
16100	0	147	0	0	0	147
16101	150	0	0	0	0	150
16102	0	0	0	146	0	146
16103	149	0	0	0	0	149
16104	153	0	0	0	0	153
16105	0	0	151	0	0	151
16106	144	0	0	0	0	144
16107	148	0	0	0	0	148
16108	147	0	0	0	0	147
16109	0	0	141	1	0	142
16110	0	144	0	0	0	144
16111	0	0	0	151	0	151
16112	150	0	0	0	0	150
16113	0	148	0	0	0	148
16114	150	0	0	0	0	150
16115	0	0	0	149	0	149
16116	0	0	138	0	0	138
16117	146	0	0	0	0	146
16118	0	0	0	147	0	147
16119	1	0	144	0	0	145
16120	149	0	0	0	0	149
16121	0	0	146	0	0	146
16122	0	0	2	145	0	147
16123	0	0	0	152	0	152
16124	153	0	0	0	0	153
16125	149	0	0	0	0	149
16126	0	147	0	0	0	147
16127	151	0	0	2	0	153
16128	0	0	144	0	0	144
16129	0	0	136	0	0	136
16130	150	0	0	0	0	150
16131	0	149	0	0	0	149
16132	152	0	0	0	0	152
16133	0	147	0	1	0	148
16134	154	0	0	0	0	154
16135	0	0	0	147	0	147
16136	0	0	152	0	0	152
16137	0	0	0	152	0	152
16138	0	0	0	153	0	153
16139	150	0	0	0	0	150
16140	0	0	148	0	0	148
16141	153	0	0	0	0	153
16142	0	150	0	0	0	150
16143	151	0	0	0	0	151
16144	0	0	0	155	0	155
16145	0	0	149	0	0	149
16146	1	0	0	154	0	155
16147	158	0	0	0	0	158
16148	0	0	0	158	0	158
16149	0	0	0	157	0	157
16150	0	155	0	0	0	155
16151	0	0	0	162	0	162
16152	0	0	151	0	0	151
16153	0	0	0	156	0	156
16154	0	0	0	157	0	157
16155	154	0	0	0	0	154
16156	0	0	0	155	0	155
16157	0	0	149	0	0	149
16158	0	147	0	0	0	147
16159	0	0	0	154	0	154
16160	0	0	0	153	0	153
16161	159	0	0	0	0	159
16162	0	153	1	0	0	154
16163	0	0	0	160	0	160
16164	151	0	0	0	0	151
16165	152	0	0	0	0	152
16166	0	0	0	149	0	149
16167	0	0	156	0	0	156
16168	152	0	2	0	0	154
16169	0	0	0	166	0	166
16170	164	0	0	0	0	164
16171	160	0	0	0	0	160
16172	0	149	1	0	0	150
16173	153	0	0	2	0	155
16174	0	151	0	0	0	151
16175	0	0	0	157	0	157
16176	0	0	1	151	0	152
16177	0	151	0	0	0	151
16178	151	0	0	0	0	151
16179	152	0	0	0	0	152
16180	0	0	147	0	0	147
16181	0	0	137	0	0	137
16182	0	0	0	147	0	147
16183	150	0	0	0	0	150
16184	0	0	0	155	0	155
16185	0	0	0	158	0	158
16186	0	1	159	0	0	160
16187	0	0	133	1	0	134
16188	0	0	144	2	0	146
16189	160	0	0	0	0	160
16190	154	0	2	0	0	156
16191	0	158	0	0	0	158
16192	0	156	0	2	0	158
16193	0	0	0	158	0	158
16194	0	0	162	0	0	162
16195	158	0	0	0	0	158
16196	0	0	165	0	0	165
16197	0	0	0	160	0	160
16198	0	0	0	160	0	160
16199	0	0	0	162	0	162
16200	0	0	0	165	0	165
16201	168	0	0	0	0	168
16202	0	0	0	169	0	169
16203	0	0	158	0	0	158
16204	170	0	0	0	0	170
16205	0	0	169	0	0	169
16206	0	1	154	0	0	155
16207	0	166	0	0	0	166
16208	0	0	0	169	0	169
16209	170	0	0	0	0	170
16210	0	0	0	173	0	173
16211	0	0	170	0	0	170
16212	0	0	0	167	0	167
16213	167	0	0	1	0	168
16214	0	168	0	0	0	168
16215	173	0	0	0	0	173
16216	0	169	0	0	0	169
16217	168	0	0	0	0	168
16218	0	165	0	0	0	165
16219	1	170	0	0	0	171
16220	1	0	160	1	0	162
16221	0	164	0	0	0	164
16222	174	0	0	0	0	174
16223	0	0	0	179	0	179
16224	174	0	0	0	0	174
16225	0	175	0	0	0	175
16226	179	0	0	0	0	179
16227	0	0	176	0	0	176
16228	0	0	0	181	0	181
16229	0	175	0	0	0	175
16230	0	0	1	176	0	177
16231	0	0	0	173	0	173
16232	177	1	0	0	0	178
16233	0	173	0	0	0	173
16234	175	0	0	0	0	175
16235	0	0	171	0	0	171
16236	1	0	171	1	0	173
16237	1	174	0	0	0	175
16238	0	0	0	182	0	182
16239	0	0	181	0	0	181
16240	0	0	0	174	0	174
16241	0	0	0	174	0	174
16242	0	0	175	0	0	175
16243	0	0	170	0	0	170
16244	2	0	171	0	0	173
16245	1	0	176	0	0	177
16246	1	174	0	0	0	175
16247	0	0	0	186	0	186
16248	0	0	0	188	0	188
16249	0	0	187	0	0	187
16250	0	0	0	179	0	179
16251	0	0	178	0	0	178
16252	0	0	0	187	0	187
16253	1	0	0	182	0	183
16254	0	182	0	0	0	182
16255	0	0	0	192	0	192
16256	0	0	0	185	0	185
16257	0	0	0	191	0	191
16258	0	0	188	0	0	188
16259	0	194	0	0	0	194
16260	198	0	0	0	0	198
16261	191	0	0	0	0	191
16262	0	0	0	187	0	187
16263	0	0	0	188	0	188
16264	0	186	0	0	0	186
16265	180	0	0	0	0	180
16266	0	186	0	0	0	186
16267	186	0	0	0	0	186
16268	0	0	180	0	0	180
16269	183	0	0	0	0	183
16270	0	190	0	0	0	190
16271	0	0	0	193	0	193
16272	0	0	1	191	0	192
16273	0	183	0	0	0	183
16274	192	0	0	0	0	192
16275	0	0	0	191	0	191
16276	0	0	0	190	0	190
16277	195	0	0	0	0	195
16278	189	0	0	0	0	189
16279	0	0	186	0	0	186
16280	182	0	0	0	0	182
16281	0	0	0	184	0	184
16282	2	0	181	0	0	183
16283	0	0	0	184	0	184
16284	0	0	175	0	0	175
16285	0	0	173	0	0	173
16286	0	0	0	192	0	192
16287	1	0	183	0	0	184
16288	0	193	0	0	0	193
16289	0	0	2	192	0	194
16290	0	0	0	208	0	208
16291	2	0	193	0	0	195
16292	0	206	0	0	0	206
16293	202	0	3	0	0	205
16294	0	0	0	211	0	211
16295	204	0	0	0	0	204
16296	0	205	0	0	0	205
16297	0	0	197	0	0	197
16298	0	0	0	213	0	213
16299	217	0	0	0	0	217
16300	0	0	208	0	0	208
16301	207	0	0	2	0	209
16302	0	207	1	0	0	208
16303	0	215	1	0	0	216
16304	225	0	0	0	0	225
16305	0	0	1	222	0	223
16306	0	0	0	222	0	222
16307	0	222	0	0	0	222
16308	0	0	0	226	0	226
16309	0	0	0	225	0	225
16310	223	0	0	0	0	223
16311	0	0	0	224	0	224
16312	0	0	219	0	0	219
16313	0	0	0	217	0	217
16314	1	0	0	224	0	225
16315	0	0	218	0	0	218
16316	0	0	0	221	0	221
16317	222	0	0	0	0	222
16318	215	0	0	1	0	216
16319	213	5	0	0	0	218
16320	1	0	0	221	0	222
16321	0	0	217	1	0	218
16322	0	216	0	0	0	216
16323	2	0	0	220	0	222
16324	0	0	225	0	0	225
16325	0	0	0	225	0	225
16326	0	0	0	232	0	232
16327	227	0	0	0	0	227
16328	0	233	0	0	0	233
16329	1	0	219	0	0	220
16330	222	0	0	1	0	223
16331	1	207	0	0	0	208
16332	1	223	1	0	0	225
16333	226	0	0	0	0	226
16334	0	0	0	227	0	227
16335	0	0	215	0	0	215
16336	0	0	0	225	0	225
16337	0	220	0	0	0	220
16338	229	0	0	0	0	229
16339	0	0	0	223	0	223
16340	221	0	0	0	0	221
16341	0	0	0	226	0	226
16342	0	225	0	0	0	225
16343	228	0	0	0	0	228
16344	226	0	0	0	0	226
16345	0	228	0	0	0	228
16346	232	0	0	0	0	232
16347	0	0	0	227	0	227
16348	0	224	0	0	0	224
16349	230	0	0	0	0	230
16350	0	223	0	0	0	223
16351	226	0	0	0	0	226
16352	0	0	0	227	0	227
16353	220	0	0	0	0	220
16354	223	0	0	1	0	224
16355	227	0	0	0	0	227
16356	0	0	0	231	0	231
16357	0	0	0	236	0	236
16358	239	0	0	1	0	240
16359	0	0	232	0	0	232
16360	1	0	0	232	0	233
16361	0	228	0	0	0	228
16362	0	0	0	241	0	241
16363	0	0	0	242	0	242
16364	2	0	233	0	0	235
16365	0	0	0	242	0	242
16366	0	229	0	0	0	229
16367	0	0	0	240	0	240
16368	0	0	238	0	0	238
16369	0	0	0	237	0	237
16370	1	0	0	245	0	246
16371	242	1	0	0	0	243
16372	244	0	0	2	0	246
16373	0	0	1	246	0	247
16374	0	231	0	0	0	231
16375	0	237	0	0	0	237
16376	0	0	241	0	0	241
16377	0	0	0	245	0	245
16378	237	0	0	0	0	237
16379	1	0	0	247	0	248
16380	0	0	244	0	0	244
16381	0	0	0	237	0	237
16382	0	0	0	233	0	233
16383	0	0	0	238	0	238
16384	0	0	229	0	0	229
16385	0	228	0	1	0	229
16386	233	0	0	1	0	234
16387	238	0	0	0	0	238
16388	0	0	0	235	0	235
16389	0	0	224	0	0	224
16390	0	218	0	0	0	218
16391	0	0	0	217	0	217
16392	0	198	0	0	0	198
16393	0	212	0	1	0	213
16394	217	0	0	0	0	217
16395	1	0	204	0	0	205
16396	0	0	199	0	0	199
16397	0	0	0	206	0	206
16398	1	0	0	214	0	215
16399	0	0	216	0	0	216
16400	0	0	0	217	0	217
16401	0	0	220	0	0	220
16402	224	0	0	0	0	224
16403	0	0	0	226	0	226
16404	0	0	225	0	0	225
16405	1	0	0	216	0	217
16406	0	220	0	0	0	220
16407	223	0	0	0	0	223
16408	0	228	0	0	0	228
16409	230	0	0	0	0	230
16410	0	0	227	0	0	227
16411	232	0	0	0	0	232
16412	1	0	0	232	0	233
16413	0	0	229	0	0	229
16414	0	0	0	232	0	232
16415	0	0	227	1	0	228
16416	231	0	0	0	0	231
16417	0	228	0	0	0	228
16418	0	0	0	222	0	222
16419	0	219	0	0	0	219
16420	224	0	0	0	0	224
16421	213	0	0	0	0	213
16422	2	210	0	2	0	214
16423	0	0	2	222	0	224
16424	0	0	0	224	0	224
16425	0	0	0	227	0	227
16426	227	0	0	0	0	227
16427	0	222	0	0	0	222
16428	0	0	0	225	0	225
16429	0	0	0	222	0	222
16430	226	0	0	1	0	227
16431	0	0	220	0	0	220
16432	0	0	211	0	0	211
16433	218	0	0	0	0	218
16434	0	1	208	0	0	209
16435	0	0	208	0	0	208
16436	0	0	0	212	0	212
16437	203	0	0	0	0	203
16438	0	0	0	215	0	215
16439	0	0	201	0	0	201
16440	204	0	0	0	0	204
16441	0	0	200	0	0	200
16442	0	196	0	0	0	196
16443	0	0	0	200	0	200
16444	199	0	0	1	0	200
16445	0	0	0	192	0	192
16446	0	0	0	195	0	195
16447	197	0	0	0	0	197
16448	0	0	0	196	0	196
16449	1	0	0	194	0	195
16450	0	0	196	0	0	196
16451	0	0	0	196	0	196
16452	198	0	0	0	0	198
16453	200	0	1	0	0	201
16454	192	4	0	0	0	196
16455	0	0	1	200	0	201
16456	0	193	0	1	0	194
16457	193	0	0	0	0	193
16458	0	202	0	1	0	203
16459	213	0	0	0	0	213
16460	0	0	0	208	0	208
16461	215	0	0	0	0	215
16462	206	0	0	0	0	206
16463	204	0	0	0	0	204
16464	1	207	0	0	0	208
16465	0	207	0	0	0	207
16466	216	0	0	0	0	216
16467	0	204	0	1	0	205
16468	0	183	0	0	0	183
16469	0	210	0	0	0	210
16470	229	0	0	0	0	229
16471	0	1	0	227	0	228
16472	0	0	0	234	0	234
16473	238	0	0	0	0	238
16474	0	1	232	0	0	233
16475	1	0	0	235	0	236
16476	0	0	0	240	0	240
16477	0	0	1	233	0	234
16478	1	0	0	237	0	238
16479	0	209	0	0	0	209
16480	0	231	0	0	0	231
16481	232	0	0	0	0	232
16482	0	0	0	244	0	244
16483	0	0	0	242	0	242
16484	1	0	230	0	0	231
16485	0	0	0	240	0	240
16486	0	0	237	0	0	237
16487	0	0	0	241	0	241
16488	0	0	238	0	0	238
16489	0	235	0	0	0	235
16490	0	0	0	244	0	244
16491	244	0	0	1	0	245
16492	242	0	0	0	0	242
16493	0	0	0	235	0	235
16494	0	0	233	0	0	233
16495	1	0	215	0	0	216
16496	222	0	0	0	0	222
16497	0	228	0	0	0	228
16498	236	0	0	0	0	236
16499	229	0	0	0	0	229
16500	0	0	220	0	0	220
16501	0	0	1	226	0	227
16502	0	0	0	225	0	225
16503	0	0	0	226	0	226
16504	0	0	0	222	0	222
16505	0	0	0	220	0	220
16506	1	0	210	0	0	211
16507	0	0	208	0	0	208
16508	0	0	0	218	0	218
16509	0	0	0	217	0	217
16510	0	0	0	217	0	217
16511	211	0	0	0	0	211
16512	0	0	0	228	0	228
16513	224	0	0	0	0	224
16514	0	0	0	229	0	229
16515	230	0	0	0	0	230
16516	231	0	0	0	0	231
16517	229	0	0	0	0	229
16518	236	0	0	0	0	236
16519	229	0	0	0	0	229
16520	0	0	0	236	0	236
16521	238	0	0	0	0	238
16522	0	232	0	1	0	233
16523	239	0	0	0	0	239
16524	0	0	0	242	0	242
16525	1	0	239	0	0	240
16526	0	0	0	244	0	244
16527	0	0	249	0	0	249
16528	0	0	0	238	0	238
16529	0	0	0	247	0	247
16530	0	0	251	1	0	252
16531	1	1	246	0	0	248
16532	0	0	0	247	0	247
16533	259	0	0	0	0	259
16534	2	0	244	0	0	246
16535	0	238	0	0	0	238
16536	0	0	255	2	0	257
16537	252	0	0	1	0	253
16538	0	0	0	256	0	256
16539	254	0	0	0	0	254
16540	263	0	0	0	0	263
16541	0	0	0	259	0	259
16542	0	0	263	0	0	263
16543	0	0	0	267	0	267
16544	1	0	0	268	0	269
16545	273	0	0	0	0	273
16546	0	274	0	0	0	274
16547	1	0	0	275	0	276
16548	0	0	261	0	0	261
16549	264	0	0	2	0	266
16550	0	259	0	0	0	259
16551	0	0	0	267	0	267
16552	0	0	0	261	0	261
16553	0	0	0	264	0	264
16554	261	0	0	0	0	261
16555	257	0	0	0	0	257
16556	0	0	0	259	0	259
16557	1	1	238	1	0	241
16558	0	246	0	0	0	246
16559	245	0	0	0	0	245
16560	247	0	0	0	0	247
16561	0	0	0	251	0	251
16562	0	0	0	243	0	243
16563	0	0	234	0	0	234
16564	0	224	0	3	0	227
16565	246	0	0	0	0	246
16566	234	0	0	0	0	234
16567	0	227	0	0	0	227
16568	226	0	0	3	0	229
16569	3	0	0	219	0	222
16570	0	0	219	0	0	219
16571	3	0	0	217	0	220
16572	1	0	212	3	0	216
16573	218	0	0	0	0	218
16574	0	209	0	0	0	209
16575	0	0	0	208	0	208
16576	0	0	206	0	0	206
16577	0	0	193	2	0	195
16578	203	0	0	0	0	203
16579	0	204	0	0	0	204
16580	214	0	0	0	0	214
16581	205	0	0	0	0	205
16582	203	0	0	0	0	203
16583	0	0	0	205	0	205
16584	0	0	202	0	0	202
16585	0	194	0	0	0	194
16586	0	0	0	208	0	208
16587	0	1	208	0	0	209
16588	1	1	195	0	0	197
16589	0	0	0	211	0	211
16590	0	0	204	0	0	204
16591	212	0	0	0	0	212
16592	1	0	0	199	0	200
16593	1	0	0	212	0	213
16594	212	0	0	0	0	212
16595	0	213	0	0	0	213
16596	225	0	0	0	0	225
16597	0	0	0	228	0	228
16598	0	0	0	229	0	229
16599	0	0	0	236	0	236
16600	0	0	0	245	0	245
16601	235	0	0	0	0	235
16602	0	0	237	0	0	237
16603	0	254	0	0	0	254
16604	0	0	0	268	0	268
16605	260	0	0	0	0	260
16606	271	0	0	0	0	271
16607	1	263	0	0	0	264
16608	262	0	0	0	0	262
16609	0	252	0	0	0	252
16610	3	253	1	0	0	257
16611	0	0	0	262	0	262
16612	0	0	257	0	0	257
16613	0	0	0	262	0	262
16614	264	0	0	0	0	264
16615	0	260	0	0	0	260
16616	1	0	0	264	0	265
16617	0	0	265	0	0	265
16618	270	0	0	0	0	270
16619	269	1	0	0	0	270
16620	273	0	0	0	0	273
16621	1	0	276	0	0	277
16622	271	1	0	0	0	272
16623	0	269	0	0	0	269
16624	0	0	0	268	0	268
16625	0	275	0	0	0	275
16626	281	0	0	0	0	281
16627	274	0	0	0	0	274
16628	0	0	273	0	0	273
16629	0	280	0	0	0	280
16630	0	0	0	289	0	289
16631	0	0	0	279	0	279
16632	0	0	0	284	0	284
16633	0	1	0	285	0	286
16634	1	0	0	288	0	289
16635	0	0	274	0	0	274
16636	0	283	0	0	0	283
16637	288	0	0	0	0	288
16638	0	0	281	0	0	281
16639	0	289	0	0	0	289
16640	294	0	0	0	0	294
16641	0	1	290	1	0	292
16642	283	1	0	3	0	287
16643	290	0	1	0	0	291
16644	291	0	0	0	0	291
16645	0	297	0	0	0	297
16646	0	0	283	3	0	286
16647	0	287	0	1	0	288
16648	0	0	0	286	0	286
16649	1	290	0	1	0	292
16650	293	0	1	0	0	294
16651	301	0	0	0	0	301
16652	301	0	0	0	0	301
16653	0	0	290	0	0	290
16654	0	291	0	0	0	291
16655	0	0	0	300	0	300
16656	296	0	0	0	0	296
16657	0	286	0	0	0	286
16658	0	0	0	302	0	302
16659	0	0	297	0	0	297
16660	306	0	0	0	0	306
16661	0	0	301	0	0	301
16662	0	0	298	0	0	298
16663	304	0	0	0	0	304
16664	0	0	306	0	0	306
16665	300	0	0	1	0	301
16666	0	291	0	0	0	291
16667	302	0	0	0	0	302
16668	2	0	0	299	0	301
16669	0	0	0	301	0	301
16670	0	0	0	312	0	312
16671	309	0	0	0	0	309
16672	302	0	1	0	0	303
16673	310	0	1	0	0	311
16674	0	304	1	0	0	305
16675	0	0	0	317	0	317
16676	0	0	305	0	0	305
16677	0	0	0	303	0	303
16678	0	297	0	0	0	297
16679	0	0	0	310	0	310
16680	0	0	0	300	0	300
16681	305	0	0	0	0	305
16682	0	0	0	305	0	305
16683	0	0	289	0	0	289
16684	3	1	279	0	0	283
16685	0	0	0	297	0	297
16686	292	0	0	0	0	292
16687	0	0	0	298	0	298
16688	2	0	0	297	0	299
16689	0	0	274	0	0	274
16690	0	274	0	2	0	276
16691	0	0	0	286	0	286
16692	285	0	0	1	0	286
16693	0	273	0	0	0	273
16694	0	0	0	284	0	284
16695	0	0	261	0	0	261
16696	0	0	0	252	0	252
16697	248	0	0	0	0	248
16698	0	246	0	0	0	246
16699	0	0	247	0	0	247
16700	0	0	0	246	0	246
16701	0	0	242	0	0	242
16702	253	0	0	0	0	253
16703	258	0	0	0	0	258
16704	0	0	249	0	0	249
16705	0	0	0	255	0	255
16706	1	1	242	0	0	244
16707	0	247	0	0	0	247
16708	0	0	0	256	0	256
16709	1	0	250	0	0	251
16710	0	0	0	243	0	243
16711	0	241	1	0	0	242
16712	0	0	0	246	0	246
16713	0	0	228	1	0	229
16714	238	0	0	1	0	239
16715	0	236	0	0	0	236
16716	238	0	0	1	0	239
16717	1	0	233	0	0	234
16718	233	0	0	0	0	233
16719	0	0	228	0	0	228
16720	227	0	1	0	0	228
16721	220	0	7	0	0	227
16722	0	0	0	228	0	228
16723	0	0	0	236	0	236
16724	230	0	0	0	0	230
16725	0	228	0	0	0	228
16726	226	0	0	1	0	227
16727	0	0	0	225	0	225
16728	0	230	0	0	0	230
16729	0	0	0	232	0	232
16730	0	0	0	232	0	232
16731	0	0	0	235	0	235
16732	0	222	0	0	0	222
16733	216	0	1	0	0	217
16734	0	0	0	218	0	218
16735	0	0	208	0	0	208
16736	1	0	184	1	0	186
16737	0	0	196	0	0	196
16738	202	0	0	0	0	202
16739	207	0	0	0	0	207
16740	0	0	202	0	0	202
16741	0	0	0	199	0	199
16742	0	0	0	201	0	201
16743	0	0	198	0	0	198
16744	0	0	185	0	0	185
16745	0	0	0	199	0	199
16746	204	0	0	0	0	204
16747	201	0	0	0	0	201
16748	200	0	0	0	0	200
16749	0	185	0	0	0	185
16750	0	189	0	0	0	189
16751	0	0	0	199	0	199
16752	197	0	0	0	0	197
16753	0	0	189	0	0	189
16754	184	0	0	1	0	185
16755	0	175	0	1	0	176
16756	0	193	0	0	0	193
16757	187	0	0	0	0	187
16758	0	183	0	1	0	184
16759	0	196	0	0	0	196
16760	200	0	0	0	0	200
16761	0	195	0	0	0	195
16762	2	0	1	201	0	204
16763	0	0	0	199	0	199
16764	193	2	0	0	0	195
16765	197	0	0	0	0	197
16766	0	180	0	1	0	181
16767	0	181	0	2	0	183
16768	0	0	189	0	0	189
16769	196	0	0	0	0	196
16770	195	0	0	0	0	195
16771	197	0	0	0	0	197
16772	0	0	0	192	0	192
16773	0	0	0	195	0	195
16774	195	0	0	0	0	195
16775	0	0	0	203	0	203
16776	0	0	202	0	0	202
16777	0	0	0	200	0	200
16778	0	201	0	0	0	201
16779	0	0	0	201	0	201
16780	1	0	0	210	0	211
16781	0	0	0	206	0	206
16782	203	0	0	0	0	203
16783	0	198	0	0	0	198
16784	0	0	0	197	0	197
16785	1	0	190	0	0	191
16786	1	0	184	0	0	185
16787	0	0	0	197	0	197
16788	0	0	0	192	0	192
16789	195	0	0	1	0	196
16790	0	1	0	197	0	198
16791	0	189	0	0	0	189
16792	0	0	183	0	0	183
16793	2	0	0	185	0	187
16794	0	0	219	0	0	219
16795	0	0	0	220	0	220
16796	220	0	0	1	0	221
16797	220	0	0	0	0	220
16798	0	219	0	0	0	219
16799	0	0	0	218	0	218
16800	202	0	0	1	0	203
16801	211	0	0	0	0	211
16802	216	0	0	0	0	216
16803	211	0	0	0	0	211
16804	207	1	0	0	0	208
16805	1	210	0	0	0	211
16806	217	0	0	0	0	217
16807	0	0	206	0	0	206
16808	2	0	0	211	0	213
16809	222	0	0	0	0	222
16810	215	0	0	0	0	215
16811	220	0	0	0	0	220
16812	0	0	212	0	0	212
16813	0	0	0	220	0	220
16814	219	0	0	0	0	219
16815	0	219	0	0	0	219
16816	226	0	0	0	0	226
16817	216	0	0	0	0	216
16818	226	0	0	0	0	226
16819	0	0	0	228	0	228
16820	225	0	0	0	0	225
16821	0	1	208	1	0	210
16822	0	0	205	0	0	205
16823	222	0	0	0	0	222
16824	0	0	208	0	0	208
16825	216	0	0	0	0	216
16826	0	0	206	0	0	206
16827	1	0	0	210	0	211
16828	216	0	0	1	0	217
16829	0	213	0	0	0	213
16830	214	0	1	0	0	215
16831	0	187	0	1	0	188
16832	0	210	0	0	0	210
16833	1	0	0	225	0	226
16834	1	0	0	236	0	237
16835	0	1	0	231	0	232
16836	0	0	226	0	0	226
16837	238	0	0	1	0	239
16838	228	0	0	0	0	228
16839	230	0	0	0	0	230
16840	225	0	0	1	0	226
16841	239	0	0	0	0	239
16842	1	0	205	0	0	206
16843	0	1	216	0	0	217
16844	2	0	0	227	0	229
16845	3	0	235	1	0	239
16846	231	0	0	1	0	232
16847	0	227	0	0	0	227
16848	1	0	0	236	0	237
16849	232	0	0	0	0	232
16850	0	0	0	234	0	234
16851	0	0	234	1	0	235
16852	0	0	226	0	0	226
16853	0	0	0	238	0	238
16854	0	0	244	0	0	244
16855	248	0	0	1	0	249
16856	0	0	0	242	0	242
16857	0	0	236	0	0	236
16858	0	229	0	0	0	229
16859	0	0	0	249	0	249
16860	0	0	238	0	0	238
16861	0	0	0	239	0	239
16862	0	0	0	244	0	244
16863	0	0	238	0	0	238
16864	1	0	1	230	0	232
16865	0	0	0	234	0	234
16866	0	0	0	247	0	247
16867	235	0	0	0	0	235
16868	0	221	0	1	0	222
16869	2	229	0	1	0	232
16870	0	0	229	0	0	229
16871	237	0	0	0	0	237
16872	0	0	228	0	0	228
16873	1	0	225	3	0	229
16874	0	0	0	243	0	243
16875	237	0	0	0	0	237
16876	0	249	0	0	0	249
16877	246	0	0	1	0	247
16878	244	0	0	0	0	244
16879	0	255	0	0	0	255
16880	250	0	0	0	0	250
16881	244	0	0	0	0	244
16882	0	246	1	0	0	247
16883	0	0	0	251	0	251
16884	0	0	0	248	0	248
16885	248	0	0	1	0	249
16886	0	253	0	0	0	253
16887	255	0	0	0	0	255
16888	258	0	0	0	0	258
16889	262	0	0	0	0	262
16890	0	0	0	257	0	257
16891	0	0	0	247	0	247
16892	256	0	0	0	0	256
16893	254	0	0	0	0	254
16894	249	0	0	2	0	251
16895	0	0	0	247	0	247
16896	0	0	243	0	0	243
16897	0	0	0	245	0	245
16898	0	0	0	238	0	238
16899	0	0	236	0	0	236
16900	0	0	228	0	0	228
16901	0	0	0	240	0	240
16902	0	0	246	0	0	246
16903	245	0	0	0	0	245
16904	1	0	0	251	0	252
16905	0	0	0	254	0	254
16906	255	0	0	0	0	255
16907	0	0	0	262	0	262
16908	0	0	0	267	0	267
16909	0	0	0	275	0	275
16910	0	0	0	269	0	269
16911	0	0	271	0	0	271
16912	2	0	0	273	0	275
16913	0	0	267	0	0	267
16914	0	280	0	0	0	280
16915	0	0	0	283	0	283
16916	0	0	279	0	0	279
16917	283	0	0	2	0	285
16918	0	290	0	0	0	290
16919	293	0	0	0	0	293
16920	0	0	0	291	0	291
16921	1	289	0	0	0	290
16922	288	0	0	0	0	288
16923	0	288	0	0	0	288
16924	300	0	0	0	0	300
16925	0	0	0	301	0	301
16926	299	0	0	0	0	299
16927	0	300	0	0	0	300
16928	312	0	0	0	0	312
16929	0	0	306	0	0	306
16930	1	0	0	306	0	307
16931	307	1	0	0	0	308
16932	308	1	0	0	0	309
16933	0	1	0	312	0	313
16934	0	0	297	1	0	298
16935	0	279	0	0	0	279
16936	0	308	0	0	0	308
16937	323	0	0	0	0	323
16938	0	0	1	313	0	314
16939	0	0	0	320	0	320
16940	325	0	0	0	0	325
16941	337	0	0	0	0	337
16942	0	0	329	0	0	329
16943	0	0	0	326	0	326
16944	1	0	300	0	0	301
16945	0	321	0	1	0	322
16946	318	0	0	0	0	318
16947	0	316	0	0	0	316
16948	0	320	0	0	0	320
16949	0	0	0	330	0	330
16950	332	0	0	0	0	332
16951	0	325	0	0	0	325
16952	336	0	0	0	0	336
16953	0	323	0	0	0	323
16954	0	0	0	340	0	340
16955	337	0	0	0	0	337
16956	0	0	328	0	0	328
16957	1	0	0	333	0	334
16958	1	0	323	0	0	324
16959	0	311	0	0	0	311
16960	0	324	0	0	0	324
16961	323	0	0	1	0	324
16962	0	320	0	0	0	320
16963	329	0	0	0	0	329
16964	340	0	0	0	0	340
16965	0	0	341	0	0	341
16966	347	0	0	0	0	347
16967	0	0	323	0	0	323
16968	0	333	0	0	0	333
16969	342	0	0	0	0	342
16970	0	330	1	1	0	332
16971	0	0	0	346	0	346
16972	350	0	0	0	0	350
16973	3	0	0	347	0	350
16974	0	0	344	0	0	344
16975	0	0	0	346	0	346
16976	0	0	0	356	0	356
16977	356	0	0	0	0	356
16978	0	2	344	0	0	346
16979	341	0	0	0	0	341
16980	350	0	0	0	0	350
16981	1	0	0	347	0	348
16982	1	0	0	350	0	351
16983	354	0	0	0	0	354
16984	1	355	0	2	0	358
16985	0	0	0	342	0	342
16986	0	1	325	1	0	327
16987	0	0	313	0	0	313
16988	0	330	0	1	0	331
16989	0	0	0	337	0	337
16990	0	0	0	330	0	330
16991	338	0	0	1	0	339
16992	1	0	0	334	0	335
16993	328	0	0	0	0	328
16994	0	318	0	0	0	318
16995	1	290	0	1	0	292
16996	0	326	0	0	0	326
16997	338	0	0	0	0	338
16998	337	0	0	0	0	337
16999	0	321	0	0	0	321
17000	326	0	0	0	0	326
17001	0	315	0	0	0	315
17002	0	0	0	323	0	323
17003	0	320	0	0	0	320
17004	323	0	0	0	0	323
17005	313	0	0	0	0	313
17006	0	0	1	312	0	313
17007	303	0	0	1	0	304
17008	0	0	0	302	0	302
17009	0	299	0	1	0	300
17010	0	0	0	303	0	303
17011	0	299	0	0	0	299
17012	301	0	0	0	0	301
17013	0	0	280	0	0	280
17014	290	0	0	0	0	290
17015	0	0	0	302	0	302
17016	0	0	298	0	0	298
17017	301	0	0	0	0	301
17018	0	1	284	0	0	285
17019	2	0	1	293	0	296
17020	0	0	0	298	0	298
17021	0	0	0	291	0	291
17022	0	0	0	296	0	296
17023	0	274	0	1	0	275
17024	0	0	0	294	0	294
17025	292	0	0	2	0	294
17026	0	0	282	0	0	282
17027	0	295	0	0	0	295
17028	305	0	0	0	0	305
17029	299	0	0	0	0	299
17030	0	0	1	297	0	298
17031	0	0	297	0	0	297
17032	0	0	0	289	0	289
17033	1	0	0	300	0	301
17034	0	0	286	0	0	286
17035	0	292	0	0	0	292
17036	306	0	0	0	0	306
17037	313	0	0	0	0	313
17038	302	0	0	0	0	302
17039	0	0	0	308	0	308
17040	0	0	0	293	0	293
17041	303	0	0	0	0	303
17042	0	0	0	311	0	311
17043	0	301	0	0	0	301
17044	317	0	0	0	0	317
17045	306	0	0	1	0	307
17046	323	0	0	0	0	323
17047	317	0	0	0	0	317
17048	0	0	306	0	0	306
17049	0	0	304	0	0	304
17050	0	0	0	327	0	327
17051	0	0	0	327	0	327
17052	0	0	320	0	0	320
17053	0	0	311	0	0	311
17054	0	0	0	324	0	324
17055	327	0	0	0	0	327
17056	0	0	0	328	0	328
17057	0	0	321	0	0	321
17058	0	315	0	0	0	315
17059	321	0	0	0	0	321
17060	321	0	0	1	0	322
17061	327	0	0	0	0	327
17062	327	0	0	0	0	327
17063	1	0	321	0	0	322
17064	1	0	0	319	0	320
17065	322	0	0	0	0	322
17066	0	0	0	322	0	322
17067	0	0	0	320	0	320
17068	0	318	0	0	0	318
17069	0	0	0	323	0	323
17070	324	0	0	0	0	324
17071	0	320	0	0	0	320
17072	328	0	0	0	0	328
17073	0	330	0	0	0	330
17074	0	0	0	338	0	338
17075	0	312	0	0	0	312
17076	0	327	0	0	0	327
17077	331	0	0	0	0	331
17078	0	0	320	0	0	320
17079	1	0	304	1	0	306
17080	0	0	317	0	0	317
17081	322	0	0	0	0	322
17082	1	304	1	0	0	306
17083	0	319	0	0	0	319
17084	318	0	0	2	0	320
17085	0	309	0	5	0	314
17086	0	320	0	0	0	320
17087	1	0	0	332	0	333
17088	0	0	322	0	0	322
17089	0	0	311	1	0	312
17090	0	0	0	329	0	329
17091	332	0	0	1	0	333
17092	0	333	1	0	0	334
17093	0	0	0	335	0	335
17094	0	0	332	1	0	333
17095	0	0	328	1	0	329
17096	0	0	0	350	0	350
17097	359	0	0	0	0	359
17098	361	0	0	0	0	361
17099	0	2	355	0	0	357
17100	363	0	0	3	0	366
17101	0	2	358	0	0	360
17102	2	1	0	359	0	362
17103	0	359	0	0	0	359
17104	372	0	0	0	0	372
17105	0	0	0	371	0	371
17106	1	0	0	367	0	368
17107	0	0	0	369	0	369
17108	0	0	0	370	0	370
17109	0	0	356	0	0	356
17110	0	358	0	0	0	358
17111	0	0	0	377	0	377
17112	363	0	0	0	0	363
17113	0	0	0	358	0	358
17114	0	0	0	359	0	359
17115	0	0	355	0	0	355
17116	0	0	333	3	0	336
17117	0	349	0	3	0	352
17118	1	367	0	1	0	369
17119	0	0	0	379	0	379
17120	361	0	0	0	0	361
17121	0	0	344	0	0	344
17122	0	356	0	0	0	356
17123	1	0	0	358	0	359
17124	0	354	0	0	0	354
17125	0	0	0	357	0	357
17126	2	351	0	0	0	353
17127	0	0	0	365	0	365
17128	353	0	0	0	0	353
17129	0	350	0	0	0	350
17130	0	0	0	348	0	348
17131	339	0	0	0	0	339
17132	0	335	0	0	0	335
17133	0	322	1	1	0	324
17134	0	327	1	4	0	332
17135	0	0	0	336	0	336
17136	0	0	0	331	0	331
17137	0	320	0	1	0	321
17138	0	0	0	324	0	324
17139	1	0	311	0	0	312
17140	0	324	0	1	0	325
17141	1	0	0	318	0	319
17142	0	313	0	0	0	313
17143	0	0	293	0	0	293
17144	0	311	0	0	0	311
17145	317	1	0	0	0	318
17146	0	0	0	320	0	320
17147	323	0	0	0	0	323
17148	0	0	313	0	0	313
17149	1	0	0	316	0	317
17150	0	0	308	0	0	308
17151	0	0	0	309	0	309
17152	311	0	0	0	0	311
17153	0	0	0	304	0	304
17154	298	0	0	1	0	299
17155	0	298	0	0	0	298
17156	311	0	0	0	0	311
17157	0	0	303	0	0	303
17158	0	306	0	0	0	306
17159	0	0	0	326	0	326
17160	0	0	0	332	0	332
17161	0	0	310	0	0	310
17162	0	304	0	0	0	304
17163	0	0	0	313	0	313
17164	0	312	0	0	0	312
17165	0	0	0	313	0	313
17166	3	304	0	0	0	307
17167	310	0	0	0	0	310
17168	0	0	0	307	0	307
17169	0	0	275	0	0	275
17170	0	286	1	0	0	287
17171	0	279	0	0	0	279
17172	0	0	279	0	0	279
17173	0	274	0	1	0	275
17174	0	0	0	287	0	287
17175	0	0	284	0	0	284
17176	0	0	0	288	0	288
17177	0	0	0	298	0	298
17178	0	0	293	0	0	293
17179	293	0	0	0	0	293
17180	0	0	0	287	0	287
17181	0	0	274	0	0	274
17182	0	280	0	0	0	280
17183	284	0	0	0	0	284
17184	0	277	0	0	0	277
17185	0	0	0	288	0	288
17186	282	0	0	0	0	282
17187	0	0	0	278	0	278
17188	0	0	263	1	0	264
17189	0	0	0	260	0	260
17190	0	0	259	0	0	259
17191	259	0	0	0	0	259
17192	1	0	246	0	0	247
17193	252	0	0	0	0	252
17194	249	0	0	0	0	249
17195	0	0	237	0	0	237
17196	0	0	220	0	0	220
17197	0	235	0	0	0	235
17198	248	0	0	1	0	249
17199	0	0	0	245	0	245
17200	0	0	0	247	0	247
17201	254	0	0	1	0	255
17202	249	0	0	1	0	250
17203	244	0	0	0	0	244
17204	242	0	0	0	0	242
17205	0	0	0	244	0	244
17206	241	0	0	0	0	241
17207	0	0	0	249	0	249
17208	0	0	0	240	0	240
17209	0	0	0	244	0	244
17210	0	0	230	0	0	230
17211	0	211	1	1	0	213
17212	0	217	2	0	0	219
17213	0	0	0	233	0	233
17214	236	0	0	0	0	236
17215	0	0	0	237	0	237
17216	242	0	0	0	0	242
17217	0	0	223	0	0	223
17218	233	0	0	0	0	233
17219	0	0	0	224	0	224
17220	227	0	0	1	0	228
17221	223	0	0	0	0	223
17222	222	0	0	1	0	223
17223	0	0	0	220	0	220
17224	0	0	224	0	0	224
17225	0	0	0	228	0	228
17226	229	0	0	0	0	229
17227	0	0	227	0	0	227
17228	0	0	0	234	0	234
17229	232	0	0	0	0	232
17230	0	0	230	0	0	230
17231	237	0	0	0	0	237
17232	242	0	0	0	0	242
17233	0	0	0	238	0	238
17234	1	0	0	234	0	235
17235	243	0	0	0	0	243
17236	1	0	0	249	0	250
17237	238	0	0	1	0	239
17238	0	236	1	0	0	237
17239	1	236	0	1	0	238
17240	0	0	0	250	0	250
17241	0	0	239	0	0	239
17242	0	247	0	0	0	247
17243	249	0	0	0	0	249
17244	0	240	0	0	0	240
17245	0	0	239	0	0	239
17246	0	0	0	245	0	245
17247	0	0	240	0	0	240
17248	0	242	0	1	0	243
17249	1	0	0	244	0	245
17250	0	230	0	0	0	230
17251	0	0	228	0	0	228
17252	1	0	0	233	0	234
17253	0	0	231	0	0	231
17254	0	0	0	224	0	224
17255	229	0	0	0	0	229
17256	1	0	227	0	0	228
17257	226	0	0	2	0	228
17258	0	0	227	0	0	227
17259	0	0	0	221	0	221
17260	0	0	237	0	0	237
17261	0	0	0	223	0	223
17262	0	0	0	227	0	227
17263	0	0	0	227	0	227
17264	0	0	0	238	0	238
17265	0	0	232	1	0	233
17266	234	0	0	1	0	235
17267	0	0	0	234	0	234
17268	233	0	0	0	0	233
17269	229	0	0	1	0	230
17270	239	0	0	0	0	239
17271	1	0	0	233	0	234
17272	0	0	0	234	0	234
17273	0	233	0	0	0	233
17274	248	0	0	0	0	248
17275	251	0	0	0	0	251
17276	250	0	0	0	0	250
17277	0	0	248	0	0	248
17278	0	0	0	247	0	247
17279	0	0	245	0	0	245
17280	244	0	0	1	0	245
17281	251	0	0	0	0	251
17282	0	0	0	251	0	251
17283	1	0	0	245	0	246
17284	1	240	0	0	0	241
17285	245	0	0	1	0	246
17286	246	1	0	0	0	247
17287	0	245	0	0	0	245
17288	245	0	0	0	0	245
17289	0	0	0	243	0	243
17290	1	0	1	250	0	252
17291	244	0	0	0	0	244
17292	0	0	242	0	0	242
17293	248	0	0	0	0	248
17294	245	0	0	0	0	245
17295	0	233	0	0	0	233
17296	243	3	0	0	0	246
17297	0	0	242	0	0	242
17298	0	0	0	247	0	247
17299	243	0	0	0	0	243
17300	0	0	0	241	0	241
17301	0	0	233	0	0	233
17302	0	0	0	230	0	230
17303	0	226	0	0	0	226
17304	0	0	0	241	0	241
17305	1	0	0	236	0	237
17306	1	0	0	235	0	236
17307	0	0	0	235	0	235
17308	0	0	239	0	0	239
17309	0	0	0	232	0	232
17310	227	0	0	1	0	228
17311	0	236	0	0	0	236
17312	0	0	0	237	0	237
17313	0	0	236	0	0	236
17314	0	0	0	234	0	234
17315	243	0	0	0	0	243
17316	241	0	0	0	0	241
17317	230	0	0	0	0	230
17318	0	0	0	239	0	239
17319	0	0	233	0	0	233
17320	0	235	1	0	0	236
17321	229	0	0	0	0	229
17322	0	0	0	240	0	240
17323	0	0	0	231	0	231
17324	0	0	225	0	0	225
17325	0	209	0	0	0	209
17326	0	218	1	0	0	219
17327	0	0	0	224	0	224
17328	0	0	227	0	0	227
17329	224	0	0	0	0	224
17330	0	0	204	0	0	204
17331	207	0	0	1	0	208
17332	0	203	1	0	0	204
17333	0	0	213	0	0	213
17334	207	0	0	0	0	207
17335	1	199	0	0	0	200
17336	214	0	0	0	0	214
17337	0	1	204	0	0	205
17338	0	215	0	0	0	215
17339	217	0	1	0	0	218
17340	0	0	213	0	0	213
17341	218	0	0	0	0	218
17342	0	0	0	220	0	220
17343	219	0	0	0	0	219
17344	0	0	0	224	0	224
17345	223	0	0	0	0	223
17346	0	0	215	0	0	215
17347	0	1	0	221	0	222
17348	0	0	0	218	0	218
17349	0	0	213	0	0	213
17350	0	0	0	217	0	217
17351	0	208	0	0	0	208
17352	0	0	0	227	0	227
17353	1	0	0	226	0	227
17354	0	0	0	237	0	237
17355	0	0	224	0	0	224
17356	235	0	0	0	0	235
17357	0	0	0	250	0	250
17358	0	0	250	1	0	251
17359	255	0	0	0	0	255
17360	257	0	0	1	0	258
17361	270	0	0	1	0	271
17362	0	0	0	264	0	264
17363	0	0	0	278	0	278
17364	1	0	0	269	0	270
17365	0	275	0	0	0	275
17366	275	0	0	0	0	275
17367	264	0	0	0	0	264
17368	0	0	0	268	0	268
17369	0	0	254	0	0	254
17370	1	1	236	0	0	238
17371	1	226	0	1	0	228
17372	0	247	0	0	0	247
17373	261	0	0	0	0	261
17374	0	261	0	0	0	261
17375	261	0	0	0	0	261
17376	265	1	0	1	0	267
17377	259	0	0	0	0	259
17378	0	0	0	271	0	271
17379	0	0	0	270	0	270
17380	267	0	0	0	0	267
17381	0	0	0	273	0	273
17382	0	0	264	0	0	264
17383	272	0	0	0	0	272
17384	2	0	0	264	0	266
17385	1	0	0	260	0	261
17386	0	0	0	267	0	267
17387	0	0	260	0	0	260
17388	265	0	0	0	0	265
17389	0	0	259	0	0	259
17390	0	0	0	258	0	258
17391	0	0	254	0	0	254
17392	0	0	0	253	0	253
17393	0	1	0	249	0	250
17394	0	0	258	0	0	258
17395	0	0	0	252	0	252
17396	0	250	0	0	0	250
17397	251	0	0	1	0	252
17398	253	0	0	1	0	254
17399	0	0	0	254	0	254
17400	0	0	261	0	0	261
17401	0	245	1	0	0	246
17402	0	257	0	0	0	257
17403	270	0	0	0	0	270
17404	1	0	258	0	0	259
17405	257	0	8	1	0	266
17406	0	0	0	264	0	264
17407	0	0	1	259	0	260
17408	255	0	0	0	0	255
17409	0	260	1	0	0	261
17410	0	0	263	0	0	263
17411	1	0	0	261	0	262
17412	0	0	262	0	0	262
17413	0	261	0	0	0	261
17414	0	0	0	263	0	263
17415	265	0	0	0	0	265
17416	269	0	0	0	0	269
17417	1	0	265	0	0	266
17418	0	258	0	0	0	258
17419	266	0	0	0	0	266
17420	0	262	0	0	0	262
17421	0	0	0	268	0	268
17422	262	0	0	0	0	262
17423	0	0	0	265	0	265
17424	0	0	260	0	0	260
17425	0	0	0	262	0	262
17426	0	0	260	0	0	260
17427	0	0	0	267	0	267
17428	265	0	1	0	0	266
17429	0	259	0	0	0	259
17430	263	0	0	2	0	265
17431	0	0	0	265	0	265
17432	0	0	0	262	0	262
17433	2	0	242	0	0	244
17434	0	0	246	0	0	246
17435	0	257	0	0	0	257
17436	0	0	257	2	0	259
17437	261	0	0	0	0	261
17438	0	235	0	1	0	236
17439	0	219	0	0	0	219
17440	0	247	0	0	0	247
17441	0	0	0	252	0	252
17442	0	0	247	0	0	247
17443	0	239	0	0	0	239
17444	0	1	0	248	0	249
17445	1	240	0	0	0	241
17446	243	0	0	0	0	243
17447	234	0	5	0	0	239
17448	0	0	0	249	0	249
17449	0	0	0	244	0	244
17450	225	0	0	0	0	225
17451	0	205	0	0	0	205
17452	0	193	0	0	0	193
17453	0	0	0	187	0	187
17454	0	0	170	0	0	170
17455	0	161	0	1	0	162
17456	161	0	0	0	0	161
17457	1	146	0	1	0	148
17458	0	160	0	0	0	160
17459	156	0	0	0	0	156
17460	0	150	0	0	0	150
17461	0	0	146	0	0	146
17462	0	154	0	0	0	154
17463	156	0	0	0	0	156
17464	0	151	0	0	0	151
17465	153	0	0	0	0	153
17466	0	0	0	144	0	144
17467	0	0	0	151	0	151
17468	0	0	151	0	0	151
17469	0	148	0	0	0	148
17470	0	0	0	147	0	147
17471	152	0	0	0	0	152
17472	141	0	0	0	0	141
17473	0	152	0	0	0	152
17474	0	0	0	153	0	153
17475	151	0	0	0	0	151
17476	147	0	0	0	0	147
17477	0	0	140	0	0	140
17478	1	0	139	0	0	140
17479	0	0	133	0	0	133
17480	0	145	0	0	0	145
17481	148	0	0	1	0	149
17482	0	144	0	0	0	144
17483	150	0	0	0	0	150
17484	0	148	0	0	0	148
17485	0	0	0	150	0	150
17486	149	0	0	0	0	149
17487	0	1	140	0	0	141
17488	149	0	0	0	0	149
17489	145	0	0	0	0	145
17490	0	131	0	0	0	131
17491	0	141	0	0	0	141
17492	148	0	0	0	0	148
17493	0	0	138	0	0	138
17494	144	0	0	0	0	144
17495	141	0	0	0	0	141
17496	0	0	0	154	0	154
17497	145	0	0	0	0	145
17498	0	0	0	158	0	158
17499	0	0	0	160	0	160
17500	0	0	0	169	0	169
17501	0	159	0	0	0	159
17502	168	0	0	0	0	168
17503	167	0	0	0	0	167
17504	0	0	0	168	0	168
17505	0	0	0	161	0	161
17506	0	163	0	0	0	163
17507	160	0	0	0	0	160
17508	0	0	163	0	0	163
17509	0	0	0	167	0	167
17510	0	0	152	0	0	152
17511	0	0	0	159	0	159
17512	0	0	155	0	0	155
17513	0	0	0	163	0	163
17514	164	0	1	0	0	165
17515	0	0	162	0	0	162
17516	160	0	0	0	0	160
17517	0	165	0	0	0	165
17518	2	0	0	168	0	170
17519	0	0	0	165	0	165
17520	168	0	0	0	0	168
17521	0	0	0	167	0	167
17522	0	0	158	0	0	158
17523	169	0	0	0	0	169
17524	169	0	0	0	0	169
17525	172	0	0	0	0	172
17526	170	0	0	0	0	170
17527	0	168	0	0	0	168
17528	0	0	0	172	0	172
17529	162	0	0	0	0	162
17530	1	0	0	165	0	166
17531	167	0	0	0	0	167
17532	0	0	154	0	0	154
17533	0	0	156	1	0	157
17534	0	0	0	160	0	160
17535	0	154	0	1	0	155
17536	0	156	0	0	0	156
17537	160	0	0	0	0	160
17538	0	0	163	0	0	163
17539	160	0	0	0	0	160
17540	0	163	0	0	0	163
17541	161	0	0	0	0	161
17542	1	0	0	163	0	164
17543	0	0	152	0	0	152
17544	1	0	0	152	0	153
17545	0	0	0	155	0	155
17546	1	143	0	0	0	144
17547	0	154	0	0	0	154
17548	0	0	0	157	0	157
17549	0	155	0	0	0	155
17550	1	0	145	0	0	146
17551	0	0	138	0	0	138
17552	151	0	0	0	0	151
17553	150	0	0	2	0	152
17554	0	157	0	0	0	157
17555	1	0	0	155	0	156
17556	0	0	0	156	0	156
17557	0	0	149	0	0	149
17558	1	0	0	145	0	146
17559	0	147	0	0	0	147
17560	0	0	148	0	0	148
17561	0	0	141	1	0	142
17562	0	145	0	0	0	145
17563	0	0	147	0	0	147
17564	0	0	0	155	0	155
17565	0	0	0	152	0	152
17566	0	0	152	0	0	152
17567	0	0	0	145	0	145
17568	0	154	1	0	0	155
17569	0	158	0	0	0	158
17570	0	0	0	166	0	166
17571	0	0	162	0	0	162
17572	0	154	0	0	0	154
17573	0	0	0	164	0	164
17574	0	0	164	0	0	164
17575	159	0	0	0	0	159
17576	161	0	0	0	0	161
17577	165	0	0	0	0	165
17578	0	0	0	160	0	160
17579	0	0	0	162	0	162
17580	0	0	164	0	0	164
17581	0	0	0	165	0	165
17582	0	0	0	168	0	168
17583	0	0	164	0	0	164
17584	164	0	0	0	0	164
17585	0	166	0	0	0	166
17586	162	0	0	0	0	162
17587	0	159	1	0	0	160
17588	0	0	0	167	0	167
17589	0	0	159	0	0	159
17590	0	0	0	156	0	156
17591	0	0	146	0	0	146
17592	146	0	0	0	0	146
17593	0	0	142	0	0	142
17594	0	0	0	144	0	144
17595	0	0	139	0	0	139
17596	0	136	0	0	0	136
17597	0	0	0	148	0	148
17598	0	0	0	150	0	150
17599	1	0	0	155	0	156
17600	0	0	158	0	0	158
17601	0	0	152	1	0	153
17602	0	0	0	164	0	164
17603	0	0	0	169	0	169
17604	0	0	0	175	0	175
17605	173	0	0	0	0	173
17606	0	0	0	179	0	179
17607	0	0	178	0	0	178
17608	183	0	0	0	0	183
17609	0	0	0	181	0	181
17610	185	0	1	0	0	186
17611	183	0	0	0	0	183
17612	0	0	0	188	0	188
17613	189	0	0	0	0	189
17614	194	0	0	0	0	194
17615	0	0	192	0	0	192
17616	1	179	0	0	0	180
17617	0	0	0	183	0	183
17618	0	0	0	184	0	184
17619	185	0	0	0	0	185
17620	181	0	0	0	0	181
17621	182	0	0	0	0	182
17622	0	0	179	0	0	179
17623	1	183	0	0	0	184
17624	183	0	0	0	0	183
17625	0	189	0	0	0	189
17626	189	0	0	0	0	189
17627	0	0	0	186	0	186
17628	194	0	0	0	0	194
17629	188	0	0	0	0	188
17630	188	0	0	0	0	188
17631	0	0	188	0	0	188
17632	179	0	0	1	0	180
17633	0	194	0	0	0	194
17634	193	0	0	1	0	194
17635	196	0	0	0	0	196
17636	192	0	0	0	0	192
17637	0	0	0	198	0	198
17638	0	204	0	0	0	204
17639	204	0	0	0	0	204
17640	0	0	192	0	0	192
17641	0	186	1	0	0	187
17642	1	0	0	191	0	192
17643	0	190	0	0	0	190
17644	199	0	0	0	0	199
17645	194	0	0	0	0	194
17646	0	0	0	196	0	196
17647	0	0	189	0	0	189
17648	0	190	0	0	0	190
17649	0	0	0	195	0	195
17650	0	0	0	193	0	193
17651	1	0	0	196	0	197
17652	199	0	0	0	0	199
17653	200	0	0	0	0	200
17654	193	0	0	0	0	193
17655	195	0	0	0	0	195
17656	0	0	0	196	0	196
17657	0	0	194	0	0	194
17658	0	0	0	200	0	200
17659	0	0	0	195	0	195
17660	0	0	0	194	0	194
17661	0	0	0	188	0	188
17662	191	0	0	0	0	191
17663	1	0	0	183	0	184
17664	181	0	0	0	0	181
17665	185	0	0	0	0	185
17666	0	0	181	0	0	181
17667	0	0	163	0	0	163
17668	0	0	184	0	0	184
17669	1	0	1	179	0	181
17670	0	0	181	0	0	181
17671	0	0	0	175	0	175
17672	1	0	1	180	0	182
17673	182	0	0	0	0	182
17674	0	0	0	182	0	182
17675	0	181	1	2	0	184
17676	178	0	0	0	0	178
17677	0	170	0	0	0	170
17678	1	0	182	1	0	184
17679	0	189	0	0	0	189
17680	186	0	0	0	0	186
17681	0	0	0	184	0	184
17682	0	0	180	0	0	180
17683	181	0	0	1	0	182
17684	0	0	0	181	0	181
17685	0	0	179	0	0	179
17686	0	0	0	187	0	187
17687	0	0	0	179	0	179
17688	0	0	0	175	0	175
17689	0	179	0	0	0	179
17690	179	0	0	0	0	179
17691	0	0	0	182	0	182
17692	0	164	0	0	0	164
17693	0	0	0	165	0	165
17694	0	0	164	0	0	164
17695	0	161	0	0	0	161
17696	161	0	0	0	0	161
17697	164	0	0	1	0	165
17698	0	0	1	158	0	159
17699	0	0	0	156	0	156
17700	151	0	0	0	0	151
17701	154	0	0	0	0	154
17702	0	146	0	0	0	146
17703	145	0	1	1	0	147
17704	0	0	141	0	0	141
17705	1	0	139	0	0	140
17706	0	137	0	0	0	137
17707	0	138	0	0	0	138
17708	144	0	0	0	0	144
17709	0	145	0	0	0	145
17710	147	0	0	0	0	147
17711	149	0	0	0	0	149
17712	139	0	0	0	0	139
17713	0	0	0	145	0	145
17714	147	0	0	0	0	147
17715	0	0	137	0	0	137
17716	0	0	130	0	0	130
17717	0	135	0	0	0	135
17718	0	0	134	0	0	134
17719	0	0	0	135	0	135
17720	0	0	129	1	0	130
17721	0	0	128	0	0	128
17722	0	0	0	135	0	135
17723	135	0	0	0	0	135
17724	135	0	0	0	0	135
17725	0	1	133	0	0	134
17726	135	0	0	1	0	136
17727	0	0	136	0	0	136
17728	133	0	0	0	0	133
17729	136	0	0	0	0	136
17730	0	0	0	130	0	130
17731	0	0	0	134	0	134
17732	1	118	0	0	0	119
17733	0	134	0	0	0	134
17734	0	0	0	137	0	137
17735	0	0	0	138	0	138
17736	130	0	0	0	0	130
17737	0	132	0	0	0	132
17738	136	0	0	0	0	136
17739	1	138	0	0	0	139
17740	0	0	128	0	0	128
17741	0	0	0	133	0	133
17742	137	0	0	1	0	138
17743	135	0	0	0	0	135
17744	0	127	0	0	0	127
17745	0	123	0	1	0	124
17746	0	135	0	1	0	136
17747	0	0	0	140	0	140
17748	0	0	131	0	0	131
17749	0	134	0	0	0	134
17750	0	0	0	131	0	131
17751	0	0	0	135	0	135
17752	0	0	128	0	0	128
17753	0	0	121	0	0	121
17754	130	0	0	0	0	130
17755	0	0	130	0	0	130
17756	130	0	0	0	0	130
17757	128	0	0	0	0	128
17758	132	0	0	0	0	132
17759	128	0	0	0	0	128
17760	0	0	124	0	0	124
17761	0	125	0	0	0	125
17762	0	0	0	126	0	126
17763	0	0	127	0	0	127
17764	0	0	0	123	0	123
17765	0	113	0	0	0	113
17766	0	0	0	129	0	129
17767	0	0	0	126	0	126
17768	1	0	0	128	0	129
17769	127	0	1	1	0	129
17770	0	0	0	133	0	133
17771	0	0	0	128	0	128
17772	0	0	0	128	0	128
17773	0	126	0	0	0	126
17774	126	0	0	0	0	126
17775	0	119	0	0	0	119
17776	0	125	0	0	0	125
17777	0	0	0	129	0	129
17778	0	1	0	129	0	130
17779	128	0	0	0	0	128
17780	0	0	0	135	0	135
17781	134	0	0	0	0	134
17782	129	0	0	0	0	129
17783	0	0	0	141	0	141
17784	0	0	0	139	0	139
17785	0	139	0	0	0	139
17786	136	0	0	1	0	137
17787	0	137	0	0	0	137
17788	137	0	0	1	0	138
17789	0	0	140	0	0	140
17790	136	0	0	0	0	136
17791	143	0	0	0	0	143
17792	0	0	0	139	0	139
17793	0	0	139	0	0	139
17794	0	137	0	0	0	137
17795	0	0	0	140	0	140
17796	0	0	140	0	0	140
17797	0	0	0	140	0	140
17798	143	0	0	0	0	143
17799	0	0	137	0	0	137
17800	0	123	0	0	0	123
17801	0	133	0	0	0	133
17802	0	0	0	135	0	135
17803	0	137	0	0	0	137
17804	138	0	0	0	0	138
17805	134	0	0	1	0	135
17806	141	0	0	0	0	141
17807	0	0	136	0	0	136
17808	144	0	0	0	0	144
17809	0	0	0	140	0	140
17810	0	0	0	139	0	139
17811	0	0	0	141	0	141
17812	0	0	0	144	0	144
17813	0	0	138	0	0	138
17814	0	0	134	0	0	134
17815	0	1	140	0	0	141
17816	151	0	0	0	0	151
17817	0	151	0	0	0	151
17818	0	0	0	152	0	152
17819	153	0	0	0	0	153
17820	0	144	0	1	0	145
17821	0	152	0	0	0	152
17822	151	0	0	0	0	151
17823	155	0	0	0	0	155
17824	0	155	0	0	0	155
17825	0	1	0	153	0	154
17826	0	149	0	0	0	149
17827	148	0	0	0	0	148
17828	144	0	0	0	0	144
17829	148	0	0	0	0	148
17830	0	137	0	0	0	137
17831	0	0	0	147	0	147
17832	0	0	144	0	0	144
17833	1	0	0	141	0	142
17834	0	0	0	147	0	147
17835	0	0	143	0	0	143
17836	138	0	0	0	0	138
17837	0	0	0	143	0	143
17838	0	0	0	142	0	142
17839	0	137	0	0	0	137
17840	143	0	0	0	0	143
17841	0	0	0	136	0	136
17842	0	138	0	0	0	138
17843	136	0	0	0	0	136
17844	0	135	0	0	0	135
17845	138	0	0	0	0	138
17846	0	0	123	0	0	123
17847	0	0	125	0	0	125
17848	0	1	129	0	0	130
17849	0	134	0	0	0	134
17850	0	0	0	129	0	129
17851	0	132	0	0	0	132
17852	130	0	0	0	0	130
17853	0	0	132	0	0	132
17854	133	0	0	0	0	133
17855	135	0	0	0	0	135
17856	4	0	0	125	0	129
17857	133	0	0	0	0	133
17858	0	0	0	131	0	131
17859	0	0	128	0	0	128
17860	132	0	0	0	0	132
17861	0	126	0	0	0	126
17862	0	0	0	128	0	128
17863	122	0	0	0	0	122
17864	0	0	0	120	0	120
17865	0	0	119	0	0	119
17866	0	0	0	123	0	123
17867	0	122	0	0	0	122
17868	129	0	0	0	0	129
17869	0	0	0	127	0	127
17870	134	0	0	0	0	134
17871	0	0	0	135	0	135
17872	0	0	0	132	0	132
17873	0	131	0	0	0	131
17874	129	0	0	0	0	129
17875	0	126	0	0	0	126
17876	0	0	0	116	0	116
17877	0	115	0	0	0	115
17878	119	0	0	0	0	119
17879	118	0	0	0	0	118
17880	116	0	0	0	0	116
17881	0	115	0	0	0	115
17882	0	114	0	0	0	114
17883	117	0	0	0	0	117
17884	0	109	0	0	0	109
17885	0	0	0	114	0	114
17886	0	0	116	0	0	116
17887	112	0	0	3	0	115
17888	116	0	0	0	0	116
17889	113	0	0	0	0	113
17890	0	111	0	0	0	111
17891	110	0	0	4	0	114
17892	0	0	103	0	0	103
17893	0	109	0	0	0	109
17894	0	0	0	119	0	119
17895	0	121	0	0	0	121
17896	115	0	0	0	0	115
17897	0	121	0	0	0	121
17898	0	0	0	124	0	124
17899	0	117	0	0	0	117
17900	0	0	0	117	0	117
17901	0	0	0	115	0	115
17902	0	0	122	0	0	122
17903	1	0	0	119	0	120
17904	121	1	0	0	0	122
17905	122	0	0	0	0	122
17906	0	4	0	112	0	116
17907	0	1	115	4	0	120
17908	1	0	1	109	0	111
17909	117	0	0	0	0	117
17910	110	0	1	0	0	111
17911	104	0	0	0	0	104
17912	0	104	0	0	0	104
17913	106	0	0	1	0	107
17914	0	0	100	0	0	100
17915	112	0	0	0	0	112
17916	0	0	0	105	0	105
17917	0	0	0	111	0	111
17918	0	1	0	104	0	105
17919	109	0	0	0	0	109
17920	108	0	0	0	0	108
17921	1	0	0	105	0	106
17922	0	0	109	0	0	109
17923	0	0	0	113	0	113
17924	0	0	0	114	0	114
17925	1	0	104	0	0	105
17926	0	112	0	0	0	112
17927	1	0	0	112	0	113
17928	116	0	1	0	0	117
17929	0	0	0	117	0	117
17930	0	0	0	116	0	116
17931	115	0	0	2	0	117
17932	0	109	0	0	0	109
17933	0	108	0	0	0	108
17934	107	0	0	0	0	107
17935	0	0	104	0	0	104
17936	103	0	0	0	0	103
17937	0	0	107	0	0	107
17938	0	106	0	0	0	106
17939	112	0	0	0	0	112
17940	108	0	0	0	0	108
17941	109	0	0	0	0	109
17942	107	0	0	1	0	108
17943	1	0	107	0	0	108
17944	0	0	0	111	0	111
17945	114	0	0	0	0	114
17946	0	0	105	0	0	105
17947	0	0	104	0	0	104
17948	0	107	0	0	0	107
17949	113	0	0	0	0	113
17950	0	1	0	107	0	108
17951	109	0	0	0	0	109
17952	0	106	0	0	0	106
17953	0	0	0	112	0	112
17954	0	0	0	109	0	109
17955	0	0	0	109	0	109
17956	0	0	109	0	0	109
17957	0	111	0	0	0	111
17958	108	0	0	0	0	108
17959	0	0	0	108	0	108
17960	112	0	0	0	0	112
17961	108	0	0	0	0	108
17962	0	0	0	103	0	103
17963	0	0	97	0	0	97
17964	0	0	0	102	0	102
17965	0	101	0	0	0	101
17966	0	0	0	110	0	110
17967	0	0	100	0	0	100
17968	104	0	0	0	0	104
17969	0	0	0	107	0	107
17970	109	0	0	0	0	109
17971	0	0	101	0	0	101
17972	100	0	0	0	0	100
17973	0	0	98	0	0	98
17974	97	0	0	0	0	97
17975	0	95	0	0	0	95
17976	0	101	0	0	0	101
17977	0	0	0	105	0	105
17978	0	0	0	107	0	107
17979	0	0	0	102	0	102
17980	106	0	0	0	0	106
17981	0	0	0	110	0	110
17982	0	0	111	0	0	111
17983	106	0	0	0	0	106
17984	0	111	0	0	0	111
17985	107	0	0	0	0	107
17986	105	0	0	0	0	105
17987	0	0	102	0	0	102
17988	0	0	0	96	0	96
17989	0	0	0	94	0	94
17990	0	0	97	0	0	97
17991	0	99	0	0	0	99
17992	102	0	0	0	0	102
17993	100	0	0	0	0	100
17994	0	0	0	100	0	100
17995	0	0	0	107	0	107
17996	0	0	0	107	0	107
17997	105	0	0	0	0	105
17998	0	107	0	0	0	107
17999	111	0	0	0	0	111
18000	111	0	0	0	0	111
18001	0	0	113	0	0	113
18002	0	0	0	110	0	110
18003	0	108	0	0	0	108
18004	0	0	0	115	0	115
18005	0	0	0	113	0	113
18006	0	1	111	0	0	112
18007	112	0	0	0	0	112
18008	119	0	0	0	0	119
18009	119	0	0	0	0	119
18010	0	0	0	121	0	121
18011	0	0	0	122	0	122
18012	0	118	0	0	0	118
18013	0	121	0	0	0	121
18014	130	0	0	0	0	130
18015	0	128	0	0	0	128
18016	0	0	133	0	0	133
18017	0	0	0	136	0	136
18018	135	0	0	0	0	135
18019	0	0	132	0	0	132
18020	0	0	128	0	0	128
18021	131	0	0	0	0	131
18022	130	0	0	1	0	131
18023	0	0	0	134	0	134
18024	0	0	131	0	0	131
18025	0	0	0	132	0	132
18026	0	0	128	0	0	128
18027	2	0	123	0	0	125
18028	0	133	0	0	0	133
18029	132	0	0	0	0	132
18030	124	1	0	1	0	126
18031	0	125	0	0	0	125
18032	0	0	0	128	0	128
18033	0	1	0	130	0	131
18034	0	0	0	132	0	132
18035	132	0	0	0	0	132
18036	0	132	0	0	0	132
18037	131	0	0	0	0	131
18038	129	0	0	0	0	129
18039	1	0	123	0	0	124
18040	0	121	0	1	0	122
18041	0	0	0	130	0	130
18042	0	0	131	0	0	131
18043	131	0	0	1	0	132
18044	131	0	1	0	0	132
18045	134	0	0	0	0	134
18046	133	0	0	0	0	133
18047	2	0	0	132	0	134
18048	0	0	130	0	0	130
18049	0	0	0	131	0	131
18050	132	0	0	3	0	135
18051	130	0	0	0	0	130
18052	0	129	0	0	0	129
18053	132	0	0	0	0	132
18054	0	0	120	1	0	121
18055	1	0	116	1	0	118
18056	128	0	0	0	0	128
18057	0	126	0	0	0	126
18058	0	0	0	126	0	126
18059	0	120	0	0	0	120
18060	0	0	0	125	0	125
18061	0	0	0	120	0	120
18062	0	0	0	124	0	124
18063	119	0	0	0	0	119
18064	121	0	0	0	0	121
18065	121	0	0	0	0	121
18066	0	0	117	0	0	117
18067	121	0	0	0	0	121
18068	0	0	1	117	0	118
18069	0	0	0	117	0	117
18070	0	0	114	0	0	114
18071	0	0	0	110	0	110
18072	116	0	0	0	0	116
18073	0	0	112	0	0	112
18074	0	0	0	110	0	110
18075	109	0	0	0	0	109
18076	113	0	0	0	0	113
18077	0	0	106	0	0	106
18078	0	1	112	0	0	113
18079	2	0	0	113	0	115
18080	115	0	0	0	0	115
18081	113	1	0	0	0	114
18082	0	1	0	114	0	115
18083	0	111	0	1	0	112
18084	110	0	0	0	0	110
18085	0	101	0	0	0	101
18086	0	0	0	107	0	107
18087	0	0	105	0	0	105
18088	1	0	91	0	0	92
18089	0	0	103	0	0	103
18090	0	0	0	108	0	108
18091	1	0	0	110	0	111
18092	105	0	0	0	0	105
18093	0	103	0	0	0	103
18094	102	0	0	1	0	103
18095	0	0	0	102	0	102
18096	0	93	0	0	0	93
18097	0	100	0	0	0	100
18098	0	0	0	100	0	100
18099	90	0	0	0	0	90
18100	0	92	0	0	0	92
18101	85	0	0	0	0	85
18102	0	80	0	2	0	82
18103	80	1	0	0	0	81
18104	0	1	73	0	0	74
18105	0	0	73	0	0	73
18106	0	75	0	0	0	75
18107	70	0	0	0	0	70
18108	0	64	0	0	0	64
18109	0	59	0	0	0	59
18110	0	0	0	60	0	60
18111	61	0	0	0	0	61
18112	0	55	0	0	0	55
18113	57	0	1	0	0	58
18114	0	59	0	0	0	59
18115	59	0	0	0	0	59
18116	0	55	0	0	0	55
18117	0	57	0	0	0	57
18118	0	0	0	58	0	58
18119	0	55	0	0	0	55
18120	59	0	0	0	0	59
18121	0	0	55	0	0	55
18122	0	0	0	60	0	60
18123	0	0	58	0	0	58
18124	1	0	0	59	0	60
18125	0	0	0	61	0	61
18126	0	0	58	0	0	58
18127	58	0	0	0	0	58
18128	0	59	0	0	0	59
18129	62	0	0	0	0	62
18130	0	62	0	0	0	62
18131	0	0	0	64	0	64
18132	66	0	0	0	0	66
18133	65	0	0	0	0	65
18134	63	2	0	0	0	65
18135	0	0	0	63	0	63
18136	0	0	0	61	0	61
18137	0	62	0	0	0	62
18138	65	0	0	0	0	65
18139	61	0	0	0	0	61
18140	61	0	0	0	0	61
18141	63	0	0	0	0	63
18142	0	64	0	0	0	64
18143	0	0	0	65	0	65
18144	0	0	60	0	0	60
18145	64	0	0	0	0	64
18146	65	0	0	0	0	65
18147	0	0	57	0	0	57
18148	0	0	57	0	0	57
18149	1	0	0	63	0	64
18150	0	0	0	64	0	64
18151	0	0	0	61	0	61
18152	69	0	0	0	0	69
18153	0	0	0	70	0	70
18154	0	0	70	0	0	70
18155	0	0	0	69	0	69
18156	0	0	67	0	0	67
18157	0	0	0	74	0	74
18158	0	0	0	72	0	72
18159	0	0	74	0	0	74
18160	71	0	0	0	0	71
18161	0	70	0	0	0	70
18162	74	0	0	0	0	74
18163	0	0	0	72	0	72
18164	72	0	0	0	0	72
18165	0	73	0	1	0	74
18166	0	71	0	0	0	71
18167	0	0	0	77	0	77
18168	0	0	74	0	0	74
18169	0	0	71	0	0	71
18170	0	75	0	0	0	75
18171	75	0	0	0	0	75
18172	0	0	0	73	0	73
18173	71	0	0	0	0	71
18174	0	70	0	0	0	70
18175	0	72	0	0	0	72
18176	0	0	0	72	0	72
18177	72	0	0	0	0	72
18178	67	0	0	0	0	67
18179	0	0	67	0	0	67
18180	0	0	66	0	0	66
18181	69	0	0	0	0	69
18182	0	70	0	0	0	70
18183	70	0	0	0	0	70
18184	0	0	0	70	0	70
18185	0	0	67	0	0	67
18186	62	0	0	0	0	62
18187	0	62	0	0	0	62
18188	0	64	0	0	0	64
18189	0	0	0	67	0	67
18190	64	0	0	0	0	64
18191	0	0	0	64	0	64
18192	66	0	0	0	0	66
18193	0	0	67	0	0	67
18194	71	0	0	0	0	71
18195	71	0	0	0	0	71
18196	0	0	71	0	0	71
18197	69	0	0	0	0	69
18198	0	66	0	0	0	66
18199	1	0	0	67	0	68
18200	0	68	0	0	0	68
18201	73	0	0	0	0	73
18202	0	0	0	71	0	71
18203	0	70	0	0	0	70
18204	0	0	0	73	0	73
18205	0	74	0	0	0	74
18206	0	0	0	76	0	76
18207	74	0	0	0	0	74
18208	0	0	0	73	0	73
18209	0	0	70	0	0	70
18210	71	0	0	0	0	71
18211	0	0	0	70	0	70
18212	0	0	66	0	0	66
18213	0	0	59	1	0	60
18214	0	0	67	0	0	67
18215	0	0	0	63	0	63
18216	0	0	0	63	0	63
18217	0	0	1	62	0	63
18218	0	0	0	61	0	61
18219	66	0	0	0	0	66
18220	61	0	0	1	0	62
18221	66	0	0	0	0	66
18222	63	0	0	0	0	63
18223	0	0	0	63	0	63
18224	1	0	61	0	0	62
18225	66	0	0	0	0	66
18226	61	0	0	0	0	61
18227	0	0	0	60	0	60
18228	0	0	0	62	0	62
18229	64	0	0	1	0	65
18230	0	0	0	57	0	57
18231	0	57	0	0	0	57
18232	65	0	0	0	0	65
18233	66	0	0	0	0	66
18234	1	0	58	0	0	59
18235	0	0	0	65	0	65
18236	0	0	0	65	0	65
18237	66	0	0	0	0	66
18238	71	0	0	0	0	71
18239	0	0	0	69	0	69
18240	0	0	67	0	0	67
18241	0	0	69	0	0	69
18242	0	0	0	74	0	74
18243	2	0	0	77	0	79
18244	76	0	0	0	0	76
18245	0	73	0	0	0	73
18246	0	64	1	2	0	67
18247	0	70	0	0	0	70
18248	0	0	0	77	0	77
18249	72	0	0	0	0	72
18250	70	0	0	0	0	70
18251	0	70	0	0	0	70
18252	69	0	0	0	0	69
18253	0	0	0	73	0	73
18254	0	0	69	1	0	70
18255	0	0	0	70	0	70
18256	0	0	0	71	0	71
18257	0	0	0	70	0	70
18258	69	0	0	0	0	69
18259	0	0	0	64	0	64
18260	0	65	0	0	0	65
18261	64	0	0	1	0	65
18262	0	68	0	0	0	68
18263	0	60	0	0	0	60
18264	0	70	0	0	0	70
18265	0	0	69	0	0	69
18266	0	73	0	0	0	73
18267	0	0	74	0	0	74
18268	79	0	0	0	0	79
18269	79	0	0	0	0	79
18270	0	0	71	0	0	71
18271	79	0	0	0	0	79
18272	79	0	0	0	0	79
18273	0	0	74	0	0	74
18274	0	77	0	0	0	77
18275	0	0	0	78	0	78
18276	81	0	0	0	0	81
18277	0	0	0	81	0	81
18278	80	0	0	0	0	80
18279	82	0	0	0	0	82
18280	0	0	79	0	0	79
18281	79	0	0	0	0	79
18282	0	81	0	0	0	81
18283	83	0	0	0	0	83
18284	0	0	0	83	0	83
18285	0	0	80	0	0	80
18286	0	0	0	78	0	78
18287	73	0	0	0	0	73
18288	0	73	0	0	0	73
18289	0	0	71	0	0	71
18290	0	0	0	71	0	71
18291	0	0	72	0	0	72
18292	0	70	0	0	0	70
18293	79	0	0	0	0	79
18294	0	0	0	80	0	80
18295	0	0	80	0	0	80
18296	0	0	73	0	0	73
18297	81	0	0	0	0	81
18298	0	0	0	76	0	76
18299	0	0	0	80	0	80
18300	0	0	74	0	0	74
18301	1	0	72	0	0	73
18302	0	79	0	0	0	79
18303	0	0	0	82	0	82
18304	0	0	0	86	0	86
18305	0	83	0	0	0	83
18306	0	0	82	0	0	82
18307	80	0	0	0	0	80
18308	0	0	0	88	0	88
18309	0	0	81	0	0	81
18310	0	0	0	85	0	85
18311	0	81	0	0	0	81
18312	0	0	84	0	0	84
18313	88	0	0	0	0	88
18314	0	0	85	0	0	85
18315	0	1	77	0	0	78
18316	0	0	79	0	0	79
18317	1	0	81	0	0	82
18318	0	0	0	84	0	84
18319	0	0	85	0	0	85
18320	0	0	0	81	0	81
18321	0	85	0	0	0	85
18322	82	0	0	0	0	82
18323	3	0	0	80	0	83
18324	0	0	79	0	0	79
18325	0	80	0	3	0	83
18326	1	0	0	84	0	85
18327	77	0	0	0	0	77
18328	0	79	0	0	0	79
18329	0	0	0	80	0	80
18330	75	0	0	0	0	75
18331	0	0	71	0	0	71
18332	72	0	0	0	0	72
18333	0	0	73	0	0	73
18334	71	0	0	0	0	71
18335	74	0	0	0	0	74
18336	0	0	68	0	0	68
18337	0	66	0	0	0	66
18338	0	0	0	69	0	69
18339	0	0	71	0	0	71
18340	0	0	0	70	0	70
18341	0	0	0	65	0	65
18342	0	0	65	0	0	65
18343	0	0	62	0	0	62
18344	0	0	0	65	0	65
18345	61	0	0	0	0	61
18346	0	59	0	0	0	59
18347	0	66	0	0	0	66
18348	68	0	0	0	0	68
18349	66	0	0	0	0	66
18350	0	0	0	68	0	68
18351	0	0	0	65	0	65
18352	0	0	0	66	0	66
18353	66	0	0	0	0	66
18354	0	59	0	0	0	59
18355	1	63	0	0	0	64
18356	0	0	1	67	0	68
18357	0	0	0	63	0	63
18358	0	0	0	62	0	62
18359	62	0	0	0	0	62
18360	0	59	0	0	0	59
18361	62	0	0	0	0	62
18362	0	0	59	0	0	59
18363	0	60	0	0	0	60
18364	0	0	0	63	0	63
18365	63	0	0	0	0	63
18366	0	0	58	0	0	58
18367	0	0	63	0	0	63
18368	0	0	0	71	0	71
18369	0	0	0	72	0	72
18370	0	0	0	72	0	72
18371	0	0	0	69	0	69
18372	0	0	0	70	0	70
18373	0	69	0	0	0	69
18374	0	0	0	73	0	73
18375	72	0	0	0	0	72
18376	0	71	0	0	0	71
18377	71	0	0	0	0	71
18378	0	1	70	0	0	71
18379	0	0	72	0	0	72
18380	0	0	0	79	0	79
18381	1	0	77	0	0	78
18382	0	0	3	80	0	83
18383	0	0	0	88	0	88
18384	86	0	0	0	0	86
18385	77	0	0	0	0	77
18386	0	81	1	0	0	82
18387	0	80	0	3	0	83
18388	0	0	0	88	0	88
18389	88	0	0	0	0	88
18390	0	0	84	0	0	84
18391	0	0	0	89	0	89
18392	0	0	0	89	0	89
18393	0	0	87	0	0	87
18394	0	83	0	0	0	83
18395	0	0	0	87	0	87
18396	0	0	81	0	0	81
18397	0	0	0	86	0	86
18398	85	0	0	0	0	85
18399	0	77	0	0	0	77
18400	1	80	0	0	0	81
18401	0	0	0	83	0	83
18402	80	0	0	0	0	80
18403	0	80	0	0	0	80
18404	81	0	0	0	0	81
18405	4	0	74	0	0	78
18406	0	0	76	0	0	76
18407	0	0	0	81	0	81
18408	0	0	0	81	0	81
18409	82	0	0	0	0	82
18410	0	4	0	78	0	82
18411	0	0	77	0	0	77
18412	0	0	0	78	0	78
18413	0	0	0	76	0	76
18414	0	0	69	0	0	69
18415	75	0	0	0	0	75
18416	0	0	0	75	0	75
18417	73	0	0	1	0	74
18418	0	73	0	0	0	73
18419	70	0	0	0	0	70
18420	0	62	0	0	0	62
18421	0	69	0	0	0	69
18422	0	0	0	71	0	71
18423	70	0	0	0	0	70
18424	70	0	0	0	0	70
18425	0	0	0	69	0	69
18426	71	0	0	0	0	71
18427	70	0	0	0	0	70
18428	0	0	0	72	0	72
18429	70	0	0	0	0	70
18430	0	71	0	0	0	71
18431	74	0	0	0	0	74
18432	0	0	67	0	0	67
18433	74	0	0	0	0	74
18434	0	0	0	76	0	76
18435	0	0	0	76	0	76
18436	1	0	0	75	0	76
18437	1	0	0	74	0	75
18438	0	0	0	79	0	79
18439	0	68	0	0	0	68
18440	0	74	0	0	0	74
18441	80	0	0	0	0	80
18442	1	0	75	0	0	76
18443	76	0	0	0	0	76
18444	0	0	76	0	0	76
18445	1	0	1	75	0	77
18446	0	0	0	81	0	81
18447	77	0	0	0	0	77
18448	0	1	75	0	0	76
18449	0	0	0	84	0	84
18450	0	1	82	0	0	83
18451	0	83	0	0	0	83
18452	0	0	0	91	0	91
18453	92	0	0	0	0	92
18454	89	0	0	0	0	89
18455	83	1	0	0	0	84
18456	0	80	0	0	0	80
18457	0	85	0	0	0	85
18458	81	0	0	0	0	81
18459	0	83	0	0	0	83
18460	0	77	0	0	0	77
18461	0	0	73	0	0	73
18462	0	60	0	0	0	60
18463	0	72	0	0	0	72
18464	0	0	0	78	0	78
18465	0	0	73	0	0	73
18466	0	0	70	0	0	70
18467	79	0	0	0	0	79
18468	0	0	77	0	0	77
18469	77	0	0	0	0	77
18470	0	0	0	80	0	80
18471	0	75	0	0	0	75
18472	80	0	0	0	0	80
18473	82	0	0	0	0	82
18474	0	0	0	85	0	85
18475	0	0	0	84	0	84
18476	0	0	0	81	0	81
18477	80	0	0	0	0	80
18478	77	0	0	0	0	77
18479	76	0	0	0	0	76
18480	0	77	0	0	0	77
18481	79	0	0	0	0	79
18482	0	72	0	0	0	72
18483	0	84	0	0	0	84
18484	1	0	0	82	0	83
18485	0	80	0	0	0	80
18486	87	0	0	0	0	87
18487	0	0	0	82	0	82
18488	85	0	0	0	0	85
18489	0	83	0	0	0	83
18490	0	80	0	0	0	80
18491	83	0	0	0	0	83
18492	0	81	0	0	0	81
18493	0	0	0	87	0	87
18494	0	0	0	89	0	89
18495	87	0	0	0	0	87
18496	0	0	0	88	0	88
18497	0	0	85	0	0	85
18498	0	0	0	92	0	92
18499	90	1	0	0	0	91
18500	0	87	0	2	0	89
18501	90	0	0	0	0	90
18502	88	0	0	0	0	88
18503	89	0	0	0	0	89
18504	0	0	84	0	0	84
18505	0	0	78	0	0	78
18506	88	0	0	0	0	88
18507	0	87	0	0	0	87
18508	0	0	0	87	0	87
18509	0	0	0	88	0	88
18510	1	79	0	0	0	80
18511	0	85	0	0	0	85
18512	0	0	0	86	0	86
18513	0	0	0	89	0	89
18514	0	0	83	0	0	83
18515	0	0	78	0	0	78
18516	86	0	0	0	0	86
18517	89	0	0	0	0	89
18518	1	0	0	85	0	86
18519	0	0	89	0	0	89
18520	0	0	0	87	0	87
18521	88	0	0	0	0	88
18522	0	0	85	0	0	85
18523	0	0	0	87	0	87
18524	0	0	87	0	0	87
18525	0	79	0	0	0	79
18526	0	0	90	0	0	90
18527	0	0	0	84	0	84
18528	89	0	0	0	0	89
18529	0	0	0	86	0	86
18530	89	0	0	0	0	89
18531	84	0	0	0	0	84
18532	90	0	0	0	0	90
18533	0	0	83	0	0	83
18534	87	0	0	0	0	87
18535	0	0	0	87	0	87
18536	0	0	0	92	0	92
18537	0	0	83	0	0	83
18538	0	0	0	88	0	88
18539	86	0	0	0	0	86
18540	0	87	0	0	0	87
18541	88	0	0	0	0	88
18542	88	0	0	0	0	88
18543	84	1	0	0	0	85
18544	0	0	0	78	0	78
18545	1	0	74	0	0	75
18546	0	0	0	76	0	76
18547	0	0	0	75	0	75
18548	77	0	0	0	0	77
18549	77	0	0	0	0	77
18550	0	0	76	0	0	76
18551	0	0	0	72	0	72
18552	0	0	77	1	0	78
18553	73	0	0	1	0	74
18554	0	71	0	0	0	71
18555	73	0	0	0	0	73
18556	0	73	0	0	0	73
18557	75	0	0	0	0	75
18558	0	72	0	0	0	72
18559	0	0	0	82	0	82
18560	0	0	0	83	0	83
18561	81	0	0	0	0	81
18562	79	0	0	0	0	79
18563	81	0	0	0	0	81
18564	81	0	0	0	0	81
18565	76	0	0	0	0	76
18566	0	0	0	75	0	75
18567	0	73	0	1	0	74
18568	0	0	0	71	0	71
18569	0	76	0	0	0	76
18570	0	0	0	81	0	81
18571	0	79	0	0	0	79
18572	0	0	0	77	0	77
18573	0	0	79	0	0	79
18574	73	0	0	0	0	73
18575	0	73	0	0	0	73
18576	71	0	0	0	0	71
18577	0	0	68	0	0	68
18578	70	0	0	0	0	70
18579	0	1	67	0	0	68
18580	0	0	0	72	0	72
18581	0	65	0	0	0	65
18582	0	0	68	0	0	68
18583	0	0	0	71	0	71
18584	70	0	0	1	0	71
18585	0	0	0	71	0	71
18586	0	0	0	73	0	73
18587	0	0	0	75	0	75
18588	0	0	70	0	0	70
18589	0	0	0	71	0	71
18590	0	73	0	0	0	73
18591	0	0	0	69	0	69
18592	0	0	0	71	0	71
18593	69	0	0	0	0	69
18594	0	0	0	74	0	74
18595	0	0	71	0	0	71
18596	0	0	63	0	0	63
18597	0	0	70	0	0	70
18598	0	69	0	0	0	69
18599	71	0	0	0	0	71
18600	0	74	0	0	0	74
18601	78	0	0	0	0	78
18602	0	0	0	78	0	78
18603	0	0	77	0	0	77
18604	0	0	73	0	0	73
18605	0	73	0	0	0	73
18606	0	0	0	77	0	77
18607	0	0	0	77	0	77
18608	0	0	0	77	0	77
18609	0	0	77	0	0	77
18610	76	0	0	0	0	76
18611	0	0	80	0	0	80
18612	0	0	0	80	0	80
18613	0	0	0	80	0	80
18614	0	0	72	0	0	72
18615	73	0	0	0	0	73
18616	0	74	0	0	0	74
18617	72	0	0	0	0	72
18618	0	0	0	74	0	74
18619	0	67	0	0	0	67
18620	0	0	0	72	0	72
18621	73	0	0	0	0	73
18622	0	0	0	72	0	72
18623	0	0	67	0	0	67
18624	71	0	0	0	0	71
18625	71	0	0	0	0	71
18626	0	0	67	0	0	67
18627	0	0	0	70	0	70
18628	70	0	0	0	0	70
18629	0	0	0	68	0	68
18630	0	0	0	67	0	67
18631	0	0	0	67	0	67
18632	1	0	0	67	0	68
18633	0	0	64	1	0	65
18634	0	0	0	63	0	63
18635	0	0	65	1	0	66
18636	63	0	0	0	0	63
18637	65	0	0	0	0	65
18638	66	0	0	0	0	66
18639	66	0	0	0	0	66
18640	0	0	0	61	0	61
18641	63	0	0	0	0	63
18642	0	0	61	0	0	61
18643	0	0	61	0	0	61
18644	58	0	0	0	0	58
18645	0	50	0	0	0	50
18646	0	52	0	0	0	52
18647	0	0	0	53	0	53
18648	1	0	54	0	0	55
18649	53	0	0	0	0	53
18650	0	0	50	0	0	50
18651	0	49	0	0	0	49
18652	0	0	47	0	0	47
18653	0	48	0	0	0	48
18654	46	0	0	0	0	46
18655	0	47	0	0	0	47
18656	0	46	0	0	0	46
18657	0	0	0	47	0	47
18658	0	0	45	0	0	45
18659	0	0	1	44	0	45
18660	0	0	0	49	0	49
18661	0	0	47	0	0	47
18662	0	0	0	42	0	42
18663	0	41	0	0	0	41
18664	0	0	0	41	0	41
18665	42	0	0	0	0	42
18666	0	0	0	45	0	45
18667	0	0	44	0	0	44
18668	0	0	0	44	0	44
18669	0	0	42	0	0	42
18670	41	0	0	0	0	41
18671	0	0	0	43	0	43
18672	43	0	0	0	0	43
18673	0	1	40	0	0	41
18674	43	0	0	0	0	43
18675	0	45	0	0	0	45
18676	0	0	48	0	0	48
18677	0	0	0	50	0	50
18678	0	0	47	0	0	47
18679	0	50	0	0	0	50
18680	0	51	0	0	0	51
18681	53	0	0	0	0	53
18682	0	55	0	0	0	55
18683	57	0	0	0	0	57
18684	0	0	0	58	0	58
18685	0	0	56	0	0	56
18686	0	59	0	0	0	59
18687	0	0	0	60	0	60
18688	0	0	0	59	0	59
18689	0	0	0	56	0	56
18690	0	0	0	55	0	55
18691	0	52	0	0	0	52
18692	0	55	0	0	0	55
18693	55	0	0	0	0	55
18694	0	51	1	0	0	52
18695	0	0	0	56	0	56
18696	0	0	55	0	0	55
18697	0	57	0	0	0	57
18698	0	0	0	58	0	58
18699	0	0	0	57	0	57
18700	0	60	0	0	0	60
18701	59	0	0	0	0	59
18702	0	0	55	1	0	56
18703	60	0	0	0	0	60
18704	0	56	0	0	0	56
18705	54	0	0	0	0	54
18706	0	55	1	0	0	56
18707	0	0	0	58	0	58
18708	0	0	0	57	0	57
18709	60	0	0	0	0	60
18710	0	0	0	58	0	58
18711	0	0	53	0	0	53
18712	0	51	0	0	0	51
18713	0	52	0	1	0	53
18714	0	0	0	54	0	54
18715	0	0	53	0	0	53
18716	0	0	0	54	0	54
18717	0	0	0	55	0	55
18718	0	0	52	0	0	52
18719	1	0	48	0	0	49
18720	0	53	0	0	0	53
18721	54	0	0	1	0	55
18722	0	0	0	56	0	56
18723	0	54	0	1	0	55
18724	55	0	0	0	0	55
18725	0	0	0	54	0	54
18726	0	0	0	53	0	53
18727	0	50	0	0	0	50
18728	0	0	0	55	0	55
18729	55	0	0	0	0	55
18730	0	0	0	54	0	54
18731	0	0	0	56	0	56
18732	0	0	52	0	0	52
18733	1	0	56	0	0	57
18734	63	0	0	0	0	63
18735	0	0	0	65	0	65
18736	0	0	0	65	0	65
18737	0	0	0	67	0	67
18738	0	0	66	0	0	66
18739	68	0	0	0	0	68
18740	0	0	0	68	0	68
18741	0	0	1	67	0	68
18742	66	0	1	1	0	68
18743	0	69	0	0	0	69
18744	0	0	69	0	0	69
18745	0	0	0	70	0	70
18746	1	67	0	0	0	68
18747	0	0	0	73	0	73
18748	71	0	0	0	0	71
18749	0	0	0	73	0	73
18750	74	0	0	0	0	74
18751	70	0	0	1	0	71
18752	1	0	0	74	0	75
18753	0	69	0	1	0	70
18754	0	73	0	0	0	73
18755	0	0	74	0	0	74
18756	0	0	0	71	0	71
18757	0	0	0	77	0	77
18758	0	0	0	74	0	74
18759	76	0	0	0	0	76
18760	0	0	0	76	0	76
18761	0	0	78	0	0	78
18762	78	0	0	0	0	78
18763	0	0	0	80	0	80
18764	0	0	0	84	0	84
18765	0	0	86	0	0	86
18766	84	0	0	0	0	84
18767	0	0	0	88	0	88
18768	1	0	83	0	0	84
18769	0	0	0	82	0	82
18770	0	0	0	81	0	81
18771	0	83	0	0	0	83
18772	84	0	0	0	0	84
18773	78	0	0	0	0	78
18774	0	85	0	0	0	85
18775	82	0	0	0	0	82
18776	84	0	0	0	0	84
18777	0	0	0	83	0	83
18778	0	0	82	0	0	82
18779	0	0	75	0	0	75
18780	0	0	79	0	0	79
18781	0	0	80	0	0	80
18782	1	0	0	81	0	82
18783	0	0	1	78	0	79
18784	0	0	0	83	0	83
18785	1	0	0	81	0	82
18786	80	0	0	0	0	80
18787	0	81	0	0	0	81
18788	78	0	0	0	0	78
18789	1	0	76	0	0	77
18790	0	0	81	0	0	81
18791	0	0	0	82	0	82
18792	84	0	0	1	0	85
18793	82	0	0	0	0	82
18794	0	79	1	0	0	80
18795	0	82	0	0	0	82
18796	0	0	0	85	0	85
18797	85	0	0	0	0	85
18798	0	84	0	0	0	84
18799	85	0	0	0	0	85
18800	90	0	0	0	0	90
18801	90	0	0	0	0	90
18802	0	0	83	0	0	83
18803	0	89	0	0	0	89
18804	91	0	0	0	0	91
18805	89	0	0	0	0	89
18806	0	89	0	0	0	89
18807	1	84	0	0	0	85
18808	96	0	0	0	0	96
18809	0	0	0	93	0	93
18810	0	0	95	0	0	95
18811	93	0	0	0	0	93
18812	0	0	0	98	0	98
18813	1	93	0	0	0	94
18814	0	0	0	99	0	99
18815	0	0	98	0	0	98
18816	0	0	0	98	0	98
18817	100	0	0	0	0	100
18818	0	0	0	98	0	98
18819	0	0	0	100	0	100
18820	0	0	102	0	0	102
18821	0	0	0	97	0	97
18822	0	97	0	0	0	97
18823	99	0	0	0	0	99
18824	103	0	0	0	0	103
18825	0	0	101	1	0	102
18826	0	0	0	105	0	105
18827	0	100	0	0	0	100
18828	0	100	0	0	0	100
18829	114	0	0	0	0	114
18830	0	0	0	117	0	117
18831	0	0	108	0	0	108
18832	1	0	113	0	0	114
18833	0	0	0	120	0	120
18834	120	0	0	1	0	121
18835	120	0	0	0	0	120
18836	0	0	0	122	0	122
18837	0	0	120	0	0	120
18838	0	122	0	0	0	122
18839	127	0	0	0	0	127
18840	0	133	0	0	0	133
18841	131	0	0	0	0	131
18842	0	0	0	129	0	129
18843	0	0	131	0	0	131
18844	0	0	0	132	0	132
18845	136	0	0	0	0	136
18846	1	0	129	0	0	130
18847	0	129	0	0	0	129
18848	0	0	0	138	0	138
18849	139	0	0	0	0	139
18850	0	0	138	0	0	138
18851	0	0	0	145	0	145
18852	0	0	0	140	0	140
18853	0	0	143	0	0	143
18854	0	0	0	143	0	143
18855	0	0	142	0	0	142
18856	145	0	0	0	0	145
18857	0	0	0	145	0	145
18858	0	0	137	0	0	137
18859	0	139	0	0	0	139
18860	144	0	0	1	0	145
18861	150	0	0	0	0	150
18862	0	0	0	148	0	148
18863	0	148	0	0	0	148
18864	152	0	0	0	0	152
18865	1	0	0	151	0	152
18866	0	0	150	0	0	150
18867	150	0	0	0	0	150
18868	0	147	0	0	0	147
18869	0	0	0	153	0	153
18870	153	0	0	0	0	153
18871	0	0	137	1	0	138
18872	0	0	136	0	0	136
18873	0	0	0	143	0	143
18874	0	0	156	0	0	156
18875	0	0	0	156	0	156
18876	0	147	0	0	0	147
18877	0	0	0	162	0	162
18878	164	0	0	0	0	164
18879	0	0	157	0	0	157
18880	0	163	0	0	0	163
18881	0	0	0	165	0	165
18882	0	0	162	0	0	162
18883	0	0	0	162	0	162
18884	0	156	0	0	0	156
18885	0	161	0	0	0	161
18886	161	0	0	0	0	161
18887	0	163	0	0	0	163
18888	1	1	157	0	0	159
18889	161	0	0	0	0	161
18890	0	0	156	0	0	156
18891	0	0	0	152	0	152
18892	0	0	149	0	0	149
18893	0	157	0	0	0	157
18894	0	0	0	159	0	159
18895	0	0	0	155	0	155
18896	1	0	0	158	0	159
18897	0	0	158	0	0	158
18898	0	0	0	156	0	156
18899	0	0	0	160	0	160
18900	155	0	0	0	0	155
18901	153	0	0	0	0	153
18902	0	0	156	0	0	156
18903	0	152	0	0	0	152
18904	0	0	157	1	0	158
18905	0	0	0	156	0	156
18906	0	0	154	0	0	154
18907	0	0	0	157	0	157
18908	0	0	0	161	0	161
18909	0	0	161	0	0	161
18910	152	0	0	0	0	152
18911	1	146	0	0	0	147
18912	0	0	0	158	0	158
18913	1	0	153	0	0	154
18914	0	0	151	1	0	152
18915	151	0	0	0	0	151
18916	0	144	0	0	0	144
18917	0	0	0	152	0	152
18918	149	0	0	0	0	149
18919	0	0	0	145	0	145
18920	0	0	0	145	0	145
18921	0	0	144	0	0	144
18922	138	0	0	0	0	138
18923	139	0	0	0	0	139
18924	0	0	0	133	0	133
18925	137	0	0	0	0	137
18926	0	0	0	142	0	142
18927	0	134	0	0	0	134
18928	0	132	0	0	0	132
18929	0	0	0	133	0	133
18930	128	0	0	0	0	128
18931	0	0	0	130	0	130
18932	132	0	0	0	0	132
18933	128	0	0	0	0	128
18934	0	0	0	125	0	125
18935	0	0	0	129	0	129
18936	0	0	127	0	0	127
18937	0	0	130	0	0	130
18938	0	0	0	132	0	132
18939	0	0	130	0	0	130
18940	130	0	0	0	0	130
18941	1	0	0	130	0	131
18942	0	0	132	0	0	132
18943	128	0	0	0	0	128
18944	128	0	0	0	0	128
18945	0	129	0	0	0	129
18946	0	0	0	126	0	126
18947	0	0	124	0	0	124
18948	125	0	0	0	0	125
18949	125	0	0	0	0	125
18950	0	0	122	0	0	122
18951	119	0	0	0	0	119
18952	0	0	0	120	0	120
18953	0	0	0	121	0	121
18954	113	0	0	0	0	113
18955	116	0	0	0	0	116
18956	0	0	0	114	0	114
18957	0	0	106	0	0	106
18958	0	106	0	0	0	106
18959	0	0	100	0	0	100
18960	0	0	104	0	0	104
18961	0	112	0	0	0	112
18962	0	0	0	117	0	117
18963	0	0	0	115	0	115
18964	0	0	111	0	0	111
18965	0	0	0	111	0	111
18966	115	0	0	0	0	115
18967	0	0	101	0	0	101
18968	113	0	0	0	0	113
18969	109	0	0	0	0	109
18970	107	0	0	0	0	107
18971	0	0	105	0	0	105
18972	0	0	101	0	0	101
18973	0	0	0	99	0	99
18974	0	0	0	103	0	103
18975	0	103	0	0	0	103
18976	104	0	0	0	0	104
18977	101	0	0	0	0	101
18978	0	99	0	0	0	99
18979	100	0	0	0	0	100
18980	0	98	0	0	0	98
18981	100	0	0	0	0	100
18982	0	0	0	99	0	99
18983	0	0	93	0	0	93
18984	0	0	96	0	0	96
18985	0	0	0	97	0	97
18986	0	0	0	96	0	96
18987	0	0	94	0	0	94
18988	0	0	0	99	0	99
18989	0	0	0	94	0	94
18990	99	0	0	0	0	99
18991	99	0	0	0	0	99
18992	100	0	0	0	0	100
18993	1	0	94	0	0	95
18994	0	93	0	0	0	93
18995	0	0	0	97	0	97
18996	0	0	102	0	0	102
18997	0	100	0	0	0	100
18998	102	0	0	0	0	102
18999	0	0	0	102	0	102
19000	0	0	0	103	0	103
19001	97	0	0	0	0	97
19002	0	0	0	96	0	96
19003	0	0	0	96	0	96
19004	95	0	0	0	0	95
19005	0	0	94	0	0	94
19006	0	92	0	0	0	92
19007	99	0	0	0	0	99
19008	0	0	94	0	0	94
19009	99	0	0	0	0	99
19010	0	96	0	1	0	97
19011	99	0	0	0	0	99
19012	100	0	0	0	0	100
19013	97	0	0	0	0	97
19014	0	0	0	94	0	94
19015	0	0	0	93	0	93
19016	0	93	0	0	0	93
19017	0	80	0	1	0	81
19018	0	92	0	0	0	92
19019	91	0	0	0	0	91
19020	0	0	90	0	0	90
19021	0	0	0	92	0	92
19022	0	0	0	94	0	94
19023	0	89	0	0	0	89
19024	0	0	0	88	0	88
19025	0	0	0	84	0	84
19026	0	84	0	0	0	84
19027	91	0	0	0	0	91
19028	0	90	0	0	0	90
19029	0	0	91	0	0	91
19030	91	0	0	0	0	91
19031	0	93	0	0	0	93
19032	97	0	0	0	0	97
19033	0	0	0	97	0	97
19034	0	0	0	105	0	105
19035	1	0	101	0	0	102
19036	0	0	115	0	0	115
19037	0	0	0	120	0	120
19038	121	0	0	2	0	123
19039	123	0	0	1	0	124
19040	0	125	0	0	0	125
19041	1	115	0	4	0	120
19042	0	123	0	2	0	125
19043	0	0	0	131	0	131
19044	128	0	0	0	0	128
19045	128	0	0	1	0	129
19046	129	0	0	0	0	129
19047	0	0	131	0	0	131
19048	0	127	0	0	0	127
19049	0	0	0	132	0	132
19050	135	0	0	0	0	135
19051	0	0	0	137	0	137
19052	0	0	0	133	0	133
19053	134	0	0	0	0	134
19054	132	0	0	0	0	132
19055	0	0	125	0	0	125
19056	0	0	0	126	0	126
19057	0	1	126	0	0	127
19058	0	0	0	126	0	126
19059	0	0	123	0	0	123
19060	1	0	0	121	0	122
19061	124	0	0	0	0	124
19062	2	119	0	0	0	121
19063	0	124	0	0	0	124
19064	0	0	0	125	0	125
19065	0	124	0	0	0	124
19066	127	0	0	1	0	128
19067	123	0	0	0	0	123
19068	0	0	118	0	0	118
19069	0	113	0	0	0	113
19070	0	0	0	119	0	119
19071	0	0	123	0	0	123
19072	119	0	0	0	0	119
19073	0	0	0	120	0	120
19074	0	0	121	0	0	121
19075	0	0	0	119	0	119
19076	122	0	0	0	0	122
19077	0	0	119	0	0	119
19078	121	0	0	0	0	121
19079	124	0	0	1	0	125
19080	0	0	0	125	0	125
19081	0	0	118	0	0	118
19082	0	0	121	0	0	121
19083	121	0	0	0	0	121
19084	119	0	0	0	0	119
19085	1	0	120	0	0	121
19086	0	0	0	119	0	119
19087	0	0	0	120	0	120
19088	0	126	0	0	0	126
19089	1	0	0	117	0	118
19090	123	0	0	0	0	123
19091	0	0	0	125	0	125
19092	0	0	122	0	0	122
19093	126	0	0	0	0	126
19094	0	0	0	125	0	125
19095	0	0	123	0	0	123
19096	0	121	0	0	0	121
19097	124	0	0	0	0	124
19098	0	122	0	0	0	122
19099	126	0	0	0	0	126
19100	0	1	121	0	0	122
19101	0	107	0	0	0	107
19102	0	124	0	0	0	124
19103	0	0	0	124	0	124
19104	1	0	0	125	0	126
19105	0	0	128	0	0	128
19106	0	0	0	131	0	131
19107	128	0	0	0	0	128
19108	0	0	127	0	0	127
19109	0	0	0	130	0	130
19110	0	0	128	0	0	128
19111	128	0	0	0	0	128
19112	0	127	0	0	0	127
19113	127	0	0	0	0	127
19114	119	0	0	1	0	120
19115	125	0	0	0	0	125
19116	0	0	123	0	0	123
19117	0	113	0	0	0	113
19118	0	0	0	125	0	125
19119	0	0	0	124	0	124
19120	122	0	0	0	0	122
19121	0	0	0	122	0	122
19122	119	0	0	0	0	119
19123	117	0	0	0	0	117
19124	110	0	0	0	0	110
19125	113	0	0	0	0	113
19126	0	0	0	115	0	115
19127	109	0	0	0	0	109
19128	0	0	102	0	0	102
19129	95	0	0	0	0	95
19130	106	0	0	0	0	106
19131	0	0	100	2	0	102
19132	87	0	0	0	0	87
19133	89	0	0	0	0	89
19134	0	0	0	90	0	90
19135	0	0	0	84	0	84
19136	89	2	0	0	0	91
19137	0	0	0	83	0	83
19138	0	0	0	82	0	82
19139	0	77	0	0	0	77
19140	0	0	0	81	0	81
19141	81	0	0	0	0	81
19142	0	0	0	78	0	78
19143	0	0	0	74	0	74
19144	0	70	0	0	0	70
19145	0	0	0	72	0	72
19146	1	0	0	71	0	72
19147	71	0	0	0	0	71
19148	0	0	0	71	0	71
19149	0	0	77	0	0	77
19150	0	73	0	0	0	73
19151	0	79	0	0	0	79
19152	78	0	0	0	0	78
19153	0	77	0	0	0	77
19154	76	0	0	0	0	76
19155	0	79	0	0	0	79
19156	80	0	0	0	0	80
19157	0	0	0	80	0	80
19158	0	0	0	80	0	80
19159	0	77	0	0	0	77
19160	0	0	0	77	0	77
19161	0	0	76	0	0	76
19162	75	0	1	0	0	76
19163	0	79	0	0	0	79
19164	82	0	0	0	0	82
19165	81	0	0	0	0	81
19166	82	0	0	0	0	82
19167	0	0	0	84	0	84
19168	0	0	0	85	0	85
19169	0	81	1	0	0	82
19170	79	0	0	0	0	79
19171	0	80	0	0	0	80
19172	79	0	0	0	0	79
19173	0	0	77	0	0	77
19174	82	0	0	0	0	82
19175	0	0	0	86	0	86
19176	0	0	81	0	0	81
19177	0	0	82	0	0	82
19178	0	0	0	87	0	87
19179	0	0	87	0	0	87
19180	0	0	0	85	0	85
19181	88	0	0	0	0	88
19182	0	0	0	87	0	87
19183	0	0	82	0	0	82
19184	0	72	0	0	0	72
19185	0	80	0	0	0	80
19186	0	0	0	78	0	78
19187	76	0	0	0	0	76
19188	0	0	0	79	0	79
19189	0	0	0	81	0	81
19190	0	0	1	79	0	80
19191	0	0	0	83	0	83
19192	0	0	78	0	0	78
19193	1	0	75	0	0	76
19194	80	0	0	0	0	80
19195	86	0	0	0	0	86
19196	0	0	0	84	0	84
19197	0	0	0	86	0	86
19198	0	0	83	0	0	83
19199	0	83	1	0	0	84
19200	88	0	0	0	0	88
19201	87	0	0	0	0	87
19202	0	0	0	88	0	88
19203	0	0	84	0	0	84
19204	0	0	0	83	0	83
19205	0	77	0	1	0	78
19206	0	0	84	0	0	84
19207	84	0	0	0	0	84
19208	0	0	0	85	0	85
19209	88	0	0	0	0	88
19210	0	0	90	0	0	90
19211	92	0	0	0	0	92
19212	0	0	0	92	0	92
19213	89	0	0	0	0	89
19214	0	0	0	88	0	88
19215	0	81	0	0	0	81
19216	1	85	0	0	0	86
19217	0	0	0	94	0	94
19218	0	0	82	0	0	82
19219	0	86	0	0	0	86
19220	0	0	0	93	0	93
19221	87	0	0	0	0	87
19222	91	0	0	0	0	91
19223	0	0	0	89	0	89
19224	0	0	0	93	0	93
19225	0	86	0	0	0	86
19226	0	86	0	0	0	86
19227	90	0	0	0	0	90
19228	0	0	0	87	0	87
19229	1	0	0	83	0	84
19230	0	0	83	0	0	83
19231	0	0	0	89	0	89
19232	0	0	0	88	0	88
19233	0	0	0	89	0	89
19234	0	1	88	0	0	89
19235	0	0	0	86	0	86
19236	86	0	0	0	0	86
19237	0	0	84	0	0	84
19238	85	0	0	0	0	85
19239	0	0	0	84	0	84
19240	0	0	0	88	0	88
19241	0	0	0	90	0	90
19242	0	0	77	0	0	77
19243	84	0	0	0	0	84
19244	0	81	0	0	0	81
19245	78	0	0	0	0	78
19246	0	77	0	0	0	77
19247	0	0	0	80	0	80
19248	83	0	0	0	0	83
19249	0	0	82	0	0	82
19250	80	0	0	0	0	80
19251	0	0	80	0	0	80
19252	0	0	0	86	0	86
19253	0	0	84	0	0	84
19254	0	83	0	1	0	84
19255	0	0	0	87	0	87
19256	83	0	0	0	0	83
19257	0	0	0	85	0	85
19258	2	80	0	0	0	82
19259	0	0	0	86	0	86
19260	81	0	0	0	0	81
19261	86	0	0	0	0	86
19262	1	82	0	0	0	83
19263	0	84	0	0	0	84
19264	0	0	0	88	0	88
19265	0	0	0	87	0	87
19266	84	0	0	0	0	84
19267	79	0	0	0	0	79
19268	0	80	0	0	0	80
19269	0	0	0	82	0	82
19270	0	0	0	82	0	82
19271	0	0	79	0	0	79
19272	1	71	0	0	0	72
19273	0	79	1	0	0	80
19274	0	0	0	80	0	80
19275	0	0	78	0	0	78
19276	1	0	76	0	0	77
19277	0	0	0	83	0	83
19278	0	0	0	82	0	82
19279	0	0	85	0	0	85
19280	0	0	0	85	0	85
19281	0	0	87	0	0	87
19282	86	0	0	0	0	86
19283	0	0	0	88	0	88
19284	0	0	83	1	0	84
19285	0	0	79	0	0	79
19286	0	0	0	85	0	85
19287	0	0	87	0	0	87
19288	0	0	81	0	0	81
19289	0	82	0	0	0	82
19290	84	0	0	0	0	84
19291	0	0	78	0	0	78
19292	0	0	0	78	0	78
19293	0	0	0	79	0	79
19294	0	0	0	79	0	79
19295	0	0	79	0	0	79
19296	0	0	0	77	0	77
19297	80	0	0	0	0	80
19298	0	0	0	76	0	76
19299	0	0	79	0	0	79
19300	0	0	0	77	0	77
19301	79	0	0	0	0	79
19302	72	0	0	0	0	72
19303	75	0	0	0	0	75
19304	0	0	0	76	0	76
19305	78	0	0	0	0	78
19306	77	0	0	0	0	77
19307	74	3	0	0	0	77
19308	0	74	0	0	0	74
19309	75	0	0	0	0	75
19310	0	0	0	70	0	70
19311	0	0	74	0	0	74
19312	0	71	0	0	0	71
19313	73	0	0	0	0	73
19314	0	0	0	71	0	71
19315	0	0	0	72	0	72
19316	0	60	0	0	0	60
19317	0	67	0	0	0	67
19318	75	0	0	0	0	75
19319	0	71	0	0	0	71
19320	70	0	0	0	0	70
19321	0	70	0	0	0	70
19322	74	0	0	0	0	74
19323	0	70	0	1	0	71
19324	0	69	0	0	0	69
19325	72	0	0	0	0	72
19326	0	0	70	0	0	70
19327	1	66	0	0	0	67
19328	0	0	0	72	0	72
19329	0	0	0	67	0	67
19330	0	0	0	70	0	70
19331	0	0	0	69	0	69
19332	0	0	71	0	0	71
19333	69	0	0	0	0	69
19334	0	0	0	68	0	68
19335	66	0	0	0	0	66
19336	71	0	0	0	0	71
19337	71	0	0	0	0	71
19338	72	0	0	0	0	72
19339	0	0	70	0	0	70
19340	0	0	0	69	0	69
19341	0	0	69	0	0	69
19342	0	62	0	0	0	62
19343	1	0	0	67	0	68
19344	0	0	0	65	0	65
19345	0	0	0	69	0	69
19346	1	0	0	66	0	67
19347	0	0	68	0	0	68
19348	0	0	0	64	0	64
19349	0	0	0	68	0	68
19350	66	0	0	0	0	66
19351	65	1	0	0	0	66
19352	0	0	0	62	0	62
19353	0	0	0	67	0	67
19354	0	0	0	66	0	66
19355	63	0	0	0	0	63
19356	62	0	0	0	0	62
19357	65	0	0	0	0	65
19358	64	0	0	0	0	64
19359	0	61	0	0	0	61
19360	70	0	0	0	0	70
19361	66	0	2	0	0	68
19362	0	0	1	67	0	68
19363	0	0	0	71	0	71
19364	69	0	0	0	0	69
19365	0	67	0	0	0	67
19366	0	65	0	0	0	65
19367	75	0	0	0	0	75
19368	0	0	0	77	0	77
19369	0	0	0	70	0	70
19370	0	0	0	77	0	77
19371	0	0	0	74	0	74
19372	0	0	0	77	0	77
19373	0	73	0	0	0	73
19374	0	0	0	74	0	74
19375	78	0	0	0	0	78
19376	0	0	0	70	0	70
19377	0	0	0	77	0	77
19378	79	0	0	0	0	79
19379	0	77	0	0	0	77
19380	0	0	0	73	0	73
19381	1	63	0	0	0	64
19382	0	0	0	73	0	73
19383	0	1	71	0	0	72
19384	72	0	0	0	0	72
19385	0	75	0	0	0	75
19386	75	0	0	0	0	75
19387	0	0	76	0	0	76
19388	0	0	0	75	0	75
19389	1	75	0	1	0	77
19390	0	78	0	0	0	78
19391	82	0	0	0	0	82
19392	0	0	0	83	0	83
19393	0	0	80	0	0	80
19394	0	0	0	86	0	86
19395	0	0	90	0	0	90
19396	84	0	0	0	0	84
19397	0	0	81	0	0	81
19398	0	0	0	82	0	82
19399	0	87	0	0	0	87
19400	0	0	0	89	0	89
19401	0	84	0	0	0	84
19402	87	0	0	0	0	87
19403	0	1	0	88	0	89
19404	0	0	86	0	0	86
19405	0	0	82	0	0	82
19406	90	0	0	0	0	90
19407	94	0	0	0	0	94
19408	92	0	0	0	0	92
19409	92	0	0	0	0	92
19410	0	86	0	0	0	86
19411	90	0	0	0	0	90
19412	91	0	0	0	0	91
19413	0	0	85	0	0	85
19414	1	0	0	89	0	90
19415	95	0	0	0	0	95
19416	1	0	89	0	0	90
19417	0	0	0	93	0	93
19418	1	0	88	0	0	89
19419	0	0	0	94	0	94
19420	0	97	0	0	0	97
19421	95	0	0	0	0	95
19422	0	0	93	0	0	93
19423	95	0	0	0	0	95
19424	0	0	0	93	0	93
19425	97	0	0	0	0	97
19426	0	0	0	95	0	95
19427	98	0	0	0	0	98
19428	0	0	95	0	0	95
19429	98	0	0	0	0	98
19430	0	0	0	99	0	99
19431	0	0	0	97	0	97
19432	97	0	0	0	0	97
19433	0	0	0	90	0	90
19434	0	0	95	0	0	95
19435	0	0	0	90	0	90
19436	93	0	0	0	0	93
19437	0	88	0	0	0	88
19438	0	97	0	0	0	97
19439	103	0	0	0	0	103
19440	0	106	0	0	0	106
19441	0	0	0	104	0	104
19442	105	0	0	0	0	105
19443	105	0	0	0	0	105
19444	106	0	0	0	0	106
19445	0	0	103	0	0	103
19446	0	0	0	106	0	106
19447	0	108	0	0	0	108
19448	0	0	0	106	0	106
19449	0	0	106	0	0	106
19450	0	107	0	0	0	107
19451	0	0	0	108	0	108
19452	100	0	1	1	0	102
19453	0	103	0	0	0	103
19454	0	0	107	0	0	107
19455	0	0	0	108	0	108
19456	1	0	104	0	0	105
19457	0	0	0	104	0	104
19458	108	0	1	0	0	109
19459	0	0	0	108	0	108
19460	108	0	0	1	0	109
19461	108	0	0	0	0	108
19462	1	108	0	0	0	109
19463	107	0	0	1	0	108
19464	1	104	0	0	0	105
19465	0	0	106	0	0	106
19466	0	0	0	110	0	110
19467	0	0	0	112	0	112
19468	1	0	107	0	0	108
19469	0	108	0	1	0	109
19470	114	0	0	0	0	114
19471	112	0	0	0	0	112
19472	0	0	0	114	0	114
19473	0	0	0	115	0	115
19474	0	0	0	115	0	115
19475	112	0	0	0	0	112
19476	0	0	105	0	0	105
19477	0	0	103	0	0	103
19478	0	0	0	104	0	104
19479	0	0	106	0	0	106
19480	0	0	98	0	0	98
19481	0	0	0	106	0	106
19482	0	0	104	0	0	104
19483	0	107	0	0	0	107
19484	0	0	0	108	0	108
19485	0	0	109	0	0	109
19486	0	0	0	103	0	103
19487	0	107	0	0	0	107
19488	0	0	0	106	0	106
19489	0	0	104	0	0	104
19490	0	0	0	108	0	108
19491	112	0	0	0	0	112
19492	1	0	104	0	0	105
19493	107	0	0	0	0	107
19494	0	111	0	0	0	111
19495	114	0	0	0	0	114
19496	0	0	0	117	0	117
19497	0	112	0	0	0	112
19498	111	0	0	0	0	111
19499	0	0	0	118	0	118
19500	0	0	111	0	0	111
19501	0	111	0	1	0	112
19502	0	0	0	119	0	119
19503	120	0	0	0	0	120
19504	119	0	0	0	0	119
19505	0	0	0	116	0	116
19506	0	0	115	0	0	115
19507	115	0	0	0	0	115
19508	0	0	109	0	0	109
19509	0	0	0	112	0	112
19510	115	0	0	0	0	115
19511	0	108	0	0	0	108
19512	115	0	0	0	0	115
19513	0	0	112	1	0	113
19514	117	0	0	0	0	117
19515	0	0	0	115	0	115
19516	0	0	0	118	0	118
19517	0	1	115	0	0	116
19518	0	0	0	119	0	119
19519	122	0	0	0	0	122
19520	0	0	0	120	0	120
19521	0	123	0	0	0	123
19522	0	0	0	125	0	125
19523	0	114	1	0	0	115
19524	0	0	113	0	0	113
19525	117	0	0	0	0	117
19526	0	0	0	120	0	120
19527	0	0	119	0	0	119
19528	0	118	0	1	0	119
19529	0	0	0	119	0	119
19530	0	0	0	113	0	113
19531	120	0	0	0	0	120
19532	0	0	0	114	0	114
19533	114	0	0	0	0	114
19534	113	0	0	0	0	113
19535	0	112	0	0	0	112
19536	115	0	0	0	0	115
19537	0	0	0	111	0	111
19538	0	0	107	0	0	107
19539	107	0	0	0	0	107
19540	0	0	0	110	0	110
19541	0	0	103	0	0	103
19542	103	0	0	1	0	104
19543	0	0	0	108	0	108
19544	0	107	0	0	0	107
19545	0	0	0	106	0	106
19546	0	102	0	0	0	102
19547	106	0	0	0	0	106
19548	1	0	105	1	0	107
19549	0	101	0	1	0	102
19550	0	0	0	109	0	109
19551	0	0	107	0	0	107
19552	0	0	102	0	0	102
19553	0	104	0	0	0	104
19554	0	0	0	111	0	111
19555	0	0	0	113	0	113
19556	0	0	0	113	0	113
19557	116	0	0	0	0	116
19558	0	0	112	0	0	112
19559	0	107	0	0	0	107
19560	0	1	0	114	0	115
19561	0	0	0	112	0	112
19562	0	0	115	0	0	115
19563	0	0	0	118	0	118
19564	0	0	114	0	0	114
19565	0	0	111	0	0	111
19566	0	0	115	0	0	115
19567	0	0	0	121	0	121
19568	0	0	0	114	0	114
19569	0	0	0	121	0	121
19570	123	0	0	0	0	123
19571	0	119	0	0	0	119
19572	123	0	0	0	0	123
19573	117	0	0	0	0	117
19574	116	0	0	0	0	116
19575	0	114	0	0	0	114
19576	118	0	0	0	0	118
19577	116	0	0	0	0	116
19578	0	0	0	115	0	115
19579	0	0	0	118	0	118
19580	0	0	0	116	0	116
19581	0	0	118	0	0	118
19582	119	0	0	0	0	119
19583	0	0	0	121	0	121
19584	113	0	0	0	0	113
19585	0	116	0	0	0	116
19586	0	0	0	114	0	114
19587	0	0	0	111	0	111
19588	106	0	0	0	0	106
19589	0	0	0	109	0	109
19590	109	0	0	0	0	109
19591	109	0	0	0	0	109
19592	0	102	0	0	0	102
19593	0	100	0	1	0	101
19594	0	0	0	97	0	97
19595	0	94	0	0	0	94
19596	0	0	0	95	0	95
19597	0	0	93	0	0	93
19598	0	0	92	1	0	93
19599	94	0	0	0	0	94
19600	95	0	0	0	0	95
19601	0	93	0	0	0	93
19602	91	0	0	1	0	92
19603	0	91	0	0	0	91
19604	0	0	0	94	0	94
19605	0	0	0	92	0	92
19606	0	0	0	99	0	99
19607	0	0	0	95	0	95
19608	97	0	0	0	0	97
19609	0	94	0	0	0	94
19610	98	0	0	0	0	98
19611	99	0	0	0	0	99
19612	0	0	91	0	0	91
19613	94	0	0	1	0	95
19614	0	91	0	0	0	91
19615	0	0	0	100	0	100
19616	1	0	0	95	0	96
19617	1	96	0	0	0	97
19618	98	0	0	0	0	98
19619	0	0	93	0	0	93
19620	97	0	0	0	0	97
19621	0	0	95	0	0	95
19622	0	0	0	94	0	94
19623	0	0	0	103	0	103
19624	0	0	0	103	0	103
19625	103	0	0	1	0	104
19626	0	0	104	0	0	104
19627	103	0	0	0	0	103
19628	106	0	0	0	0	106
19629	107	0	0	0	0	107
19630	109	0	0	0	0	109
19631	0	0	0	107	0	107
19632	0	0	104	0	0	104
19633	0	0	0	109	0	109
19634	0	0	101	0	0	101
19635	0	0	106	0	0	106
19636	0	98	1	0	0	99
19637	0	0	0	104	0	104
19638	1	0	0	104	0	105
19639	0	0	0	100	0	100
19640	0	0	0	108	0	108
19641	104	0	0	0	0	104
19642	107	0	0	0	0	107
19643	0	0	0	102	0	102
19644	0	0	100	0	0	100
19645	1	0	0	99	0	100
19646	0	0	0	102	0	102
19647	0	0	96	0	0	96
19648	0	0	0	96	0	96
19649	100	0	0	0	0	100
19650	99	0	0	0	0	99
19651	100	1	0	0	0	101
19652	0	0	0	97	0	97
19653	96	0	0	1	0	97
19654	93	0	0	0	0	93
19655	0	0	89	0	0	89
19656	0	0	74	1	0	75
19657	0	0	83	0	0	83
19658	86	0	0	0	0	86
19659	0	86	0	0	0	86
19660	87	0	0	0	0	87
19661	0	84	0	0	0	84
19662	0	0	0	88	0	88
19663	0	0	0	93	0	93
19664	0	0	0	89	0	89
19665	0	0	90	0	0	90
19666	90	0	0	0	0	90
19667	0	0	0	92	0	92
19668	0	0	93	0	0	93
19669	0	0	85	0	0	85
19670	89	0	0	0	0	89
19671	0	88	0	0	0	88
19672	92	0	0	0	0	92
19673	88	0	1	0	0	89
19674	0	90	0	0	0	90
19675	90	0	0	0	0	90
19676	0	0	85	0	0	85
19677	0	0	83	0	0	83
19678	0	0	87	0	0	87
19679	0	0	0	87	0	87
19680	0	0	89	0	0	89
19681	89	0	0	0	0	89
19682	88	0	0	0	0	88
19683	0	0	87	0	0	87
19684	0	0	0	87	0	87
19685	88	0	0	0	0	88
19686	0	83	0	0	0	83
19687	0	83	0	0	0	83
19688	85	0	0	0	0	85
19689	0	0	78	0	0	78
19690	0	0	0	82	0	82
19691	0	0	0	87	0	87
19692	0	0	0	84	0	84
19693	0	79	0	0	0	79
19694	0	0	0	84	0	84
19695	85	0	0	0	0	85
19696	0	0	0	84	0	84
19697	0	78	0	0	0	78
19698	86	0	0	0	0	86
19699	1	0	0	88	0	89
19700	0	0	0	89	0	89
19701	87	0	0	0	0	87
19702	86	0	1	0	0	87
19703	0	0	0	90	0	90
19704	86	0	0	0	0	86
19705	88	0	0	0	0	88
19706	0	90	0	0	0	90
19707	88	0	0	1	0	89
19708	0	89	0	0	0	89
19709	0	0	0	94	0	94
19710	0	0	87	0	0	87
19711	0	0	1	90	0	91
19712	0	0	0	93	0	93
19713	0	0	0	94	0	94
19714	92	0	0	0	0	92
19715	0	86	0	0	0	86
19716	85	0	0	0	0	85
19717	0	86	0	0	0	86
19718	88	0	0	0	0	88
19719	86	0	0	0	0	86
19720	85	0	0	0	0	85
19721	82	0	0	0	0	82
19722	0	0	78	0	0	78
19723	0	0	0	76	0	76
19724	0	0	0	78	0	78
19725	0	0	77	1	0	78
19726	79	0	0	0	0	79
19727	0	0	0	77	0	77
19728	0	0	75	0	0	75
19729	0	0	74	0	0	74
19730	0	0	0	81	0	81
19731	0	0	76	0	0	76
19732	0	0	0	77	0	77
19733	1	0	0	81	0	82
19734	0	0	81	0	0	81
19735	79	0	0	0	0	79
19736	0	0	0	79	0	79
19737	0	0	75	0	0	75
19738	0	0	0	73	0	73
19739	76	0	0	0	0	76
19740	0	0	74	0	0	74
19741	67	0	0	0	0	67
19742	67	0	0	0	0	67
19743	0	0	0	65	0	65
19744	0	0	0	69	0	69
19745	0	0	65	0	0	65
19746	0	0	0	77	0	77
19747	0	0	0	76	0	76
19748	1	0	0	76	0	77
19749	0	0	77	0	0	77
19750	76	0	0	0	0	76
19751	75	0	0	0	0	75
19752	77	0	0	0	0	77
19753	72	0	0	0	0	72
19754	0	0	0	78	0	78
19755	74	0	0	0	0	74
19756	81	0	0	0	0	81
19757	74	0	0	0	0	74
19758	77	0	0	0	0	77
19759	0	77	0	0	0	77
19760	82	0	0	0	0	82
19761	78	0	0	0	0	78
19762	0	70	0	0	0	70
19763	74	0	0	0	0	74
19764	0	0	0	76	0	76
19765	0	0	0	73	0	73
19766	71	0	0	0	0	71
19767	0	69	0	0	0	69
19768	0	71	0	0	0	71
19769	0	0	0	78	0	78
19770	0	0	77	0	0	77
19771	0	0	0	78	0	78
19772	0	0	0	79	0	79
19773	79	0	0	0	0	79
19774	82	0	0	0	0	82
19775	0	0	0	85	0	85
19776	0	0	78	0	0	78
19777	0	0	0	81	0	81
19778	84	0	0	0	0	84
19779	0	0	76	0	0	76
19780	0	82	0	0	0	82
19781	89	0	0	0	0	89
19782	0	0	0	89	0	89
19783	0	0	0	82	0	82
19784	0	0	0	81	0	81
19785	0	0	87	0	0	87
19786	86	0	0	1	0	87
19787	0	0	83	0	0	83
19788	1	79	0	0	0	80
19789	0	0	0	87	0	87
19790	0	0	0	87	0	87
19791	0	0	1	82	0	83
19792	0	0	85	0	0	85
19793	0	0	71	0	0	71
19794	0	0	78	0	0	78
19795	0	76	0	0	0	76
19796	0	0	0	79	0	79
19797	81	0	0	0	0	81
19798	83	0	0	0	0	83
19799	0	0	76	0	0	76
19800	0	81	0	0	0	81
19801	0	0	84	0	0	84
19802	0	82	0	4	0	86
19803	90	0	0	0	0	90
19804	86	0	0	0	0	86
19805	0	92	0	0	0	92
19806	91	0	0	4	0	95
19807	0	0	0	87	0	87
19808	0	0	0	89	0	89
19809	93	0	0	0	0	93
19810	88	0	0	0	0	88
19811	88	0	0	0	0	88
19812	1	86	0	0	0	87
19813	0	91	0	0	0	91
19814	95	0	0	0	0	95
19815	0	0	96	0	0	96
19816	0	0	0	98	0	98
19817	97	1	0	0	0	98
19818	0	93	0	0	0	93
19819	0	96	0	0	0	96
19820	100	0	1	0	0	101
19821	0	0	102	0	0	102
19822	105	0	0	0	0	105
19823	0	0	98	0	0	98
19824	0	0	92	0	0	92
19825	0	0	0	105	0	105
19826	0	0	110	0	0	110
19827	117	0	0	0	0	117
19828	114	0	0	0	0	114
19829	112	0	0	0	0	112
19830	115	0	0	0	0	115
19831	0	0	0	114	0	114
19832	110	0	0	1	0	111
19833	0	112	0	0	0	112
19834	0	0	1	119	0	120
19835	0	117	0	0	0	117
19836	119	0	0	0	0	119
19837	121	0	0	0	0	121
19838	0	0	0	122	0	122
19839	118	0	0	0	0	118
19840	121	0	0	0	0	121
19841	0	0	0	116	0	116
19842	1	0	0	113	0	114
19843	0	0	0	115	0	115
19844	1	0	115	0	0	116
19845	0	0	96	3	0	99
19846	0	0	106	0	0	106
19847	0	0	1	115	0	116
19848	0	0	113	0	0	113
19849	0	0	0	115	0	115
19850	0	0	113	0	0	113
19851	0	0	105	1	0	106
19852	112	0	0	0	0	112
19853	0	110	0	0	0	110
19854	110	0	0	0	0	110
19855	0	0	0	112	0	112
19856	0	0	0	115	0	115
19857	0	0	111	0	0	111
19858	0	111	0	0	0	111
19859	0	0	0	114	0	114
19860	0	0	112	0	0	112
19861	0	106	0	0	0	106
19862	0	0	0	109	0	109
19863	110	0	0	0	0	110
19864	105	0	0	0	0	105
19865	0	0	0	106	0	106
19866	100	0	0	0	0	100
19867	0	102	0	0	0	102
19868	0	0	0	108	0	108
19869	0	0	106	0	0	106
19870	0	0	0	106	0	106
19871	0	0	106	0	0	106
19872	107	0	0	0	0	107
19873	0	0	0	104	0	104
19874	0	99	0	0	0	99
19875	0	0	0	103	0	103
19876	0	0	100	0	0	100
19877	1	0	95	0	0	96
19878	0	0	98	0	0	98
19879	99	0	0	0	0	99
19880	0	98	0	0	0	98
19881	0	0	0	101	0	101
19882	101	0	0	0	0	101
19883	0	98	0	0	0	98
19884	108	0	0	0	0	108
19885	106	0	0	0	0	106
19886	111	0	0	1	0	112
19887	117	0	0	0	0	117
19888	0	0	112	0	0	112
19889	114	0	0	0	0	114
19890	0	0	110	0	0	110
19891	114	0	0	0	0	114
19892	0	0	0	109	0	109
19893	0	0	103	0	0	103
19894	0	108	0	0	0	108
19895	0	0	0	109	0	109
19896	0	104	0	0	0	104
19897	0	107	0	0	0	107
19898	108	0	0	0	0	108
19899	0	0	100	0	0	100
19900	0	97	0	0	0	97
19901	106	0	0	0	0	106
19902	1	105	0	0	0	106
19903	107	0	0	0	0	107
19904	0	1	0	107	0	108
19905	112	0	0	0	0	112
19906	0	0	0	110	0	110
19907	110	0	0	0	0	110
19908	0	0	0	107	0	107
19909	0	105	0	0	0	105
19910	0	0	0	110	0	110
19911	106	0	0	0	0	106
19912	0	105	0	0	0	105
19913	0	0	0	110	0	110
19914	105	0	0	0	0	105
19915	0	0	0	97	0	97
19916	0	0	0	95	0	95
19917	0	0	91	1	0	92
19918	0	0	86	1	0	87
19919	0	0	0	93	0	93
19920	0	0	87	0	0	87
19921	0	0	0	87	0	87
19922	0	0	1	88	0	89
19923	0	0	0	90	0	90
19924	0	0	88	0	0	88
19925	0	0	0	86	0	86
19926	0	0	0	86	0	86
19927	0	84	0	0	0	84
19928	0	0	0	86	0	86
19929	88	0	0	0	0	88
19930	0	0	0	88	0	88
19931	0	0	85	0	0	85
19932	84	0	0	0	0	84
19933	0	88	0	0	0	88
19934	0	0	1	89	0	90
19935	0	1	87	0	0	88
19936	88	0	0	0	0	88
19937	0	89	0	0	0	89
19938	92	0	0	0	0	92
19939	0	0	0	93	0	93
19940	96	0	0	0	0	96
19941	0	0	93	0	0	93
19942	0	82	0	1	0	83
19943	0	92	0	0	0	92
19944	97	0	0	0	0	97
19945	99	0	0	0	0	99
19946	0	0	98	0	0	98
19947	106	0	0	0	0	106
19948	107	0	0	0	0	107
19949	102	0	0	1	0	103
19950	0	106	0	0	0	106
19951	0	101	0	0	0	101
19952	107	0	0	0	0	107
19953	103	0	0	0	0	103
19954	0	107	0	0	0	107
19955	0	0	0	112	0	112
19956	0	0	115	0	0	115
19957	115	0	0	5	0	120
19958	112	1	0	1	0	114
19959	122	0	0	0	0	122
19960	0	119	0	0	0	119
19961	0	0	106	5	0	111
19962	113	0	0	0	0	113
19963	0	0	0	120	0	120
19964	0	0	0	117	0	117
19965	0	0	0	125	0	125
19966	0	0	125	0	0	125
19967	1	0	0	128	0	129
19968	0	0	128	1	0	129
19969	0	127	0	0	0	127
19970	129	1	0	0	0	130
19971	0	128	0	0	0	128
19972	0	131	0	0	0	131
19973	134	0	0	0	0	134
19974	0	135	0	0	0	135
19975	0	0	0	143	0	143
19976	0	139	0	0	0	139
19977	140	0	0	0	0	140
19978	0	137	0	1	0	138
19979	0	0	0	134	0	134
19980	0	0	132	0	0	132
19981	1	0	0	132	0	133
19982	0	133	0	1	0	134
19983	0	0	0	132	0	132
19984	0	0	0	133	0	133
19985	0	0	0	135	0	135
19986	0	0	0	136	0	136
19987	0	0	0	134	0	134
19988	0	0	0	136	0	136
19989	0	0	129	0	0	129
19990	135	0	0	0	0	135
19991	0	0	0	135	0	135
19992	0	0	127	0	0	127
19993	2	0	120	0	0	122
19994	0	0	1	126	0	127
19995	130	0	0	0	0	130
19996	0	0	125	0	0	125
19997	125	0	0	0	0	125
19998	1	0	124	0	0	125
19999	0	0	0	125	0	125
20000	0	0	0	127	0	127
20001	1	0	119	0	0	120
20002	122	0	0	0	0	122
20003	0	0	0	119	0	119
20004	0	0	109	0	0	109
20005	0	0	109	0	0	109
20006	1	0	0	116	0	117
20007	0	118	0	0	0	118
20008	124	0	0	0	0	124
20009	124	0	0	0	0	124
20010	0	0	120	0	0	120
20011	0	0	0	116	0	116
20012	122	0	0	0	0	122
20013	0	0	120	0	0	120
20014	112	0	0	0	0	112
20015	0	112	0	0	0	112
20016	0	0	0	118	0	118
20017	0	0	0	120	0	120
20018	123	0	0	0	0	123
20019	0	0	0	126	0	126
20020	0	0	0	124	0	124
20021	0	0	0	130	0	130
20022	127	0	0	0	0	127
20023	0	0	125	0	0	125
20024	126	0	0	0	0	126
20025	124	0	0	0	0	124
20026	124	0	0	0	0	124
20027	0	0	0	119	0	119
20028	0	0	116	0	0	116
20029	0	107	0	0	0	107
20030	0	109	0	0	0	109
20031	0	117	0	0	0	117
20032	0	1	117	0	0	118
20033	0	0	0	126	0	126
20034	128	0	0	0	0	128
20035	123	0	0	0	0	123
20036	1	0	0	124	0	125
20037	0	0	120	0	0	120
20038	0	0	117	1	0	118
20039	0	0	0	115	0	115
20040	0	0	121	0	0	121
20041	0	0	0	120	0	120
20042	0	0	0	116	0	116
20043	0	117	0	0	0	117
20044	0	0	0	123	0	123
20045	0	0	0	126	0	126
20046	123	1	0	1	0	125
20047	0	0	0	128	0	128
20048	0	0	0	126	0	126
20049	123	0	0	0	0	123
20050	0	124	0	0	0	124
20051	128	0	0	0	0	128
20052	0	0	127	0	0	127
20053	131	0	0	0	0	131
20054	129	0	0	0	0	129
20055	0	0	123	0	0	123
20056	0	0	121	0	0	121
20057	0	0	0	111	0	111
20058	118	0	0	0	0	118
20059	0	0	116	0	0	116
20060	0	0	0	113	0	113
20061	0	0	120	0	0	120
20062	0	0	0	117	0	117
20063	0	0	0	122	0	122
20064	122	0	0	0	0	122
20065	119	0	0	0	0	119
20066	122	0	0	0	0	122
20067	0	0	119	0	0	119
20068	0	0	107	0	0	107
20069	0	0	0	117	0	117
20070	0	0	0	117	0	117
20071	0	0	0	117	0	117
20072	116	0	0	1	0	117
20073	0	118	0	0	0	118
20074	115	0	0	0	0	115
20075	112	1	0	0	0	113
20076	0	121	0	0	0	121
20077	0	121	0	1	0	122
20078	125	0	0	0	0	125
20079	0	0	0	121	0	121
20080	0	118	0	0	0	118
20081	0	0	0	118	0	118
20082	0	0	118	0	0	118
20083	0	0	0	121	0	121
20084	119	0	0	0	0	119
20085	0	0	118	0	0	118
20086	0	0	108	0	0	108
20087	0	0	0	112	0	112
20088	0	116	1	1	0	118
20089	0	111	0	0	0	111
20090	0	126	1	0	0	127
20091	129	0	0	0	0	129
20092	125	0	0	0	0	125
20093	116	0	1	0	0	117
20094	0	126	0	0	0	126
20095	127	0	0	1	0	128
20096	125	0	0	0	0	125
20097	0	0	119	0	0	119
20098	0	120	0	0	0	120
20099	0	0	0	123	0	123
20100	128	0	0	0	0	128
20101	0	0	120	0	0	120
20102	0	0	0	122	0	122
20103	0	117	0	0	0	117
20104	0	0	0	118	0	118
20105	0	0	0	118	0	118
20106	119	0	0	1	0	120
20107	114	0	0	0	0	114
20108	0	0	0	115	0	115
20109	0	0	115	0	0	115
20110	0	0	108	1	0	109
20111	108	0	0	0	0	108
20112	0	0	109	0	0	109
20113	0	0	0	112	0	112
20114	0	104	0	0	0	104
20115	108	0	0	0	0	108
20116	0	102	0	0	0	102
20117	106	0	0	0	0	106
20118	0	0	0	108	0	108
20119	1	0	0	111	0	112
20120	106	0	0	0	0	106
20121	108	0	0	1	0	109
20122	0	0	0	111	0	111
20123	0	0	0	108	0	108
20124	0	0	111	0	0	111
20125	1	0	96	0	0	97
20126	104	0	0	0	0	104
20127	0	0	95	0	0	95
20128	105	0	0	0	0	105
20129	109	0	0	0	0	109
20130	0	0	97	0	0	97
20131	1	89	0	0	0	90
20132	0	98	0	2	0	100
20133	0	0	114	0	0	114
20134	0	0	0	116	0	116
20135	122	0	0	0	0	122
20136	115	0	0	0	0	115
20137	121	3	0	0	0	124
20138	116	0	0	3	0	119
20139	108	0	0	0	0	108
20140	0	117	0	0	0	117
20141	115	0	0	0	0	115
20142	0	111	0	0	0	111
20143	117	0	0	0	0	117
20144	0	0	114	0	0	114
20145	0	0	0	117	0	117
20146	0	0	0	119	0	119
20147	0	116	0	0	0	116
20148	117	0	0	0	0	117
20149	120	0	0	0	0	120
20150	0	0	0	118	0	118
20151	0	0	0	122	0	122
20152	119	1	0	0	0	120
20153	0	0	0	115	0	115
20154	1	0	0	112	0	113
20155	116	0	0	0	0	116
20156	0	0	0	111	0	111
20157	112	0	0	0	0	112
20158	108	0	0	0	0	108
20159	0	0	107	0	0	107
20160	105	0	0	2	0	107
20161	109	0	0	0	0	109
20162	108	0	0	0	0	108
20163	0	0	101	0	0	101
20164	1	0	0	105	0	106
20165	0	0	0	109	0	109
20166	0	0	101	0	0	101
20167	101	0	0	0	0	101
20168	0	0	0	101	0	101
20169	0	0	98	0	0	98
20170	0	0	96	0	0	96
20171	0	0	0	99	0	99
20172	0	0	97	0	0	97
20173	0	0	0	98	0	98
20174	0	0	0	101	0	101
20175	0	0	92	0	0	92
20176	0	0	0	94	0	94
20177	0	90	0	0	0	90
20178	0	100	0	1	0	101
20179	102	0	0	0	0	102
20180	99	0	0	0	0	99
20181	0	101	0	0	0	101
20182	104	0	0	1	0	105
20183	98	0	0	0	0	98
20184	0	0	0	98	0	98
20185	1	0	0	101	0	102
20186	104	0	0	0	0	104
20187	0	91	1	2	0	94
20188	1	98	0	0	0	99
20189	0	0	0	107	0	107
20190	0	0	104	0	0	104
20191	101	0	0	1	0	102
20192	107	0	0	0	0	107
20193	102	0	0	0	0	102
20194	0	107	0	0	0	107
20195	1	0	0	107	0	108
20196	0	0	0	107	0	107
20197	110	0	0	0	0	110
20198	0	100	0	0	0	100
20199	0	0	0	107	0	107
20200	0	0	0	108	0	108
20201	0	0	0	107	0	107
20202	108	0	0	0	0	108
20203	0	100	0	0	0	100
20204	0	0	0	104	0	104
20205	0	109	0	0	0	109
20206	103	0	0	0	0	103
20207	0	0	99	0	0	99
20208	105	0	0	0	0	105
20209	0	0	97	0	0	97
20210	0	0	0	103	0	103
20211	108	0	0	0	0	108
20212	0	0	101	0	0	101
20213	107	0	0	0	0	107
20214	99	0	0	0	0	99
20215	104	0	0	0	0	104
20216	0	0	0	100	0	100
20217	0	0	0	95	0	95
20218	0	0	0	99	0	99
20219	98	0	0	0	0	98
20220	0	94	0	0	0	94
20221	99	0	0	0	0	99
20222	93	0	0	0	0	93
20223	0	0	84	0	0	84
20224	92	0	0	0	0	92
20225	91	0	0	0	0	91
20226	0	0	0	84	0	84
20227	0	0	0	88	0	88
20228	0	0	0	85	0	85
20229	85	0	0	0	0	85
20230	80	0	0	1	0	81
20231	80	1	0	0	0	81
20232	0	74	0	0	0	74
20233	0	63	1	1	0	65
20234	0	68	0	0	0	68
20235	73	0	0	0	0	73
20236	0	0	73	0	0	73
20237	0	0	63	0	0	63
20238	72	0	0	0	0	72
20239	0	0	71	0	0	71
20240	0	0	0	68	0	68
20241	1	59	0	1	0	61
20242	71	0	0	0	0	71
20243	69	0	0	0	0	69
20244	69	0	0	2	0	71
20245	0	0	0	71	0	71
20246	0	0	72	0	0	72
20247	0	0	69	0	0	69
20248	74	0	0	0	0	74
20249	78	0	0	0	0	78
20250	71	0	0	0	0	71
20251	0	0	0	72	0	72
20252	0	0	0	74	0	74
20253	0	0	72	0	0	72
20254	80	0	0	0	0	80
20255	0	0	0	77	0	77
20256	0	0	0	77	0	77
20257	0	0	0	78	0	78
20258	0	81	0	0	0	81
20259	0	0	0	90	0	90
20260	0	0	0	89	0	89
20261	88	0	0	0	0	88
20262	0	0	85	0	0	85
20263	89	0	0	1	0	90
20264	88	0	0	0	0	88
20265	0	0	0	82	0	82
20266	0	0	0	88	0	88
20267	90	0	0	0	0	90
20268	0	0	79	0	0	79
20269	0	79	0	0	0	79
20270	1	0	0	84	0	85
20271	84	0	0	0	0	84
20272	0	0	0	77	0	77
20273	0	0	73	0	0	73
20274	0	1	73	0	0	74
20275	79	0	0	0	0	79
20276	0	0	0	79	0	79
20277	0	0	79	0	0	79
20278	81	0	0	0	0	81
20279	79	0	0	0	0	79
20280	0	0	0	75	0	75
20281	0	0	0	74	0	74
20282	0	77	0	0	0	77
20283	72	0	0	0	0	72
20284	0	0	0	79	0	79
20285	0	0	0	75	0	75
20286	0	0	74	0	0	74
20287	77	0	0	0	0	77
20288	79	0	0	0	0	79
20289	0	76	0	0	0	76
20290	0	0	70	0	0	70
20291	1	0	71	0	0	72
20292	0	0	0	77	0	77
20293	77	0	0	0	0	77
20294	0	0	0	81	0	81
20295	82	0	0	0	0	82
20296	83	0	0	0	0	83
20297	84	0	0	0	0	84
20298	0	0	0	82	0	82
20299	0	0	0	78	0	78
20300	84	0	0	0	0	84
20301	0	0	78	0	0	78
20302	84	0	0	0	0	84
20303	82	0	0	0	0	82
20304	0	0	81	0	0	81
20305	0	0	80	0	0	80
20306	0	82	0	1	0	83
20307	0	0	0	92	0	92
20308	91	0	0	0	0	91
20309	0	0	0	97	0	97
20310	0	0	96	0	0	96
20311	0	92	0	2	0	94
20312	0	100	0	0	0	100
20313	0	0	0	107	0	107
20314	0	0	0	100	0	100
20315	1	107	0	0	0	108
20316	0	0	104	0	0	104
20317	108	0	0	0	0	108
20318	108	0	0	1	0	109
20319	0	108	0	0	0	108
20320	114	0	0	0	0	114
20321	0	0	0	116	0	116
20322	111	0	0	0	0	111
20323	0	0	0	107	0	107
20324	0	113	0	0	0	113
20325	0	0	115	0	0	115
20326	0	0	0	117	0	117
20327	0	0	1	108	0	109
20328	0	0	0	120	0	120
20329	114	0	0	0	0	114
20330	0	0	0	120	0	120
20331	0	0	119	0	0	119
20332	0	1	112	0	0	113
20333	126	0	0	0	0	126
20334	0	0	125	0	0	125
20335	124	0	0	0	0	124
20336	0	0	0	124	0	124
20337	0	0	0	126	0	126
20338	0	0	0	125	0	125
20339	0	0	0	125	0	125
20340	127	0	0	0	0	127
20341	0	0	131	0	0	131
20342	0	0	0	127	0	127
20343	0	124	0	1	0	125
20344	130	0	0	0	0	130
20345	0	0	0	130	0	130
20346	129	0	0	0	0	129
20347	0	0	125	0	0	125
20348	0	0	0	128	0	128
20349	0	129	0	0	0	129
20350	129	0	0	0	0	129
20351	0	0	119	0	0	119
20352	0	0	0	117	0	117
20353	0	0	0	115	0	115
20354	115	0	0	0	0	115
20355	0	0	116	0	0	116
20356	0	0	108	0	0	108
20357	0	0	0	112	0	112
20358	0	0	107	0	0	107
20359	2	0	108	0	0	110
20360	0	0	2	103	0	105
20361	0	0	0	110	0	110
20362	0	0	0	110	0	110
20363	110	0	0	0	0	110
20364	0	113	0	0	0	113
20365	105	0	0	0	0	105
20366	0	0	0	113	0	113
20367	0	113	0	0	0	113
20368	0	0	0	114	0	114
20369	114	0	0	0	0	114
20370	0	115	0	0	0	115
20371	0	0	0	117	0	117
20372	0	0	119	0	0	119
20373	118	0	0	0	0	118
20374	0	0	0	121	0	121
20375	0	0	0	120	0	120
20376	0	0	119	0	0	119
20377	0	0	113	0	0	113
20378	120	0	0	1	0	121
20379	0	121	0	0	0	121
20380	0	0	0	125	0	125
20381	125	0	0	0	0	125
20382	0	0	119	0	0	119
20383	0	115	0	0	0	115
20384	1	0	0	119	0	120
20385	123	0	0	0	0	123
20386	121	0	0	0	0	121
20387	117	0	0	0	0	117
20388	0	112	0	0	0	112
20389	0	0	119	0	0	119
20390	0	0	0	116	0	116
20391	0	0	0	115	0	115
20392	1	0	0	124	0	125
20393	0	0	0	120	0	120
20394	123	0	0	0	0	123
20395	117	0	0	0	0	117
20396	0	0	116	0	0	116
20397	0	0	115	0	0	115
20398	118	0	0	0	0	118
20399	117	0	0	0	0	117
20400	0	0	0	114	0	114
20401	0	106	0	0	0	106
20402	111	0	0	0	0	111
20403	0	96	0	1	0	97
20404	0	101	0	0	0	101
20405	0	1	0	107	0	108
20406	0	0	0	108	0	108
20407	0	0	0	107	0	107
20408	0	0	0	100	0	100
20409	0	0	100	0	0	100
20410	101	0	0	0	0	101
20411	102	0	0	0	0	102
20412	0	0	0	103	0	103
20413	0	0	0	102	0	102
20414	100	0	0	0	0	100
20415	0	0	96	0	0	96
20416	98	0	0	0	0	98
20417	100	0	0	0	0	100
20418	0	0	92	0	0	92
20419	100	0	0	0	0	100
20420	0	0	0	94	0	94
20421	0	0	0	93	0	93
20422	0	0	0	96	0	96
20423	0	0	0	92	0	92
20424	88	0	0	0	0	88
20425	0	0	0	85	0	85
20426	0	0	0	84	0	84
20427	0	75	0	0	0	75
20428	0	79	0	1	0	80
20429	0	0	0	84	0	84
20430	85	0	0	0	0	85
20431	0	0	0	87	0	87
20432	0	0	79	1	0	80
20433	0	0	77	0	0	77
20434	81	0	0	1	0	82
20435	0	81	0	0	0	81
20436	83	0	0	0	0	83
20437	0	0	77	0	0	77
20438	0	0	0	78	0	78
20439	85	0	0	0	0	85
20440	0	81	0	0	0	81
20441	80	0	0	0	0	80
20442	0	0	78	0	0	78
20443	0	0	0	83	0	83
20444	0	0	0	80	0	80
20445	85	0	0	0	0	85
20446	88	0	0	0	0	88
20447	91	0	0	0	0	91
20448	90	0	0	0	0	90
20449	94	0	0	0	0	94
20450	0	92	0	0	0	92
20451	1	0	0	95	0	96
20452	95	0	1	0	0	96
20453	0	0	0	100	0	100
20454	0	0	0	96	0	96
20455	0	0	0	99	0	99
20456	0	99	0	0	0	99
20457	100	0	0	0	0	100
20458	0	0	0	105	0	105
20459	99	0	0	0	0	99
20460	97	0	0	0	0	97
20461	0	100	0	0	0	100
20462	103	0	0	0	0	103
20463	0	0	100	0	0	100
20464	102	0	0	0	0	102
20465	0	0	0	99	0	99
20466	1	0	99	0	0	100
20467	0	98	0	0	0	98
20468	0	0	102	0	0	102
20469	0	107	0	0	0	107
20470	111	0	1	0	0	112
20471	108	0	0	0	0	108
20472	105	0	0	0	0	105
20473	0	102	0	0	0	102
20474	105	0	0	0	0	105
20475	0	0	104	0	0	104
20476	0	0	102	0	0	102
20477	0	0	0	110	0	110
20478	0	0	0	114	0	114
20479	0	109	0	0	0	109
20480	112	0	0	0	0	112
20481	1	0	0	112	0	113
20482	1	104	0	0	0	105
20483	0	0	0	115	0	115
20484	113	0	0	0	0	113
20485	112	0	0	0	0	112
20486	0	2	106	0	0	108
20487	0	0	0	110	0	110
20488	0	0	109	0	0	109
20489	0	0	0	107	0	107
20490	0	0	108	0	0	108
20491	0	0	0	110	0	110
20492	0	0	110	0	0	110
20493	0	0	0	109	0	109
20494	0	0	110	0	0	110
20495	0	0	0	108	0	108
20496	1	0	0	113	0	114
20497	0	107	0	0	0	107
20498	0	0	0	116	0	116
20499	0	0	115	0	0	115
20500	0	0	0	120	0	120
20501	0	0	0	117	0	117
20502	118	0	0	0	0	118
20503	0	0	0	118	0	118
20504	0	0	0	118	0	118
20505	0	0	116	0	0	116
20506	121	0	0	0	0	121
20507	0	0	0	120	0	120
20508	0	0	0	114	0	114
20509	1	0	0	117	0	118
20510	116	0	0	0	0	116
20511	0	0	0	115	0	115
20512	0	0	0	116	0	116
20513	111	0	0	1	0	112
20514	0	115	0	0	0	115
20515	0	0	0	115	0	115
20516	0	0	0	118	0	118
20517	0	0	114	0	0	114
20518	115	0	0	0	0	115
20519	0	0	0	117	0	117
20520	0	0	109	0	0	109
20521	116	0	0	0	0	116
20522	0	0	0	109	0	109
20523	0	0	0	114	0	114
20524	0	0	0	113	0	113
20525	0	0	0	114	0	114
20526	0	0	120	0	0	120
20527	0	0	0	120	0	120
20528	0	0	0	119	0	119
20529	0	0	116	0	0	116
20530	117	0	0	1	0	118
20531	118	0	0	0	0	118
20532	116	0	0	0	0	116
20533	0	0	0	113	0	113
20534	118	0	0	0	0	118
20535	119	0	0	0	0	119
20536	0	0	0	125	0	125
20537	121	0	0	1	0	122
20538	119	0	0	0	0	119
20539	116	0	0	0	0	116
20540	108	0	0	0	0	108
20541	0	0	0	110	0	110
20542	0	103	0	0	0	103
20543	0	100	0	0	0	100
20544	0	117	0	0	0	117
20545	117	0	0	0	0	117
20546	118	0	0	0	0	118
20547	0	0	113	0	0	113
20548	120	0	0	0	0	120
20549	0	0	0	120	0	120
20550	0	0	0	114	0	114
20551	0	0	0	116	0	116
20552	115	0	0	0	0	115
20553	0	0	0	112	0	112
20554	0	107	0	0	0	107
20555	0	0	0	110	0	110
20556	0	0	112	0	0	112
20557	0	0	0	112	0	112
20558	111	0	0	0	0	111
20559	0	0	103	0	0	103
20560	1	0	0	109	0	110
20561	0	0	0	105	0	105
20562	0	0	0	105	0	105
20563	0	105	0	0	0	105
20564	0	0	0	106	0	106
20565	105	1	0	0	0	106
20566	108	0	0	0	0	108
20567	0	0	105	0	0	105
20568	0	0	104	0	0	104
20569	0	0	0	108	0	108
20570	0	0	0	105	0	105
20571	0	0	109	0	0	109
20572	0	0	0	112	0	112
20573	0	111	0	0	0	111
20574	119	0	0	0	0	119
20575	112	0	0	0	0	112
20576	117	0	0	0	0	117
20577	0	0	112	0	0	112
20578	0	0	0	119	0	119
20579	1	0	117	0	0	118
20580	119	0	0	1	0	120
20581	0	118	0	0	0	118
20582	0	0	0	123	0	123
20583	120	0	0	1	0	121
20584	0	0	0	120	0	120
20585	0	0	0	119	0	119
20586	0	1	115	0	0	116
20587	116	0	0	0	0	116
20588	0	116	0	0	0	116
20589	0	0	0	115	0	115
20590	112	0	0	0	0	112
20591	0	0	0	114	0	114
20592	110	0	0	0	0	110
20593	0	108	0	0	0	108
20594	108	0	0	0	0	108
20595	0	0	108	0	0	108
20596	112	0	0	0	0	112
20597	113	0	0	0	0	113
20598	112	0	0	0	0	112
20599	0	0	0	111	0	111
20600	0	0	0	110	0	110
20601	0	0	0	111	0	111
20602	0	111	0	0	0	111
20603	115	0	0	0	0	115
20604	0	0	0	108	0	108
20605	0	0	0	107	0	107
20606	1	0	0	107	0	108
20607	107	0	0	0	0	107
20608	1	0	0	113	0	114
20609	0	0	108	0	0	108
20610	0	107	0	0	0	107
20611	0	0	0	111	0	111
20612	1	0	0	109	0	110
20613	0	0	0	113	0	113
20614	0	0	108	0	0	108
20615	1	0	105	0	0	106
20616	0	0	0	108	0	108
20617	0	0	107	0	0	107
20618	0	0	0	113	0	113
20619	113	0	0	1	0	114
20620	115	0	0	0	0	115
20621	116	1	0	0	0	117
20622	0	0	111	1	0	112
20623	118	0	0	0	0	118
20624	0	0	0	116	0	116
20625	0	0	114	0	0	114
20626	0	2	99	0	0	101
20627	1	104	0	0	0	105
20628	0	109	1	0	0	110
20629	110	0	1	0	0	111
20630	0	0	0	116	0	116
20631	0	0	116	0	0	116
20632	0	0	0	120	0	120
20633	119	0	0	0	0	119
20634	0	0	119	0	0	119
20635	126	0	0	0	0	126
20636	117	0	0	1	0	118
20637	116	0	0	0	0	116
20638	0	115	0	0	0	115
20639	117	0	0	0	0	117
20640	1	0	0	114	0	115
20641	0	0	1	108	0	109
20642	0	0	0	106	0	106
20643	0	0	0	107	0	107
20644	104	0	0	0	0	104
20645	0	103	1	0	0	104
20646	0	93	0	0	0	93
20647	1	101	1	0	0	103
20648	113	0	0	0	0	113
20649	107	0	0	0	0	107
20650	109	0	0	0	0	109
20651	107	0	0	0	0	107
20652	1	0	0	108	0	109
20653	0	0	0	110	0	110
20654	113	0	0	1	0	114
20655	0	113	0	0	0	113
20656	113	0	0	0	0	113
20657	112	0	0	0	0	112
20658	0	0	0	112	0	112
20659	0	108	0	0	0	108
20660	0	0	0	112	0	112
20661	109	0	0	0	0	109
20662	0	0	102	0	0	102
20663	0	0	0	108	0	108
20664	0	107	1	0	0	108
20665	107	0	0	0	0	107
20666	106	0	0	0	0	106
20667	0	0	100	0	0	100
20668	0	102	0	1	0	103
20669	0	0	105	0	0	105
20670	0	0	0	101	0	101
20671	0	0	96	0	0	96
20672	0	0	90	0	0	90
20673	0	98	1	2	0	101
20674	107	0	0	0	0	107
20675	106	0	0	0	0	106
20676	0	97	0	0	0	97
20677	0	104	1	2	0	107
20678	0	0	104	0	0	104
20679	0	0	107	0	0	107
20680	0	0	109	0	0	109
20681	0	0	0	117	0	117
20682	0	0	119	0	0	119
20683	0	0	0	120	0	120
20684	1	0	0	124	0	125
20685	0	0	125	0	0	125
20686	0	124	0	0	0	124
20687	0	0	0	125	0	125
20688	125	0	0	0	0	125
20689	0	0	0	129	0	129
20690	0	0	123	0	0	123
20691	0	118	0	1	0	119
20692	0	123	0	0	0	123
20693	0	0	0	126	0	126
20694	126	0	0	0	0	126
20695	124	0	0	0	0	124
20696	0	0	0	125	0	125
20697	0	123	0	0	0	123
20698	0	0	0	127	0	127
20699	0	0	0	129	0	129
20700	0	0	0	128	0	128
20701	129	0	0	0	0	129
20702	0	124	0	0	0	124
20703	135	0	0	0	0	135
20704	133	0	0	0	0	133
20705	139	0	0	0	0	139
20706	137	0	0	0	0	137
20707	0	0	0	139	0	139
20708	1	0	136	0	0	137
20709	0	142	0	0	0	142
20710	150	0	0	0	0	150
20711	147	0	0	0	0	147
20712	145	0	0	0	0	145
20713	0	0	140	0	0	140
20714	145	0	0	0	0	145
20715	148	0	0	0	0	148
20716	0	0	0	148	0	148
20717	0	0	143	0	0	143
20718	0	140	0	0	0	140
20719	0	0	0	147	0	147
20720	152	0	0	1	0	153
20721	0	0	1	154	0	155
20722	1	0	0	163	0	164
20723	160	0	0	0	0	160
20724	0	0	156	0	0	156
20725	164	0	0	0	0	164
20726	165	0	0	0	0	165
20727	159	0	0	0	0	159
20728	160	0	0	1	0	161
20729	0	0	156	0	0	156
20730	0	0	0	164	0	164
20731	0	1	165	0	0	166
20732	0	0	0	173	0	173
20733	1	0	170	0	0	171
20734	174	0	0	0	0	174
20735	0	165	0	0	0	165
20736	0	170	0	1	0	171
20737	0	0	0	195	0	195
20738	0	0	0	197	0	197
20739	0	193	0	0	0	193
20740	208	0	0	0	0	208
20741	210	0	0	0	0	210
20742	204	0	0	1	0	205
20743	209	0	0	0	0	209
20744	0	0	0	209	0	209
20745	1	0	0	208	0	209
20746	204	0	0	0	0	204
20747	0	0	0	209	0	209
20748	0	0	197	1	0	198
20749	1	1	186	0	0	188
20750	0	0	0	212	0	212
20751	0	0	208	0	0	208
20752	211	0	1	0	0	212
20753	0	0	0	211	0	211
20754	219	0	0	0	0	219
20755	0	0	220	0	0	220
20756	0	0	0	227	0	227
20757	0	1	227	0	0	228
20758	0	227	0	1	0	228
20759	237	0	0	0	0	237
20760	237	0	0	0	0	237
20761	0	234	0	0	0	234
20762	242	0	0	1	0	243
20763	0	0	0	241	0	241
20764	0	0	0	239	0	239
20765	239	0	0	0	0	239
20766	0	236	0	1	0	237
20767	0	241	0	0	0	241
20768	0	0	0	246	0	246
20769	238	0	0	1	0	239
20770	237	0	0	0	0	237
20771	243	0	0	0	0	243
20772	0	0	230	0	0	230
20773	0	0	216	0	0	216
20774	0	236	0	0	0	236
20775	240	0	0	0	0	240
20776	1	0	0	234	0	235
20777	233	0	0	0	0	233
20778	238	0	0	0	0	238
20779	0	0	0	236	0	236
20780	0	0	233	0	0	233
20781	235	0	0	0	0	235
20782	0	0	0	242	0	242
20783	0	0	230	0	0	230
20784	238	0	0	0	0	238
20785	239	0	0	0	0	239
20786	0	0	0	239	0	239
20787	0	0	236	0	0	236
20788	1	0	0	235	0	236
20789	0	226	0	0	0	226
20790	0	0	229	0	0	229
20791	0	243	0	0	0	243
20792	252	0	0	0	0	252
20793	249	0	0	0	0	249
20794	251	0	0	0	0	251
20795	249	0	0	0	0	249
20796	0	0	0	247	0	247
20797	249	0	0	0	0	249
20798	1	0	0	249	0	250
20799	251	0	0	0	0	251
20800	0	236	0	0	0	236
20801	0	0	0	245	0	245
20802	0	243	0	0	0	243
20803	245	0	0	0	0	245
20804	251	0	0	0	0	251
20805	0	240	0	1	0	241
20806	0	0	0	244	0	244
20807	0	0	235	0	0	235
20808	0	0	0	240	0	240
20809	0	0	237	0	0	237
20810	0	0	0	243	0	243
20811	0	243	0	0	0	243
20812	251	0	0	0	0	251
20813	243	0	0	1	0	244
20814	0	0	0	236	0	236
20815	237	0	0	0	0	237
20816	0	2	0	234	0	236
20817	0	0	0	234	0	234
20818	0	0	0	237	0	237
20819	239	0	0	0	0	239
20820	236	0	0	0	0	236
20821	240	0	0	0	0	240
20822	0	235	0	0	0	235
20823	239	0	0	1	0	240
20824	0	230	0	0	0	230
20825	235	0	0	0	0	235
20826	0	0	2	228	0	230
20827	0	0	0	227	0	227
20828	233	0	0	0	0	233
20829	223	0	0	0	0	223
20830	0	219	0	0	0	219
20831	224	0	0	2	0	226
20832	0	0	0	225	0	225
20833	0	0	0	219	0	219
20834	217	0	0	0	0	217
20835	0	1	219	0	0	220
20836	0	216	0	0	0	216
20837	0	0	0	231	0	231
20838	0	0	228	0	0	228
20839	1	0	0	225	0	226
20840	231	0	0	1	0	232
20841	1	208	0	0	0	209
20842	0	201	0	1	0	202
20843	0	218	0	1	0	219
20844	0	0	0	225	0	225
20845	227	0	0	0	0	227
20846	1	0	0	227	0	228
20847	225	0	0	0	0	225
20848	226	1	0	0	0	227
20849	0	0	0	220	0	220
20850	210	0	0	0	0	210
20851	0	0	0	216	0	216
20852	1	0	204	1	0	206
20853	217	0	0	0	0	217
20854	0	0	204	1	0	205
20855	214	0	0	0	0	214
20856	0	0	212	0	0	212
20857	0	0	0	212	0	212
20858	0	0	0	213	0	213
20859	219	0	0	0	0	219
20860	0	1	0	219	0	220
20861	209	0	0	0	0	209
20862	0	210	0	0	0	210
20863	213	0	0	0	0	213
20864	1	0	0	212	0	213
20865	2	0	0	211	0	213
20866	0	0	0	218	0	218
20867	0	0	0	218	0	218
20868	0	0	207	0	0	207
20869	1	0	198	0	0	199
20870	0	0	0	216	0	216
20871	0	0	214	0	0	214
20872	0	207	0	0	0	207
20873	1	0	0	219	0	220
20874	0	0	213	0	0	213
20875	0	0	207	0	0	207
20876	0	0	1	218	0	219
20877	0	0	0	220	0	220
20878	0	215	1	0	0	216
20879	0	0	0	222	0	222
20880	0	0	216	0	0	216
20881	223	0	0	0	0	223
20882	0	0	0	224	0	224
20883	221	0	0	0	0	221
20884	220	0	0	0	0	220
20885	221	0	0	0	0	221
20886	0	0	215	0	0	215
20887	0	0	204	0	0	204
20888	219	0	0	0	0	219
20889	0	0	219	0	0	219
20890	1	0	0	220	0	221
20891	1	0	0	223	0	224
20892	0	0	218	0	0	218
20893	0	218	0	0	0	218
20894	222	0	0	0	0	222
20895	1	210	1	2	0	214
20896	0	219	0	0	0	219
20897	227	0	0	0	0	227
20898	0	0	228	0	0	228
20899	0	0	221	2	0	223
20900	0	0	0	229	0	229
20901	231	1	0	0	0	232
20902	0	228	0	1	0	229
20903	233	0	0	0	0	233
20904	0	0	228	0	0	228
20905	0	225	0	0	0	225
20906	0	0	0	236	0	236
20907	0	0	233	0	0	233
20908	0	0	0	240	0	240
20909	0	0	0	223	0	223
20910	0	0	0	235	0	235
20911	0	0	0	232	0	232
20912	229	0	0	0	0	229
20913	228	1	0	0	0	229
20914	0	0	233	0	0	233
20915	228	0	0	0	0	228
20916	0	235	0	0	0	235
20917	232	0	0	0	0	232
20918	0	0	226	0	0	226
20919	0	0	0	246	0	246
20920	0	0	228	2	0	230
20921	1	0	230	0	0	231
20922	0	0	0	240	0	240
20923	0	0	0	250	0	250
20924	0	0	242	0	0	242
20925	0	223	0	1	0	224
20926	0	236	0	0	0	236
20927	0	0	0	240	0	240
20928	226	0	0	0	0	226
20929	0	217	0	4	0	221
20930	1	0	217	0	0	218
20931	0	1	210	1	0	212
20932	1	0	218	1	0	220
20933	0	0	0	222	0	222
20934	221	0	0	0	0	221
20935	0	225	0	0	0	225
20936	0	0	217	0	0	217
20937	0	224	1	0	0	225
20938	1	0	0	221	0	222
20939	0	0	217	0	0	217
20940	0	212	1	0	0	213
20941	0	1	0	228	0	229
20942	0	0	0	231	0	231
20943	0	0	226	0	0	226
20944	0	0	0	220	0	220
20945	0	225	0	0	0	225
20946	0	0	224	0	0	224
20947	225	0	0	0	0	225
20948	0	0	0	222	0	222
20949	0	0	0	231	0	231
20950	0	228	0	0	0	228
20951	232	0	0	0	0	232
20952	0	0	230	0	0	230
20953	236	0	0	0	0	236
20954	0	0	0	232	0	232
20955	0	229	0	0	0	229
20956	0	0	0	230	0	230
20957	0	0	0	230	0	230
20958	226	0	0	0	0	226
20959	223	0	0	0	0	223
20960	0	0	0	229	0	229
20961	0	0	228	0	0	228
20962	234	0	0	0	0	234
20963	0	235	0	0	0	235
20964	0	0	0	238	0	238
20965	0	0	0	235	0	235
20966	0	0	0	235	0	235
20967	0	0	231	0	0	231
20968	0	0	0	229	0	229
20969	0	233	0	0	0	233
20970	0	0	0	243	0	243
20971	0	238	0	0	0	238
20972	0	0	0	242	0	242
20973	0	0	232	0	0	232
20974	239	0	0	0	0	239
20975	0	0	0	237	0	237
20976	0	0	227	0	0	227
20977	0	228	0	0	0	228
20978	228	0	0	0	0	228
20979	0	0	228	0	0	228
20980	228	0	0	0	0	228
20981	0	0	1	224	0	225
20982	0	0	0	224	0	224
20983	0	218	0	0	0	218
20984	227	0	0	0	0	227
20985	221	0	0	0	0	221
20986	0	225	0	0	0	225
20987	0	0	0	225	0	225
20988	0	0	0	222	0	222
20989	0	0	0	226	0	226
20990	0	0	217	0	0	217
20991	217	0	0	0	0	217
20992	0	0	0	220	0	220
20993	0	0	0	222	0	222
20994	0	0	217	0	0	217
20995	0	0	210	1	0	211
20996	0	0	0	221	0	221
20997	0	0	216	0	0	216
20998	215	0	0	0	0	215
20999	0	0	0	225	0	225
21000	0	0	0	223	0	223
21001	0	0	224	0	0	224
21002	0	0	0	225	0	225
21003	1	0	221	1	0	223
21004	0	227	0	1	0	228
21005	232	0	0	0	0	232
21006	222	0	0	1	0	223
21007	0	220	0	0	0	220
21008	0	0	0	226	0	226
21009	0	0	218	0	0	218
21010	0	0	0	219	0	219
21011	228	0	0	0	0	228
21012	0	229	0	0	0	229
21013	229	0	0	0	0	229
21014	1	0	0	222	0	223
21015	215	0	0	1	0	216
21016	0	214	0	0	0	214
21017	219	0	0	0	0	219
21018	1	0	212	0	0	213
21019	0	208	0	0	0	208
21020	0	0	0	223	0	223
21021	222	0	0	0	0	222
21022	222	0	0	0	0	222
21023	0	0	0	224	0	224
21024	223	1	0	0	0	224
21025	226	0	0	0	0	226
21026	231	0	0	0	0	231
21027	1	0	0	228	0	229
21028	0	0	217	0	0	217
21029	1	0	204	1	0	206
21030	1	0	212	0	0	213
21031	233	0	0	0	0	233
21032	0	0	0	237	0	237
21033	1	223	0	1	0	225
21034	0	0	0	226	0	226
21035	0	227	0	0	0	227
21036	234	0	0	0	0	234
21037	0	0	0	230	0	230
21038	0	0	0	234	0	234
21039	230	0	0	2	0	232
21040	0	0	0	226	0	226
21041	0	0	0	235	0	235
21042	231	0	0	0	0	231
21043	0	0	220	0	0	220
21044	0	0	0	225	0	225
21045	0	0	223	1	0	224
21046	226	0	0	0	0	226
21047	1	0	0	218	0	219
21048	230	0	0	0	0	230
21049	0	0	0	232	0	232
21050	0	0	224	1	0	225
21051	0	0	0	227	0	227
21052	225	0	1	0	0	226
21053	0	212	0	0	0	212
21054	0	0	216	0	0	216
21055	220	0	0	0	0	220
21056	0	201	0	0	0	201
21057	2	185	1	0	0	188
21058	0	203	0	0	0	203
21059	0	0	0	217	0	217
21060	217	0	0	0	0	217
21061	213	1	0	0	0	214
21062	0	0	193	0	0	193
21063	210	0	0	0	0	210
21064	0	197	0	0	0	197
21065	0	0	0	210	0	210
21066	216	0	0	0	0	216
21067	204	0	0	0	0	204
21068	214	0	0	0	0	214
21069	197	1	0	0	0	198
21070	207	0	0	0	0	207
21071	1	0	1	204	0	206
21072	0	0	208	0	0	208
21073	0	0	0	206	0	206
21074	0	0	0	214	0	214
21075	205	0	0	1	0	206
21076	1	203	0	0	0	204
21077	198	0	0	0	0	198
21078	199	0	0	0	0	199
21079	184	0	0	0	0	184
21080	197	0	0	0	0	197
21081	0	0	192	0	0	192
21082	195	0	0	0	0	195
21083	202	0	0	0	0	202
21084	185	0	0	0	0	185
21085	201	0	0	1	0	202
21086	1	0	0	197	0	198
21087	0	0	195	0	0	195
21088	200	0	0	1	0	201
21089	0	189	1	0	0	190
21090	0	0	0	205	0	205
21091	0	205	0	0	0	205
21092	0	0	0	204	0	204
21093	201	0	0	0	0	201
21094	202	0	0	1	0	203
21095	196	0	0	0	0	196
21096	0	0	188	0	0	188
21097	195	0	0	0	0	195
21098	0	0	171	0	0	171
21099	0	0	169	0	0	169
21100	2	0	181	0	0	183
21101	0	0	0	194	0	194
21102	0	0	0	200	0	200
21103	0	0	0	193	0	193
21104	0	0	0	190	0	190
21105	0	0	1	183	0	184
21106	0	0	0	188	0	188
21107	0	173	0	1	0	174
21108	179	0	0	0	0	179
21109	0	186	2	0	0	188
21110	0	0	0	189	0	189
21111	0	0	0	193	0	193
21112	193	0	0	0	0	193
21113	0	184	0	0	0	184
21114	187	0	0	1	0	188
21115	0	0	0	190	0	190
21116	0	0	0	190	0	190
21117	0	0	0	188	0	188
21118	0	0	177	0	0	177
21119	0	0	0	183	0	183
21120	0	0	176	0	0	176
21121	0	0	156	0	0	156
21122	0	0	158	0	0	158
21123	0	0	0	177	0	177
21124	0	0	0	183	0	183
21125	0	0	0	182	0	182
21126	182	0	0	0	0	182
21127	0	0	0	180	0	180
21128	177	0	0	0	0	177
21129	0	172	0	0	0	172
21130	186	0	0	0	0	186
21131	177	0	0	0	0	177
21132	0	193	0	0	0	193
21133	198	0	0	0	0	198
21134	197	0	0	0	0	197
21135	201	0	0	0	0	201
21136	191	0	1	0	0	192
21137	0	0	198	0	0	198
21138	0	203	0	0	0	203
21139	0	0	0	213	0	213
21140	221	0	0	0	0	221
21141	1	0	215	0	0	216
21142	0	212	0	0	0	212
21143	1	0	0	220	0	221
21144	0	223	0	0	0	223
21145	0	0	0	234	0	234
21146	0	2	0	223	0	225
21147	0	0	219	0	0	219
21148	0	0	197	0	0	197
21149	234	0	0	2	0	236
21150	0	0	227	0	0	227
21151	0	0	221	0	0	221
21152	0	0	0	224	0	224
21153	0	0	0	231	0	231
21154	0	215	0	0	0	215
21155	0	216	0	0	0	216
21156	0	0	224	0	0	224
21157	2	0	0	229	0	231
21158	0	0	218	2	0	220
21159	2	0	195	0	0	197
21160	0	230	0	0	0	230
21161	0	0	0	229	0	229
21162	235	0	0	0	0	235
21163	1	0	0	232	0	233
21164	239	0	0	0	0	239
21165	238	0	0	0	0	238
21166	245	0	0	0	0	245
21167	0	0	236	0	0	236
21168	251	0	1	0	0	252
21169	0	0	0	249	0	249
21170	251	0	0	0	0	251
21171	247	0	0	0	0	247
21172	1	244	1	0	0	246
21173	253	0	0	1	0	254
21174	0	0	251	0	0	251
21175	260	0	0	0	0	260
21176	259	0	0	0	0	259
21177	0	260	0	1	0	261
21178	262	0	0	1	0	263
21179	0	0	0	277	0	277
21180	0	0	0	275	0	275
21181	0	288	0	0	0	288
21182	0	0	0	301	0	301
21183	1	0	0	296	0	297
21184	0	0	286	1	0	287
21185	0	1	269	1	0	271
21186	316	0	0	0	0	316
21187	314	0	0	0	0	314
21188	0	0	0	311	0	311
21189	0	0	309	0	0	309
21190	1	312	0	0	0	313
21191	1	0	0	336	0	337
21192	0	1	335	0	0	336
21193	347	0	0	0	0	347
21194	0	0	0	350	0	350
21195	0	347	0	0	0	347
21196	0	0	0	363	0	363
21197	1	0	0	361	0	362
21198	0	0	0	366	0	366
21199	361	0	0	1	0	362
21200	0	0	0	377	0	377
21201	369	0	0	0	0	369
21202	377	0	0	0	0	377
21203	0	0	372	0	0	372
21204	0	355	0	1	0	356
21205	0	0	0	364	0	364
21206	0	353	0	1	0	354
21207	367	0	0	0	0	367
21208	0	0	0	376	0	376
21209	0	0	370	0	0	370
21210	0	1	336	0	0	337
21211	0	0	354	1	0	355
21212	376	0	0	2	0	378
21213	0	376	0	0	0	376
21214	373	0	0	0	0	373
21215	0	377	2	0	0	379
21216	0	0	0	379	0	379
21217	1	0	0	372	0	373
21218	0	375	0	0	0	375
21219	0	0	367	0	0	367
21220	0	379	0	1	0	380
21221	389	0	0	0	0	389
21222	0	0	0	388	0	388
21223	0	0	380	0	0	380
21224	0	0	370	0	0	370
21225	0	0	0	374	0	374
21226	0	0	373	0	0	373
21227	1	0	368	1	0	370
21228	374	0	0	1	0	375
21229	0	386	0	0	0	386
21230	379	0	0	0	0	379
21231	0	0	365	0	0	365
21232	0	349	0	0	0	349
21233	0	364	0	1	0	365
21234	0	0	0	379	0	379
21235	0	0	0	378	0	378
21236	1	0	0	391	0	392
21237	0	1	388	0	0	389
21238	1	0	0	390	0	391
21239	4	0	0	399	0	403
21240	405	0	0	0	0	405
21241	0	391	0	0	0	391
21242	0	0	0	399	0	399
21243	400	0	0	2	0	402
21244	388	0	0	1	0	389
21245	0	0	0	406	0	406
21246	0	0	400	0	0	400
21247	0	0	0	411	0	411
21248	0	0	410	0	0	410
21249	404	0	0	0	0	404
21250	401	0	0	0	0	401
21251	0	0	0	410	0	410
21252	1	0	400	0	0	401
21253	0	392	0	1	0	393
21254	0	1	406	0	0	407
21255	1	0	1	401	0	403
21256	0	414	0	0	0	414
21257	419	0	0	0	0	419
21258	0	0	0	418	0	418
21259	0	416	1	0	0	417
21260	415	0	0	0	0	415
21261	0	0	0	416	0	416
21262	0	410	0	0	0	410
21263	0	0	0	415	0	415
21264	0	0	413	0	0	413
21265	423	0	0	0	0	423
21266	415	0	0	0	0	415
21267	0	0	412	0	0	412
21268	0	423	0	0	0	423
21269	422	0	0	0	0	422
21270	0	0	0	422	0	422
21271	0	0	0	417	0	417
21272	0	0	0	407	0	407
21273	0	0	0	409	0	409
21274	0	0	0	414	0	414
21275	417	0	0	0	0	417
21276	409	0	0	0	0	409
21277	1	0	0	393	0	394
21278	0	0	0	386	0	386
21279	0	0	373	0	0	373
21280	0	0	360	0	0	360
21281	376	0	0	0	0	376
21282	1	0	0	371	0	372
21283	0	0	356	0	0	356
21284	0	0	0	361	0	361
21285	349	0	0	0	0	349
21286	338	0	1	0	0	339
21287	0	1	1	341	0	343
21288	1	0	0	331	0	332
21289	328	0	0	0	0	328
21290	0	0	0	325	0	325
21291	0	318	0	2	0	320
21292	0	0	0	325	0	325
21293	1	0	0	317	0	318
21294	0	0	309	0	0	309
21295	0	0	307	0	0	307
21296	0	327	0	0	0	327
21297	325	0	0	0	0	325
21298	323	0	0	0	0	323
21299	318	0	0	0	0	318
21300	0	307	0	1	0	308
21301	0	318	0	0	0	318
21302	324	0	0	0	0	324
21303	0	322	0	0	0	322
21304	0	0	314	0	0	314
21305	0	305	0	0	0	305
21306	0	0	321	1	0	322
21307	327	0	0	1	0	328
21308	313	0	0	1	0	314
21309	0	319	0	0	0	319
21310	327	0	0	0	0	327
21311	335	0	0	0	0	335
21312	322	0	0	1	0	323
21313	0	0	0	335	0	335
21314	333	0	0	0	0	333
21315	0	0	319	0	0	319
21316	332	0	1	0	0	333
21317	0	0	0	321	0	321
21318	2	0	307	0	0	309
21319	0	0	286	1	0	287
21320	1	0	0	305	0	306
21321	0	0	0	311	0	311
21322	302	0	0	0	0	302
21323	0	1	0	294	0	295
21324	0	0	296	0	0	296
21325	1	0	0	290	0	291
21326	0	290	0	0	0	290
21327	299	0	0	0	0	299
21328	0	1	0	288	0	289
21329	0	0	275	0	0	275
21330	0	278	0	2	0	280
21331	283	0	1	0	0	284
21332	0	2	0	288	0	290
21333	1	0	282	0	0	283
21334	0	285	0	0	0	285
21335	298	0	0	1	0	299
21336	285	0	0	0	0	285
21337	286	0	0	0	0	286
21338	0	0	0	285	0	285
21339	0	0	0	285	0	285
21340	283	0	0	0	0	283
21341	0	284	0	1	0	285
21342	276	0	0	0	0	276
21343	0	0	0	277	0	277
21344	280	0	0	0	0	280
21345	0	0	0	284	0	284
21346	0	0	0	273	0	273
21347	0	0	0	270	0	270
21348	0	0	0	281	0	281
21349	0	0	259	0	0	259
21350	0	2	249	0	0	251
21351	270	0	0	0	0	270
21352	0	0	271	0	0	271
21353	0	0	255	0	0	255
21354	270	0	0	0	0	270
21355	270	0	0	0	0	270
21356	0	0	0	278	0	278
21357	278	0	0	0	0	278
21358	0	281	0	0	0	281
21359	289	0	0	0	0	289
21360	281	0	0	0	0	281
21361	272	0	0	0	0	272
21362	0	0	0	281	0	281
21363	2	256	1	2	0	261
21364	0	284	0	0	0	284
21365	304	0	0	0	0	304
21366	303	0	0	2	0	305
21367	0	0	1	322	0	323
21368	0	0	0	316	0	316
21369	0	312	0	0	0	312
21370	318	0	0	0	0	318
21371	0	0	305	0	0	305
21372	0	0	0	321	0	321
21373	1	0	0	324	0	325
21374	0	0	321	1	0	322
21375	1	0	1	323	0	325
21376	0	296	0	1	0	297
21377	1	0	0	336	0	337
21378	0	0	0	331	0	331
21379	0	313	0	0	0	313
21380	0	315	1	1	0	317
21381	0	0	0	347	0	347
21382	332	0	0	0	0	332
21383	0	0	0	342	0	342
21384	0	0	0	348	0	348
21385	0	332	0	0	0	332
21386	0	0	0	352	0	352
21387	0	0	0	354	0	354
21388	0	0	0	350	0	350
21389	357	0	0	0	0	357
21390	1	0	0	357	0	358
21391	1	0	0	349	0	350
21392	0	0	0	349	0	349
21393	0	1	347	0	0	348
21394	341	0	0	0	0	341
21395	0	346	0	0	0	346
21396	354	0	0	0	0	354
21397	0	0	0	351	0	351
21398	0	0	342	1	0	343
21399	353	0	0	0	0	353
21400	0	0	355	0	0	355
21401	0	0	0	359	0	359
21402	369	0	0	0	0	369
21403	349	0	0	1	0	350
21404	354	2	0	0	0	356
21405	1	0	0	358	0	359
21406	2	0	0	355	0	357
21407	0	0	0	360	0	360
21408	0	338	0	1	0	339
21409	0	330	0	2	0	332
21410	0	327	0	0	0	327
21411	0	357	0	0	0	357
21412	0	0	0	395	0	395
21413	1	0	0	397	0	398
21414	393	0	0	0	0	393
21415	401	0	1	0	0	402
21416	401	1	2	1	0	405
21417	2	0	0	401	0	403
21418	0	0	0	396	0	396
21419	405	0	0	0	0	405
21420	390	0	0	0	0	390
21421	0	1	372	0	0	373
21422	2	0	320	1	0	323
21423	4	3	327	0	0	334
21424	0	1	367	1	0	369
21425	0	0	0	384	0	384
21426	379	0	0	0	0	379
21427	0	373	0	0	0	373
21428	0	0	0	378	0	378
21429	0	0	363	1	0	364
21430	0	366	0	0	0	366
21431	0	0	0	384	0	384
21432	0	0	360	0	0	360
21433	1	0	1	359	0	361
21434	0	0	0	366	0	366
21435	363	0	0	0	0	363
21436	0	0	0	365	0	365
21437	0	0	356	0	0	356
21438	0	0	0	361	0	361
21439	0	346	0	3	0	349
21440	0	0	0	361	0	361
21441	0	0	0	368	0	368
21442	0	0	0	362	0	362
21443	355	0	0	1	0	356
21444	357	0	0	0	0	357
21445	351	0	0	0	0	351
21446	350	0	0	0	0	350
21447	0	0	346	0	0	346
21448	347	0	0	0	0	347
21449	345	0	0	0	0	345
21450	0	0	319	0	0	319
21451	1	0	306	0	0	307
21452	1	0	0	326	0	327
21453	0	337	0	0	0	337
21454	338	0	0	0	0	338
21455	333	0	0	0	0	333
21456	324	0	0	0	0	324
21457	0	0	0	312	0	312
21458	0	300	0	0	0	300
21459	313	0	0	0	0	313
21460	304	0	0	0	0	304
21461	0	0	0	306	0	306
21462	0	0	296	0	0	296
21463	302	0	0	1	0	303
21464	0	0	0	293	0	293
21465	299	0	1	0	0	300
21466	0	0	0	300	0	300
21467	0	0	292	0	0	292
21468	294	0	0	0	0	294
21469	1	0	0	299	0	300
21470	1	0	1	294	0	296
21471	0	0	0	298	0	298
21472	0	0	0	296	0	296
21473	298	0	0	0	0	298
21474	0	0	0	286	0	286
21475	2	283	0	0	0	285
21476	0	0	0	296	0	296
21477	0	283	0	0	0	283
21478	0	0	0	285	0	285
21479	0	0	0	281	0	281
21480	0	278	0	0	0	278
21481	0	0	0	283	0	283
21482	0	0	0	275	0	275
21483	280	0	0	0	0	280
21484	0	0	265	0	0	265
21485	0	0	0	276	0	276
21486	274	0	0	0	0	274
21487	275	0	0	0	0	275
21488	268	0	0	0	0	268
21489	0	0	256	0	0	256
21490	2	0	241	0	0	243
21491	1	0	0	256	0	257
21492	262	0	0	0	0	262
21493	0	0	243	0	0	243
21494	236	0	0	0	0	236
21495	0	237	0	0	0	237
21496	2	0	0	237	0	239
21497	0	0	0	235	0	235
21498	238	0	0	0	0	238
21499	0	0	0	227	0	227
21500	233	0	0	0	0	233
21501	231	0	0	0	0	231
21502	1	0	0	219	0	220
21503	0	0	0	220	0	220
21504	211	0	0	0	0	211
21505	0	0	208	0	0	208
21506	207	0	0	0	0	207
21507	0	0	207	0	0	207
21508	210	0	1	0	0	211
21509	201	1	0	0	0	202
21510	202	1	0	0	0	203
21511	202	0	0	0	0	202
21512	1	198	0	0	0	199
21513	206	0	0	0	0	206
21514	201	0	0	0	0	201
21515	0	201	0	0	0	201
21516	206	0	0	0	0	206
21517	1	0	188	0	0	189
21518	194	0	0	1	0	195
21519	1	0	189	0	0	190
21520	0	0	0	185	0	185
21521	2	0	0	189	0	191
21522	1	0	184	0	0	185
21523	1	0	0	179	0	180
21524	0	0	0	171	0	171
21525	202	0	0	0	0	202
21526	1	0	2	195	0	198
21527	0	0	0	202	0	202
21528	0	0	0	206	0	206
21529	0	206	0	0	0	206
21530	0	0	0	211	0	211
21531	227	0	0	0	0	227
21532	0	0	243	0	0	243
21533	0	0	0	244	0	244
21534	0	0	252	1	0	253
21535	257	0	0	0	0	257
21536	0	0	0	260	0	260
21537	1	0	267	0	0	268
21538	0	0	0	273	0	273
21539	0	0	0	330	0	330
21540	0	334	0	0	0	334
21541	0	0	0	355	0	355
21542	0	0	0	359	0	359
21543	0	0	357	0	0	357
21544	0	0	1	412	0	413
21545	0	0	0	413	0	413
21546	403	0	0	0	0	403
21547	369	3	0	1	0	373
21548	0	406	0	0	0	406
21549	417	0	0	0	0	417
21550	410	0	0	0	0	410
21551	0	408	0	0	0	408
21552	0	0	0	412	0	412
21553	414	0	0	0	0	414
21554	403	0	0	0	0	403
21555	400	0	0	1	0	401
21556	0	385	0	0	0	385
21557	0	0	391	0	0	391
21558	381	0	0	1	0	382
21559	367	0	0	3	0	370
21560	0	375	0	0	0	375
21561	381	0	0	0	0	381
21562	374	0	0	1	0	375
21563	0	0	0	390	0	390
21564	1	0	377	0	0	378
21565	0	0	0	384	0	384
21566	0	0	0	385	0	385
21567	0	0	0	386	0	386
21568	0	0	384	0	0	384
21569	0	0	0	390	0	390
21570	0	0	0	385	0	385
21571	0	0	0	383	0	383
21572	0	0	0	375	0	375
21573	0	0	0	379	0	379
21574	0	375	0	0	0	375
21575	0	0	0	389	0	389
21576	0	0	0	379	0	379
21577	1	0	376	0	0	377
21578	0	0	0	380	0	380
21579	1	0	0	384	0	385
21580	0	0	1	384	0	385
21581	0	0	0	391	0	391
21582	379	1	0	0	0	380
21583	0	1	0	389	0	390
21584	0	0	0	394	0	394
21585	0	0	382	0	0	382
21586	0	323	0	1	0	324
21587	0	377	0	1	0	378
21588	392	0	0	0	0	392
21589	0	384	0	0	0	384
21590	0	0	0	401	0	401
21591	404	0	0	0	0	404
21592	0	0	389	0	0	389
21593	1	0	0	397	0	398
21594	0	381	1	0	0	382
21595	0	0	0	383	0	383
21596	0	380	0	0	0	380
21597	1	0	0	390	0	391
21598	396	0	0	0	0	396
21599	0	0	378	0	0	378
21600	0	0	0	371	0	371
21601	0	378	0	3	0	381
21602	384	0	0	0	0	384
21603	0	0	372	1	0	373
21604	2	0	0	367	0	369
21605	0	0	377	0	0	377
21606	0	0	0	385	0	385
21607	0	0	384	0	0	384
21608	2	0	1	371	0	374
21609	0	0	0	378	0	378
21610	378	0	0	1	0	379
21611	383	0	0	0	0	383
21612	0	0	0	378	0	378
21613	0	356	0	0	0	356
21614	0	0	0	364	0	364
21615	0	0	0	381	0	381
21616	365	0	0	0	0	365
21617	0	354	0	0	0	354
21618	350	0	0	0	0	350
21619	362	0	0	0	0	362
21620	0	274	0	2	0	276
21621	2	314	1	1	0	318
21622	335	0	0	0	0	335
21623	0	0	342	1	0	343
21624	310	0	0	0	0	310
21625	300	0	0	1	0	301
21626	0	261	0	0	0	261
21627	0	0	0	261	0	261
21628	0	232	1	0	0	233
21629	237	0	0	1	0	238
21630	237	0	3	0	0	240
21631	0	0	0	247	0	247
21632	0	0	0	184	0	184
21633	222	0	0	0	0	222
21634	0	166	0	0	0	166
21635	0	120	1	1	0	122
21636	0	112	0	0	0	112
21637	0	52	0	0	0	52
21638	0	53	0	0	0	53
21639	0	0	0	57	0	57
21640	1	0	57	0	0	58
21641	0	49	0	0	0	49
21642	52	0	0	0	0	52
21643	0	0	0	48	0	48
21644	46	0	0	0	0	46
21645	0	47	0	0	0	47
21646	47	0	0	0	0	47
21647	0	49	0	0	0	49
21648	0	0	0	49	0	49
21649	46	0	0	0	0	46
21650	47	0	0	0	0	47
21651	0	0	0	45	0	45
21652	0	0	0	47	0	47
21653	0	43	0	0	0	43
21654	0	0	0	49	0	49
21655	0	0	0	48	0	48
21656	0	0	0	48	0	48
21657	0	44	0	0	0	44
21658	48	0	0	0	0	48
21659	0	48	0	0	0	48
21660	47	0	0	0	0	47
21661	0	44	0	0	0	44
21662	0	0	43	0	0	43
21663	0	0	0	46	0	46
21664	0	0	42	0	0	42
21665	0	0	41	0	0	41
21666	0	0	0	48	0	48
21667	0	0	44	0	0	44
21668	0	0	0	49	0	49
21669	0	0	0	47	0	47
21670	1	0	0	43	0	44
21671	40	0	1	0	0	41
21672	0	0	0	36	0	36
21673	0	0	0	38	0	38
21674	33	0	0	0	0	33
21675	0	31	0	0	0	31
21676	0	23	0	0	0	23
21677	0	30	0	0	0	30
21678	0	0	0	33	0	33
21679	0	0	32	0	0	32
21680	31	0	0	0	0	31
21681	0	30	0	0	0	30
21682	31	0	0	0	0	31
21683	30	0	0	0	0	30
21684	29	0	0	0	0	29
21685	0	0	32	0	0	32
21686	0	0	0	30	0	30
21687	0	0	0	31	0	31
21688	0	0	0	32	0	32
21689	0	0	0	31	0	31
21690	0	32	0	0	0	32
21691	32	0	0	0	0	32
21692	0	0	31	0	0	31
21693	31	0	0	0	0	31
21694	0	0	0	31	0	31
21695	0	28	0	0	0	28
21696	0	33	0	0	0	33
21697	0	0	0	31	0	31
21698	0	30	0	0	0	30
21699	28	0	0	0	0	28
21700	0	0	25	0	0	25
21701	0	0	0	27	0	27
21702	0	0	0	28	0	28
21703	0	0	0	28	0	28
21704	0	0	0	28	0	28
21705	31	0	0	0	0	31
21706	0	29	0	0	0	29
21707	28	0	0	0	0	28
21708	0	0	0	31	0	31
21709	0	0	0	27	0	27
21710	0	27	0	0	0	27
21711	29	0	0	0	0	29
21712	26	0	0	0	0	26
21713	0	26	0	0	0	26
21714	0	0	0	25	0	25
21715	0	22	0	0	0	22
21716	23	0	0	0	0	23
21717	0	0	23	0	0	23
21718	0	0	21	0	0	21
21719	24	0	0	0	0	24
21720	0	22	0	0	0	22
21721	0	0	0	22	0	22
21722	0	0	0	24	0	24
21723	0	0	22	0	0	22
21724	0	0	0	22	0	22
21725	0	0	0	22	0	22
21726	0	24	0	0	0	24
21727	0	0	0	25	0	25
21728	0	0	0	24	0	24
21729	24	0	0	0	0	24
21730	0	22	0	0	0	22
21731	0	26	0	0	0	26
21732	0	0	0	28	0	28
21733	0	0	0	29	0	29
21734	0	0	0	29	0	29
21735	0	30	0	0	0	30
21736	0	0	0	30	0	30
21737	0	0	0	28	0	28
21738	0	0	0	29	0	29
21739	0	0	0	31	0	31
21740	0	28	0	0	0	28
21741	0	28	0	0	0	28
21742	28	0	0	0	0	28
21743	28	0	0	0	0	28
21744	0	0	0	31	0	31
21745	0	0	33	0	0	33
21746	1	0	0	29	0	30
21747	0	0	0	30	0	30
21748	32	0	0	0	0	32
21749	0	29	0	0	0	29
21750	0	0	0	31	0	31
21751	0	0	0	32	0	32
21752	0	0	30	0	0	30
21753	0	0	28	0	0	28
21754	0	0	0	34	0	34
21755	0	0	0	33	0	33
21756	0	34	0	0	0	34
21757	0	36	0	0	0	36
21758	36	0	0	0	0	36
21759	0	0	0	36	0	36
21760	0	0	33	0	0	33
21761	0	35	0	0	0	35
21762	0	0	0	35	0	35
21763	32	0	0	0	0	32
21764	0	0	0	34	0	34
21765	33	0	0	0	0	33
21766	0	34	0	0	0	34
21767	34	0	0	0	0	34
21768	0	0	0	33	0	33
21769	0	0	32	0	0	32
21770	0	0	0	30	0	30
21771	0	30	0	0	0	30
21772	0	0	0	30	0	30
21773	0	28	0	0	0	28
21774	0	0	0	29	0	29
21775	0	0	29	0	0	29
21776	0	0	27	0	0	27
21777	0	0	30	0	0	30
21778	30	0	0	0	0	30
21779	0	32	0	0	0	32
21780	0	32	0	0	0	32
21781	33	0	0	0	0	33
21782	33	0	0	0	0	33
21783	0	0	0	34	0	34
21784	0	0	34	0	0	34
21785	0	0	35	0	0	35
21786	0	0	0	35	0	35
21787	35	0	0	0	0	35
21788	0	33	0	0	0	33
21789	0	0	0	34	0	34
21790	36	0	0	0	0	36
21791	36	0	0	0	0	36
21792	0	0	35	0	0	35
21793	36	0	0	0	0	36
21794	1	0	36	0	0	37
21795	0	0	38	0	0	38
21796	0	0	0	37	0	37
21797	0	0	0	38	0	38
21798	0	0	0	41	0	41
21799	0	1	40	0	0	41
21800	41	0	0	0	0	41
21801	0	0	0	41	0	41
21802	40	0	0	0	0	40
21803	40	0	0	0	0	40
21804	0	40	0	0	0	40
21805	0	35	0	0	0	35
21806	0	39	0	0	0	39
21807	0	0	0	40	0	40
21808	0	0	42	0	0	42
21809	0	0	0	43	0	43
21810	0	37	0	0	0	37
21811	0	43	0	0	0	43
21812	0	0	0	43	0	43
21813	42	0	0	0	0	42
21814	0	42	0	0	0	42
21815	0	41	0	0	0	41
21816	42	0	0	0	0	42
21817	0	0	0	42	0	42
21818	0	0	0	40	0	40
21819	0	0	0	41	0	41
21820	40	0	0	0	0	40
21821	39	0	0	0	0	39
21822	0	0	0	40	0	40
21823	0	0	39	0	0	39
21824	39	0	0	0	0	39
21825	0	0	0	37	0	37
21826	0	0	36	0	0	36
21827	0	0	35	0	0	35
21828	0	0	0	35	0	35
21829	0	0	35	0	0	35
21830	0	0	0	37	0	37
21831	0	0	0	36	0	36
21832	0	0	0	36	0	36
21833	34	0	0	0	0	34
21834	0	0	0	37	0	37
21835	0	0	0	37	0	37
21836	0	0	0	36	0	36
21837	0	0	0	38	0	38
21838	0	0	35	0	0	35
21839	0	34	0	0	0	34
21840	0	0	0	34	0	34
21841	0	0	0	38	0	38
21842	0	31	0	0	0	31
21843	0	40	0	0	0	40
21844	37	0	0	0	0	37
21845	0	36	0	0	0	36
21846	0	0	0	36	0	36
21847	0	0	34	0	0	34
21848	37	0	0	0	0	37
21849	0	0	33	0	0	33
21850	33	0	0	0	0	33
21851	33	0	0	0	0	33
21852	0	0	33	0	0	33
21853	0	0	0	35	0	35
21854	0	33	0	0	0	33
21855	0	0	0	39	0	39
21856	38	0	0	0	0	38
21857	37	0	0	0	0	37
21858	0	38	0	0	0	38
21859	39	0	0	0	0	39
21860	0	0	0	37	0	37
21861	39	0	0	0	0	39
21862	36	0	0	0	0	36
21863	0	0	0	40	0	40
21864	40	0	0	0	0	40
21865	38	0	0	0	0	38
21866	0	0	42	0	0	42
21867	46	0	0	0	0	46
21868	0	0	43	0	0	43
21869	0	0	37	1	0	38
21870	0	43	0	0	0	43
21871	0	0	0	45	0	45
21872	1	0	45	0	0	46
21873	0	0	43	0	0	43
21874	46	0	0	0	0	46
21875	0	0	1	43	0	44
21876	0	0	0	44	0	44
21877	0	0	0	44	0	44
21878	0	0	0	43	0	43
21879	0	0	0	46	0	46
21880	0	0	45	0	0	45
21881	0	0	39	1	0	40
21882	0	0	0	46	0	46
21883	45	0	0	0	0	45
21884	0	42	0	0	0	42
21885	0	0	0	43	0	43
21886	44	0	0	0	0	44
21887	0	44	0	0	0	44
21888	0	0	0	43	0	43
21889	0	0	0	43	0	43
21890	0	0	0	47	0	47
21891	41	0	0	0	0	41
21892	0	0	41	0	0	41
21893	43	0	0	0	0	43
21894	1	0	0	43	0	44
21895	0	0	0	46	0	46
21896	0	43	0	0	0	43
21897	0	0	43	0	0	43
21898	45	0	0	0	0	45
21899	47	0	0	0	0	47
21900	0	0	44	0	0	44
21901	46	0	0	0	0	46
21902	0	45	0	0	0	45
21903	0	42	0	0	0	42
21904	0	44	0	0	0	44
21905	45	0	0	0	0	45
21906	0	0	46	0	0	46
21907	0	0	0	48	0	48
21908	0	47	0	0	0	47
21909	0	45	0	0	0	45
21910	0	46	0	1	0	47
21911	0	0	0	47	0	47
21912	46	0	0	0	0	46
21913	0	48	0	0	0	48
21914	0	1	0	44	0	45
21915	0	0	0	46	0	46
21916	45	0	0	0	0	45
21917	0	0	0	44	0	44
21918	0	0	0	46	0	46
21919	0	0	45	0	0	45
21920	0	0	0	42	0	42
21921	0	0	0	43	0	43
21922	43	0	0	0	0	43
21923	40	0	0	0	0	40
21924	0	0	0	42	0	42
21925	41	0	0	0	0	41
21926	42	0	0	0	0	42
21927	0	40	0	0	0	40
21928	0	0	35	0	0	35
21929	0	39	0	0	0	39
21930	0	0	0	41	0	41
21931	40	0	0	0	0	40
21932	0	41	0	0	0	41
21933	0	0	0	44	0	44
21934	44	0	0	0	0	44
21935	45	0	0	0	0	45
21936	0	0	1	43	0	44
21937	0	0	42	0	0	42
21938	0	0	0	44	0	44
21939	0	0	0	46	0	46
21940	0	0	44	0	0	44
21941	0	0	0	43	0	43
21942	0	0	0	43	0	43
21943	44	0	0	0	0	44
21944	0	0	0	46	0	46
21945	0	0	0	45	0	45
21946	48	0	0	0	0	48
21947	46	0	0	0	0	46
21948	43	0	0	0	0	43
21949	0	0	43	0	0	43
21950	0	0	0	42	0	42
21951	0	42	0	0	0	42
21952	0	0	0	42	0	42
21953	0	0	41	0	0	41
21954	0	0	0	40	0	40
21955	0	0	43	0	0	43
21956	41	0	0	0	0	41
21957	40	0	0	0	0	40
21958	0	0	0	41	0	41
21959	0	0	0	41	0	41
21960	0	0	0	39	0	39
21961	0	40	0	0	0	40
21962	41	0	0	0	0	41
21963	39	0	0	0	0	39
21964	0	0	0	40	0	40
21965	0	0	0	39	0	39
21966	0	0	0	38	0	38
21967	0	0	0	36	0	36
21968	1	0	34	0	0	35
21969	0	0	0	37	0	37
21970	37	0	0	0	0	37
21971	37	0	0	0	0	37
21972	0	0	0	38	0	38
21973	0	0	36	0	0	36
21974	37	0	0	0	0	37
21975	0	0	0	40	0	40
21976	0	40	0	1	0	41
21977	0	45	0	0	0	45
21978	48	0	0	0	0	48
21979	0	0	0	47	0	47
21980	0	0	0	48	0	48
21981	0	0	0	47	0	47
21982	0	0	0	44	0	44
21983	0	0	0	45	0	45
21984	0	0	43	0	0	43
21985	0	0	34	0	0	34
21986	0	0	39	0	0	39
21987	0	0	0	43	0	43
21988	0	0	46	0	0	46
21989	0	0	0	48	0	48
21990	0	0	0	45	0	45
21991	0	0	0	48	0	48
21992	47	0	0	0	0	47
21993	0	0	0	52	0	52
21994	0	0	0	52	0	52
21995	49	0	0	0	0	49
21996	0	44	0	0	0	44
21997	0	47	0	0	0	47
21998	49	0	0	0	0	49
21999	0	46	0	0	0	46
22000	50	0	0	0	0	50
22001	52	1	0	0	0	53
22002	48	0	0	0	0	48
22003	51	0	0	0	0	51
22004	51	0	0	0	0	51
22005	0	49	1	1	0	51
22006	54	0	0	0	0	54
22007	54	0	0	0	0	54
22008	0	54	0	0	0	54
22009	56	0	0	0	0	56
22010	57	0	1	0	0	58
22011	55	0	0	0	0	55
22012	59	0	0	0	0	59
22013	0	0	56	0	0	56
22014	0	0	0	57	0	57
22015	0	0	0	61	0	61
22016	0	0	60	0	0	60
22017	0	0	57	0	0	57
22018	61	0	0	0	0	61
22019	1	0	0	59	0	60
22020	0	0	60	0	0	60
22021	0	0	54	0	0	54
22022	60	0	0	0	0	60
22023	60	0	0	0	0	60
22024	58	0	0	0	0	58
22025	0	0	54	0	0	54
22026	1	0	0	55	0	56
22027	0	0	56	0	0	56
22028	58	0	0	0	0	58
22029	0	0	60	0	0	60
22030	0	0	1	58	0	59
22031	0	0	0	60	0	60
22032	0	59	0	0	0	59
22033	61	0	0	0	0	61
22034	0	0	59	0	0	59
22035	60	0	0	0	0	60
22036	0	0	62	0	0	62
22037	0	0	1	63	0	64
22038	0	0	0	66	0	66
22039	0	0	0	65	0	65
22040	65	0	0	0	0	65
22041	0	0	0	63	0	63
22042	0	0	0	64	0	64
22043	0	64	0	0	0	64
22044	0	0	0	66	0	66
22045	65	0	0	0	0	65
22046	0	0	66	0	0	66
22047	0	0	0	65	0	65
22048	0	0	64	0	0	64
22049	0	63	0	0	0	63
22050	0	0	65	0	0	65
22051	65	0	0	0	0	65
22052	62	0	0	0	0	62
22053	0	0	0	67	0	67
22054	61	0	0	0	0	61
22055	67	0	0	0	0	67
22056	0	0	0	66	0	66
22057	0	0	0	67	0	67
22058	0	0	60	0	0	60
22059	0	63	0	0	0	63
22060	60	0	0	1	0	61
22061	0	68	0	0	0	68
22062	0	0	0	67	0	67
22063	0	0	0	71	0	71
22064	0	0	0	68	0	68
22065	0	0	0	66	0	66
22066	0	0	68	0	0	68
22067	69	0	0	0	0	69
22068	70	1	0	0	0	71
22069	0	0	0	66	0	66
22070	66	0	0	0	0	66
22071	0	0	0	64	0	64
22072	0	0	61	0	0	61
22073	0	0	0	64	0	64
22074	0	62	0	0	0	62
22075	0	0	0	64	0	64
22076	0	63	0	0	0	63
22077	0	0	0	62	0	62
22078	0	63	0	0	0	63
22079	63	0	0	0	0	63
22080	0	0	58	0	0	58
22081	0	54	0	0	0	54
22082	0	58	0	0	0	58
22083	0	0	0	59	0	59
22084	0	0	0	60	0	60
22085	0	0	0	59	0	59
22086	0	0	0	55	0	55
22087	0	51	0	0	0	51
22088	0	0	0	55	0	55
22089	0	0	0	55	0	55
22090	55	0	0	0	0	55
22091	0	0	0	57	0	57
22092	2	0	52	0	0	54
22093	0	0	49	0	0	49
22094	50	0	0	0	0	50
22095	0	43	0	0	0	43
22096	0	45	0	0	0	45
22097	0	0	0	49	0	49
22098	0	0	0	49	0	49
22099	0	0	48	0	0	48
22100	47	0	0	1	0	48
22101	50	0	0	0	0	50
22102	0	0	47	0	0	47
22103	0	0	44	0	0	44
22104	49	0	0	0	0	49
22105	47	0	0	0	0	47
22106	46	0	0	0	0	46
22107	44	0	0	0	0	44
22108	0	43	0	0	0	43
22109	45	0	0	0	0	45
22110	0	0	41	0	0	41
22111	0	0	34	0	0	34
22112	0	0	42	0	0	42
22113	0	0	0	43	0	43
22114	42	0	0	0	0	42
22115	41	0	0	0	0	41
22116	0	0	0	43	0	43
22117	0	0	0	45	0	45
22118	0	0	0	43	0	43
22119	0	43	0	0	0	43
22120	43	0	0	0	0	43
22121	46	0	0	0	0	46
22122	42	0	0	0	0	42
22123	41	0	0	1	0	42
22124	41	0	0	0	0	41
22125	0	0	0	44	0	44
22126	0	36	0	1	0	37
22127	0	0	0	39	0	39
22128	0	0	0	40	0	40
22129	40	0	0	0	0	40
22130	1	0	34	0	0	35
22131	0	0	31	0	0	31
22132	0	0	35	0	0	35
22133	35	0	0	0	0	35
22134	35	0	0	0	0	35
22135	0	0	0	33	0	33
22136	0	0	0	34	0	34
22137	0	0	0	33	0	33
22138	0	0	32	0	0	32
22139	0	0	0	30	0	30
22140	0	0	31	0	0	31
22141	0	0	0	32	0	32
22142	0	0	0	32	0	32
22143	0	0	0	33	0	33
22144	32	0	0	0	0	32
22145	31	0	0	0	0	31
22146	0	0	30	0	0	30
22147	34	0	0	0	0	34
22148	31	0	0	0	0	31
22149	0	0	0	33	0	33
22150	30	0	0	0	0	30
22151	0	0	0	30	0	30
22152	0	0	0	29	0	29
22153	0	0	26	0	0	26
22154	25	0	0	0	0	25
22155	0	0	0	26	0	26
22156	1	0	22	0	0	23
22157	0	0	23	0	0	23
22158	0	0	0	23	0	23
22159	0	0	0	24	0	24
22160	20	0	0	0	0	20
22161	0	0	0	20	0	20
22162	0	0	0	22	0	22
22163	0	0	0	24	0	24
22164	0	0	0	22	0	22
22165	23	0	0	0	0	23
22166	22	0	0	0	0	22
22167	23	0	0	0	0	23
22168	22	1	0	0	0	23
22169	0	0	0	24	0	24
22170	23	0	0	0	0	23
22171	0	0	0	25	0	25
22172	25	0	0	0	0	25
22173	0	0	0	28	0	28
22174	0	0	0	33	0	33
22175	0	26	0	0	0	26
22176	0	0	0	33	0	33
22177	34	0	0	0	0	34
22178	34	0	0	0	0	34
22179	0	1	33	0	0	34
22180	0	33	0	0	0	33
22181	35	0	0	0	0	35
22182	0	37	0	0	0	37
22183	35	0	0	0	0	35
22184	0	35	0	0	0	35
22185	0	0	36	0	0	36
22186	0	33	0	1	0	34
22187	0	32	0	0	0	32
22188	0	0	0	38	0	38
22189	37	0	0	0	0	37
22190	0	0	0	38	0	38
22191	0	0	0	38	0	38
22192	41	0	0	0	0	41
22193	38	0	0	0	0	38
22194	0	0	0	35	0	35
22195	0	0	0	39	0	39
22196	0	0	0	39	0	39
22197	40	0	0	0	0	40
22198	0	0	40	0	0	40
22199	1	0	0	37	0	38
22200	0	0	38	0	0	38
22201	0	34	0	0	0	34
22202	0	0	36	0	0	36
22203	0	0	0	37	0	37
22204	0	0	38	0	0	38
22205	42	0	0	0	0	42
22206	0	0	0	41	0	41
22207	0	45	0	0	0	45
22208	0	0	0	47	0	47
22209	0	46	0	0	0	46
22210	0	44	0	0	0	44
22211	0	47	0	0	0	47
22212	0	0	0	48	0	48
22213	0	47	0	0	0	47
22214	47	0	0	0	0	47
22215	0	0	45	0	0	45
22216	1	0	44	0	0	45
22217	0	0	45	0	0	45
22218	0	0	0	45	0	45
22219	0	0	0	46	0	46
22220	0	0	0	46	0	46
22221	0	0	0	45	0	45
22222	0	0	0	47	0	47
22223	0	45	0	0	0	45
22224	0	0	44	0	0	44
22225	0	0	43	0	0	43
22226	0	46	0	0	0	46
22227	0	0	0	47	0	47
22228	0	0	0	50	0	50
22229	0	0	0	49	0	49
22230	51	0	0	0	0	51
22231	0	0	50	0	0	50
22232	49	0	0	0	0	49
22233	54	0	0	0	0	54
22234	0	56	0	0	0	56
22235	0	55	0	0	0	55
22236	55	0	0	0	0	55
22237	0	0	0	54	0	54
22238	0	0	0	55	0	55
22239	0	0	51	0	0	51
22240	0	0	52	0	0	52
22241	0	0	0	53	0	53
22242	54	0	0	0	0	54
22243	0	0	54	0	0	54
22244	52	0	0	0	0	52
22245	0	1	0	53	0	54
22246	0	0	0	54	0	54
22247	0	0	0	53	0	53
22248	0	0	52	0	0	52
22249	0	46	0	0	0	46
22250	0	49	0	0	0	49
22251	54	0	0	0	0	54
22252	58	0	0	0	0	58
22253	0	0	0	57	0	57
22254	56	0	0	0	0	56
22255	0	0	56	0	0	56
22256	0	0	56	0	0	56
22257	0	0	0	53	0	53
22258	55	0	0	0	0	55
22259	0	0	1	53	0	54
22260	0	0	0	54	0	54
22261	55	0	0	0	0	55
22262	52	0	0	0	0	52
22263	0	47	0	1	0	48
22264	51	0	0	1	0	52
22265	1	0	0	46	0	47
22266	0	47	0	0	0	47
22267	44	0	0	0	0	44
22268	0	47	0	0	0	47
22269	0	0	0	44	0	44
22270	47	0	0	0	0	47
22271	0	0	48	0	0	48
22272	0	0	45	0	0	45
22273	1	0	0	50	0	51
22274	0	0	0	54	0	54
22275	0	0	0	51	0	51
22276	0	49	0	0	0	49
22277	53	0	0	0	0	53
22278	50	0	0	0	0	50
22279	52	0	0	0	0	52
22280	0	49	0	0	0	49
22281	0	0	0	53	0	53
22282	1	0	0	51	0	52
22283	0	0	0	52	0	52
22284	54	0	0	0	0	54
22285	0	54	0	1	0	55
22286	0	0	0	57	0	57
22287	0	0	0	53	0	53
22288	0	0	54	0	0	54
22289	0	53	0	0	0	53
22290	0	0	0	55	0	55
22291	0	0	0	56	0	56
22292	0	0	0	56	0	56
22293	55	0	0	0	0	55
22294	0	57	0	0	0	57
22295	54	0	0	1	0	55
22296	0	0	0	58	0	58
22297	57	0	0	0	0	57
22298	0	0	51	0	0	51
22299	57	0	0	0	0	57
22300	52	0	0	0	0	52
22301	0	1	50	0	0	51
22302	0	0	0	53	0	53
22303	0	0	0	59	0	59
22304	54	0	1	0	0	55
22305	0	0	0	55	0	55
22306	0	0	0	56	0	56
22307	0	0	0	60	0	60
22308	0	0	57	0	0	57
22309	53	0	0	0	0	53
22310	0	57	0	0	0	57
22311	0	0	0	58	0	58
22312	0	54	0	0	0	54
22313	0	58	0	0	0	58
22314	0	0	0	60	0	60
22315	0	0	57	0	0	57
22316	0	0	54	0	0	54
22317	0	0	0	59	0	59
22318	0	0	55	0	0	55
22319	59	0	0	0	0	59
22320	0	0	0	58	0	58
22321	0	0	0	56	0	56
22322	0	52	0	0	0	52
22323	0	0	0	56	0	56
22324	0	0	0	54	0	54
22325	0	53	0	0	0	53
22326	0	0	0	50	0	50
22327	0	0	0	51	0	51
22328	0	46	0	1	0	47
22329	50	0	0	0	0	50
22330	0	0	50	0	0	50
22331	1	0	49	0	0	50
22332	0	0	0	47	0	47
22333	1	0	0	50	0	51
22334	0	0	49	0	0	49
22335	0	0	47	0	0	47
22336	48	0	0	0	0	48
22337	0	49	0	0	0	49
22338	47	0	0	0	0	47
22339	0	0	48	0	0	48
22340	0	48	0	0	0	48
22341	0	0	0	48	0	48
22342	0	0	48	0	0	48
22343	0	0	46	0	0	46
22344	0	0	0	46	0	46
22345	0	0	51	0	0	51
22346	0	51	0	0	0	51
22347	0	0	0	53	0	53
22348	0	0	52	0	0	52
22349	0	52	0	0	0	52
22350	54	0	0	0	0	54
22351	0	0	56	0	0	56
22352	0	55	0	0	0	55
22353	1	0	0	57	0	58
22354	0	0	0	57	0	57
22355	56	0	0	0	0	56
22356	0	0	1	57	0	58
22357	0	0	0	53	0	53
22358	54	0	0	0	0	54
22359	0	0	0	53	0	53
22360	0	0	54	0	0	54
22361	0	0	0	47	0	47
22362	0	0	48	0	0	48
22363	0	0	38	0	0	38
22364	0	0	46	0	0	46
22365	0	0	0	45	0	45
22366	0	0	0	45	0	45
22367	42	0	0	0	0	42
22368	1	0	0	41	0	42
22369	0	43	0	0	0	43
22370	0	0	0	45	0	45
22371	0	0	0	45	0	45
22372	0	46	0	0	0	46
22373	44	0	0	0	0	44
22374	46	0	0	0	0	46
22375	0	41	0	0	0	41
22376	0	41	0	0	0	41
22377	0	0	0	44	0	44
22378	42	0	0	0	0	42
22379	0	0	46	0	0	46
22380	0	0	44	0	0	44
22381	43	0	0	0	0	43
22382	0	42	0	0	0	42
22383	0	0	0	43	0	43
22384	0	0	0	43	0	43
22385	0	0	0	42	0	42
22386	0	0	0	41	0	41
22387	0	40	0	0	0	40
22388	0	0	0	41	0	41
22389	38	0	0	1	0	39
22390	1	0	0	40	0	41
22391	0	0	0	42	0	42
22392	41	0	0	0	0	41
22393	38	0	0	0	0	38
22394	39	0	0	0	0	39
22395	37	0	0	0	0	37
22396	0	0	0	36	0	36
22397	36	0	0	0	0	36
22398	0	0	0	36	0	36
22399	35	0	0	0	0	35
22400	37	0	0	0	0	37
22401	0	0	0	37	0	37
22402	0	0	37	0	0	37
22403	38	0	0	0	0	38
22404	38	0	0	0	0	38
22405	39	0	0	0	0	39
22406	41	0	0	0	0	41
22407	0	0	0	42	0	42
22408	0	0	38	0	0	38
22409	0	0	37	0	0	37
22410	38	0	0	0	0	38
22411	36	0	0	0	0	36
22412	0	34	0	0	0	34
22413	0	36	0	0	0	36
22414	38	0	0	0	0	38
22415	0	0	0	37	0	37
22416	0	0	0	40	0	40
22417	40	0	0	0	0	40
22418	0	39	0	0	0	39
22419	40	0	0	0	0	40
22420	0	0	42	0	0	42
22421	44	0	0	0	0	44
22422	0	0	0	44	0	44
22423	0	0	43	0	0	43
22424	0	44	0	0	0	44
22425	0	0	0	45	0	45
22426	0	0	44	0	0	44
22427	0	0	0	45	0	45
22428	50	0	0	0	0	50
22429	0	0	51	0	0	51
22430	48	0	0	0	0	48
22431	0	50	0	0	0	50
22432	0	0	0	48	0	48
22433	0	0	49	0	0	49
22434	0	0	0	49	0	49
22435	0	0	47	0	0	47
22436	0	51	0	0	0	51
22437	54	0	0	0	0	54
22438	0	48	0	0	0	48
22439	0	0	0	53	0	53
22440	0	0	0	50	0	50
22441	0	0	49	0	0	49
22442	44	0	0	0	0	44
22443	0	46	0	0	0	46
22444	0	44	0	0	0	44
22445	0	46	0	1	0	47
22446	0	0	0	47	0	47
22447	0	45	0	0	0	45
22448	0	0	0	48	0	48
22449	0	48	0	0	0	48
22450	0	0	0	47	0	47
22451	0	51	0	0	0	51
22452	50	0	0	0	0	50
22453	0	0	49	0	0	49
22454	51	0	0	0	0	51
22455	52	0	0	0	0	52
22456	52	0	0	0	0	52
22457	0	51	0	0	0	51
22458	52	0	0	0	0	52
22459	53	0	0	0	0	53
22460	53	0	0	0	0	53
22461	0	0	49	0	0	49
22462	0	0	0	55	0	55
22463	0	0	57	0	0	57
22464	0	0	0	52	0	52
22465	54	0	0	0	0	54
22466	0	51	0	0	0	51
22467	0	0	52	0	0	52
22468	1	0	0	51	0	52
22469	0	0	0	53	0	53
22470	0	0	52	0	0	52
22471	50	0	0	0	0	50
22472	53	0	0	0	0	53
22473	55	0	0	0	0	55
22474	0	0	0	53	0	53
22475	0	52	0	0	0	52
22476	0	50	0	0	0	50
22477	0	0	0	53	0	53
22478	0	0	0	52	0	52
22479	0	51	0	0	0	51
22480	57	0	0	0	0	57
22481	0	57	0	0	0	57
22482	0	0	0	56	0	56
22483	0	0	58	0	0	58
22484	0	0	0	58	0	58
22485	58	0	0	0	0	58
22486	1	0	57	0	0	58
22487	57	0	0	0	0	57
22488	56	0	0	0	0	56
22489	57	0	0	0	0	57
22490	57	0	0	0	0	57
22491	58	0	0	0	0	58
22492	0	0	56	0	0	56
22493	0	0	55	0	0	55
22494	56	0	0	0	0	56
22495	59	1	0	0	0	60
22496	0	0	0	61	0	61
22497	0	59	0	0	0	59
22498	0	0	0	59	0	59
22499	59	0	0	0	0	59
22500	0	0	0	57	0	57
22501	0	58	0	0	0	58
22502	63	0	0	0	0	63
22503	63	0	0	0	0	63
22504	64	0	0	0	0	64
22505	0	66	0	0	0	66
22506	0	0	0	64	0	64
22507	0	0	0	62	0	62
22508	0	62	0	0	0	62
22509	0	0	0	62	0	62
22510	62	0	0	0	0	62
22511	63	0	0	0	0	63
22512	0	57	0	0	0	57
22513	0	0	0	61	0	61
22514	0	0	0	57	0	57
22515	0	0	0	57	0	57
22516	59	0	0	0	0	59
22517	0	0	56	0	0	56
22518	56	0	0	0	0	56
22519	0	0	58	0	0	58
22520	1	0	0	57	0	58
22521	0	49	0	0	0	49
22522	0	49	0	0	0	49
22523	58	0	0	0	0	58
22524	55	0	0	0	0	55
22525	0	47	0	0	0	47
22526	0	51	0	0	0	51
22527	56	0	0	0	0	56
22528	56	0	0	0	0	56
22529	0	53	0	0	0	53
22530	54	0	0	0	0	54
22531	0	0	50	0	0	50
22532	55	0	0	0	0	55
22533	49	0	0	0	0	49
22534	0	0	0	55	0	55
22535	0	51	0	0	0	51
22536	0	0	0	54	0	54
22537	51	0	0	0	0	51
22538	0	0	0	56	0	56
22539	0	0	0	58	0	58
22540	0	0	56	0	0	56
22541	0	1	0	57	0	58
22542	0	0	0	58	0	58
22543	59	0	0	0	0	59
22544	0	0	54	0	0	54
22545	57	0	0	0	0	57
22546	0	0	0	51	0	51
22547	0	0	0	53	0	53
22548	0	0	0	52	0	52
22549	0	51	0	0	0	51
22550	0	54	0	0	0	54
22551	0	0	0	51	0	51
22552	54	0	0	0	0	54
22553	54	0	0	0	0	54
22554	0	0	0	55	0	55
22555	54	0	0	0	0	54
22556	0	0	0	56	0	56
22557	0	0	0	60	0	60
22558	55	0	0	0	0	55
22559	0	61	0	0	0	61
22560	62	0	0	0	0	62
22561	63	0	0	0	0	63
22562	55	0	0	0	0	55
22563	0	58	0	0	0	58
22564	0	0	0	57	0	57
22565	1	0	0	59	0	60
22566	0	0	55	0	0	55
22567	0	0	0	58	0	58
22568	0	0	54	0	0	54
22569	0	53	0	0	0	53
22570	0	51	0	0	0	51
22571	0	50	0	0	0	50
22572	0	0	0	57	0	57
22573	0	0	1	53	0	54
22574	0	0	0	56	0	56
22575	0	0	0	56	0	56
22576	0	0	55	0	0	55
22577	0	0	54	0	0	54
22578	0	0	0	57	0	57
22579	0	0	56	0	0	56
22580	57	0	0	0	0	57
22581	59	0	0	0	0	59
22582	0	0	62	0	0	62
22583	0	0	0	59	0	59
22584	0	0	0	59	0	59
22585	0	0	0	63	0	63
22586	0	0	0	63	0	63
22587	0	0	0	62	0	62
22588	59	0	0	0	0	59
22589	63	0	0	0	0	63
22590	0	57	0	0	0	57
22591	0	1	52	0	0	53
22592	0	57	0	0	0	57
22593	0	61	1	0	0	62
22594	59	1	0	0	0	60
22595	0	53	0	0	0	53
22596	0	60	0	0	0	60
22597	63	0	0	0	0	63
22598	0	0	62	0	0	62
22599	64	0	0	0	0	64
22600	0	0	0	64	0	64
22601	0	0	0	61	0	61
22602	0	0	0	66	0	66
22603	0	0	64	0	0	64
22604	0	61	0	0	0	61
22605	62	0	0	0	0	62
22606	0	0	0	62	0	62
22607	0	62	0	0	0	62
22608	0	0	0	63	0	63
22609	0	0	63	0	0	63
22610	0	0	0	66	0	66
22611	0	0	0	64	0	64
22612	0	0	0	64	0	64
22613	65	0	0	0	0	65
22614	0	0	0	67	0	67
22615	0	0	62	0	0	62
22616	0	61	0	0	0	61
22617	0	0	0	64	0	64
22618	0	0	0	68	0	68
22619	0	0	65	0	0	65
22620	0	0	62	0	0	62
22621	66	0	0	0	0	66
22622	62	0	0	0	0	62
22623	0	60	0	0	0	60
22624	66	0	0	0	0	66
22625	0	0	62	0	0	62
22626	0	0	59	0	0	59
22627	64	0	1	0	0	65
22628	65	0	0	0	0	65
22629	0	0	66	0	0	66
22630	66	0	0	0	0	66
22631	0	0	60	1	0	61
22632	66	0	0	0	0	66
22633	65	0	0	0	0	65
22634	0	0	0	65	0	65
22635	0	65	0	0	0	65
22636	68	0	0	0	0	68
22637	1	0	64	0	0	65
22638	0	69	0	0	0	69
22639	74	0	0	0	0	74
22640	71	0	0	0	0	71
22641	0	71	0	0	0	71
22642	0	1	0	71	0	72
22643	0	0	72	0	0	72
22644	1	0	0	71	0	72
22645	0	0	72	0	0	72
22646	0	0	0	73	0	73
22647	0	0	0	71	0	71
22648	0	0	66	0	0	66
22649	0	70	0	0	0	70
22650	1	0	0	72	0	73
22651	0	0	72	0	0	72
22652	73	1	0	0	0	74
22653	0	0	0	73	0	73
22654	0	0	0	73	0	73
22655	69	0	0	0	0	69
22656	0	0	0	73	0	73
22657	0	0	0	73	0	73
22658	0	74	0	0	0	74
22659	0	0	0	71	0	71
22660	0	0	68	0	0	68
22661	0	0	0	71	0	71
22662	1	61	0	1	0	63
22663	0	67	0	0	0	67
22664	0	0	0	73	0	73
22665	71	0	0	0	0	71
22666	0	0	0	71	0	71
22667	70	0	0	0	0	70
22668	0	0	0	71	0	71
22669	66	0	0	0	0	66
22670	65	1	0	0	0	66
22671	0	0	0	70	0	70
22672	0	0	0	67	0	67
22673	0	62	0	0	0	62
22674	0	59	0	0	0	59
22675	0	0	60	0	0	60
22676	0	64	0	0	0	64
22677	64	0	0	0	0	64
22678	0	0	0	67	0	67
22679	0	62	0	0	0	62
22680	64	0	0	0	0	64
22681	0	0	0	63	0	63
22682	0	0	0	61	0	61
22683	0	0	0	65	0	65
22684	0	0	0	64	0	64
22685	0	61	0	0	0	61
22686	0	61	0	1	0	62
22687	61	0	0	0	0	61
22688	0	64	0	0	0	64
22689	0	0	0	61	0	61
22690	0	0	0	63	0	63
22691	0	0	0	65	0	65
22692	0	0	0	65	0	65
22693	66	0	0	0	0	66
22694	68	0	0	0	0	68
22695	0	0	67	0	0	67
22696	2	0	0	67	0	69
22697	0	0	68	0	0	68
22698	0	0	0	67	0	67
22699	0	0	0	69	0	69
22700	66	0	0	0	0	66
22701	0	1	0	68	0	69
22702	0	0	64	0	0	64
22703	0	0	60	0	0	60
22704	63	0	0	0	0	63
22705	0	0	61	0	0	61
22706	0	0	0	66	0	66
22707	0	0	61	0	0	61
22708	1	0	0	64	0	65
22709	0	64	0	0	0	64
22710	0	0	0	68	0	68
22711	0	63	0	0	0	63
22712	0	63	0	0	0	63
22713	1	0	0	65	0	66
22714	67	0	0	0	0	67
22715	0	67	0	0	0	67
22716	1	0	0	66	0	67
22717	67	0	0	0	0	67
22718	69	0	0	0	0	69
22719	69	0	0	0	0	69
22720	0	0	0	70	0	70
22721	0	0	0	69	0	69
22722	71	0	0	0	0	71
22723	73	0	0	0	0	73
22724	73	0	0	0	0	73
22725	0	0	0	75	0	75
22726	0	0	72	0	0	72
22727	77	0	0	0	0	77
22728	0	0	0	77	0	77
22729	0	81	0	0	0	81
22730	0	0	0	80	0	80
22731	0	77	0	0	0	77
22732	0	0	0	87	0	87
22733	0	0	81	0	0	81
22734	0	93	0	0	0	93
22735	0	0	0	93	0	93
22736	0	0	0	92	0	92
22737	0	0	0	94	0	94
22738	99	0	0	0	0	99
22739	0	94	0	0	0	94
22740	0	0	0	96	0	96
22741	93	0	0	0	0	93
22742	96	0	0	0	0	96
22743	0	0	0	96	0	96
22744	0	0	94	0	0	94
22745	0	0	0	92	0	92
22746	0	90	0	0	0	90
22747	0	0	0	95	0	95
22748	92	1	0	0	0	93
22749	0	0	0	97	0	97
22750	0	0	96	0	0	96
22751	0	96	0	0	0	96
22752	97	0	0	0	0	97
22753	0	0	98	0	0	98
22754	105	0	0	0	0	105
22755	0	0	0	103	0	103
22756	0	0	0	97	0	97
22757	0	101	0	0	0	101
22758	103	0	0	0	0	103
22759	0	0	0	102	0	102
22760	1	0	0	100	0	101
22761	0	0	0	103	0	103
22762	0	0	103	0	0	103
22763	0	0	0	105	0	105
22764	104	0	0	0	0	104
22765	105	0	0	0	0	105
22766	0	0	0	105	0	105
22767	0	0	0	104	0	104
22768	103	0	0	0	0	103
22769	0	0	104	0	0	104
22770	99	0	0	0	0	99
22771	0	0	98	0	0	98
22772	0	0	101	0	0	101
22773	0	0	0	101	0	101
22774	0	0	103	0	0	103
22775	106	0	0	0	0	106
22776	0	0	0	106	0	106
22777	0	0	102	0	0	102
22778	107	0	0	0	0	107
22779	107	0	0	0	0	107
22780	0	0	102	0	0	102
22781	0	0	0	102	0	102
22782	0	99	0	0	0	99
22783	103	0	0	0	0	103
22784	0	0	101	0	0	101
22785	103	0	0	0	0	103
22786	0	102	0	0	0	102
22787	104	0	0	0	0	104
22788	100	0	0	0	0	100
22789	102	0	0	0	0	102
22790	0	0	0	101	0	101
22791	0	96	0	0	0	96
22792	0	0	95	0	0	95
22793	0	94	0	0	0	94
22794	0	0	0	103	0	103
22795	1	97	0	0	0	98
22796	0	106	0	0	0	106
22797	109	0	0	0	0	109
22798	0	0	100	0	0	100
22799	0	0	97	0	0	97
22800	0	0	100	1	0	101
22801	0	106	0	0	0	106
22802	109	0	0	0	0	109
22803	105	0	0	0	0	105
22804	106	0	0	0	0	106
22805	0	105	0	0	0	105
22806	0	0	0	107	0	107
22807	0	0	103	0	0	103
22808	0	0	105	0	0	105
22809	108	0	0	0	0	108
22810	106	0	0	0	0	106
22811	104	0	0	0	0	104
22812	1	0	101	0	0	102
22813	104	0	0	0	0	104
22814	0	0	0	105	0	105
22815	0	0	0	102	0	102
22816	0	1	96	0	0	97
22817	0	100	0	0	0	100
22818	0	0	0	102	0	102
22819	0	0	96	0	0	96
22820	98	0	0	0	0	98
22821	0	0	0	98	0	98
22822	0	0	0	95	0	95
22823	95	0	0	0	0	95
22824	0	0	0	87	0	87
22825	86	0	0	0	0	86
22826	85	0	0	0	0	85
22827	0	0	0	79	0	79
22828	0	0	0	80	0	80
22829	74	0	0	0	0	74
22830	0	0	0	81	0	81
22831	79	0	0	0	0	79
22832	78	0	0	0	0	78
22833	76	0	0	0	0	76
22834	0	0	0	79	0	79
22835	0	0	0	80	0	80
22836	78	0	0	0	0	78
22837	0	73	0	1	0	74
22838	0	77	0	0	0	77
22839	79	0	0	0	0	79
22840	0	0	79	0	0	79
22841	78	0	0	0	0	78
22842	0	1	0	81	0	82
22843	0	0	69	0	0	69
22844	79	0	0	0	0	79
22845	0	0	0	78	0	78
22846	0	0	0	79	0	79
22847	0	0	0	79	0	79
22848	0	0	0	78	0	78
22849	77	0	0	0	0	77
22850	0	74	0	0	0	74
22851	75	0	0	0	0	75
22852	0	0	75	0	0	75
22853	0	0	74	0	0	74
22854	0	78	0	0	0	78
22855	0	0	0	82	0	82
22856	0	0	75	0	0	75
22857	4	71	0	0	0	75
22858	1	0	78	0	0	79
22859	0	0	0	80	0	80
22860	0	0	0	81	0	81
22861	84	0	0	0	0	84
22862	0	3	0	74	0	77
22863	79	0	0	0	0	79
22864	0	0	74	0	0	74
22865	0	80	0	0	0	80
22866	0	0	0	80	0	80
22867	0	0	0	79	0	79
22868	0	0	82	0	0	82
22869	1	0	74	1	0	76
22870	82	0	0	0	0	82
22871	78	0	0	0	0	78
22872	0	0	0	82	0	82
22873	0	0	0	84	0	84
22874	0	82	0	1	0	83
22875	0	0	0	87	0	87
22876	85	0	0	0	0	85
22877	86	0	0	0	0	86
22878	1	86	0	0	0	87
22879	87	0	0	0	0	87
22880	78	0	0	0	0	78
22881	0	0	0	86	0	86
22882	0	82	0	0	0	82
22883	0	0	0	87	0	87
22884	0	0	0	86	0	86
22885	0	0	87	0	0	87
22886	84	0	0	0	0	84
22887	0	0	0	90	0	90
22888	0	0	0	92	0	92
22889	0	88	0	0	0	88
22890	0	0	0	90	0	90
22891	90	0	0	0	0	90
22892	89	0	0	0	0	89
22893	0	0	90	0	0	90
22894	2	1	77	0	0	80
22895	0	0	0	86	0	86
22896	0	0	0	86	0	86
22897	0	0	84	0	0	84
22898	1	0	81	0	0	82
22899	0	0	0	84	0	84
22900	0	0	79	0	0	79
22901	0	0	83	0	0	83
22902	0	0	0	88	0	88
22903	93	0	0	0	0	93
22904	90	0	0	0	0	90
22905	0	0	0	90	0	90
22906	0	0	0	88	0	88
22907	88	0	0	0	0	88
22908	0	0	0	90	0	90
22909	89	0	0	0	0	89
22910	86	0	1	0	0	87
22911	0	0	0	90	0	90
22912	0	0	0	93	0	93
22913	85	0	0	0	0	85
22914	0	78	0	1	0	79
22915	0	84	0	0	0	84
22916	0	0	0	88	0	88
22917	0	0	87	0	0	87
22918	0	0	0	87	0	87
22919	91	0	0	0	0	91
22920	0	0	0	87	0	87
22921	90	0	0	0	0	90
22922	0	0	89	0	0	89
22923	88	0	0	0	0	88
22924	0	0	0	89	0	89
22925	0	0	0	90	0	90
22926	0	0	94	0	0	94
22927	0	0	0	93	0	93
22928	0	0	0	91	0	91
22929	0	0	0	93	0	93
22930	92	0	0	0	0	92
22931	0	0	86	0	0	86
22932	0	0	82	0	0	82
22933	94	0	0	0	0	94
22934	96	0	0	0	0	96
22935	0	0	91	0	0	91
22936	0	0	0	87	0	87
22937	0	85	0	0	0	85
22938	0	0	0	89	0	89
22939	88	0	0	0	0	88
22940	87	0	0	0	0	87
22941	0	0	0	89	0	89
22942	0	92	0	0	0	92
22943	1	0	0	88	0	89
22944	0	91	0	0	0	91
22945	101	0	0	0	0	101
22946	92	0	0	0	0	92
22947	97	0	0	0	0	97
22948	0	85	0	0	0	85
22949	0	85	0	0	0	85
22950	0	0	0	93	0	93
22951	0	0	0	93	0	93
22952	0	0	0	88	0	88
22953	0	0	0	90	0	90
22954	0	0	87	0	0	87
22955	90	0	0	0	0	90
22956	0	0	88	0	0	88
22957	87	0	0	0	0	87
22958	0	0	85	0	0	85
22959	81	0	0	0	0	81
22960	0	0	84	0	0	84
22961	83	0	0	0	0	83
22962	0	0	0	82	0	82
22963	83	0	0	0	0	83
22964	0	0	0	81	0	81
22965	0	0	0	80	0	80
22966	0	0	0	82	0	82
22967	0	75	0	0	0	75
22968	77	0	0	0	0	77
22969	75	0	0	0	0	75
22970	0	77	0	0	0	77
22971	0	0	0	79	0	79
22972	0	0	76	0	0	76
22973	77	0	0	0	0	77
22974	81	0	0	0	0	81
22975	79	0	0	0	0	79
22976	0	0	0	78	0	78
22977	0	77	0	0	0	77
22978	0	0	0	82	0	82
22979	80	0	0	0	0	80
22980	0	0	0	79	0	79
22981	0	74	0	0	0	74
22982	79	0	0	0	0	79
22983	0	0	72	0	0	72
22984	0	0	64	0	0	64
22985	0	76	0	0	0	76
22986	0	73	0	0	0	73
22987	0	0	74	0	0	74
22988	0	0	74	0	0	74
22989	0	0	0	75	0	75
22990	79	0	0	0	0	79
22991	0	0	77	0	0	77
22992	0	74	0	0	0	74
22993	75	0	0	1	0	76
22994	0	77	0	0	0	77
22995	74	0	0	0	0	74
22996	0	69	0	0	0	69
22997	0	70	0	0	0	70
22998	0	0	0	76	0	76
22999	0	0	0	79	0	79
23000	0	0	81	0	0	81
23001	0	0	0	84	0	84
23002	82	0	0	1	0	83
23003	88	0	0	0	0	88
23004	0	1	0	83	0	84
23005	0	0	83	1	0	84
23006	0	0	82	0	0	82
23007	0	0	0	87	0	87
23008	0	0	84	0	0	84
23009	0	0	0	88	0	88
23010	0	0	0	87	0	87
23011	0	0	87	0	0	87
23012	88	0	0	0	0	88
23013	87	0	0	1	0	88
23014	0	0	94	0	0	94
23015	0	0	88	0	0	88
23016	0	0	0	89	0	89
23017	0	0	0	97	0	97
23018	0	0	0	100	0	100
23019	0	0	0	98	0	98
23020	102	0	0	0	0	102
23021	97	0	0	0	0	97
23022	0	0	0	104	0	104
23023	0	0	0	109	0	109
23024	0	0	110	0	0	110
23025	0	0	0	112	0	112
23026	1	0	0	114	0	115
23027	114	0	0	0	0	114
23028	0	112	0	1	0	113
23029	0	0	0	113	0	113
23030	0	0	0	115	0	115
23031	0	0	0	117	0	117
23032	0	111	0	0	0	111
23033	0	112	0	0	0	112
23034	0	0	0	123	0	123
23035	0	0	0	119	0	119
23036	0	0	0	120	0	120
23037	114	0	0	0	0	114
23038	0	114	0	0	0	114
23039	117	0	0	0	0	117
23040	111	0	0	0	0	111
23041	0	0	0	115	0	115
23042	0	111	0	0	0	111
23043	114	0	0	0	0	114
23044	0	0	0	112	0	112
23045	118	0	0	0	0	118
23046	0	0	0	116	0	116
23047	0	0	116	0	0	116
23048	0	0	108	1	0	109
23049	0	0	0	117	0	117
23050	0	0	1	115	0	116
23051	0	0	0	119	0	119
23052	0	116	0	0	0	116
23053	0	115	0	0	0	115
23054	120	0	0	0	0	120
23055	116	0	0	0	0	116
23056	0	121	0	0	0	121
23057	0	110	0	0	0	110
23058	0	124	0	0	0	124
23059	124	0	0	0	0	124
23060	0	124	0	0	0	124
23061	0	0	0	122	0	122
23062	116	0	0	0	0	116
23063	113	0	0	0	0	113
23064	0	0	0	119	0	119
23065	0	0	116	1	0	117
23066	0	0	112	0	0	112
23067	0	0	0	118	0	118
23068	0	0	117	0	0	117
23069	0	0	0	116	0	116
23070	0	0	0	118	0	118
23071	1	0	116	0	0	117
23072	0	0	112	0	0	112
23073	1	0	1	118	0	120
23074	0	0	0	121	0	121
23075	124	0	0	0	0	124
23076	0	113	0	1	0	114
23077	0	114	0	0	0	114
23078	122	1	0	0	0	123
23079	112	0	0	1	0	113
23080	0	110	0	2	0	112
23081	0	120	0	0	0	120
23082	117	0	0	0	0	117
23083	0	0	0	115	0	115
23084	119	0	0	0	0	119
23085	0	119	0	0	0	119
23086	121	0	0	0	0	121
23087	0	0	118	0	0	118
23088	120	0	0	0	0	120
23089	1	1	113	0	0	115
23090	0	0	0	117	0	117
23091	117	0	0	0	0	117
23092	0	0	110	0	0	110
23093	0	0	0	112	0	112
23094	111	0	0	0	0	111
23095	0	1	108	0	0	109
23096	0	0	0	109	0	109
23097	111	0	0	0	0	111
23098	0	105	0	0	0	105
23099	0	0	0	111	0	111
23100	0	0	0	108	0	108
23101	0	0	0	108	0	108
23102	0	106	0	0	0	106
23103	0	0	0	109	0	109
23104	0	0	0	108	0	108
23105	0	0	0	110	0	110
23106	0	0	0	114	0	114
23107	0	0	103	0	0	103
23108	106	0	0	0	0	106
23109	97	1	0	0	0	98
23110	0	98	1	0	0	99
23111	0	0	0	101	0	101
23112	0	0	0	97	0	97
23113	0	95	1	0	0	96
23114	0	0	0	96	0	96
23115	88	0	0	0	0	88
23116	0	85	0	0	0	85
23117	87	0	0	0	0	87
23118	0	0	0	86	0	86
23119	0	0	82	0	0	82
23120	1	78	0	0	0	79
23121	82	0	0	0	0	82
23122	0	71	0	0	0	71
23123	0	77	0	0	0	77
23124	78	0	0	0	0	78
23125	0	0	74	0	0	74
23126	0	76	0	0	0	76
23127	78	0	0	0	0	78
23128	75	0	0	0	0	75
23129	0	77	0	0	0	77
23130	0	0	0	82	0	82
23131	0	0	70	0	0	70
23132	0	0	0	75	0	75
23133	1	0	0	77	0	78
23134	0	0	0	80	0	80
23135	0	0	80	0	0	80
23136	0	0	0	80	0	80
23137	0	0	83	0	0	83
23138	0	0	75	0	0	75
23139	81	0	0	0	0	81
23140	0	74	0	0	0	74
23141	0	84	0	0	0	84
23142	0	0	0	88	0	88
23143	90	0	0	0	0	90
23144	89	0	0	0	0	89
23145	92	0	0	0	0	92
23146	87	0	0	0	0	87
23147	89	0	0	0	0	89
23148	0	0	88	0	0	88
23149	0	0	0	85	0	85
23150	0	84	0	0	0	84
23151	0	0	0	91	0	91
23152	91	0	0	0	0	91
23153	0	87	0	0	0	87
23154	0	0	0	91	0	91
23155	87	0	0	0	0	87
23156	91	0	0	0	0	91
23157	0	0	0	90	0	90
23158	0	0	0	91	0	91
23159	0	0	0	95	0	95
23160	0	0	88	0	0	88
23161	0	0	82	0	0	82
23162	0	0	0	90	0	90
23163	0	0	0	91	0	91
23164	90	0	0	0	0	90
23165	90	0	1	0	0	91
23166	87	0	0	0	0	87
23167	92	0	0	0	0	92
23168	93	0	0	0	0	93
23169	1	86	0	0	0	87
23170	91	0	0	0	0	91
23171	93	0	0	0	0	93
23172	93	0	0	0	0	93
23173	0	0	0	84	0	84
23174	0	0	88	0	0	88
23175	0	0	0	92	0	92
23176	0	0	94	0	0	94
23177	1	0	0	89	0	90
23178	0	97	0	0	0	97
23179	97	0	0	0	0	97
23180	97	1	0	0	0	98
23181	0	0	0	92	0	92
23182	0	0	0	100	0	100
23183	0	0	0	105	0	105
23184	0	101	0	0	0	101
23185	106	0	0	0	0	106
23186	104	0	0	0	0	104
23187	0	103	0	0	0	103
23188	0	0	0	107	0	107
23189	0	0	0	106	0	106
23190	1	98	0	0	0	99
23191	107	0	0	0	0	107
23192	109	0	0	0	0	109
23193	0	0	0	107	0	107
23194	0	0	106	0	0	106
23195	0	0	100	0	0	100
23196	0	0	0	110	0	110
23197	0	0	1	108	0	109
23198	0	0	0	112	0	112
23199	104	0	0	0	0	104
23200	112	0	0	0	0	112
23201	0	112	0	0	0	112
23202	119	0	0	1	0	120
23203	0	0	109	0	0	109
23204	0	0	108	0	0	108
23205	0	115	0	0	0	115
23206	122	0	0	0	0	122
23207	0	124	0	0	0	124
23208	122	0	0	0	0	122
23209	0	0	120	0	0	120
23210	1	0	120	1	0	122
23211	0	0	0	119	0	119
23212	0	0	122	0	0	122
23213	0	0	0	122	0	122
23214	0	0	0	125	0	125
23215	0	137	0	0	0	137
23216	0	0	0	135	0	135
23217	0	0	0	136	0	136
23218	135	0	0	0	0	135
23219	0	135	0	0	0	135
23220	0	0	0	140	0	140
23221	0	0	145	0	0	145
23222	142	0	0	0	0	142
23223	0	0	134	0	0	134
23224	1	0	0	132	0	133
23225	0	138	0	0	0	138
23226	0	0	0	139	0	139
23227	136	0	0	0	0	136
23228	131	0	0	2	0	133
23229	0	133	0	0	0	133
23230	132	0	0	0	0	132
23231	135	0	0	0	0	135
23232	136	0	0	0	0	136
23233	132	0	0	1	0	133
23234	137	0	0	0	0	137
23235	0	0	142	0	0	142
23236	0	0	0	143	0	143
23237	0	0	0	138	0	138
23238	2	0	0	139	0	141
23239	0	139	0	0	0	139
23240	0	0	0	134	0	134
23241	0	0	128	0	0	128
23242	0	118	0	0	0	118
23243	0	131	0	0	0	131
23244	0	0	0	133	0	133
23245	0	0	0	137	0	137
23246	0	0	0	136	0	136
23247	0	138	0	0	0	138
23248	0	137	0	0	0	137
23249	138	0	0	0	0	138
23250	138	0	0	0	0	138
23251	0	140	0	0	0	140
23252	142	0	0	0	0	142
23253	142	0	0	0	0	142
23254	0	0	0	148	0	148
23255	0	0	0	147	0	147
23256	0	0	0	147	0	147
23257	0	0	149	0	0	149
23258	0	0	137	0	0	137
23259	0	148	0	0	0	148
23260	150	0	0	0	0	150
23261	0	0	148	0	0	148
23262	150	0	0	0	0	150
23263	0	0	146	0	0	146
23264	149	0	0	0	0	149
23265	0	151	0	0	0	151
23266	156	0	0	0	0	156
23267	0	0	0	154	0	154
23268	0	0	0	154	0	154
23269	0	0	134	0	0	134
23270	0	141	0	0	0	141
23271	0	0	0	142	0	142
23272	0	0	142	0	0	142
23273	141	0	0	0	0	141
23274	0	141	0	1	0	142
23275	138	0	0	0	0	138
23276	0	136	0	1	0	137
23277	0	0	0	142	0	142
23278	136	0	0	0	0	136
23279	0	134	0	0	0	134
23280	0	0	0	135	0	135
23281	0	0	138	0	0	138
23282	138	0	0	0	0	138
23283	0	0	0	135	0	135
23284	0	0	133	0	0	133
23285	0	129	0	0	0	129
23286	0	0	0	136	0	136
23287	0	0	130	0	0	130
23288	0	0	0	133	0	133
23289	0	119	0	0	0	119
23290	1	125	0	0	0	126
23291	1	1	127	0	0	129
23292	0	0	0	132	0	132
23293	0	0	126	0	0	126
23294	124	0	0	0	0	124
23295	0	0	0	124	0	124
23296	0	111	0	1	0	112
23297	0	120	0	0	0	120
23298	121	0	0	0	0	121
23299	0	121	0	1	0	122
23300	127	0	0	0	0	127
23301	0	0	125	0	0	125
23302	126	0	0	0	0	126
23303	0	126	0	0	0	126
23304	125	0	0	0	0	125
23305	0	122	0	0	0	122
23306	0	0	0	133	0	133
23307	0	0	0	134	0	134
23308	0	0	126	0	0	126
23309	127	0	0	0	0	127
23310	0	0	128	0	0	128
23311	116	0	0	0	0	116
23312	0	0	0	117	0	117
23313	0	0	0	117	0	117
23314	0	108	0	0	0	108
23315	0	0	0	115	0	115
23316	0	0	0	114	0	114
23317	0	0	111	0	0	111
23318	104	0	0	0	0	104
23319	1	106	0	0	0	107
23320	110	0	1	0	0	111
23321	0	0	0	112	0	112
23322	0	0	0	110	0	110
23323	109	0	0	0	0	109
23324	0	105	0	0	0	105
23325	104	0	0	0	0	104
23326	0	91	0	1	0	92
23327	0	92	0	0	0	92
23328	98	0	0	0	0	98
23329	0	0	0	99	0	99
23330	0	0	101	0	0	101
23331	0	0	0	104	0	104
23332	0	0	0	105	0	105
23333	0	98	1	0	0	99
23334	0	0	0	108	0	108
23335	0	0	0	108	0	108
23336	0	0	0	109	0	109
23337	0	0	0	112	0	112
23338	1	0	106	0	0	107
23339	0	0	103	0	0	103
23340	0	0	0	104	0	104
23341	0	0	103	0	0	103
23342	0	0	98	0	0	98
23343	0	0	0	101	0	101
23344	0	0	100	0	0	100
23345	0	0	0	99	0	99
23346	0	96	0	0	0	96
23347	97	0	0	0	0	97
23348	0	0	92	0	0	92
23349	2	0	0	92	0	94
23350	0	0	91	0	0	91
23351	0	0	0	91	0	91
23352	0	0	0	94	0	94
23353	94	0	2	0	0	96
23354	0	1	0	101	0	102
23355	97	0	0	0	0	97
23356	104	0	0	0	0	104
23357	0	98	0	0	0	98
23358	95	0	0	2	0	97
23359	0	90	0	0	0	90
23360	0	100	0	0	0	100
23361	101	0	0	0	0	101
23362	0	0	103	0	0	103
23363	1	0	98	1	0	100
23364	102	0	0	0	0	102
23365	102	0	0	0	0	102
23366	0	98	0	0	0	98
23367	107	0	0	0	0	107
23368	102	0	0	0	0	102
23369	98	0	0	0	0	98
23370	0	0	0	103	0	103
23371	99	0	0	0	0	99
23372	0	107	0	0	0	107
23373	0	0	0	108	0	108
23374	0	0	0	105	0	105
23375	0	103	1	0	0	104
23376	0	0	0	109	0	109
23377	107	0	0	0	0	107
23378	101	0	0	0	0	101
23379	0	101	0	0	0	101
23380	0	97	0	1	0	98
23381	100	0	0	0	0	100
23382	0	0	103	0	0	103
23383	0	0	98	0	0	98
23384	1	0	0	100	0	101
23385	0	0	0	101	0	101
23386	0	0	97	0	0	97
23387	0	92	0	0	0	92
23388	0	0	0	103	0	103
23389	0	0	101	0	0	101
23390	0	0	1	101	0	102
23391	0	0	0	96	0	96
23392	0	99	0	0	0	99
23393	0	0	0	100	0	100
23394	1	0	0	90	0	91
23395	0	0	0	93	0	93
23396	93	0	0	0	0	93
23397	0	0	0	95	0	95
23398	0	91	0	0	0	91
23399	90	0	0	0	0	90
23400	0	0	89	0	0	89
23401	0	0	85	0	0	85
23402	87	0	0	0	0	87
23403	0	0	0	89	0	89
23404	0	0	91	0	0	91
23405	0	0	0	91	0	91
23406	0	0	0	96	0	96
23407	93	0	0	1	0	94
23408	93	0	0	0	0	93
23409	0	89	0	0	0	89
23410	0	0	0	93	0	93
23411	0	0	88	1	0	89
23412	0	91	0	0	0	91
23413	99	0	0	0	0	99
23414	0	100	0	0	0	100
23415	107	0	0	0	0	107
23416	0	0	105	0	0	105
23417	104	0	0	0	0	104
23418	105	0	0	1	0	106
23419	0	0	106	0	0	106
23420	1	0	0	104	0	105
23421	0	92	0	0	0	92
23422	0	105	0	0	0	105
23423	0	104	0	0	0	104
23424	0	0	0	108	0	108
23425	0	1	95	0	0	96
23426	0	0	0	103	0	103
23427	0	0	0	100	0	100
23428	0	0	96	0	0	96
23429	0	95	0	0	0	95
23430	0	0	0	99	0	99
23431	94	0	0	0	0	94
23432	0	0	0	96	0	96
23433	0	0	0	99	0	99
23434	0	99	0	0	0	99
23435	98	0	0	0	0	98
23436	0	0	0	96	0	96
23437	0	0	92	0	0	92
23438	0	87	0	0	0	87
23439	92	0	0	0	0	92
23440	0	0	90	0	0	90
23441	95	0	0	0	0	95
23442	0	0	0	98	0	98
23443	0	94	0	0	0	94
23444	91	0	0	0	0	91
23445	87	0	0	0	0	87
23446	0	88	2	0	0	90
23447	0	0	0	92	0	92
23448	0	0	0	89	0	89
23449	85	0	0	0	0	85
23450	0	88	0	0	0	88
23451	0	0	0	78	0	78
23452	0	76	0	0	0	76
23453	1	73	0	0	0	74
23454	0	0	0	81	0	81
23455	73	0	0	0	0	73
23456	0	79	0	0	0	79
23457	0	0	0	82	0	82
23458	0	0	0	78	0	78
23459	0	0	76	1	0	77
23460	0	0	63	0	0	63
23461	0	71	0	0	0	71
23462	0	0	79	0	0	79
23463	0	0	0	81	0	81
23464	1	0	79	0	0	80
23465	0	0	0	74	0	74
23466	0	0	0	78	0	78
23467	0	0	0	78	0	78
23468	76	0	0	0	0	76
23469	0	0	0	79	0	79
23470	0	0	0	74	0	74
23471	0	79	0	0	0	79
23472	0	0	0	79	0	79
23473	78	0	0	0	0	78
23474	0	77	0	0	0	77
23475	80	0	0	0	0	80
23476	0	0	79	0	0	79
23477	0	0	79	0	0	79
23478	0	0	0	77	0	77
23479	0	0	0	80	0	80
23480	0	77	0	1	0	78
23481	0	0	0	78	0	78
23482	79	0	0	0	0	79
23483	78	0	0	0	0	78
23484	0	0	0	80	0	80
23485	0	0	78	0	0	78
23486	0	0	0	78	0	78
23487	0	0	0	80	0	80
23488	0	0	0	79	0	79
23489	0	0	0	81	0	81
23490	0	0	0	76	0	76
23491	0	83	0	0	0	83
23492	83	0	0	0	0	83
23493	88	0	0	0	0	88
23494	87	0	0	0	0	87
23495	0	92	0	0	0	92
23496	91	0	0	0	0	91
23497	0	93	0	0	0	93
23498	0	0	88	0	0	88
23499	0	0	0	91	0	91
23500	0	0	94	0	0	94
23501	0	94	0	1	0	95
23502	96	0	0	1	0	97
23503	0	0	95	0	0	95
23504	1	0	87	1	0	89
23505	0	93	0	0	0	93
23506	0	0	0	92	0	92
23507	0	0	86	0	0	86
23508	0	0	0	91	0	91
23509	0	0	0	91	0	91
23510	0	0	0	97	0	97
23511	111	0	0	0	0	111
23512	112	0	0	0	0	112
23513	0	0	0	115	0	115
23514	115	0	0	0	0	115
23515	0	0	111	0	0	111
23516	0	0	108	0	0	108
23517	0	0	112	0	0	112
23518	0	0	111	0	0	111
23519	0	117	0	0	0	117
23520	0	0	0	118	0	118
23521	0	0	120	0	0	120
23522	115	0	1	0	0	116
23523	116	0	0	0	0	116
23524	0	116	0	0	0	116
23525	116	0	0	0	0	116
23526	0	0	0	115	0	115
23527	0	0	116	0	0	116
23528	0	0	0	117	0	117
23529	0	116	0	0	0	116
23530	116	1	0	0	0	117
23531	113	1	0	0	0	114
23532	0	114	0	0	0	114
23533	116	0	0	0	0	116
23534	113	0	0	0	0	113
23535	0	116	0	0	0	116
23536	0	0	0	117	0	117
23537	0	119	0	0	0	119
23538	119	0	0	0	0	119
23539	0	0	0	114	0	114
23540	116	0	0	0	0	116
23541	0	0	0	119	0	119
23542	0	0	116	0	0	116
23543	115	0	0	0	0	115
23544	0	0	113	0	0	113
23545	0	0	0	113	0	113
23546	0	0	117	0	0	117
23547	0	0	0	116	0	116
23548	0	0	115	0	0	115
23549	113	0	0	0	0	113
23550	0	112	0	0	0	112
23551	114	0	0	0	0	114
23552	0	0	0	113	0	113
23553	110	0	0	0	0	110
23554	0	106	0	0	0	106
23555	0	98	0	0	0	98
23556	0	102	0	0	0	102
23557	107	0	0	0	0	107
23558	1	0	0	110	0	111
23559	0	0	0	113	0	113
23560	0	0	110	0	0	110
23561	0	0	103	0	0	103
23562	0	0	0	108	0	108
23563	0	0	108	0	0	108
23564	0	102	0	1	0	103
23565	110	0	0	0	0	110
23566	0	0	106	0	0	106
23567	0	0	109	0	0	109
23568	0	0	0	109	0	109
23569	111	0	0	0	0	111
23570	0	0	0	109	0	109
23571	108	0	0	0	0	108
23572	0	0	0	109	0	109
23573	0	0	104	0	0	104
23574	1	98	0	0	0	99
23575	0	0	102	0	0	102
23576	0	100	0	0	0	100
23577	0	0	0	104	0	104
23578	101	0	0	0	0	101
23579	0	0	106	0	0	106
23580	0	0	0	103	0	103
23581	0	0	0	108	0	108
23582	105	0	0	0	0	105
23583	0	0	0	110	0	110
23584	0	103	0	0	0	103
23585	102	0	0	0	0	102
23586	0	0	103	0	0	103
23587	102	0	0	0	0	102
23588	0	94	0	0	0	94
23589	0	0	0	92	0	92
23590	0	95	0	0	0	95
23591	99	0	0	0	0	99
23592	0	0	96	0	0	96
23593	93	0	0	0	0	93
23594	0	86	1	0	0	87
23595	0	0	0	88	0	88
23596	89	0	0	0	0	89
23597	94	0	0	0	0	94
23598	0	0	0	95	0	95
23599	0	0	0	94	0	94
23600	0	85	0	0	0	85
23601	0	0	0	88	0	88
23602	0	80	0	0	0	80
23603	0	80	0	0	0	80
23604	0	0	0	69	0	69
23605	0	66	0	0	0	66
23606	0	0	68	0	0	68
23607	0	0	64	0	0	64
23608	0	65	0	0	0	65
23609	0	0	71	0	0	71
23610	2	0	63	0	0	65
23611	0	0	65	0	0	65
23612	0	61	0	0	0	61
23613	67	0	0	0	0	67
23614	0	60	0	0	0	60
23615	2	0	61	0	0	63
23616	0	0	0	64	0	64
23617	64	0	0	0	0	64
23618	0	0	65	0	0	65
23619	0	0	0	65	0	65
23620	0	0	70	0	0	70
23621	0	0	0	73	0	73
23622	70	0	0	0	0	70
23623	6	0	67	0	0	73
23624	0	73	0	0	0	73
23625	0	0	0	73	0	73
23626	66	0	0	2	0	68
23627	0	0	68	0	0	68
23628	0	0	0	70	0	70
23629	0	68	0	0	0	68
23630	69	0	0	0	0	69
23631	69	0	0	0	0	69
23632	0	0	0	70	0	70
23633	0	62	0	0	0	62
23634	0	66	0	0	0	66
23635	69	0	0	0	0	69
23636	0	0	0	69	0	69
23637	0	66	0	0	0	66
23638	68	0	0	0	0	68
23639	0	0	0	69	0	69
23640	0	0	0	72	0	72
23641	0	0	62	0	0	62
23642	0	64	0	1	0	65
23643	0	69	0	1	0	70
23644	0	0	0	71	0	71
23645	66	0	0	0	0	66
23646	0	71	0	0	0	71
23647	73	0	0	0	0	73
23648	0	70	0	0	0	70
23649	0	0	0	71	0	71
23650	74	0	0	0	0	74
23651	0	0	0	73	0	73
23652	0	0	70	0	0	70
23653	0	0	0	69	0	69
23654	0	71	0	0	0	71
23655	70	0	0	0	0	70
23656	0	69	0	0	0	69
23657	0	0	0	69	0	69
23658	0	0	0	73	0	73
23659	0	0	67	0	0	67
23660	0	0	61	0	0	61
23661	0	0	0	69	0	69
23662	0	0	64	1	0	65
23663	0	70	0	0	0	70
23664	73	0	0	0	0	73
23665	0	0	69	0	0	69
23666	73	0	0	0	0	73
23667	74	0	0	0	0	74
23668	70	0	0	0	0	70
23669	71	0	0	0	0	71
23670	0	0	0	69	0	69
23671	0	0	0	64	0	64
23672	0	64	0	1	0	65
23673	69	0	0	0	0	69
23674	0	0	69	0	0	69
23675	0	0	0	67	0	67
23676	0	0	0	68	0	68
23677	2	0	68	0	0	70
23678	0	62	2	0	0	64
23679	0	0	0	70	0	70
23680	0	0	0	73	0	73
23681	72	0	0	0	0	72
23682	0	65	0	0	0	65
23683	0	0	0	66	0	66
23684	0	65	0	0	0	65
23685	0	0	0	69	0	69
23686	61	0	0	0	0	61
23687	62	0	0	0	0	62
23688	0	0	0	66	0	66
23689	64	0	0	0	0	64
23690	60	0	0	0	0	60
23691	0	56	0	0	0	56
23692	0	0	0	61	0	61
23693	0	56	0	0	0	56
23694	0	0	0	50	0	50
23695	56	0	0	0	0	56
23696	0	0	0	54	0	54
23697	0	0	0	54	0	54
23698	0	0	46	0	0	46
23699	0	46	0	0	0	46
23700	0	51	0	0	0	51
23701	51	0	0	0	0	51
23702	0	0	0	40	0	40
23703	45	0	0	0	0	45
23704	0	38	0	0	0	38
23705	0	39	0	0	0	39
23706	0	39	0	0	0	39
23707	42	0	0	0	0	42
23708	0	40	0	0	0	40
23709	42	0	0	0	0	42
23710	39	0	0	0	0	39
23711	39	0	0	0	0	39
23712	1	0	1	38	0	40
23713	0	0	1	37	0	38
23714	0	0	0	42	0	42
23715	0	0	0	44	0	44
23716	44	0	0	0	0	44
23717	0	45	0	0	0	45
23718	0	0	0	44	0	44
23719	44	0	0	0	0	44
23720	0	0	0	41	0	41
23721	0	0	0	41	0	41
23722	38	0	0	0	0	38
23723	0	0	39	0	0	39
23724	0	0	0	39	0	39
23725	0	0	38	0	0	38
23726	0	0	0	40	0	40
23727	0	0	0	40	0	40
23728	37	0	0	0	0	37
23729	0	38	0	0	0	38
23730	0	40	0	0	0	40
23731	40	0	0	0	0	40
23732	0	42	0	0	0	42
23733	43	0	0	0	0	43
23734	2	0	45	0	0	47
23735	48	0	0	0	0	48
23736	51	0	0	0	0	51
23737	50	0	0	0	0	50
23738	0	0	0	47	0	47
23739	0	0	0	46	0	46
23740	0	48	0	0	0	48
23741	0	0	0	48	0	48
23742	50	0	0	0	0	50
23743	0	48	0	0	0	48
23744	0	49	0	0	0	49
23745	51	0	0	0	0	51
23746	0	1	51	0	0	52
23747	0	0	0	49	0	49
23748	0	0	51	0	0	51
23749	0	0	0	52	0	52
23750	0	54	0	0	0	54
23751	0	0	0	53	0	53
23752	51	0	0	0	0	51
23753	0	0	0	54	0	54
23754	0	0	52	0	0	52
23755	50	0	0	1	0	51
23756	0	53	0	0	0	53
23757	0	51	0	0	0	51
23758	53	0	0	0	0	53
23759	51	0	0	0	0	51
23760	1	0	51	0	0	52
23761	49	0	0	0	0	49
23762	0	50	0	1	0	51
23763	51	0	0	0	0	51
23764	0	0	0	53	0	53
23765	0	51	0	0	0	51
23766	54	0	0	0	0	54
23767	0	0	52	0	0	52
23768	0	0	0	55	0	55
23769	56	0	0	0	0	56
23770	0	0	53	0	0	53
23771	57	0	0	0	0	57
23772	0	0	0	54	0	54
23773	0	0	0	54	0	54
23774	0	0	53	0	0	53
23775	0	0	1	55	0	56
23776	55	0	0	0	0	55
23777	0	57	0	0	0	57
23778	53	0	0	0	0	53
23779	55	0	0	0	0	55
23780	0	0	0	54	0	54
23781	0	0	56	0	0	56
23782	0	0	0	56	0	56
23783	55	0	0	0	0	55
23784	0	58	0	0	0	58
23785	59	0	0	0	0	59
23786	0	0	0	57	0	57
23787	0	0	0	61	0	61
23788	0	0	0	60	0	60
23789	0	0	60	0	0	60
23790	0	0	0	58	0	58
23791	0	0	62	0	0	62
23792	1	0	56	0	0	57
23793	0	0	0	65	0	65
23794	0	0	61	0	0	61
23795	63	0	0	0	0	63
23796	0	0	0	59	0	59
23797	0	0	0	62	0	62
23798	0	63	0	0	0	63
23799	65	0	0	0	0	65
23800	60	0	0	0	0	60
23801	0	60	0	0	0	60
23802	0	0	0	62	0	62
23803	0	0	63	0	0	63
23804	59	0	0	0	0	59
23805	61	0	0	0	0	61
23806	0	0	0	60	0	60
23807	0	0	56	0	0	56
23808	0	54	0	0	0	54
23809	55	0	0	0	0	55
23810	0	0	54	0	0	54
23811	0	53	0	0	0	53
23812	51	0	0	0	0	51
23813	54	0	0	0	0	54
23814	0	0	0	54	0	54
23815	0	55	0	0	0	55
23816	0	0	0	57	0	57
23817	1	0	0	56	0	57
23818	0	0	0	56	0	56
23819	0	0	0	59	0	59
23820	0	0	58	0	0	58
23821	0	0	0	58	0	58
23822	0	0	0	59	0	59
23823	0	0	60	0	0	60
23824	0	60	0	0	0	60
23825	57	0	0	0	0	57
23826	56	0	0	0	0	56
23827	0	0	0	56	0	56
23828	54	0	0	0	0	54
23829	0	0	0	53	0	53
23830	0	0	53	0	0	53
23831	0	0	48	0	0	48
23832	2	47	0	0	0	49
23833	51	0	0	0	0	51
23834	0	0	47	0	0	47
23835	0	0	0	49	0	49
23836	0	1	0	49	0	50
23837	0	0	0	51	0	51
23838	0	0	0	55	0	55
23839	0	0	0	54	0	54
23840	0	0	53	0	0	53
23841	0	0	0	50	0	50
23842	49	0	0	0	0	49
23843	0	47	0	0	0	47
23844	49	0	0	0	0	49
23845	0	47	0	0	0	47
23846	49	0	0	0	0	49
23847	49	0	0	0	0	49
23848	0	0	0	48	0	48
23849	0	0	0	47	0	47
23850	43	0	0	0	0	43
23851	45	0	0	0	0	45
23852	44	0	0	0	0	44
23853	0	39	0	0	0	39
23854	0	43	0	0	0	43
23855	0	0	44	0	0	44
23856	0	0	0	43	0	43
23857	0	0	43	0	0	43
23858	0	46	0	0	0	46
23859	0	0	0	45	0	45
23860	0	0	0	40	0	40
23861	0	0	0	44	0	44
23862	45	0	0	0	0	45
23863	43	0	0	0	0	43
23864	0	40	0	0	0	40
23865	0	0	0	44	0	44
23866	0	0	43	0	0	43
23867	0	0	44	0	0	44
23868	45	0	0	0	0	45
23869	47	0	0	0	0	47
23870	0	0	0	45	0	45
23871	46	0	0	0	0	46
23872	0	0	44	0	0	44
23873	0	43	0	0	0	43
23874	0	0	0	41	0	41
23875	0	0	42	0	0	42
23876	0	0	0	41	0	41
23877	0	0	0	36	0	36
23878	0	0	37	0	0	37
23879	35	0	0	0	0	35
23880	40	0	0	0	0	40
23881	0	41	0	0	0	41
23882	39	0	0	0	0	39
23883	41	0	0	0	0	41
23884	0	0	37	0	0	37
23885	39	0	0	0	0	39
23886	0	38	0	0	0	38
23887	42	0	0	0	0	42
23888	41	0	0	0	0	41
23889	39	0	0	0	0	39
23890	40	0	0	0	0	40
23891	42	0	0	0	0	42
23892	0	42	0	0	0	42
23893	39	0	0	0	0	39
23894	0	40	0	0	0	40
23895	1	34	0	0	0	35
23896	0	39	0	0	0	39
23897	41	0	0	0	0	41
23898	41	0	0	0	0	41
23899	0	0	39	0	0	39
23900	43	0	0	0	0	43
23901	44	0	0	0	0	44
23902	0	0	41	0	0	41
23903	0	0	0	42	0	42
23904	0	0	0	42	0	42
23905	0	0	0	43	0	43
23906	0	0	1	42	0	43
23907	0	0	0	45	0	45
23908	0	0	42	0	0	42
23909	0	42	0	0	0	42
23910	44	0	0	0	0	44
23911	0	40	0	0	0	40
23912	41	0	0	0	0	41
23913	38	0	0	0	0	38
23914	0	0	37	0	0	37
23915	0	0	0	36	0	36
23916	0	34	0	0	0	34
23917	37	0	0	0	0	37
23918	35	0	0	0	0	35
23919	34	0	0	0	0	34
23920	0	34	0	0	0	34
23921	36	0	0	0	0	36
23922	35	0	0	0	0	35
23923	36	0	0	0	0	36
23924	0	0	0	35	0	35
23925	0	0	0	35	0	35
23926	0	0	0	34	0	34
23927	30	0	0	0	0	30
23928	0	33	0	0	0	33
23929	36	0	0	0	0	36
23930	36	0	0	0	0	36
23931	28	0	0	0	0	28
23932	33	0	0	0	0	33
23933	0	34	0	0	0	34
23934	32	0	0	1	0	33
23935	1	26	0	0	0	27
23936	0	30	0	0	0	30
23937	34	0	0	0	0	34
23938	0	33	0	0	0	33
23939	0	37	0	0	0	37
23940	38	0	0	0	0	38
23941	37	0	0	0	0	37
23942	0	0	0	39	0	39
23943	0	0	0	39	0	39
23944	38	0	0	0	0	38
23945	40	0	0	0	0	40
23946	37	0	0	0	0	37
23947	0	0	36	0	0	36
23948	39	0	0	0	0	39
23949	0	0	0	37	0	37
23950	0	0	0	38	0	38
23951	0	0	0	38	0	38
23952	0	0	0	37	0	37
23953	0	0	36	0	0	36
23954	0	0	32	0	0	32
23955	0	0	0	38	0	38
23956	0	0	32	0	0	32
23957	0	0	37	0	0	37
23958	0	0	0	33	0	33
23959	0	0	0	35	0	35
23960	0	0	0	36	0	36
23961	0	0	0	34	0	34
23962	33	0	0	0	0	33
23963	35	0	0	0	0	35
23964	0	0	0	33	0	33
23965	0	0	0	33	0	33
23966	0	0	0	32	0	32
23967	0	0	0	34	0	34
23968	0	1	0	32	0	33
23969	0	32	0	0	0	32
23970	32	0	0	0	0	32
23971	0	29	0	0	0	29
23972	33	0	0	0	0	33
23973	32	0	0	0	0	32
23974	30	0	0	0	0	30
23975	0	0	0	33	0	33
23976	34	0	0	0	0	34
23977	0	0	0	37	0	37
23978	0	0	0	32	0	32
23979	33	0	0	0	0	33
23980	0	27	0	0	0	27
23981	0	30	0	0	0	30
23982	27	0	0	0	0	27
23983	0	0	25	0	0	25
23984	28	0	0	1	0	29
23985	0	0	0	30	0	30
23986	0	24	0	0	0	24
23987	0	30	0	0	0	30
23988	33	0	0	0	0	33
23989	0	0	0	31	0	31
23990	0	29	0	0	0	29
23991	29	0	0	0	0	29
23992	36	0	0	0	0	36
23993	34	0	0	0	0	34
23994	33	0	0	0	0	33
23995	0	29	0	0	0	29
23996	0	29	0	0	0	29
23997	30	0	0	0	0	30
23998	32	0	0	0	0	32
23999	0	0	29	0	0	29
24000	0	33	0	0	0	33
24001	34	0	0	0	0	34
24002	34	0	0	0	0	34
24003	0	0	33	0	0	33
24004	32	0	0	0	0	32
24005	0	0	33	0	0	33
24006	0	0	32	0	0	32
24007	0	0	0	32	0	32
24008	0	35	0	0	0	35
24009	35	0	0	0	0	35
24010	0	0	0	36	0	36
24011	0	0	0	37	0	37
24012	0	0	0	36	0	36
24013	36	0	0	0	0	36
24014	0	0	0	37	0	37
24015	0	0	0	40	0	40
24016	0	0	39	0	0	39
24017	40	0	0	0	0	40
24018	41	0	0	0	0	41
24019	0	0	40	0	0	40
24020	43	0	0	0	0	43
24021	0	0	0	42	0	42
24022	0	40	0	0	0	40
24023	0	0	0	43	0	43
24024	41	0	0	0	0	41
24025	0	43	0	0	0	43
24026	0	0	0	43	0	43
24027	0	0	0	45	0	45
24028	0	0	0	47	0	47
24029	0	0	0	46	0	46
24030	0	47	0	0	0	47
24031	47	0	0	0	0	47
24032	46	0	0	0	0	46
24033	0	48	0	0	0	48
24034	52	0	0	0	0	52
24035	52	0	0	0	0	52
24036	49	0	0	0	0	49
24037	0	0	51	0	0	51
24038	0	0	0	52	0	52
24039	0	0	49	0	0	49
24040	49	0	0	0	0	49
24041	0	48	0	0	0	48
24042	50	0	0	0	0	50
24043	0	51	0	0	0	51
24044	0	0	0	52	0	52
24045	0	0	0	54	0	54
24046	0	0	54	0	0	54
24047	0	51	0	0	0	51
24048	55	0	0	0	0	55
24049	0	0	51	0	0	51
24050	54	0	0	0	0	54
24051	0	0	0	54	0	54
24052	0	0	51	0	0	51
24053	0	51	0	0	0	51
24054	0	0	0	56	0	56
24055	0	0	53	0	0	53
24056	0	0	46	0	0	46
24057	0	55	0	0	0	55
24058	0	0	0	55	0	55
24059	0	0	0	57	0	57
24060	0	57	0	1	0	58
24061	59	0	0	0	0	59
24062	0	0	0	60	0	60
24063	0	60	0	0	0	60
24064	61	0	0	0	0	61
24065	57	0	0	0	0	57
24066	58	0	0	0	0	58
24067	0	61	0	0	0	61
24068	60	0	0	0	0	60
24069	59	0	0	0	0	59
24070	0	0	0	60	0	60
24071	61	0	0	0	0	61
24072	0	0	0	54	0	54
24073	0	0	55	0	0	55
24074	0	0	51	0	0	51
24075	0	0	0	58	0	58
24076	0	0	59	0	0	59
24077	57	0	0	0	0	57
24078	0	0	0	55	0	55
24079	0	0	0	56	0	56
24080	0	0	50	0	0	50
24081	0	45	0	0	0	45
24082	0	49	0	0	0	49
24083	0	0	0	52	0	52
24084	0	0	0	55	0	55
24085	0	0	47	0	0	47
24086	0	0	48	0	0	48
24087	0	0	0	48	0	48
24088	0	0	46	0	0	46
24089	46	0	0	0	0	46
24090	0	0	0	47	0	47
24091	45	0	0	0	0	45
24092	0	0	0	48	0	48
24093	0	0	0	49	0	49
24094	0	0	45	0	0	45
24095	0	48	0	0	0	48
24096	0	0	0	46	0	46
24097	0	0	46	0	0	46
24098	0	47	0	0	0	47
24099	0	0	0	50	0	50
24100	48	0	0	0	0	48
24101	0	0	50	0	0	50
24102	48	0	0	0	0	48
24103	0	0	48	0	0	48
24104	47	0	0	0	0	47
24105	0	46	0	0	0	46
24106	0	48	0	0	0	48
24107	0	0	0	50	0	50
24108	0	40	0	0	0	40
24109	46	0	0	0	0	46
24110	0	0	0	49	0	49
24111	0	0	0	47	0	47
24112	0	0	0	49	0	49
24113	0	0	46	0	0	46
24114	0	0	0	48	0	48
24115	0	0	46	0	0	46
24116	0	47	0	0	0	47
24117	44	0	0	0	0	44
24118	0	45	0	0	0	45
24119	48	0	0	0	0	48
24120	47	0	0	0	0	47
24121	47	0	0	0	0	47
24122	48	0	0	0	0	48
24123	0	0	45	0	0	45
24124	0	0	0	42	0	42
24125	0	0	0	46	0	46
24126	0	0	0	44	0	44
24127	39	0	0	0	0	39
24128	39	0	0	0	0	39
24129	0	40	0	0	0	40
24130	0	0	41	0	0	41
24131	0	0	34	0	0	34
24132	0	36	0	0	0	36
24133	0	39	0	0	0	39
24134	0	0	0	40	0	40
24135	0	0	0	42	0	42
24136	38	0	0	0	0	38
24137	0	36	0	0	0	36
24138	0	0	0	38	0	38
24139	0	0	35	0	0	35
24140	0	0	0	37	0	37
24141	0	0	0	38	0	38
24142	0	0	0	39	0	39
24143	0	0	0	37	0	37
24144	0	0	33	0	0	33
24145	0	33	0	0	0	33
24146	0	35	0	0	0	35
24147	37	0	0	0	0	37
24148	0	37	0	0	0	37
24149	0	37	0	0	0	37
24150	0	0	0	40	0	40
24151	0	0	0	39	0	39
24152	0	0	0	39	0	39
24153	0	0	39	0	0	39
24154	0	39	0	0	0	39
24155	0	0	0	37	0	37
24156	0	38	0	1	0	39
24157	39	0	0	0	0	39
24158	0	39	0	0	0	39
24159	38	0	0	1	0	39
24160	0	0	37	0	0	37
24161	42	0	0	0	0	42
24162	0	0	0	41	0	41
24163	0	0	40	0	0	40
24164	41	0	0	0	0	41
24165	40	0	0	0	0	40
24166	41	0	0	0	0	41
24167	0	0	0	42	0	42
24168	0	0	43	0	0	43
24169	44	0	0	0	0	44
24170	0	0	0	47	0	47
24171	0	0	0	44	0	44
24172	0	0	48	0	0	48
24173	0	47	0	0	0	47
24174	0	0	0	46	0	46
24175	0	50	0	0	0	50
24176	49	0	0	0	0	49
24177	46	0	0	0	0	46
24178	1	0	0	49	0	50
24179	48	0	0	0	0	48
24180	0	46	0	0	0	46
24181	46	0	0	1	0	47
24182	1	45	0	0	0	46
24183	0	0	0	47	0	47
24184	0	0	0	50	0	50
24185	0	45	0	0	0	45
24186	0	0	0	46	0	46
24187	0	0	46	0	0	46
24188	0	47	0	0	0	47
24189	46	0	0	0	0	46
24190	0	43	0	0	0	43
24191	0	0	0	43	0	43
24192	0	0	40	0	0	40
24193	0	0	0	41	0	41
24194	0	0	0	40	0	40
24195	39	0	0	0	0	39
24196	0	0	37	0	0	37
24197	0	35	0	0	0	35
24198	0	0	31	0	0	31
24199	0	0	34	0	0	34
24200	0	0	33	0	0	33
24201	0	0	0	35	0	35
24202	38	0	0	0	0	38
24203	0	38	0	0	0	38
24204	37	0	0	0	0	37
24205	35	0	0	0	0	35
24206	0	0	0	40	0	40
24207	0	38	0	0	0	38
24208	39	0	0	0	0	39
24209	0	38	0	0	0	38
24210	0	0	0	40	0	40
24211	0	0	0	41	0	41
24212	0	38	0	0	0	38
24213	0	0	0	40	0	40
24214	0	0	40	1	0	41
24215	0	0	37	0	0	37
24216	0	0	0	39	0	39
24217	0	0	0	40	0	40
24218	0	0	37	0	0	37
24219	0	0	40	0	0	40
24220	37	0	0	0	0	37
24221	0	37	0	0	0	37
24222	0	39	0	0	0	39
24223	0	0	0	37	0	37
24224	0	0	0	37	0	37
24225	0	0	0	38	0	38
24226	0	0	37	0	0	37
24227	0	0	31	0	0	31
24228	0	0	0	35	0	35
24229	0	0	38	0	0	38
24230	0	39	0	0	0	39
24231	38	0	0	0	0	38
24232	0	0	37	0	0	37
24233	0	0	37	0	0	37
24234	0	0	0	40	0	40
24235	0	0	38	0	0	38
24236	0	41	0	0	0	41
24237	0	0	0	43	0	43
24238	0	0	40	0	0	40
24239	0	41	0	0	0	41
24240	38	0	0	0	0	38
24241	0	0	0	44	0	44
24242	0	0	0	43	0	43
24243	41	0	0	0	0	41
24244	0	42	0	0	0	42
24245	42	0	0	0	0	42
24246	42	0	0	0	0	42
24247	44	0	0	0	0	44
24248	0	0	0	42	0	42
24249	40	0	0	0	0	40
24250	0	37	0	0	0	37
24251	0	40	0	0	0	40
24252	44	0	0	0	0	44
24253	0	0	0	42	0	42
24254	0	0	0	41	0	41
24255	0	0	0	42	0	42
24256	0	0	41	0	0	41
24257	0	39	0	0	0	39
24258	0	0	0	42	0	42
24259	44	0	0	0	0	44
24260	0	0	0	43	0	43
24261	0	0	43	0	0	43
24262	0	41	0	0	0	41
24263	42	0	0	0	0	42
24264	41	0	0	0	0	41
24265	40	0	0	0	0	40
24266	0	0	0	40	0	40
24267	0	0	41	0	0	41
24268	0	0	37	0	0	37
24269	0	40	0	0	0	40
24270	0	0	0	43	0	43
24271	0	0	0	46	0	46
24272	47	0	0	0	0	47
24273	0	0	0	51	0	51
24274	56	0	0	1	0	57
24275	0	0	52	0	0	52
24276	0	0	52	1	0	53
24277	0	0	0	53	0	53
24278	0	0	0	55	0	55
24279	0	0	0	55	0	55
24280	55	0	0	0	0	55
24281	53	0	0	0	0	53
24282	0	0	1	55	0	56
24283	0	0	58	0	0	58
24284	1	0	53	0	0	54
24285	0	0	1	55	0	56
24286	54	0	0	0	0	54
24287	0	0	0	57	0	57
24288	0	0	0	56	0	56
24289	0	0	55	0	0	55
24290	0	0	52	0	0	52
24291	57	0	0	0	0	57
24292	0	0	59	0	0	59
24293	0	0	0	60	0	60
24294	1	0	0	60	0	61
24295	59	0	0	0	0	59
24296	0	56	0	0	0	56
24297	54	0	0	1	0	55
24298	0	55	0	0	0	55
24299	57	0	0	0	0	57
24300	0	0	54	0	0	54
24301	57	0	0	0	0	57
24302	55	0	0	0	0	55
24303	0	0	0	56	0	56
24304	0	0	54	0	0	54
24305	0	0	0	56	0	56
24306	0	0	0	56	0	56
24307	0	53	0	0	0	53
24308	0	0	0	53	0	53
24309	0	51	0	0	0	51
24310	0	0	0	56	0	56
24311	57	0	0	0	0	57
24312	0	0	0	54	0	54
24313	0	0	53	0	0	53
24314	54	0	0	0	0	54
24315	0	0	52	0	0	52
24316	55	0	0	0	0	55
24317	56	0	0	0	0	56
24318	0	48	0	0	0	48
24319	0	57	0	0	0	57
24320	57	0	0	0	0	57
24321	57	0	0	0	0	57
24322	59	0	0	0	0	59
24323	56	0	0	0	0	56
24324	59	0	0	0	0	59
24325	0	0	0	54	0	54
24326	0	0	0	58	0	58
24327	0	0	57	0	0	57
24328	59	0	0	0	0	59
24329	0	0	0	54	0	54
24330	0	0	0	52	0	52
24331	0	0	53	0	0	53
24332	0	44	0	0	0	44
24333	0	52	0	0	0	52
24334	52	0	0	0	0	52
24335	52	0	0	0	0	52
24336	1	40	0	0	0	41
24337	0	50	0	0	0	50
24338	51	0	0	0	0	51
24339	51	0	0	0	0	51
24340	0	0	0	48	0	48
24341	0	0	0	49	0	49
24342	0	0	0	50	0	50
24343	47	0	0	0	0	47
24344	48	0	0	0	0	48
24345	0	0	0	51	0	51
24346	48	0	0	0	0	48
24347	0	0	55	0	0	55
24348	0	0	0	53	0	53
24349	0	0	55	0	0	55
24350	0	52	0	0	0	52
24351	0	0	0	53	0	53
24352	51	0	0	0	0	51
24353	0	0	0	50	0	50
24354	0	0	0	52	0	52
24355	1	0	47	0	0	48
24356	0	0	43	0	0	43
24357	0	51	0	0	0	51
24358	54	0	0	0	0	54
24359	51	0	0	1	0	52
24360	50	0	0	0	0	50
24361	50	0	0	0	0	50
24362	0	0	0	50	0	50
24363	0	0	0	51	0	51
24364	0	48	0	0	0	48
24365	51	0	0	0	0	51
24366	48	0	0	0	0	48
24367	0	0	40	0	0	40
24368	38	0	0	0	0	38
24369	0	39	0	0	0	39
24370	0	0	0	42	0	42
24371	0	39	0	0	0	39
24372	42	0	0	0	0	42
24373	0	42	0	0	0	42
24374	0	0	0	42	0	42
24375	0	0	0	41	0	41
24376	0	0	0	39	0	39
24377	0	44	0	0	0	44
24378	0	0	0	43	0	43
24379	0	0	0	44	0	44
24380	0	42	0	0	0	42
24381	0	45	0	0	0	45
24382	42	0	0	0	0	42
24383	0	45	0	0	0	45
24384	45	0	0	0	0	45
24385	0	0	41	0	0	41
24386	0	41	0	0	0	41
24387	42	0	0	0	0	42
24388	41	0	0	0	0	41
24389	0	0	41	0	0	41
24390	0	0	0	42	0	42
24391	0	0	40	0	0	40
24392	0	40	0	0	0	40
24393	43	0	0	0	0	43
24394	0	42	1	0	0	43
24395	0	0	0	44	0	44
24396	0	0	0	41	0	41
24397	0	0	44	0	0	44
24398	0	0	44	0	0	44
24399	50	0	0	0	0	50
24400	49	0	0	0	0	49
24401	49	0	0	0	0	49
24402	49	0	0	0	0	49
24403	0	52	0	0	0	52
24404	1	0	0	50	0	51
24405	0	0	0	50	0	50
24406	0	49	0	0	0	49
24407	51	0	0	0	0	51
24408	49	0	0	0	0	49
24409	0	0	48	0	0	48
24410	50	0	0	0	0	50
24411	0	0	0	51	0	51
24412	0	0	45	0	0	45
24413	0	0	0	45	0	45
24414	0	0	46	0	0	46
24415	0	0	42	0	0	42
24416	0	0	0	44	0	44
24417	0	46	0	0	0	46
24418	49	0	0	0	0	49
24419	45	0	0	0	0	45
24420	0	42	0	0	0	42
24421	0	45	0	0	0	45
24422	49	0	0	0	0	49
24423	47	0	0	0	0	47
24424	48	0	0	0	0	48
24425	44	0	0	0	0	44
24426	0	0	0	49	0	49
24427	0	0	46	0	0	46
24428	0	47	0	2	0	49
24429	47	0	0	0	0	47
24430	0	50	0	0	0	50
24431	49	0	0	0	0	49
24432	49	0	0	0	0	49
24433	0	0	47	0	0	47
24434	0	49	0	0	0	49
24435	0	0	0	49	0	49
24436	0	0	0	49	0	49
24437	0	0	0	49	0	49
24438	48	0	0	0	0	48
24439	49	0	0	0	0	49
24440	43	0	0	0	0	43
24441	0	44	0	0	0	44
24442	41	0	0	0	0	41
24443	0	42	0	0	0	42
24444	0	0	40	0	0	40
24445	0	43	0	0	0	43
24446	0	0	0	45	0	45
24447	0	0	0	44	0	44
24448	0	0	44	0	0	44
24449	0	0	0	40	0	40
24450	0	0	0	43	0	43
24451	44	0	0	0	0	44
24452	39	0	0	0	0	39
24453	42	0	0	0	0	42
24454	0	42	0	0	0	42
24455	41	0	0	0	0	41
24456	42	0	0	0	0	42
24457	0	40	0	0	0	40
24458	0	0	0	42	0	42
24459	0	0	0	41	0	41
24460	40	0	0	0	0	40
24461	0	0	39	0	0	39
24462	0	45	0	0	0	45
24463	0	0	0	45	0	45
24464	0	40	0	0	0	40
24465	0	47	0	0	0	47
24466	49	0	0	0	0	49
24467	49	0	0	0	0	49
24468	0	0	0	48	0	48
24469	0	0	0	49	0	49
24470	0	0	0	49	0	49
24471	0	0	0	49	0	49
24472	0	0	43	0	0	43
24473	0	0	32	0	0	32
24474	0	0	0	46	0	46
24475	0	0	44	0	0	44
24476	0	45	0	0	0	45
24477	43	0	0	0	0	43
24478	45	0	0	0	0	45
24479	0	0	0	44	0	44
24480	0	0	0	44	0	44
24481	0	0	0	45	0	45
24482	0	45	0	0	0	45
24483	43	0	0	0	0	43
24484	44	0	0	0	0	44
24485	0	0	44	0	0	44
24486	0	0	0	44	0	44
24487	0	0	44	0	0	44
24488	0	0	0	40	0	40
24489	0	0	0	40	0	40
24490	0	0	0	37	0	37
24491	0	0	0	37	0	37
24492	34	0	0	0	0	34
24493	35	0	0	0	0	35
24494	35	0	0	0	0	35
24495	0	0	0	33	0	33
24496	0	0	35	0	0	35
24497	34	0	0	0	0	34
24498	0	0	0	35	0	35
24499	36	0	0	0	0	36
24500	0	0	0	36	0	36
24501	0	35	0	0	0	35
24502	0	35	0	0	0	35
24503	0	0	0	36	0	36
24504	0	0	0	35	0	35
24505	0	0	0	34	0	34
24506	0	35	0	0	0	35
24507	34	0	0	0	0	34
24508	0	32	0	0	0	32
24509	0	0	33	0	0	33
24510	0	0	0	33	0	33
24511	0	40	0	0	0	40
24512	0	0	0	40	0	40
24513	0	0	0	37	0	37
24514	0	0	38	0	0	38
24515	33	0	0	0	0	33
24516	0	37	0	0	0	37
24517	36	0	0	0	0	36
24518	37	0	0	0	0	37
24519	38	0	0	0	0	38
24520	0	0	39	0	0	39
24521	0	0	0	42	0	42
24522	0	0	0	45	0	45
24523	0	0	48	0	0	48
24524	46	0	0	0	0	46
24525	0	0	46	0	0	46
24526	0	0	47	0	0	47
24527	0	44	0	0	0	44
24528	0	0	0	45	0	45
24529	0	0	51	0	0	51
24530	51	0	0	0	0	51
24531	50	0	0	0	0	50
24532	0	0	52	0	0	52
24533	0	0	0	53	0	53
24534	0	0	53	0	0	53
24535	0	52	0	0	0	52
24536	51	0	0	0	0	51
24537	54	0	0	0	0	54
24538	50	0	0	0	0	50
24539	0	0	0	51	0	51
24540	0	0	0	50	0	50
24541	0	0	52	0	0	52
24542	52	0	0	0	0	52
24543	0	0	0	50	0	50
24544	54	0	0	0	0	54
24545	0	0	52	0	0	52
24546	0	0	50	0	0	50
24547	0	0	0	49	0	49
24548	0	0	0	51	0	51
24549	0	0	52	0	0	52
24550	52	0	0	0	0	52
24551	0	0	0	51	0	51
24552	0	50	0	0	0	50
24553	52	0	0	0	0	52
24554	0	52	0	0	0	52
24555	52	0	0	0	0	52
24556	0	0	51	0	0	51
24557	0	0	45	0	0	45
24558	0	42	0	0	0	42
24559	46	0	0	0	0	46
24560	0	0	45	0	0	45
24561	43	0	0	0	0	43
24562	0	45	0	0	0	45
24563	0	0	0	47	0	47
24564	0	0	0	47	0	47
24565	0	48	0	0	0	48
24566	47	0	0	0	0	47
24567	47	0	0	0	0	47
24568	49	0	0	0	0	49
24569	0	0	46	0	0	46
24570	0	0	0	48	0	48
24571	0	0	0	46	0	46
24572	0	0	0	51	0	51
24573	0	0	48	0	0	48
24574	0	49	0	0	0	49
24575	46	0	0	0	0	46
24576	0	0	49	0	0	49
24577	48	0	0	0	0	48
24578	0	48	0	0	0	48
24579	49	0	0	0	0	49
24580	0	0	0	51	0	51
24581	51	0	0	0	0	51
24582	0	0	0	52	0	52
24583	0	0	51	0	0	51
24584	0	0	0	51	0	51
24585	0	0	52	0	0	52
24586	49	0	0	0	0	49
24587	0	49	0	0	0	49
24588	0	0	0	49	0	49
24589	0	50	0	0	0	50
24590	51	0	0	0	0	51
24591	49	0	0	0	0	49
24592	0	47	0	0	0	47
24593	47	0	0	0	0	47
24594	44	0	0	0	0	44
24595	0	0	0	45	0	45
24596	0	0	0	44	0	44
24597	49	0	0	0	0	49
24598	49	0	0	0	0	49
24599	0	0	0	48	0	48
24600	0	0	0	48	0	48
24601	49	0	0	0	0	49
24602	0	0	50	0	0	50
24603	46	0	0	0	0	46
24604	0	0	42	0	0	42
24605	0	43	0	0	0	43
24606	0	0	0	41	0	41
24607	0	0	43	0	0	43
24608	0	41	0	0	0	41
24609	43	0	0	0	0	43
24610	0	0	41	0	0	41
24611	43	0	0	0	0	43
24612	44	0	0	0	0	44
24613	42	0	0	0	0	42
24614	0	0	0	39	0	39
24615	0	37	0	0	0	37
24616	38	0	0	0	0	38
24617	0	0	39	0	0	39
24618	33	0	0	0	0	33
24619	0	0	39	0	0	39
24620	0	38	0	0	0	38
24621	0	0	0	40	0	40
24622	0	0	0	33	0	33
24623	0	36	0	0	0	36
24624	0	0	0	38	0	38
24625	0	0	38	0	0	38
24626	0	38	0	0	0	38
24627	0	0	1	36	0	37
24628	39	0	0	0	0	39
24629	43	0	0	0	0	43
24630	0	0	0	43	0	43
24631	0	40	0	0	0	40
24632	0	0	0	44	0	44
24633	0	0	0	45	0	45
24634	0	0	43	0	0	43
24635	0	43	0	0	0	43
24636	3	0	0	44	0	47
24637	0	0	44	0	0	44
24638	0	42	0	3	0	45
24639	0	0	0	45	0	45
24640	49	0	0	0	0	49
24641	0	49	0	0	0	49
24642	0	0	0	45	0	45
24643	46	0	0	0	0	46
24644	43	0	0	0	0	43
24645	45	0	0	0	0	45
24646	43	0	0	0	0	43
24647	0	0	0	49	0	49
24648	0	0	47	0	0	47
24649	0	0	0	46	0	46
24650	0	43	0	0	0	43
24651	44	0	0	0	0	44
24652	0	0	44	0	0	44
24653	49	0	0	0	0	49
24654	0	0	50	0	0	50
24655	0	0	0	50	0	50
24656	0	0	46	0	0	46
24657	0	0	0	46	0	46
24658	0	0	46	0	0	46
24659	0	0	0	46	0	46
24660	43	0	0	0	0	43
24661	0	47	0	0	0	47
24662	0	0	0	48	0	48
24663	0	0	0	45	0	45
24664	0	0	46	0	0	46
24665	0	0	41	0	0	41
24666	44	0	0	0	0	44
24667	0	46	0	0	0	46
24668	44	0	0	0	0	44
24669	44	0	0	0	0	44
24670	0	0	0	43	0	43
24671	0	45	0	0	0	45
24672	47	0	0	0	0	47
24673	45	0	0	0	0	45
24674	47	0	0	0	0	47
24675	48	0	0	0	0	48
24676	49	0	0	0	0	49
24677	0	0	46	0	0	46
24678	47	0	0	0	0	47
24679	0	0	46	0	0	46
24680	0	0	0	47	0	47
24681	0	0	0	51	0	51
24682	0	0	45	0	0	45
24683	55	0	0	0	0	55
24684	1	0	0	51	0	52
24685	0	0	0	50	0	50
24686	0	0	0	52	0	52
24687	0	0	0	53	0	53
24688	0	0	0	51	0	51
24689	0	0	46	0	0	46
24690	0	0	0	49	0	49
24691	0	0	49	0	0	49
24692	0	0	49	0	0	49
24693	50	0	0	1	0	51
24694	50	0	0	0	0	50
24695	50	0	0	0	0	50
24696	0	0	50	0	0	50
24697	0	0	48	0	0	48
24698	1	0	50	0	0	51
24699	0	50	0	0	0	50
24700	0	0	0	54	0	54
24701	55	0	0	0	0	55
24702	1	0	0	53	0	54
24703	0	55	0	0	0	55
24704	55	0	0	0	0	55
24705	0	0	0	56	0	56
24706	0	53	0	0	0	53
24707	0	0	0	56	0	56
24708	0	0	0	56	0	56
24709	57	0	0	0	0	57
24710	0	0	0	53	0	53
24711	0	0	52	0	0	52
24712	1	0	0	49	0	50
24713	0	48	0	0	0	48
24714	0	51	0	0	0	51
24715	0	0	0	52	0	52
24716	0	0	0	52	0	52
24717	0	41	0	0	0	41
24718	0	38	0	1	0	39
24719	0	41	0	0	0	41
24720	0	0	0	45	0	45
24721	0	45	0	0	0	45
24722	43	0	0	0	0	43
24723	0	0	42	0	0	42
24724	0	0	0	43	0	43
24725	0	42	0	0	0	42
24726	42	0	0	0	0	42
24727	0	0	41	0	0	41
24728	0	40	0	0	0	40
24729	40	0	0	0	0	40
24730	0	39	0	0	0	39
24731	0	39	0	0	0	39
24732	0	0	0	40	0	40
24733	0	37	0	0	0	37
24734	42	0	0	0	0	42
24735	0	0	0	40	0	40
24736	0	0	38	0	0	38
24737	0	0	38	0	0	38
24738	0	0	0	38	0	38
24739	0	0	37	0	0	37
24740	0	0	0	38	0	38
24741	38	0	0	0	0	38
24742	0	0	35	0	0	35
24743	0	0	0	37	0	37
24744	0	40	0	0	0	40
24745	0	0	0	42	0	42
24746	0	0	0	37	0	37
24747	0	41	0	0	0	41
24748	0	0	0	40	0	40
24749	0	0	0	39	0	39
24750	0	0	40	0	0	40
24751	0	40	0	0	0	40
24752	40	0	0	0	0	40
24753	1	0	0	40	0	41
24754	0	0	40	0	0	40
24755	0	0	0	41	0	41
24756	0	0	39	1	0	40
24757	37	0	0	0	0	37
24758	0	41	0	1	0	42
24759	0	0	0	39	0	39
24760	0	0	0	37	0	37
24761	36	0	0	0	0	36
24762	0	0	0	39	0	39
24763	0	0	38	0	0	38
24764	0	0	0	35	0	35
24765	0	35	0	0	0	35
24766	0	34	0	0	0	34
24767	0	34	0	0	0	34
24768	0	0	0	34	0	34
24769	0	0	32	0	0	32
24770	0	34	0	0	0	34
24771	35	0	0	0	0	35
24772	0	35	0	0	0	35
24773	35	0	0	0	0	35
24774	35	0	0	0	0	35
24775	0	0	36	0	0	36
24776	31	0	0	0	0	31
24777	34	0	0	0	0	34
24778	32	0	0	0	0	32
24779	34	0	0	0	0	34
24780	0	0	37	0	0	37
24781	39	0	0	0	0	39
24782	40	1	0	0	0	41
24783	0	43	0	0	0	43
24784	0	0	0	39	0	39
24785	0	0	0	37	0	37
24786	0	40	0	0	0	40
24787	37	1	0	0	0	38
24788	0	40	0	0	0	40
24789	39	0	0	0	0	39
24790	39	0	0	0	0	39
24791	0	38	0	0	0	38
24792	0	0	0	38	0	38
24793	0	0	39	0	0	39
24794	0	41	0	0	0	41
24795	0	0	0	44	0	44
24796	0	41	0	1	0	42
24797	0	44	0	0	0	44
24798	0	0	0	45	0	45
24799	0	0	47	0	0	47
24800	0	41	0	0	0	41
24801	0	46	0	0	0	46
24802	45	0	0	0	0	45
24803	0	0	0	42	0	42
24804	0	0	0	47	0	47
24805	0	0	0	46	0	46
24806	0	0	47	0	0	47
24807	0	0	0	46	0	46
24808	0	49	0	0	0	49
24809	49	0	0	0	0	49
24810	0	0	0	50	0	50
24811	0	0	47	0	0	47
24812	50	0	0	0	0	50
24813	0	0	0	50	0	50
24814	0	0	51	0	0	51
24815	0	0	49	0	0	49
24816	49	0	0	0	0	49
24817	52	0	0	0	0	52
24818	51	0	0	0	0	51
24819	51	0	0	0	0	51
24820	0	0	50	0	0	50
24821	0	52	0	0	0	52
24822	53	0	0	0	0	53
24823	0	52	0	0	0	52
24824	53	0	0	0	0	53
24825	0	51	0	0	0	51
24826	0	0	0	51	0	51
24827	0	0	0	54	0	54
24828	0	0	0	54	0	54
24829	0	50	0	0	0	50
24830	0	52	0	0	0	52
24831	0	0	0	53	0	53
24832	0	53	0	0	0	53
24833	0	0	49	0	0	49
24834	0	0	0	55	0	55
24835	0	0	53	0	0	53
24836	55	0	0	0	0	55
24837	51	0	0	0	0	51
24838	0	0	50	0	0	50
24839	0	0	49	0	0	49
24840	0	0	0	46	0	46
24841	0	0	46	0	0	46
24842	0	0	0	47	0	47
24843	0	40	0	0	0	40
24844	0	0	0	46	0	46
24845	0	0	0	46	0	46
24846	0	0	0	47	0	47
24847	0	0	47	0	0	47
24848	0	0	0	46	0	46
24849	0	0	0	45	0	45
24850	0	0	0	47	0	47
24851	0	46	0	0	0	46
24852	46	0	0	0	0	46
24853	44	0	0	0	0	44
24854	44	0	0	0	0	44
24855	0	0	0	46	0	46
24856	0	0	44	0	0	44
24857	0	0	39	0	0	39
24858	0	44	0	0	0	44
24859	49	0	0	0	0	49
24860	0	48	0	1	0	49
24861	46	0	0	1	0	47
24862	0	48	0	0	0	48
24863	49	0	0	0	0	49
24864	0	47	0	0	0	47
24865	0	0	0	48	0	48
24866	0	0	45	0	0	45
24867	0	0	44	0	0	44
24868	0	0	0	47	0	47
24869	0	0	0	49	0	49
24870	0	0	0	49	0	49
24871	0	0	49	0	0	49
24872	0	0	0	46	0	46
24873	41	0	0	0	0	41
24874	45	0	0	1	0	46
24875	0	46	0	0	0	46
24876	43	0	0	0	0	43
24877	0	40	0	0	0	40
24878	45	0	0	0	0	45
24879	42	0	0	0	0	42
24880	43	0	0	0	0	43
24881	0	0	43	0	0	43
24882	0	0	45	0	0	45
24883	48	0	0	0	0	48
24884	53	0	0	0	0	53
24885	0	0	0	50	0	50
24886	0	0	0	51	0	51
24887	0	0	0	51	0	51
24888	0	0	0	51	0	51
24889	0	0	0	52	0	52
24890	47	0	0	0	0	47
24891	0	0	0	51	0	51
24892	0	0	47	0	0	47
24893	47	0	0	0	0	47
24894	47	0	0	0	0	47
24895	0	47	0	0	0	47
24896	0	47	0	0	0	47
24897	50	0	0	0	0	50
24898	0	47	0	0	0	47
24899	50	0	0	0	0	50
24900	48	0	0	0	0	48
24901	49	0	0	0	0	49
24902	0	0	0	48	0	48
24903	1	51	0	0	0	52
24904	52	0	1	0	0	53
24905	0	0	0	53	0	53
24906	0	0	0	52	0	52
24907	49	0	0	0	0	49
24908	0	51	0	0	0	51
24909	0	0	0	50	0	50
24910	49	0	0	0	0	49
24911	0	50	0	0	0	50
24912	55	0	0	0	0	55
24913	0	0	48	0	0	48
24914	53	0	0	0	0	53
24915	0	52	0	0	0	52
24916	54	0	0	0	0	54
24917	53	0	0	0	0	53
24918	0	53	0	0	0	53
24919	48	0	0	0	0	48
24920	0	51	0	0	0	51
24921	53	0	0	0	0	53
24922	0	0	0	53	0	53
24923	0	0	0	51	0	51
24924	0	0	0	56	0	56
24925	0	0	55	0	0	55
24926	0	0	0	51	0	51
24927	0	0	54	0	0	54
24928	1	0	0	54	0	55
24929	0	54	0	0	0	54
24930	0	0	0	53	0	53
24931	0	0	53	0	0	53
24932	0	0	54	0	0	54
24933	0	0	0	59	0	59
24934	60	0	0	0	0	60
24935	58	0	0	0	0	58
24936	0	58	0	0	0	58
24937	0	0	0	59	0	59
24938	0	0	56	1	0	57
24939	0	0	0	58	0	58
24940	0	0	58	0	0	58
24941	60	0	0	0	0	60
24942	0	0	0	59	0	59
24943	0	0	64	0	0	64
24944	0	0	1	60	0	61
24945	0	0	0	67	0	67
24946	0	0	68	0	0	68
24947	0	0	0	66	0	66
24948	64	0	0	0	0	64
24949	64	0	0	0	0	64
24950	0	0	0	65	0	65
24951	66	0	0	0	0	66
24952	0	0	61	0	0	61
24953	0	0	63	0	0	63
24954	65	0	0	0	0	65
24955	64	0	0	0	0	64
24956	0	0	0	65	0	65
24957	0	0	0	64	0	64
24958	0	0	65	0	0	65
24959	1	0	0	57	0	58
24960	0	63	0	0	0	63
24961	60	3	0	0	0	63
24962	61	0	0	0	0	61
24963	0	65	0	0	0	65
24964	66	0	0	0	0	66
24965	67	0	0	0	0	67
24966	0	66	0	0	0	66
24967	65	0	0	0	0	65
24968	0	63	0	0	0	63
24969	66	0	0	0	0	66
24970	0	0	62	0	0	62
24971	0	0	0	60	0	60
24972	0	0	0	65	0	65
24973	0	0	0	66	0	66
24974	64	0	0	0	0	64
24975	0	0	0	62	0	62
24976	0	0	58	0	0	58
24977	54	0	0	0	0	54
24978	0	0	0	57	0	57
24979	0	50	0	0	0	50
24980	0	54	0	1	0	55
24981	0	0	0	56	0	56
24982	0	0	0	57	0	57
24983	0	0	0	57	0	57
24984	0	0	55	0	0	55
24985	0	54	0	1	0	55
24986	58	0	0	0	0	58
24987	54	0	0	0	0	54
24988	0	52	0	0	0	52
24989	0	51	0	1	0	52
24990	0	0	0	55	0	55
24991	0	0	57	0	0	57
24992	55	0	0	0	0	55
24993	54	0	0	0	0	54
24994	0	0	0	54	0	54
24995	0	0	0	55	0	55
24996	53	0	0	0	0	53
24997	0	0	49	0	0	49
24998	49	0	0	0	0	49
24999	0	51	0	0	0	51
25000	0	0	0	53	0	53
25001	0	53	0	0	0	53
25002	54	0	0	0	0	54
25003	0	0	0	53	0	53
25004	0	0	0	55	0	55
25005	0	52	0	0	0	52
25006	57	0	0	0	0	57
25007	58	0	0	0	0	58
25008	0	0	55	0	0	55
25009	0	0	49	0	0	49
25010	55	0	0	0	0	55
25011	0	0	53	0	0	53
25012	0	0	54	0	0	54
25013	55	0	0	1	0	56
25014	0	0	52	0	0	52
25015	0	0	1	53	0	54
25016	0	0	0	55	0	55
25017	52	0	0	0	0	52
25018	0	1	46	0	0	47
25019	52	0	0	0	0	52
25020	0	0	0	52	0	52
25021	53	0	0	0	0	53
25022	50	0	0	0	0	50
25023	51	0	0	0	0	51
25024	0	0	0	52	0	52
25025	47	0	0	0	0	47
25026	0	0	0	49	0	49
25027	0	0	0	51	0	51
25028	0	0	0	51	0	51
25029	0	0	0	51	0	51
25030	48	0	0	0	0	48
25031	51	0	0	0	0	51
25032	0	0	49	0	0	49
25033	46	0	0	0	0	46
25034	50	0	0	0	0	50
25035	0	0	0	49	0	49
25036	0	45	0	0	0	45
25037	47	0	0	0	0	47
25038	0	0	0	45	0	45
25039	47	0	0	0	0	47
25040	0	47	0	0	0	47
25041	51	0	0	0	0	51
25042	0	0	0	55	0	55
25043	0	51	0	0	0	51
25044	49	0	0	0	0	49
25045	0	47	0	0	0	47
25046	0	52	0	0	0	52
25047	53	0	0	0	0	53
25048	0	0	52	0	0	52
25049	53	0	0	0	0	53
25050	0	0	0	52	0	52
25051	1	0	52	0	0	53
25052	0	0	0	54	0	54
25053	0	0	0	56	0	56
25054	0	0	54	0	0	54
25055	56	0	0	0	0	56
25056	0	0	0	56	0	56
25057	0	0	0	53	0	53
25058	0	0	0	55	0	55
25059	57	0	0	0	0	57
25060	0	0	51	0	0	51
25061	0	0	46	0	0	46
25062	0	0	0	53	0	53
25063	0	0	55	0	0	55
25064	54	0	0	0	0	54
25065	0	52	0	0	0	52
25066	55	0	0	0	0	55
25067	0	0	0	55	0	55
25068	0	53	0	0	0	53
25069	0	0	0	56	0	56
25070	0	56	0	0	0	56
25071	0	0	0	55	0	55
25072	0	0	53	0	0	53
25073	0	0	50	0	0	50
25074	0	55	0	0	0	55
25075	55	0	0	0	0	55
25076	0	0	0	55	0	55
25077	0	0	0	53	0	53
25078	52	0	0	0	0	52
25079	53	0	0	0	0	53
25080	0	0	0	57	0	57
25081	0	0	54	0	0	54
25082	0	53	0	0	0	53
25083	0	0	2	52	0	54
25084	0	0	0	53	0	53
25085	2	48	0	0	0	50
25086	51	0	0	0	0	51
25087	0	0	49	0	0	49
25088	0	0	0	52	0	52
25089	0	0	0	52	0	52
25090	0	0	55	0	0	55
25091	0	0	0	55	0	55
25092	55	0	0	0	0	55
25093	53	0	0	0	0	53
25094	50	3	0	0	0	53
25095	0	48	0	3	0	51
25096	49	0	0	0	0	49
25097	0	0	0	56	0	56
25098	0	0	0	55	0	55
25099	0	49	0	0	0	49
25100	52	0	0	0	0	52
25101	50	0	0	0	0	50
25102	49	0	0	0	0	49
25103	51	0	0	0	0	51
25104	53	0	0	0	0	53
25105	0	0	53	0	0	53
25106	52	0	0	0	0	52
25107	53	0	0	0	0	53
25108	50	0	0	0	0	50
25109	1	0	0	52	0	53
25110	0	0	0	53	0	53
25111	0	0	51	0	0	51
25112	49	0	0	0	0	49
25113	0	47	0	0	0	47
25114	0	48	0	0	0	48
25115	0	0	50	0	0	50
25116	0	49	0	0	0	49
25117	0	50	0	0	0	50
25118	0	0	0	51	0	51
25119	0	54	0	0	0	54
25120	53	0	0	0	0	53
25121	52	0	0	1	0	53
25122	0	0	0	52	0	52
25123	0	0	52	0	0	52
25124	51	0	0	0	0	51
25125	0	0	47	0	0	47
25126	0	0	48	0	0	48
25127	0	0	0	49	0	49
25128	0	0	0	49	0	49
25129	0	0	49	0	0	49
25130	0	48	0	0	0	48
25131	0	52	0	0	0	52
25132	50	0	0	0	0	50
25133	54	0	0	0	0	54
25134	0	0	52	0	0	52
25135	51	0	0	0	0	51
25136	47	0	0	0	0	47
25137	0	0	0	45	0	45
25138	0	0	0	47	0	47
25139	0	0	0	52	0	52
25140	51	0	0	0	0	51
25141	56	0	0	0	0	56
25142	58	0	0	0	0	58
25143	0	0	0	57	0	57
25144	0	0	53	0	0	53
25145	52	0	0	0	0	52
25146	52	0	0	0	0	52
25147	0	0	0	50	0	50
25148	0	46	0	0	0	46
25149	0	0	0	51	0	51
25150	0	49	0	0	0	49
25151	0	0	0	51	0	51
25152	0	52	0	0	0	52
25153	52	0	0	0	0	52
25154	0	0	0	53	0	53
25155	0	53	0	0	0	53
25156	0	0	51	0	0	51
25157	54	0	0	0	0	54
25158	0	0	0	52	0	52
25159	0	51	0	0	0	51
25160	0	0	0	51	0	51
25161	0	46	0	0	0	46
25162	0	47	0	0	0	47
25163	48	0	0	0	0	48
25164	48	0	0	0	0	48
25165	0	1	46	0	0	47
25166	46	0	0	0	0	46
25167	45	0	0	0	0	45
25168	0	47	0	0	0	47
25169	0	0	0	46	0	46
25170	0	0	0	49	0	49
25171	0	0	47	0	0	47
25172	0	0	48	0	0	48
25173	51	0	0	0	0	51
25174	50	0	0	0	0	50
25175	51	0	0	0	0	51
25176	0	0	50	0	0	50
25177	0	0	0	50	0	50
25178	52	0	0	0	0	52
25179	0	0	0	53	0	53
25180	0	0	49	0	0	49
25181	50	0	0	0	0	50
25182	0	0	47	0	0	47
25183	0	46	0	0	0	46
25184	48	0	0	0	0	48
25185	0	0	44	0	0	44
25186	0	0	0	43	0	43
25187	46	0	0	0	0	46
25188	0	0	0	45	0	45
25189	46	0	0	0	0	46
25190	0	0	0	45	0	45
25191	45	0	0	0	0	45
25192	44	0	0	0	0	44
25193	46	0	0	0	0	46
25194	42	0	0	0	0	42
25195	0	0	0	42	0	42
25196	0	0	38	0	0	38
25197	0	0	38	0	0	38
25198	0	35	0	0	0	35
25199	0	39	0	0	0	39
25200	43	0	0	0	0	43
25201	1	0	0	44	0	45
25202	0	0	44	0	0	44
25203	0	0	42	1	0	43
25204	0	0	0	44	0	44
25205	44	0	0	0	0	44
25206	0	46	0	0	0	46
25207	44	0	0	0	0	44
25208	0	0	0	44	0	44
25209	0	0	0	44	0	44
25210	0	0	0	42	0	42
25211	0	0	43	0	0	43
25212	0	0	39	0	0	39
25213	0	40	0	0	0	40
25214	0	0	0	44	0	44
25215	45	0	0	0	0	45
25216	0	0	41	0	0	41
25217	0	0	42	0	0	42
25218	0	0	0	47	0	47
25219	0	0	0	50	0	50
25220	1	0	0	47	0	48
25221	0	0	0	48	0	48
25222	50	0	0	0	0	50
25223	0	0	0	49	0	49
25224	50	0	0	0	0	50
25225	0	0	54	0	0	54
25226	0	49	0	0	0	49
25227	0	0	0	53	0	53
25228	0	0	51	0	0	51
25229	0	0	47	0	0	47
25230	0	56	0	0	0	56
25231	0	0	0	56	0	56
25232	0	0	0	56	0	56
25233	0	0	54	0	0	54
25234	50	0	0	0	0	50
25235	0	0	0	47	0	47
25236	0	0	0	48	0	48
25237	0	0	45	0	0	45
25238	0	42	0	0	0	42
25239	0	47	0	0	0	47
25240	48	0	0	0	0	48
25241	0	0	0	46	0	46
25242	46	0	0	0	0	46
25243	0	0	50	0	0	50
25244	0	0	0	48	0	48
25245	46	0	0	0	0	46
25246	50	0	0	0	0	50
25247	0	1	0	47	0	48
25248	1	0	45	1	0	47
25249	0	0	46	0	0	46
25250	0	0	0	51	0	51
25251	0	0	49	1	0	50
25252	49	0	0	1	0	50
25253	1	48	0	0	0	49
25254	52	0	0	0	0	52
25255	48	0	0	0	0	48
25256	0	0	0	49	0	49
25257	0	0	0	51	0	51
25258	52	0	0	0	0	52
25259	0	0	0	53	0	53
25260	0	0	51	1	0	52
25261	0	53	0	0	0	53
25262	0	0	0	54	0	54
25263	0	0	0	54	0	54
25264	0	0	0	55	0	55
25265	0	0	51	0	0	51
25266	0	52	0	0	0	52
25267	0	0	0	53	0	53
25268	0	0	51	0	0	51
25269	0	0	0	54	0	54
25270	54	0	0	0	0	54
25271	0	0	0	53	0	53
25272	0	0	55	0	0	55
25273	55	0	0	2	0	57
25274	0	55	0	0	0	55
25275	0	55	0	1	0	56
25276	54	0	0	0	0	54
25277	0	0	52	0	0	52
25278	0	0	0	52	0	52
25279	0	0	0	57	0	57
25280	0	0	54	0	0	54
25281	0	53	0	0	0	53
25282	0	0	0	57	0	57
25283	0	0	58	0	0	58
25284	0	0	1	57	0	58
25285	55	0	0	0	0	55
25286	0	0	59	0	0	59
25287	0	0	0	58	0	58
25288	0	0	0	58	0	58
25289	0	0	52	0	0	52
25290	0	0	0	53	0	53
25291	0	53	0	0	0	53
25292	0	0	0	52	0	52
25293	0	48	0	0	0	48
25294	54	0	0	0	0	54
25295	51	0	0	0	0	51
25296	0	0	49	0	0	49
25297	0	0	45	0	0	45
25298	0	0	44	0	0	44
25299	0	49	0	0	0	49
25300	0	0	0	46	0	46
25301	0	0	49	0	0	49
25302	0	0	0	50	0	50
25303	0	0	0	48	0	48
25304	0	0	48	0	0	48
25305	0	0	0	48	0	48
25306	0	0	0	47	0	47
25307	0	44	0	0	0	44
25308	0	0	0	48	0	48
25309	0	0	0	50	0	50
25310	0	0	44	0	0	44
25311	0	0	0	46	0	46
25312	0	0	45	0	0	45
25313	0	0	43	0	0	43
25314	43	0	0	0	0	43
25315	0	0	0	42	0	42
25316	0	44	0	0	0	44
25317	0	42	0	0	0	42
25318	0	0	0	39	0	39
25319	0	0	38	0	0	38
25320	0	38	0	0	0	38
25321	0	0	0	42	0	42
25322	0	0	40	0	0	40
25323	0	44	0	0	0	44
25324	45	0	0	0	0	45
25325	43	0	0	0	0	43
25326	44	0	0	0	0	44
25327	0	0	0	46	0	46
25328	0	0	0	47	0	47
25329	0	0	0	46	0	46
25330	0	0	46	0	0	46
25331	47	0	0	0	0	47
25332	0	0	0	46	0	46
25333	0	0	45	0	0	45
25334	45	0	0	0	0	45
25335	46	0	0	0	0	46
25336	0	1	37	0	0	38
25337	46	0	0	0	0	46
25338	0	48	0	0	0	48
25339	0	0	49	0	0	49
25340	48	0	0	0	0	48
25341	0	52	0	0	0	52
25342	0	0	0	48	0	48
25343	0	49	0	0	0	49
25344	0	0	0	53	0	53
25345	0	0	51	0	0	51
25346	54	0	0	0	0	54
25347	0	0	54	0	0	54
25348	1	55	0	0	0	56
25349	0	54	0	0	0	54
25350	53	0	0	0	0	53
25351	0	0	55	0	0	55
25352	0	0	0	53	0	53
25353	0	0	56	0	0	56
25354	0	52	0	0	0	52
25355	1	0	0	53	0	54
25356	0	51	0	0	0	51
25357	54	0	0	0	0	54
25358	54	0	0	0	0	54
25359	53	0	0	0	0	53
25360	0	0	52	0	0	52
25361	1	0	51	0	0	52
25362	52	0	0	0	0	52
25363	0	0	51	0	0	51
25364	0	0	0	50	0	50
25365	0	49	0	0	0	49
25366	53	0	0	1	0	54
25367	53	0	0	0	0	53
25368	54	0	0	0	0	54
25369	1	0	0	53	0	54
25370	0	0	0	53	0	53
25371	55	0	0	0	0	55
25372	0	53	0	0	0	53
25373	53	0	0	0	0	53
25374	0	0	0	54	0	54
25375	1	0	0	52	0	53
25376	52	0	0	0	0	52
25377	0	53	0	0	0	53
25378	56	0	0	0	0	56
25379	0	53	0	0	0	53
25380	55	0	0	0	0	55
25381	0	0	0	61	0	61
25382	61	0	0	0	0	61
25383	61	0	0	0	0	61
25384	56	0	0	0	0	56
25385	0	58	0	0	0	58
25386	0	0	58	0	0	58
25387	62	0	0	0	0	62
25388	64	0	0	0	0	64
25389	0	64	0	0	0	64
25390	0	0	0	73	0	73
25391	0	0	0	75	0	75
25392	73	0	0	1	0	74
25393	0	0	0	73	0	73
25394	0	0	69	0	0	69
25395	0	0	66	1	0	67
25396	72	0	0	0	0	72
25397	0	0	0	69	0	69
25398	0	0	0	75	0	75
25399	0	0	0	71	0	71
25400	0	0	74	0	0	74
25401	0	0	0	72	0	72
25402	0	0	0	72	0	72
25403	0	0	0	74	0	74
25404	73	0	0	0	0	73
25405	0	0	0	75	0	75
25406	0	0	77	0	0	77
25407	74	0	0	0	0	74
25408	0	0	75	0	0	75
25409	79	0	0	1	0	80
25410	81	0	0	0	0	81
25411	0	0	0	84	0	84
25412	0	84	0	0	0	84
25413	0	0	0	86	0	86
25414	0	0	0	86	0	86
25415	0	83	0	0	0	83
25416	80	0	0	0	0	80
25417	0	78	1	0	0	79
25418	77	0	0	0	0	77
25419	79	0	0	0	0	79
25420	0	0	0	80	0	80
25421	0	0	0	81	0	81
25422	0	0	81	0	0	81
25423	1	0	75	1	0	77
25424	81	0	0	1	0	82
25425	81	0	0	0	0	81
25426	0	83	0	0	0	83
25427	0	0	0	84	0	84
25428	0	0	83	0	0	83
25429	0	0	0	87	0	87
25430	89	0	0	0	0	89
25431	84	0	0	0	0	84
25432	0	87	0	0	0	87
25433	0	0	0	85	0	85
25434	0	0	0	85	0	85
25435	0	0	0	85	0	85
25436	0	0	81	0	0	81
25437	81	0	0	0	0	81
25438	83	0	0	0	0	83
25439	0	0	85	0	0	85
25440	0	80	0	0	0	80
25441	81	0	0	0	0	81
25442	81	0	0	1	0	82
25443	0	1	75	0	0	76
25444	0	0	76	0	0	76
25445	0	0	0	78	0	78
25446	0	0	81	0	0	81
25447	76	0	0	1	0	77
25448	77	0	0	0	0	77
25449	78	0	0	1	0	79
25450	0	0	0	79	0	79
25451	0	77	0	0	0	77
25452	77	0	0	0	0	77
25453	79	0	0	0	0	79
25454	0	0	82	0	0	82
25455	0	0	76	0	0	76
25456	82	0	0	0	0	82
25457	0	0	0	83	0	83
25458	0	0	83	0	0	83
25459	0	85	0	0	0	85
25460	0	0	0	82	0	82
25461	80	0	0	0	0	80
25462	0	79	0	0	0	79
25463	0	0	0	81	0	81
25464	0	73	0	0	0	73
25465	0	79	0	0	0	79
25466	0	0	0	79	0	79
25467	0	0	0	81	0	81
25468	0	79	0	0	0	79
25469	83	0	0	0	0	83
25470	0	0	81	0	0	81
25471	84	0	0	0	0	84
25472	1	0	0	81	0	82
25473	0	0	0	86	0	86
25474	0	0	0	88	0	88
25475	0	0	0	86	0	86
25476	0	0	79	0	0	79
25477	0	0	1	83	0	84
25478	0	0	0	82	0	82
25479	0	78	0	0	0	78
25480	0	0	82	0	0	82
25481	0	77	0	0	0	77
25482	0	0	82	0	0	82
25483	0	78	0	0	0	78
25484	0	0	0	78	0	78
25485	80	0	0	0	0	80
25486	0	80	0	0	0	80
25487	0	0	0	80	0	80
25488	0	0	81	0	0	81
25489	0	82	0	0	0	82
25490	87	0	0	0	0	87
25491	85	0	0	0	0	85
25492	0	87	0	0	0	87
25493	0	0	83	0	0	83
25494	87	0	0	0	0	87
25495	0	0	0	86	0	86
25496	83	0	0	0	0	83
25497	0	82	0	0	0	82
25498	2	79	0	0	0	81
25499	0	0	79	0	0	79
25500	79	0	0	2	0	81
25501	1	0	0	78	0	79
25502	83	0	0	0	0	83
25503	0	79	0	0	0	79
25504	74	0	0	1	0	75
25505	69	0	0	1	0	70
25506	0	0	68	0	0	68
25507	0	71	0	0	0	71
25508	0	73	0	0	0	73
25509	0	0	0	75	0	75
25510	0	72	0	0	0	72
25511	69	0	0	1	0	70
25512	0	71	0	0	0	71
25513	0	0	0	75	0	75
25514	0	75	0	0	0	75
25515	0	72	0	0	0	72
25516	0	70	0	0	0	70
25517	0	0	0	80	0	80
25518	0	0	0	78	0	78
25519	0	0	0	78	0	78
25520	0	74	0	0	0	74
25521	0	0	73	0	0	73
25522	1	0	68	0	0	69
25523	76	0	0	0	0	76
25524	0	0	0	78	0	78
25525	0	1	74	0	0	75
25526	0	0	68	0	0	68
25527	0	73	0	0	0	73
25528	0	0	0	78	0	78
25529	0	0	0	78	0	78
25530	76	0	0	0	0	76
25531	0	0	0	77	0	77
25532	0	0	0	74	0	74
25533	0	0	74	0	0	74
25534	0	0	0	76	0	76
25535	0	0	0	80	0	80
25536	0	0	73	0	0	73
25537	0	0	67	0	0	67
25538	0	77	0	0	0	77
25539	0	0	80	0	0	80
25540	0	0	0	80	0	80
25541	0	0	0	81	0	81
25542	0	0	86	1	0	87
25543	0	86	0	0	0	86
25544	89	0	0	0	0	89
25545	0	88	0	0	0	88
25546	0	0	0	90	0	90
25547	0	0	0	88	0	88
25548	0	85	1	0	0	86
25549	0	0	0	89	0	89
25550	0	0	0	90	0	90
25551	0	0	82	0	0	82
25552	0	82	0	0	0	82
25553	0	0	0	85	0	85
25554	0	0	86	0	0	86
25555	0	0	0	88	0	88
25556	0	0	0	89	0	89
25557	0	0	0	92	0	92
25558	0	0	0	86	0	86
25559	0	0	0	91	0	91
25560	0	90	0	0	0	90
25561	89	0	0	0	0	89
25562	0	0	86	0	0	86
25563	92	0	0	1	0	93
25564	0	0	92	0	0	92
25565	0	89	0	0	0	89
25566	0	0	88	0	0	88
25567	0	90	0	0	0	90
25568	0	0	0	93	0	93
25569	0	0	0	94	0	94
25570	0	86	0	0	0	86
25571	0	97	0	0	0	97
25572	98	0	0	0	0	98
25573	95	0	0	0	0	95
25574	96	0	0	0	0	96
25575	91	0	0	0	0	91
25576	0	0	0	90	0	90
25577	0	88	0	0	0	88
25578	86	0	1	0	0	87
25579	0	0	0	90	0	90
25580	91	0	0	0	0	91
25581	89	0	0	0	0	89
25582	0	81	0	0	0	81
25583	1	78	0	1	0	80
25584	0	84	0	0	0	84
25585	0	0	0	78	0	78
25586	0	81	0	0	0	81
25587	84	0	0	0	0	84
25588	87	0	0	0	0	87
25589	83	0	0	0	0	83
25590	82	0	0	0	0	82
25591	82	0	0	0	0	82
25592	0	0	78	0	0	78
25593	79	0	0	0	0	79
25594	0	0	83	0	0	83
25595	83	0	0	0	0	83
25596	0	0	0	89	0	89
25597	0	0	72	0	0	72
25598	0	1	84	0	0	85
25599	0	86	0	1	0	87
25600	86	0	0	0	0	86
25601	88	0	0	0	0	88
25602	0	87	0	0	0	87
25603	0	0	0	91	0	91
25604	88	0	0	0	0	88
25605	0	0	88	0	0	88
25606	0	89	0	0	0	89
25607	92	0	0	1	0	93
25608	0	95	0	0	0	95
25609	0	0	0	92	0	92
25610	0	95	0	0	0	95
25611	0	0	0	96	0	96
25612	0	85	0	0	0	85
25613	0	93	0	0	0	93
25614	96	0	0	0	0	96
25615	99	0	0	0	0	99
25616	0	0	94	0	0	94
25617	0	0	87	0	0	87
25618	0	0	88	0	0	88
25619	0	0	0	92	0	92
25620	0	0	92	0	0	92
25621	0	0	0	95	0	95
25622	0	0	0	98	0	98
25623	0	94	0	0	0	94
25624	92	0	0	0	0	92
25625	0	94	0	0	0	94
25626	0	0	0	97	0	97
25627	0	0	0	90	0	90
25628	0	0	0	95	0	95
25629	0	0	87	0	0	87
25630	0	0	0	93	0	93
25631	0	0	0	91	0	91
25632	0	0	0	89	0	89
25633	0	0	90	0	0	90
25634	0	82	0	0	0	82
25635	85	0	0	0	0	85
25636	78	0	0	0	0	78
25637	0	78	0	6	0	84
25638	0	0	0	85	0	85
25639	0	0	0	88	0	88
25640	1	0	85	0	0	86
25641	0	84	0	0	0	84
25642	0	0	0	87	0	87
25643	0	0	87	0	0	87
25644	0	0	0	83	0	83
25645	0	0	0	86	0	86
25646	0	1	84	0	0	85
25647	0	0	0	81	0	81
25648	0	0	0	79	0	79
25649	0	0	80	2	0	82
25650	0	0	0	86	0	86
25651	0	0	0	85	0	85
25652	0	0	0	86	0	86
25653	0	1	85	0	0	86
25654	0	0	0	84	0	84
25655	79	0	0	1	0	80
25656	83	0	0	0	0	83
25657	0	77	0	0	0	77
25658	85	0	0	0	0	85
25659	0	0	85	0	0	85
25660	0	0	0	84	0	84
25661	0	0	0	77	0	77
25662	0	0	0	80	0	80
25663	73	0	0	0	0	73
25664	0	74	0	0	0	74
25665	0	0	0	75	0	75
25666	0	71	0	0	0	71
25667	71	0	0	0	0	71
25668	0	70	0	0	0	70
25669	71	0	0	0	0	71
25670	0	70	0	0	0	70
25671	0	74	0	0	0	74
25672	0	0	0	75	0	75
25673	0	0	0	75	0	75
25674	0	0	0	76	0	76
25675	0	0	0	74	0	74
25676	0	0	75	0	0	75
25677	0	73	0	0	0	73
25678	0	0	0	75	0	75
25679	0	64	0	0	0	64
25680	0	0	69	0	0	69
25681	0	0	0	64	0	64
25682	0	0	0	68	0	68
25683	0	0	64	0	0	64
25684	0	63	0	0	0	63
25685	0	0	0	67	0	67
25686	0	0	67	0	0	67
25687	0	58	0	1	0	59
25688	0	0	0	56	0	56
25689	0	0	59	0	0	59
25690	0	0	54	0	0	54
25691	0	48	1	0	0	49
25692	0	54	0	0	0	54
25693	0	0	0	55	0	55
25694	0	0	0	53	0	53
25695	0	0	52	0	0	52
25696	53	0	0	0	0	53
25697	59	0	0	0	0	59
25698	0	0	54	0	0	54
25699	0	52	0	0	0	52
25700	0	50	0	0	0	50
25701	0	52	0	1	0	53
25702	0	50	0	0	0	50
25703	0	0	0	55	0	55
25704	0	0	0	53	0	53
25705	0	0	0	52	0	52
25706	0	0	0	53	0	53
25707	0	49	0	0	0	49
25708	0	0	0	51	0	51
25709	0	51	0	0	0	51
25710	0	0	0	53	0	53
25711	50	0	0	0	0	50
25712	0	0	0	54	0	54
25713	0	50	0	0	0	50
25714	0	0	0	52	0	52
25715	0	0	0	53	0	53
25716	0	0	0	51	0	51
25717	52	0	0	0	0	52
25718	0	0	0	55	0	55
25719	0	0	52	0	0	52
25720	0	52	0	0	0	52
25721	0	0	0	56	0	56
25722	0	0	0	53	0	53
25723	0	0	0	55	0	55
25724	55	0	0	0	0	55
25725	0	0	53	0	0	53
25726	0	0	0	56	0	56
25727	0	49	0	0	0	49
25728	0	0	0	52	0	52
25729	48	1	0	0	0	49
25730	0	49	0	0	0	49
25731	0	0	0	49	0	49
25732	0	0	0	48	0	48
25733	0	49	1	0	0	50
25734	0	0	0	45	0	45
25735	0	0	0	47	0	47
25736	0	0	46	0	0	46
25737	0	44	0	0	0	44
25738	43	0	0	0	0	43
25739	1	0	42	0	0	43
25740	44	0	0	0	0	44
25741	0	0	47	0	0	47
25742	0	0	0	47	0	47
25743	46	0	0	0	0	46
25744	0	0	0	45	0	45
25745	46	0	0	0	0	46
25746	43	0	0	0	0	43
25747	44	0	0	0	0	44
25748	0	43	0	0	0	43
25749	0	0	0	44	0	44
25750	0	0	0	45	0	45
25751	0	0	0	44	0	44
25752	0	0	44	0	0	44
25753	0	0	0	44	0	44
25754	43	0	0	0	0	43
25755	44	0	0	0	0	44
25756	0	0	42	0	0	42
25757	45	0	0	0	0	45
25758	45	0	0	0	0	45
25759	0	0	0	43	0	43
25760	44	0	0	0	0	44
25761	47	0	0	0	0	47
25762	0	0	0	43	0	43
25763	46	0	0	0	0	46
25764	44	0	0	0	0	44
25765	0	0	0	44	0	44
25766	0	0	41	0	0	41
25767	43	0	0	0	0	43
25768	0	0	45	0	0	45
25769	0	0	47	0	0	47
25770	0	44	0	0	0	44
25771	0	0	0	46	0	46
25772	0	0	0	44	0	44
25773	0	0	0	46	0	46
25774	0	0	42	0	0	42
25775	0	0	36	0	0	36
25776	0	47	0	0	0	47
25777	0	0	0	49	0	49
25778	0	0	0	53	0	53
25779	0	0	0	48	0	48
25780	0	0	54	0	0	54
25781	0	52	0	0	0	52
25782	0	0	0	54	0	54
25783	0	0	50	0	0	50
25784	0	1	43	0	0	44
25785	51	0	0	0	0	51
25786	49	0	0	0	0	49
25787	46	0	0	0	0	46
25788	0	0	0	48	0	48
25789	0	0	49	0	0	49
25790	0	44	0	0	0	44
25791	2	44	0	0	0	46
25792	0	0	48	0	0	48
25793	0	0	1	47	0	48
25794	0	0	0	44	0	44
25795	2	39	0	0	0	41
25796	0	47	0	0	0	47
25797	46	0	0	0	0	46
25798	41	0	0	0	0	41
25799	47	0	0	0	0	47
25800	52	0	0	0	0	52
25801	49	0	0	0	0	49
25802	0	48	0	0	0	48
25803	0	44	0	0	0	44
25804	2	46	0	0	0	48
25805	51	0	2	0	0	53
25806	0	0	0	54	0	54
25807	0	0	0	55	0	55
25808	56	0	0	0	0	56
25809	0	53	0	0	0	53
25810	0	0	0	55	0	55
25811	0	0	0	54	0	54
25812	0	0	0	57	0	57
25813	50	0	0	0	0	50
25814	0	0	0	56	0	56
25815	0	0	55	0	0	55
25816	57	0	0	0	0	57
25817	0	0	0	54	0	54
25818	0	0	54	0	0	54
25819	0	47	0	0	0	47
25820	0	54	0	0	0	54
25821	55	0	0	0	0	55
25822	52	0	0	0	0	52
25823	0	56	0	0	0	56
25824	0	0	0	56	0	56
25825	59	0	0	0	0	59
25826	0	0	0	59	0	59
25827	0	0	0	60	0	60
25828	0	0	0	61	0	61
25829	0	0	0	57	0	57
25830	0	55	1	0	0	56
25831	0	0	0	62	0	62
25832	0	0	0	64	0	64
25833	0	0	0	63	0	63
25834	0	0	63	0	0	63
25835	0	60	0	0	0	60
25836	0	0	0	66	0	66
25837	0	0	67	0	0	67
25838	0	0	64	0	0	64
25839	0	70	0	1	0	71
25840	74	0	0	0	0	74
25841	0	0	0	73	0	73
25842	70	0	0	0	0	70
25843	0	74	0	0	0	74
25844	0	0	0	73	0	73
25845	74	0	0	0	0	74
25846	73	0	0	0	0	73
25847	0	0	0	76	0	76
25848	0	0	0	74	0	74
25849	0	0	73	0	0	73
25850	0	0	0	75	0	75
25851	0	0	0	78	0	78
25852	77	0	0	0	0	77
25853	0	75	0	0	0	75
25854	0	0	71	0	0	71
25855	70	0	0	0	0	70
25856	0	68	0	0	0	68
25857	0	0	0	74	0	74
25858	71	0	0	0	0	71
25859	0	0	0	70	0	70
25860	0	0	0	74	0	74
25861	0	0	75	0	0	75
25862	0	0	0	73	0	73
25863	73	0	0	0	0	73
25864	0	0	0	73	0	73
25865	76	0	0	0	0	76
25866	2	67	0	0	0	69
25867	0	72	2	0	0	74
25868	0	0	0	75	0	75
25869	0	0	0	74	0	74
25870	75	0	0	0	0	75
25871	0	73	0	0	0	73
25872	75	0	0	0	0	75
25873	72	0	0	0	0	72
25874	0	0	0	73	0	73
25875	76	0	0	0	0	76
25876	0	0	74	0	0	74
25877	0	0	0	74	0	74
25878	0	0	72	0	0	72
25879	1	0	0	70	0	71
25880	72	0	0	0	0	72
25881	70	0	0	1	0	71
25882	0	70	0	0	0	70
25883	0	0	0	72	0	72
25884	0	0	0	68	0	68
25885	0	67	0	0	0	67
25886	0	0	0	67	0	67
25887	0	0	0	71	0	71
25888	0	67	0	0	0	67
25889	68	0	0	0	0	68
25890	67	0	0	0	0	67
25891	0	0	0	67	0	67
25892	0	0	0	71	0	71
25893	0	0	67	0	0	67
25894	0	0	0	69	0	69
25895	0	67	0	0	0	67
25896	71	0	0	0	0	71
25897	0	0	0	66	0	66
25898	0	0	0	67	0	67
25899	66	0	0	0	0	66
25900	0	65	0	0	0	65
25901	0	0	0	63	0	63
25902	0	0	0	65	0	65
25903	0	63	0	0	0	63
25904	63	0	0	0	0	63
25905	0	0	61	0	0	61
25906	0	0	65	0	0	65
25907	0	0	0	65	0	65
25908	0	0	66	0	0	66
25909	65	0	0	0	0	65
25910	0	0	0	62	0	62
25911	0	0	63	0	0	63
25912	1	0	55	0	0	56
25913	0	61	0	0	0	61
25914	62	0	0	0	0	62
25915	0	62	0	0	0	62
25916	64	0	0	0	0	64
25917	61	0	0	0	0	61
25918	0	63	0	0	0	63
25919	65	0	0	0	0	65
25920	62	0	0	0	0	62
25921	0	0	65	0	0	65
25922	1	0	0	64	0	65
25923	0	60	0	0	0	60
25924	0	62	0	0	0	62
25925	0	0	0	60	0	60
25926	58	0	0	0	0	58
25927	0	0	0	64	0	64
25928	0	0	0	63	0	63
25929	0	0	0	59	0	59
25930	0	54	0	0	0	54
25931	0	0	0	57	0	57
25932	0	0	54	0	0	54
25933	53	0	0	0	0	53
25934	54	0	0	0	0	54
25935	0	57	0	0	0	57
25936	56	0	0	0	0	56
25937	0	0	0	56	0	56
25938	0	0	54	0	0	54
25939	55	0	0	0	0	55
25940	0	53	0	0	0	53
25941	0	0	0	57	0	57
25942	58	0	0	0	0	58
25943	0	53	0	1	0	54
25944	1	51	0	0	0	52
25945	57	0	0	0	0	57
25946	0	0	54	0	0	54
25947	53	0	0	0	0	53
25948	0	0	0	55	0	55
25949	0	0	0	59	0	59
25950	0	0	58	0	0	58
25951	0	0	56	0	0	56
25952	0	0	0	59	0	59
25953	1	0	59	0	0	60
25954	0	0	53	0	0	53
25955	0	0	0	52	0	52
25956	0	0	0	56	0	56
25957	55	0	0	0	0	55
25958	0	1	0	54	0	55
25959	53	0	0	0	0	53
25960	0	49	0	1	0	50
25961	0	0	0	54	0	54
25962	0	0	51	0	0	51
25963	52	0	0	0	0	52
25964	53	0	0	0	0	53
25965	51	0	0	0	0	51
25966	49	0	0	0	0	49
25967	51	0	0	0	0	51
25968	0	0	0	49	0	49
25969	0	0	51	0	0	51
25970	0	0	46	0	0	46
25971	0	0	46	0	0	46
25972	48	0	0	0	0	48
25973	51	0	0	0	0	51
25974	0	0	0	51	0	51
25975	0	50	0	0	0	50
25976	0	0	0	52	0	52
25977	0	0	51	0	0	51
25978	0	0	47	0	0	47
25979	50	0	0	0	0	50
25980	0	0	51	0	0	51
25981	0	0	0	53	0	53
25982	53	0	0	0	0	53
25983	53	0	0	0	0	53
25984	52	0	0	0	0	52
25985	50	0	0	0	0	50
25986	0	0	47	0	0	47
25987	50	0	0	0	0	50
25988	0	53	1	0	0	54
25989	0	0	0	51	0	51
25990	0	0	57	0	0	57
25991	0	0	0	54	0	54
25992	0	0	57	0	0	57
25993	0	0	0	54	0	54
25994	0	0	0	57	0	57
25995	1	0	55	0	0	56
25996	0	0	0	56	0	56
25997	59	0	0	0	0	59
25998	0	0	0	56	0	56
25999	0	0	0	60	0	60
26000	54	0	0	0	0	54
26001	0	59	0	0	0	59
26002	58	0	0	0	0	58
26003	0	56	0	0	0	56
26004	62	0	0	0	0	62
26005	0	0	58	0	0	58
26006	0	0	0	62	0	62
26007	0	0	0	63	0	63
26008	57	0	0	0	0	57
26009	0	58	0	0	0	58
26010	1	0	0	51	0	52
26011	0	0	0	53	0	53
26012	0	53	0	0	0	53
26013	53	0	0	0	0	53
26014	0	53	0	0	0	53
26015	0	0	0	53	0	53
26016	0	0	0	54	0	54
26017	0	53	0	0	0	53
26018	53	0	0	0	0	53
26019	0	0	52	0	0	52
26020	50	0	0	0	0	50
26021	0	50	0	0	0	50
26022	2	1	0	49	0	52
26023	51	0	2	0	0	53
26024	0	0	0	50	0	50
26025	0	0	0	53	0	53
26026	51	0	0	0	0	51
26027	0	51	1	0	0	52
26028	0	51	0	0	0	51
26029	49	0	0	0	0	49
26030	0	0	48	0	0	48
26031	0	49	0	0	0	49
26032	0	0	0	51	0	51
26033	0	0	49	0	0	49
26034	0	0	0	51	0	51
26035	49	0	0	0	0	49
26036	0	50	0	1	0	51
26037	0	0	0	51	0	51
26038	0	48	1	0	0	49
26039	51	0	0	0	0	51
26040	48	0	0	0	0	48
26041	0	43	0	0	0	43
26042	0	0	0	48	0	48
26043	0	48	0	0	0	48
26044	49	0	0	0	0	49
26045	46	0	0	0	0	46
26046	0	0	0	49	0	49
26047	0	0	0	48	0	48
26048	0	0	46	0	0	46
26049	48	0	0	0	0	48
26050	0	0	46	0	0	46
26051	0	0	0	51	0	51
26052	50	0	0	0	0	50
26053	0	50	0	0	0	50
26054	50	0	0	0	0	50
26055	0	0	53	0	0	53
26056	48	0	0	0	0	48
26057	0	52	0	0	0	52
26058	50	0	0	0	0	50
26059	0	52	0	0	0	52
26060	0	0	0	49	0	49
26061	0	0	49	0	0	49
26062	0	0	47	0	0	47
26063	0	0	0	47	0	47
26064	0	0	47	0	0	47
26065	0	0	0	47	0	47
26066	0	0	0	51	0	51
26067	0	0	49	0	0	49
26068	47	0	0	0	0	47
26069	47	0	0	0	0	47
26070	0	49	0	0	0	49
26071	49	0	0	0	0	49
26072	0	0	0	47	0	47
26073	0	0	49	0	0	49
26074	0	0	0	50	0	50
26075	2	0	0	51	0	53
26076	51	0	0	0	0	51
26077	0	43	0	0	0	43
26078	0	43	0	2	0	45
26079	0	0	0	43	0	43
26080	0	0	0	44	0	44
26081	0	47	0	0	0	47
26082	0	0	0	47	0	47
26083	0	0	0	43	0	43
26084	0	43	0	0	0	43
26085	41	0	0	0	0	41
26086	0	0	0	42	0	42
26087	0	45	0	0	0	45
26088	0	0	0	46	0	46
26089	45	0	0	0	0	45
26090	0	45	0	0	0	45
26091	49	0	0	0	0	49
26092	51	0	0	0	0	51
26093	0	0	0	52	0	52
26094	47	0	0	0	0	47
26095	51	0	0	0	0	51
26096	51	0	0	0	0	51
26097	52	0	0	0	0	52
26098	0	0	0	53	0	53
26099	0	0	0	53	0	53
26100	0	0	52	0	0	52
26101	0	0	0	53	0	53
26102	0	0	0	56	0	56
26103	0	0	55	0	0	55
26104	56	0	0	0	0	56
26105	0	0	0	54	0	54
26106	0	0	52	0	0	52
26107	52	0	0	0	0	52
26108	0	0	57	0	0	57
26109	1	53	0	0	0	54
26110	0	59	0	0	0	59
26111	0	0	0	61	0	61
26112	0	0	62	0	0	62
26113	62	0	0	0	0	62
26114	62	0	0	0	0	62
26115	0	0	57	0	0	57
26116	60	0	0	0	0	60
26117	59	0	0	0	0	59
26118	0	61	0	0	0	61
26119	60	0	0	0	0	60
26120	0	0	0	63	0	63
26121	0	0	62	0	0	62
26122	0	0	0	63	0	63
26123	0	63	0	0	0	63
26124	0	67	0	0	0	67
26125	65	0	0	0	0	65
26126	63	0	0	0	0	63
26127	66	0	0	0	0	66
26128	0	0	1	65	0	66
26129	0	0	0	69	0	69
26130	0	64	0	0	0	64
26131	67	0	0	0	0	67
26132	0	66	0	0	0	66
26133	70	0	0	0	0	70
26134	0	70	0	0	0	70
26135	69	0	0	0	0	69
26136	65	0	0	0	0	65
26137	0	0	0	72	0	72
26138	0	69	0	0	0	69
26139	0	0	68	0	0	68
26140	74	0	0	0	0	74
26141	0	71	0	0	0	71
26142	0	0	69	0	0	69
26143	0	0	64	0	0	64
26144	0	0	0	66	0	66
26145	0	0	0	71	0	71
26146	0	65	0	0	0	65
26147	70	0	0	0	0	70
26148	0	0	0	69	0	69
26149	0	69	0	0	0	69
26150	0	67	0	0	0	67
26151	0	0	62	0	0	62
26152	0	0	65	0	0	65
26153	71	0	0	0	0	71
26154	0	0	71	0	0	71
26155	0	0	0	77	0	77
26156	0	0	0	77	0	77
26157	0	0	84	0	0	84
26158	0	0	0	79	0	79
26159	0	0	0	81	0	81
26160	80	0	0	0	0	80
26161	80	0	0	0	0	80
26162	0	0	0	83	0	83
26163	0	75	0	0	0	75
26164	0	83	0	0	0	83
26165	83	0	0	0	0	83
26166	0	0	85	0	0	85
26167	0	0	0	86	0	86
26168	88	0	0	0	0	88
26169	93	0	0	0	0	93
26170	0	1	0	86	0	87
26171	0	0	89	1	0	90
26172	1	0	82	1	0	84
26173	91	0	0	0	0	91
26174	92	0	0	0	0	92
26175	0	89	0	0	0	89
26176	0	93	0	1	0	94
26177	92	0	0	0	0	92
26178	95	0	0	0	0	95
26179	1	0	0	87	0	88
26180	0	0	0	89	0	89
26181	0	0	0	90	0	90
26182	89	0	0	0	0	89
26183	0	0	0	91	0	91
26184	0	0	87	0	0	87
26185	91	0	0	0	0	91
26186	0	0	0	92	0	92
26187	0	0	89	0	0	89
26188	89	0	0	0	0	89
26189	93	0	0	0	0	93
26190	0	88	0	0	0	88
26191	0	90	0	0	0	90
26192	0	0	81	0	0	81
26193	91	0	0	0	0	91
26194	0	89	0	0	0	89
26195	0	0	89	0	0	89
26196	95	0	0	0	0	95
26197	0	96	0	0	0	96
26198	0	0	93	0	0	93
26199	91	0	0	0	0	91
26200	0	100	0	0	0	100
26201	0	0	0	97	0	97
26202	92	0	0	0	0	92
26203	0	98	0	0	0	98
26204	0	0	0	101	0	101
26205	95	0	0	0	0	95
26206	0	1	87	0	0	88
26207	0	92	0	0	0	92
26208	0	0	89	0	0	89
26209	0	0	0	96	0	96
26210	0	0	95	0	0	95
26211	0	94	0	1	0	95
26212	0	97	0	0	0	97
26213	0	0	0	99	0	99
26214	1	0	0	95	0	96
26215	0	0	0	92	0	92
26216	0	0	95	0	0	95
26217	0	0	0	92	0	92
26218	98	0	0	0	0	98
26219	98	0	0	0	0	98
26220	0	1	93	0	0	94
26221	0	95	0	1	0	96
26222	94	0	0	0	0	94
26223	0	92	0	0	0	92
26224	95	0	0	0	0	95
26225	95	0	0	0	0	95
26226	0	0	90	0	0	90
26227	0	99	0	0	0	99
26228	0	0	0	101	0	101
26229	0	0	103	0	0	103
26230	99	0	0	0	0	99
26231	1	0	0	103	0	104
26232	0	0	99	0	0	99
26233	102	0	0	0	0	102
26234	0	0	106	0	0	106
26235	1	0	0	108	0	109
26236	110	0	0	0	0	110
26237	1	111	0	0	0	112
26238	0	0	113	0	0	113
26239	113	0	0	0	0	113
26240	105	0	0	1	0	106
26241	0	109	0	0	0	109
26242	0	0	0	112	0	112
26243	0	0	0	114	0	114
26244	111	0	0	0	0	111
26245	0	0	0	108	0	108
26246	0	0	111	0	0	111
26247	0	0	0	111	0	111
26248	103	0	0	0	0	103
26249	0	104	0	0	0	104
26250	0	0	0	103	0	103
26251	0	98	0	0	0	98
26252	99	0	0	0	0	99
26253	0	0	0	99	0	99
26254	0	0	0	102	0	102
26255	0	100	0	0	0	100
26256	0	0	101	0	0	101
26257	0	0	0	102	0	102
26258	0	0	0	102	0	102
26259	0	0	0	102	0	102
26260	0	95	0	0	0	95
26261	0	0	95	0	0	95
26262	0	0	98	0	0	98
26263	106	0	0	0	0	106
26264	104	0	0	0	0	104
26265	0	0	101	0	0	101
26266	107	0	0	0	0	107
26267	0	0	106	0	0	106
26268	102	0	0	0	0	102
26269	0	104	0	0	0	104
26270	105	0	0	0	0	105
26271	0	0	104	0	0	104
26272	0	0	103	0	0	103
26273	0	0	1	104	0	105
26274	111	0	0	0	0	111
26275	0	107	0	0	0	107
26276	0	0	113	0	0	113
26277	0	0	0	107	0	107
26278	0	0	0	111	0	111
26279	111	0	0	0	0	111
26280	114	0	0	0	0	114
26281	1	0	0	109	0	110
26282	114	0	0	0	0	114
26283	0	0	111	0	0	111
26284	0	0	0	116	0	116
26285	1	0	0	116	0	117
26286	116	0	0	1	0	117
26287	116	1	0	0	0	117
26288	0	0	0	117	0	117
26289	117	0	0	0	0	117
26290	0	0	113	0	0	113
26291	0	110	0	0	0	110
26292	0	0	110	0	0	110
26293	0	0	0	116	0	116
26294	110	0	0	1	0	111
26295	0	116	0	0	0	116
26296	0	0	0	114	0	114
26297	0	0	0	114	0	114
26298	0	108	0	1	0	109
26299	0	0	0	117	0	117
26300	0	0	0	116	0	116
26301	0	0	0	119	0	119
26302	0	0	0	121	0	121
26303	0	0	0	120	0	120
26304	0	118	0	0	0	118
26305	0	0	0	120	0	120
26306	0	0	0	119	0	119
26307	0	0	116	0	0	116
26308	0	115	0	1	0	116
26309	0	0	0	123	0	123
26310	0	0	0	120	0	120
26311	0	0	0	125	0	125
26312	0	120	0	0	0	120
26313	0	0	121	0	0	121
26314	0	2	0	120	0	122
26315	0	0	119	0	0	119
26316	0	0	115	5	0	120
26317	0	0	0	121	0	121
26318	117	0	0	0	0	117
26319	0	0	0	118	0	118
26320	0	0	0	117	0	117
26321	0	112	0	0	0	112
26322	0	0	0	110	0	110
26323	0	0	0	111	0	111
26324	0	0	105	0	0	105
26325	0	107	0	0	0	107
26326	0	0	0	106	0	106
26327	110	0	0	0	0	110
26328	0	0	117	0	0	117
26329	0	0	0	110	0	110
26330	0	0	0	111	0	111
26331	105	0	0	0	0	105
26332	0	104	0	3	0	107
26333	98	0	0	0	0	98
26334	0	98	0	0	0	98
26335	0	0	0	96	0	96
26336	97	0	0	0	0	97
26337	0	0	96	0	0	96
26338	0	88	0	0	0	88
26339	0	98	0	0	0	98
26340	96	0	0	0	0	96
26341	1	0	0	97	0	98
26342	0	86	0	0	0	86
26343	0	97	0	0	0	97
26344	0	0	0	97	0	97
26345	0	0	0	99	0	99
26346	92	0	0	0	0	92
26347	0	88	0	0	0	88
26348	0	0	0	93	0	93
26349	0	0	96	0	0	96
26350	0	88	0	0	0	88
26351	0	0	86	0	0	86
26352	0	90	0	0	0	90
26353	0	0	0	91	0	91
26354	0	0	0	88	0	88
26355	0	87	0	0	0	87
26356	0	0	78	0	0	78
26357	86	0	0	0	0	86
26358	0	0	0	83	0	83
26359	0	0	0	86	0	86
26360	0	0	81	0	0	81
26361	0	0	0	83	0	83
26362	0	0	81	0	0	81
26363	0	0	0	84	0	84
26364	0	0	78	0	0	78
26365	0	78	0	0	0	78
26366	0	0	77	0	0	77
26367	0	0	0	77	0	77
26368	76	0	0	0	0	76
26369	0	69	0	0	0	69
26370	0	0	0	72	0	72
26371	0	0	68	0	0	68
26372	0	65	0	0	0	65
26373	0	0	0	66	0	66
26374	0	0	65	0	0	65
26375	0	65	0	0	0	65
26376	68	0	0	0	0	68
26377	65	0	0	0	0	65
26378	0	0	0	66	0	66
26379	60	0	0	0	0	60
26380	0	0	0	63	0	63
26381	0	0	0	63	0	63
26382	0	0	63	0	0	63
26383	0	0	1	64	0	65
26384	0	0	0	63	0	63
26385	65	0	0	0	0	65
26386	64	0	0	0	0	64
26387	0	60	0	0	0	60
26388	0	0	62	1	0	63
26389	0	0	0	64	0	64
26390	0	0	62	0	0	62
26391	60	0	0	0	0	60
26392	1	0	57	0	0	58
26393	0	0	0	62	0	62
26394	0	61	0	0	0	61
26395	0	0	0	61	0	61
26396	0	0	0	64	0	64
26397	0	0	61	0	0	61
26398	0	0	0	64	0	64
26399	69	0	0	0	0	69
26400	70	0	0	0	0	70
26401	65	2	0	0	0	67
26402	67	0	0	2	0	69
26403	0	63	0	0	0	63
26404	0	63	0	0	0	63
26405	0	0	0	70	0	70
26406	0	0	0	65	0	65
26407	0	65	0	1	0	66
26408	0	0	0	65	0	65
26409	1	0	0	64	0	65
26410	0	0	1	62	0	63
26411	1	0	0	67	0	68
26412	0	0	0	70	0	70
26413	59	0	0	1	0	60
26414	0	66	0	0	0	66
26415	0	1	64	0	0	65
26416	0	0	0	71	0	71
26417	0	0	0	67	0	67
26418	0	0	0	69	0	69
26419	69	0	0	0	0	69
26420	0	72	0	0	0	72
26421	0	0	0	70	0	70
26422	0	68	0	0	0	68
26423	0	0	0	71	0	71
26424	0	69	0	0	0	69
26425	0	0	71	1	0	72
26426	3	0	0	75	0	78
26427	0	0	76	0	0	76
26428	0	0	0	72	0	72
26429	0	0	0	76	0	76
26430	76	0	0	0	0	76
26431	71	3	0	0	0	74
26432	74	0	0	0	0	74
26433	70	0	0	0	0	70
26434	71	0	0	0	0	71
26435	0	0	0	75	0	75
26436	0	68	0	0	0	68
26437	0	0	0	72	0	72
26438	0	0	69	0	0	69
26439	70	0	0	0	0	70
26440	70	0	0	0	0	70
26441	0	0	0	71	0	71
26442	0	0	0	71	0	71
26443	0	69	0	0	0	69
26444	0	0	0	72	0	72
26445	0	0	0	71	0	71
26446	0	67	0	0	0	67
26447	0	0	0	74	0	74
26448	76	0	0	0	0	76
26449	0	0	73	0	0	73
26450	75	0	0	0	0	75
26451	0	0	71	1	0	72
26452	0	0	0	74	0	74
26453	0	0	0	77	0	77
26454	1	69	0	0	0	70
26455	0	76	0	0	0	76
26456	0	0	0	77	0	77
26457	0	0	75	0	0	75
26458	74	0	0	0	0	74
26459	0	0	0	75	0	75
26460	0	69	0	0	0	69
26461	0	0	0	74	0	74
26462	0	0	0	71	0	71
26463	0	68	0	0	0	68
26464	0	0	0	71	0	71
26465	0	0	69	0	0	69
26466	0	0	67	0	0	67
26467	0	0	0	81	0	81
26468	0	75	0	0	0	75
26469	0	0	0	83	0	83
26470	86	0	0	0	0	86
26471	85	0	0	0	0	85
26472	84	0	0	0	0	84
26473	0	79	0	0	0	79
26474	0	0	78	0	0	78
26475	81	0	0	0	0	81
26476	86	0	0	0	0	86
26477	0	84	0	0	0	84
26478	0	0	0	80	0	80
26479	82	0	0	0	0	82
26480	79	0	0	0	0	79
26481	81	0	0	0	0	81
26482	0	0	0	81	0	81
26483	74	0	0	1	0	75
26484	0	0	0	78	0	78
26485	0	0	0	81	0	81
26486	77	0	0	0	0	77
26487	0	0	0	79	0	79
26488	77	0	0	0	0	77
26489	0	0	0	81	0	81
26490	1	0	0	84	0	85
26491	82	0	0	0	0	82
26492	0	0	77	0	0	77
26493	0	0	0	76	0	76
26494	0	0	0	76	0	76
26495	0	0	0	77	0	77
26496	0	0	0	76	0	76
26497	0	0	0	76	0	76
26498	0	74	0	0	0	74
26499	0	0	0	78	0	78
26500	0	0	75	0	0	75
26501	0	0	0	79	0	79
26502	0	0	0	74	0	74
26503	0	0	0	81	0	81
26504	0	0	76	0	0	76
26505	0	0	74	0	0	74
26506	80	0	0	0	0	80
26507	78	0	0	0	0	78
26508	0	74	0	0	0	74
26509	0	0	0	73	0	73
26510	0	0	0	78	0	78
26511	0	0	0	80	0	80
26512	76	0	0	0	0	76
26513	80	0	0	0	0	80
26514	0	0	0	80	0	80
26515	0	0	0	76	0	76
26516	1	0	0	75	0	76
26517	0	0	0	75	0	75
26518	75	0	0	0	0	75
26519	0	0	71	0	0	71
26520	0	59	0	0	0	59
26521	0	64	0	0	0	64
26522	67	0	0	0	0	67
26523	0	0	0	73	0	73
26524	0	0	70	0	0	70
26525	0	0	63	0	0	63
26526	0	78	0	0	0	78
26527	74	0	0	0	0	74
26528	0	0	74	0	0	74
26529	80	0	0	0	0	80
26530	0	0	0	77	0	77
26531	0	0	0	78	0	78
26532	0	69	0	2	0	71
26533	0	77	0	1	0	78
26534	79	0	0	0	0	79
26535	80	0	0	0	0	80
26536	0	75	0	0	0	75
26537	0	0	74	0	0	74
26538	0	0	70	0	0	70
26539	0	0	0	72	0	72
26540	74	0	0	0	0	74
26541	0	71	0	0	0	71
26542	0	0	0	70	0	70
26543	73	0	0	0	0	73
26544	0	0	0	66	0	66
26545	0	0	0	72	0	72
26546	69	0	0	0	0	69
26547	0	64	0	1	0	65
26548	0	63	0	0	0	63
26549	0	0	67	0	0	67
26550	1	0	0	65	0	66
26551	1	0	0	70	0	71
26552	1	0	69	0	0	70
26553	69	0	0	1	0	70
26554	71	0	0	0	0	71
26555	0	0	72	0	0	72
26556	71	0	0	0	0	71
26557	0	0	70	0	0	70
26558	0	71	0	0	0	71
26559	0	0	0	72	0	72
26560	0	0	0	79	0	79
26561	78	0	0	0	0	78
26562	71	0	0	0	0	71
26563	76	0	0	0	0	76
26564	76	0	0	0	0	76
26565	76	0	0	0	0	76
26566	0	0	74	0	0	74
26567	0	72	0	0	0	72
26568	0	0	0	78	0	78
26569	0	72	0	0	0	72
26570	0	77	0	0	0	77
26571	0	0	0	80	0	80
26572	0	0	0	78	0	78
26573	0	0	80	0	0	80
26574	78	0	0	0	0	78
26575	79	0	0	0	0	79
26576	0	81	0	0	0	81
26577	81	0	0	0	0	81
26578	81	1	0	0	0	82
26579	0	0	0	79	0	79
26580	0	0	79	0	0	79
26581	0	0	77	0	0	77
26582	80	0	0	0	0	80
26583	75	0	0	0	0	75
26584	0	77	0	0	0	77
26585	0	75	0	0	0	75
26586	0	0	0	78	0	78
26587	80	0	0	0	0	80
26588	0	0	78	0	0	78
26589	0	0	0	82	0	82
26590	82	0	0	0	0	82
26591	76	0	0	0	0	76
26592	0	0	0	84	0	84
26593	83	0	0	0	0	83
26594	0	0	81	0	0	81
26595	0	0	80	0	0	80
26596	0	0	0	76	0	76
26597	0	0	0	85	0	85
26598	0	0	0	87	0	87
26599	0	82	0	0	0	82
26600	0	87	0	0	0	87
26601	0	0	0	89	0	89
26602	89	0	0	0	0	89
26603	0	0	1	89	0	90
26604	0	0	0	90	0	90
26605	0	85	0	0	0	85
26606	0	84	0	0	0	84
26607	1	0	1	86	0	88
26608	0	0	0	88	0	88
26609	89	0	0	0	0	89
26610	0	92	0	0	0	92
26611	89	0	0	0	0	89
26612	0	0	0	87	0	87
26613	0	0	88	0	0	88
26614	0	0	80	0	0	80
26615	82	0	0	0	0	82
26616	0	0	0	87	0	87
26617	0	0	0	85	0	85
26618	0	0	0	80	0	80
26619	0	0	74	0	0	74
26620	0	0	0	77	0	77
26621	0	74	0	0	0	74
26622	0	0	0	77	0	77
26623	0	0	0	76	0	76
26624	0	74	0	0	0	74
26625	0	0	0	78	0	78
26626	78	0	0	0	0	78
26627	0	75	0	0	0	75
26628	73	0	0	0	0	73
26629	76	0	0	0	0	76
26630	0	0	0	75	0	75
26631	0	0	0	79	0	79
26632	0	0	0	77	0	77
26633	0	0	76	0	0	76
26634	0	74	0	0	0	74
26635	0	76	0	0	0	76
26636	0	0	0	81	0	81
26637	81	0	0	0	0	81
26638	0	0	0	82	0	82
26639	0	0	73	0	0	73
26640	0	72	0	0	0	72
26641	0	77	0	0	0	77
26642	79	0	0	0	0	79
26643	77	0	0	0	0	77
26644	0	79	0	0	0	79
26645	83	0	0	0	0	83
26646	0	0	80	0	0	80
26647	0	0	77	0	0	77
26648	84	0	0	0	0	84
26649	84	0	0	0	0	84
26650	0	0	0	81	0	81
26651	82	0	0	0	0	82
26652	0	0	80	0	0	80
26653	0	0	84	0	0	84
26654	0	0	1	82	0	83
26655	0	0	0	86	0	86
26656	0	0	0	81	0	81
26657	0	0	0	77	0	77
26658	0	0	0	75	0	75
26659	0	0	78	0	0	78
26660	0	0	0	80	0	80
26661	80	0	0	0	0	80
26662	0	0	0	80	0	80
26663	78	0	0	0	0	78
26664	0	0	0	80	0	80
26665	79	0	0	0	0	79
26666	77	0	0	0	0	77
26667	0	0	1	76	0	77
26668	0	0	0	79	0	79
26669	77	0	0	0	0	77
26670	80	0	0	0	0	80
26671	0	0	81	0	0	81
26672	0	0	0	78	0	78
26673	0	0	0	89	0	89
26674	85	0	0	0	0	85
26675	83	1	0	1	0	85
26676	0	0	0	87	0	87
26677	0	0	0	89	0	89
26678	0	0	0	90	0	90
26679	0	0	0	91	0	91
26680	0	81	0	0	0	81
26681	0	87	0	0	0	87
26682	0	0	0	84	0	84
26683	0	85	0	0	0	85
26684	0	0	0	90	0	90
26685	0	0	82	0	0	82
26686	0	0	71	0	0	71
26687	0	84	0	0	0	84
26688	0	0	0	88	0	88
26689	0	0	84	0	0	84
26690	0	0	0	85	0	85
26691	0	0	0	87	0	87
26692	90	0	0	0	0	90
26693	0	0	0	91	0	91
26694	0	0	83	0	0	83
26695	0	0	74	0	0	74
26696	0	82	0	0	0	82
26697	0	88	0	0	0	88
26698	92	0	0	0	0	92
26699	0	0	102	0	0	102
26700	0	0	1	107	0	108
26701	113	0	0	0	0	113
26702	106	0	0	0	0	106
26703	0	109	0	0	0	109
26704	0	0	0	108	0	108
26705	0	0	0	103	0	103
26706	0	0	0	105	0	105
26707	105	0	0	0	0	105
26708	0	0	100	1	0	101
26709	0	109	0	0	0	109
26710	1	0	0	116	0	117
26711	0	0	0	112	0	112
26712	0	0	112	0	0	112
26713	0	1	0	112	0	113
26714	0	0	0	117	0	117
26715	0	0	1	115	0	116
26716	0	0	0	116	0	116
26717	0	0	112	0	0	112
26718	0	0	0	108	0	108
26719	0	0	111	0	0	111
26720	0	114	0	0	0	114
26721	0	0	0	116	0	116
26722	0	0	0	110	0	110
26723	0	0	111	0	0	111
26724	0	106	0	0	0	106
26725	0	0	0	116	0	116
26726	0	0	106	0	0	106
26727	0	107	0	0	0	107
26728	0	0	0	118	0	118
26729	0	0	114	0	0	114
26730	0	0	0	114	0	114
26731	1	0	0	116	0	117
26732	0	0	0	118	0	118
26733	112	0	0	1	0	113
26734	0	107	0	0	0	107
26735	111	0	0	0	0	111
26736	0	0	110	0	0	110
26737	113	0	0	0	0	113
26738	115	0	0	0	0	115
26739	0	0	0	117	0	117
26740	119	0	0	1	0	120
26741	114	0	0	0	0	114
26742	122	0	0	0	0	122
26743	0	0	0	115	0	115
26744	0	0	0	117	0	117
26745	0	0	108	0	0	108
26746	0	0	101	0	0	101
26747	114	0	0	0	0	114
26748	0	0	0	122	0	122
26749	0	119	0	1	0	120
26750	123	0	0	0	0	123
26751	0	117	1	0	0	118
26752	0	119	0	0	0	119
26753	0	0	117	0	0	117
26754	0	0	126	0	0	126
26755	0	1	0	125	0	126
26756	0	0	129	0	0	129
26757	0	1	123	0	0	124
26758	132	0	0	0	0	132
26759	133	0	0	0	0	133
26760	0	0	0	139	0	139
26761	0	0	0	137	0	137
26762	0	0	140	0	0	140
26763	0	136	0	0	0	136
26764	0	0	0	143	0	143
26765	145	0	0	0	0	145
26766	0	0	0	147	0	147
26767	0	145	0	0	0	145
26768	0	0	135	0	0	135
26769	0	137	0	0	0	137
26770	144	0	0	0	0	144
26771	149	0	0	0	0	149
26772	0	0	0	146	0	146
26773	0	0	140	0	0	140
26774	0	0	129	0	0	129
26775	0	142	0	0	0	142
26776	0	0	0	140	0	140
26777	0	0	0	147	0	147
26778	0	0	143	0	0	143
26779	0	0	0	143	0	143
26780	0	145	0	1	0	146
26781	0	0	0	150	0	150
26782	0	0	0	153	0	153
26783	0	0	152	0	0	152
26784	0	1	0	150	0	151
26785	148	0	0	0	0	148
26786	0	1	152	0	0	153
26787	0	0	144	0	0	144
26788	0	140	0	0	0	140
26789	0	0	0	149	0	149
26790	0	0	0	149	0	149
26791	0	0	145	0	0	145
26792	145	0	0	0	0	145
26793	1	0	0	142	0	143
26794	0	0	140	0	0	140
26795	0	0	0	143	0	143
26796	1	0	138	0	0	139
26797	0	0	134	0	0	134
26798	0	145	0	0	0	145
26799	0	0	0	139	0	139
26800	0	141	0	0	0	141
26801	136	0	0	0	0	136
26802	0	0	133	0	0	133
26803	0	134	0	1	0	135
26804	0	0	0	138	0	138
26805	128	0	0	0	0	128
26806	0	138	0	1	0	139
26807	0	0	0	144	0	144
26808	0	0	0	142	0	142
26809	0	145	0	0	0	145
26810	147	0	0	0	0	147
26811	0	0	0	152	0	152
26812	0	0	0	154	0	154
26813	0	0	148	0	0	148
26814	0	155	0	0	0	155
26815	0	0	0	159	0	159
26816	0	0	0	167	0	167
26817	0	171	0	1	0	172
26818	0	0	0	178	0	178
26819	0	0	0	175	0	175
26820	0	0	1	175	0	176
26821	0	172	0	0	0	172
26822	172	0	0	0	0	172
26823	0	0	175	0	0	175
26824	171	0	0	0	0	171
26825	0	171	0	0	0	171
26826	0	0	0	174	0	174
26827	0	0	178	0	0	178
26828	0	0	0	175	0	175
26829	0	0	0	170	0	170
26830	0	0	1	177	0	178
26831	0	0	173	0	0	173
26832	0	166	1	0	0	167
26833	1	0	166	0	0	167
26834	0	161	0	0	0	161
26835	0	0	163	0	0	163
26836	0	0	1	168	0	169
26837	163	0	0	0	0	163
26838	0	173	0	0	0	173
26839	0	0	158	0	0	158
26840	4	160	0	0	0	164
26841	0	0	173	0	0	173
26842	0	0	1	162	0	163
26843	1	0	0	165	0	166
26844	3	155	0	0	0	158
26845	0	163	0	0	0	163
26846	164	0	0	0	0	164
26847	0	0	0	160	0	160
26848	0	0	151	0	0	151
26849	0	0	0	150	0	150
26850	0	0	150	0	0	150
26851	0	0	154	0	0	154
26852	0	0	0	156	0	156
26853	0	147	0	0	0	147
26854	152	0	0	0	0	152
26855	0	0	0	148	0	148
26856	0	0	0	148	0	148
26857	0	147	0	0	0	147
26858	141	0	0	0	0	141
26859	133	1	0	0	0	134
26860	0	0	0	136	0	136
26861	0	124	0	0	0	124
26862	0	132	0	0	0	132
26863	131	0	0	0	0	131
26864	0	0	134	0	0	134
26865	134	0	0	1	0	135
26866	129	0	0	0	0	129
26867	129	0	0	0	0	129
26868	0	129	1	0	0	130
26869	0	0	0	126	0	126
26870	139	0	0	0	0	139
26871	128	0	0	0	0	128
26872	0	132	0	0	0	132
26873	135	0	0	1	0	136
26874	0	0	0	131	0	131
26875	0	0	0	129	0	129
26876	0	127	0	0	0	127
26877	0	0	0	136	0	136
26878	0	0	0	136	0	136
26879	0	128	0	0	0	128
26880	0	0	0	126	0	126
26881	0	126	0	0	0	126
26882	129	0	0	0	0	129
26883	119	0	0	0	0	119
26884	0	120	0	0	0	120
26885	1	0	120	0	0	121
26886	0	0	0	120	0	120
26887	1	0	121	0	0	122
26888	0	106	0	1	0	107
26889	0	117	0	0	0	117
26890	120	0	0	0	0	120
26891	0	114	0	0	0	114
26892	0	0	0	117	0	117
26893	0	110	0	0	0	110
26894	0	116	0	0	0	116
26895	118	0	0	0	0	118
26896	0	0	0	119	0	119
26897	0	0	114	0	0	114
26898	0	0	110	0	0	110
26899	0	109	0	0	0	109
26900	113	0	0	0	0	113
26901	0	110	0	0	0	110
26902	0	0	0	111	0	111
26903	111	0	0	0	0	111
26904	1	0	0	106	0	107
26905	0	0	0	113	0	113
26906	0	112	0	0	0	112
26907	0	0	0	109	0	109
26908	0	0	105	0	0	105
26909	102	0	0	0	0	102
26910	0	91	0	0	0	91
26911	0	89	0	0	0	89
26912	98	0	0	0	0	98
26913	1	0	97	0	0	98
26914	95	0	0	0	0	95
26915	0	91	0	0	0	91
26916	0	97	0	0	0	97
26917	0	0	105	0	0	105
26918	0	104	0	0	0	104
26919	0	0	0	111	0	111
26920	0	0	0	108	0	108
26921	0	109	0	0	0	109
26922	0	0	0	112	0	112
26923	114	0	0	0	0	114
26924	0	0	110	0	0	110
26925	114	0	0	0	0	114
26926	113	0	0	0	0	113
26927	113	0	0	0	0	113
26928	0	0	112	0	0	112
26929	1	0	0	107	0	108
26930	0	0	108	0	0	108
26931	115	0	0	1	0	116
26932	108	0	0	0	0	108
26933	0	111	0	0	0	111
26934	0	0	0	110	0	110
26935	0	105	0	0	0	105
26936	0	0	112	0	0	112
26937	0	0	0	115	0	115
26938	116	0	0	0	0	116
26939	118	0	0	0	0	118
26940	0	1	0	111	0	112
26941	0	109	0	2	0	111
26942	0	0	111	0	0	111
26943	0	0	111	0	0	111
26944	115	0	0	0	0	115
26945	0	0	114	0	0	114
26946	0	115	0	0	0	115
26947	0	0	0	120	0	120
26948	0	0	117	0	0	117
26949	0	0	0	121	0	121
26950	0	0	122	0	0	122
26951	123	0	0	0	0	123
26952	0	0	0	121	0	121
26953	1	117	0	0	0	118
26954	0	125	0	0	0	125
26955	0	0	0	128	0	128
26956	0	0	0	132	0	132
26957	0	133	0	0	0	133
26958	0	0	131	0	0	131
26959	0	0	0	139	0	139
26960	0	0	136	0	0	136
26961	0	0	129	0	0	129
26962	133	0	0	0	0	133
26963	0	133	0	0	0	133
26964	132	0	0	0	0	132
26965	0	0	0	133	0	133
26966	0	128	0	0	0	128
26967	0	0	0	132	0	132
26968	0	0	0	127	0	127
26969	0	123	0	0	0	123
26970	0	0	122	0	0	122
26971	0	0	0	123	0	123
26972	122	0	0	0	0	122
26973	0	0	0	119	0	119
26974	0	0	0	121	0	121
26975	0	0	119	0	0	119
26976	0	117	0	0	0	117
26977	0	0	0	123	0	123
26978	0	0	119	0	0	119
26979	0	0	115	0	0	115
26980	113	0	0	0	0	113
26981	0	118	0	0	0	118
26982	114	0	0	0	0	114
26983	0	112	1	0	0	113
26984	1	116	1	0	0	118
26985	116	0	0	0	0	116
26986	0	0	0	119	0	119
26987	0	113	0	0	0	113
26988	0	0	0	114	0	114
26989	113	0	0	0	0	113
26990	0	1	110	0	0	111
26991	0	0	111	0	0	111
26992	111	0	0	0	0	111
26993	0	110	0	0	0	110
26994	0	0	107	1	0	108
26995	0	108	0	0	0	108
26996	0	0	0	115	0	115
26997	0	0	113	0	0	113
26998	0	0	0	110	0	110
26999	3	0	104	0	0	107
27000	111	0	0	0	0	111
27001	0	108	0	1	0	109
27002	109	0	0	3	0	112
27003	0	0	0	109	0	109
27004	0	108	0	0	0	108
27005	110	0	0	0	0	110
27006	110	0	0	0	0	110
27007	0	0	103	0	0	103
27008	0	0	90	0	0	90
27009	99	0	0	0	0	99
27010	0	97	0	0	0	97
27011	0	97	0	0	0	97
27012	0	0	0	101	0	101
27013	0	0	100	0	0	100
27014	0	94	0	0	0	94
27015	0	95	0	0	0	95
27016	0	0	0	96	0	96
27017	100	0	0	0	0	100
27018	96	0	0	0	0	96
27019	99	1	0	0	0	100
27020	0	0	98	0	0	98
27021	98	0	0	0	0	98
27022	103	0	0	0	0	103
27023	99	0	0	0	0	99
27024	0	0	0	95	0	95
27025	0	99	0	0	0	99
27026	102	0	0	0	0	102
27027	0	96	0	0	0	96
27028	0	0	0	100	0	100
27029	1	0	97	0	0	98
27030	0	1	0	102	0	103
27031	0	0	0	103	0	103
27032	0	0	97	0	0	97
27033	0	100	0	0	0	100
27034	0	0	0	105	0	105
27035	101	0	0	0	0	101
27036	0	101	0	0	0	101
27037	100	0	0	0	0	100
27038	0	0	0	104	0	104
27039	1	106	0	0	0	107
27040	105	0	3	0	0	108
27041	0	109	0	2	0	111
27042	0	0	103	0	0	103
27043	102	0	0	4	0	106
27044	99	0	0	0	0	99
27045	0	100	1	0	0	101
27046	0	0	100	0	0	100
27047	1	94	0	0	0	95
27048	1	0	0	103	0	104
27049	0	0	0	102	0	102
27050	0	0	0	103	0	103
27051	0	103	0	0	0	103
27052	0	0	0	104	0	104
27053	1	0	0	105	0	106
27054	103	0	1	0	0	104
27055	0	0	0	108	0	108
27056	0	0	0	111	0	111
27057	110	0	0	0	0	110
27058	0	113	0	0	0	113
27059	112	0	0	0	0	112
27060	112	0	0	0	0	112
27061	117	0	0	0	0	117
27062	1	0	0	115	0	116
27063	0	0	0	115	0	115
27064	0	0	116	0	0	116
27065	0	0	112	0	0	112
27066	0	0	119	0	0	119
27067	121	0	0	0	0	121
27068	0	0	127	0	0	127
27069	0	123	0	0	0	123
27070	0	0	0	130	0	130
27071	0	0	0	134	0	134
27072	0	131	0	0	0	131
27073	1	0	132	0	0	133
27074	0	133	0	0	0	133
27075	135	0	0	0	0	135
27076	0	0	140	0	0	140
27077	0	136	0	0	0	136
27078	0	0	137	0	0	137
27079	0	0	0	138	0	138
27080	0	0	146	0	0	146
27081	0	0	0	137	0	137
27082	143	0	0	0	0	143
27083	0	0	140	0	0	140
27084	0	139	0	0	0	139
27085	151	0	0	1	0	152
27086	1	0	152	0	0	153
27087	0	0	153	0	0	153
27088	0	0	0	159	0	159
27089	0	0	160	1	0	161
27090	156	0	0	0	0	156
27091	0	145	0	0	0	145
27092	0	0	0	160	0	160
27093	0	158	0	0	0	158
27094	161	0	0	0	0	161
27095	1	0	156	0	0	157
27096	0	0	154	0	0	154
27097	1	0	0	152	0	153
27098	1	0	0	157	0	158
27099	0	0	0	159	0	159
27100	0	0	0	156	0	156
27101	0	0	163	0	0	163
27102	0	159	0	0	0	159
27103	0	0	0	160	0	160
27104	0	0	159	0	0	159
27105	0	165	0	0	0	165
27106	168	0	0	0	0	168
27107	0	0	0	168	0	168
27108	165	0	0	0	0	165
27109	0	168	0	0	0	168
27110	170	0	0	0	0	170
27111	0	0	171	0	0	171
27112	0	0	0	168	0	168
27113	0	170	0	0	0	170
27114	0	0	167	0	0	167
27115	0	165	0	0	0	165
27116	0	0	0	164	0	164
27117	168	0	0	0	0	168
27118	0	163	0	0	0	163
27119	169	0	0	0	0	169
27120	0	0	173	0	0	173
27121	0	1	163	0	0	164
27122	174	0	0	0	0	174
27123	0	0	0	172	0	172
27124	0	0	0	171	0	171
27125	0	0	162	0	0	162
27126	0	0	160	0	0	160
27127	0	168	0	0	0	168
27128	173	0	0	0	0	173
27129	171	0	0	0	0	171
27130	0	169	0	0	0	169
27131	0	0	0	163	0	163
27132	163	0	0	0	0	163
27133	1	0	0	167	0	168
27134	166	0	0	0	0	166
27135	166	0	0	0	0	166
27136	170	0	0	0	0	170
27137	0	0	0	173	0	173
27138	0	0	0	182	0	182
27139	180	0	0	0	0	180
27140	178	0	0	0	0	178
27141	184	1	0	0	0	185
27142	0	182	0	0	0	182
27143	183	0	0	1	0	184
27144	0	178	0	0	0	178
27145	183	0	0	0	0	183
27146	0	0	180	1	0	181
27147	193	0	0	0	0	193
27148	0	176	0	1	0	177
27149	0	184	0	0	0	184
27150	194	0	0	0	0	194
27151	0	0	0	196	0	196
27152	0	0	0	195	0	195
27153	0	186	0	0	0	186
27154	0	184	0	0	0	184
27155	198	0	0	0	0	198
27156	0	0	192	0	0	192
27157	0	0	1	197	0	198
27158	200	0	0	0	0	200
27159	4	0	181	0	0	185
27160	0	182	0	0	0	182
27161	181	0	0	4	0	185
27162	0	0	188	0	0	188
27163	0	0	0	185	0	185
27164	0	1	181	2	0	184
27165	178	0	0	0	0	178
27166	0	179	0	0	0	179
27167	184	0	0	0	0	184
27168	183	0	0	0	0	183
27169	0	0	0	187	0	187
27170	179	0	0	0	0	179
27171	0	0	0	179	0	179
27172	0	0	0	193	0	193
27173	0	0	177	0	0	177
27174	0	182	0	0	0	182
27175	0	0	0	189	0	189
27176	0	1	0	183	0	184
27177	0	0	0	184	0	184
27178	1	0	181	0	0	182
27179	0	179	0	0	0	179
27180	0	0	0	180	0	180
27181	0	0	0	172	0	172
27182	0	0	177	0	0	177
27183	0	0	0	172	0	172
27184	167	0	0	0	0	167
27185	0	170	0	0	0	170
27186	171	0	0	0	0	171
27187	0	0	173	0	0	173
27188	0	0	0	169	0	169
27189	169	0	0	2	0	171
27190	174	0	0	0	0	174
27191	0	0	165	0	0	165
27192	0	0	0	168	0	168
27193	0	0	172	0	0	172
27194	170	0	0	0	0	170
27195	0	172	0	0	0	172
27196	179	0	0	0	0	179
27197	168	0	0	0	0	168
27198	1	165	0	0	0	166
27199	165	0	0	0	0	165
27200	0	0	155	0	0	155
27201	169	0	0	0	0	169
27202	2	0	0	160	0	162
27203	0	0	166	0	0	166
27204	0	0	0	161	0	161
27205	0	0	0	160	0	160
27206	2	0	0	156	0	158
27207	0	158	0	0	0	158
27208	158	0	0	0	0	158
27209	0	0	0	158	0	158
27210	0	156	0	0	0	156
27211	0	0	0	161	0	161
27212	0	162	0	0	0	162
27213	0	0	157	0	0	157
27214	0	0	0	158	0	158
27215	0	0	0	157	0	157
27216	0	0	154	0	0	154
27217	151	0	0	1	0	152
27218	0	149	0	0	0	149
27219	0	0	0	154	0	154
27220	0	0	0	154	0	154
27221	0	0	0	150	0	150
27222	0	145	0	0	0	145
27223	154	0	0	1	0	155
27224	1	0	142	0	0	143
27225	0	1	145	0	0	146
27226	1	0	0	148	0	149
27227	0	0	0	154	0	154
27228	154	0	0	0	0	154
27229	0	145	0	0	0	145
27230	0	0	0	146	0	146
27231	148	0	0	0	0	148
27232	0	0	0	139	0	139
27233	144	0	0	0	0	144
27234	0	0	138	0	0	138
27235	0	132	0	0	0	132
27236	143	0	0	0	0	143
27237	0	0	140	0	0	140
27238	140	0	0	0	0	140
27239	0	0	128	1	0	129
27240	130	0	0	0	0	130
27241	4	0	0	125	0	129
27242	121	0	4	0	0	125
27243	0	0	0	124	0	124
27244	0	0	0	124	0	124
27245	125	0	0	0	0	125
27246	2	120	0	0	0	122
27247	0	0	0	119	0	119
27248	122	0	0	1	0	123
27249	118	0	1	0	0	119
27250	0	0	0	115	0	115
27251	1	0	0	121	0	122
27252	121	0	0	0	0	121
27253	0	0	0	122	0	122
27254	0	0	0	121	0	121
27255	120	0	0	0	0	120
27256	0	1	0	118	0	119
27257	0	0	121	0	0	121
27258	124	0	0	0	0	124
27259	0	0	122	0	0	122
27260	0	0	118	0	0	118
27261	124	0	0	0	0	124
27262	0	120	0	0	0	120
27263	0	0	0	125	0	125
27264	0	0	0	133	0	133
27265	0	0	1	125	0	126
27266	0	0	0	126	0	126
27267	125	0	0	0	0	125
27268	126	0	0	0	0	126
27269	131	0	0	0	0	131
27270	0	0	122	0	0	122
27271	0	0	0	126	0	126
27272	0	0	0	125	0	125
27273	1	0	0	126	0	127
27274	0	114	0	1	0	115
27275	0	124	0	0	0	124
27276	126	0	0	0	0	126
27277	0	0	0	127	0	127
27278	0	0	0	130	0	130
27279	0	0	0	135	0	135
27280	0	0	125	0	0	125
27281	0	0	125	0	0	125
27282	126	0	0	0	0	126
27283	131	0	0	0	0	131
27284	0	0	0	133	0	133
27285	0	136	0	0	0	136
27286	0	0	0	136	0	136
27287	0	0	0	139	0	139
27288	0	2	135	0	0	137
27289	131	0	0	0	0	131
27290	0	0	0	136	0	136
27291	0	0	0	138	0	138
27292	129	0	0	0	0	129
27293	0	138	0	0	0	138
27294	138	0	0	0	0	138
27295	0	0	0	137	0	137
27296	0	134	0	0	0	134
27297	139	0	0	0	0	139
27298	0	0	0	138	0	138
27299	139	0	0	0	0	139
27300	143	0	0	0	0	143
27301	141	0	0	0	0	141
27302	0	130	0	0	0	130
27303	0	129	0	0	0	129
27304	0	0	0	139	0	139
27305	0	136	0	0	0	136
27306	144	0	0	0	0	144
27307	0	0	0	144	0	144
27308	147	0	0	0	0	147
27309	144	0	0	0	0	144
27310	0	0	0	144	0	144
27311	0	0	0	145	0	145
27312	143	0	0	0	0	143
27313	141	0	0	0	0	141
27314	147	1	0	0	0	148
27315	153	0	0	0	0	153
27316	151	0	0	0	0	151
27317	0	0	0	150	0	150
27318	0	0	0	149	0	149
27319	1	0	0	151	0	152
27320	150	0	0	0	0	150
27321	1	0	0	149	0	150
27322	0	148	1	0	0	149
27323	0	0	0	161	0	161
27324	165	0	0	0	0	165
27325	162	0	0	0	0	162
27326	0	0	164	0	0	164
27327	0	0	0	156	0	156
27328	3	158	0	0	0	161
27329	157	0	0	0	0	157
27330	0	158	2	0	0	160
27331	0	0	0	168	0	168
27332	161	0	0	0	0	161
27333	167	0	0	0	0	167
27334	0	162	0	3	0	165
27335	1	0	0	170	0	171
27336	0	0	161	0	0	161
27337	169	0	0	0	0	169
27338	0	0	166	0	0	166
27339	166	0	0	0	0	166
27340	176	0	0	0	0	176
27341	0	0	0	168	0	168
27342	167	0	0	0	0	167
27343	166	0	0	0	0	166
27344	162	0	0	0	0	162
27345	0	0	0	163	0	163
27346	159	0	0	0	0	159
27347	0	0	0	161	0	161
27348	1	0	0	158	0	159
27349	0	154	0	0	0	154
27350	0	0	0	155	0	155
27351	0	155	0	0	0	155
27352	152	0	0	0	0	152
27353	149	0	2	0	0	151
27354	1	0	0	151	0	152
27355	0	0	0	155	0	155
27356	150	0	0	0	0	150
27357	0	0	147	0	0	147
27358	148	0	0	0	0	148
27359	0	0	0	148	0	148
27360	0	0	142	0	0	142
27361	147	0	0	0	0	147
27362	146	0	0	0	0	146
27363	0	0	147	0	0	147
27364	141	0	0	0	0	141
27365	0	0	136	0	0	136
27366	0	139	0	2	0	141
27367	148	0	0	0	0	148
27368	148	0	0	0	0	148
27369	0	126	0	2	0	128
27370	0	138	0	3	0	141
27371	148	0	0	0	0	148
27372	153	0	0	0	0	153
27373	0	0	0	149	0	149
27374	0	0	144	0	0	144
27375	0	0	130	0	0	130
27376	148	0	0	0	0	148
27377	0	0	138	0	0	138
27378	139	0	0	0	0	139
27379	0	0	0	136	0	136
27380	0	0	0	141	0	141
27381	0	0	137	0	0	137
27382	141	0	0	0	0	141
27383	0	0	0	142	0	142
27384	0	0	0	142	0	142
27385	141	0	0	0	0	141
27386	135	0	0	1	0	136
27387	137	0	0	0	0	137
27388	0	132	0	1	0	133
27389	0	0	129	0	0	129
27390	134	0	0	0	0	134
27391	123	0	0	0	0	123
27392	0	117	0	0	0	117
27393	128	0	0	0	0	128
27394	0	0	0	123	0	123
27395	0	0	124	0	0	124
27396	125	0	0	0	0	125
27397	125	0	0	0	0	125
27398	125	0	0	0	0	125
27399	121	0	0	1	0	122
27400	0	0	0	121	0	121
27401	0	0	0	125	0	125
27402	119	0	0	0	0	119
27403	0	0	0	125	0	125
27404	0	0	0	123	0	123
27405	0	120	0	0	0	120
27406	0	0	0	122	0	122
27407	0	0	0	115	0	115
27408	0	0	0	118	0	118
27409	0	0	0	123	0	123
27410	0	118	0	0	0	118
27411	0	0	0	124	0	124
27412	0	0	0	123	0	123
27413	0	0	115	0	0	115
27414	0	0	106	0	0	106
27415	0	113	0	0	0	113
27416	115	0	0	1	0	116
27417	0	112	0	0	0	112
27418	0	0	0	120	0	120
27419	0	0	117	0	0	117
27420	121	0	0	0	0	121
27421	0	0	0	119	0	119
27422	119	0	0	0	0	119
27423	115	0	0	0	0	115
27424	0	120	0	0	0	120
27425	122	0	0	0	0	122
27426	0	121	0	0	0	121
27427	0	0	0	124	0	124
27428	2	121	0	0	0	123
27429	0	0	121	0	0	121
27430	0	122	0	0	0	122
27431	0	0	0	125	0	125
27432	124	0	0	0	0	124
27433	0	123	0	0	0	123
27434	0	1	0	119	0	120
27435	0	0	0	126	0	126
27436	0	0	126	0	0	126
27437	0	0	0	121	0	121
27438	0	0	126	0	0	126
27439	123	0	0	0	0	123
27440	0	0	125	0	0	125
27441	0	122	0	0	0	122
27442	0	0	0	125	0	125
27443	0	0	0	123	0	123
27444	0	0	0	124	0	124
27445	118	0	0	0	0	118
27446	0	0	0	122	0	122
27447	0	117	0	0	0	117
27448	120	0	0	0	0	120
27449	0	115	0	0	0	115
27450	0	0	0	121	0	121
27451	118	0	0	0	0	118
27452	0	115	0	0	0	115
27453	0	113	0	0	0	113
27454	121	0	0	0	0	121
27455	117	0	0	0	0	117
27456	0	0	111	0	0	111
27457	116	0	0	0	0	116
27458	2	0	112	0	0	114
27459	0	0	0	111	0	111
27460	0	0	111	0	0	111
27461	1	0	0	112	0	113
27462	0	0	117	0	0	117
27463	0	0	0	115	0	115
27464	0	0	0	116	0	116
27465	116	0	0	0	0	116
27466	0	1	117	0	0	118
27467	118	0	0	0	0	118
27468	0	0	111	0	0	111
27469	0	0	114	0	0	114
27470	0	0	0	113	0	113
27471	116	0	0	0	0	116
27472	0	117	0	0	0	117
27473	113	0	0	0	0	113
27474	113	0	0	1	0	114
27475	0	113	1	0	0	114
27476	114	0	0	0	0	114
27477	0	0	122	0	0	122
27478	0	0	0	126	0	126
27479	123	0	0	0	0	123
27480	0	123	0	0	0	123
27481	0	0	0	133	0	133
27482	0	0	0	131	0	131
27483	0	0	0	134	0	134
27484	0	0	0	132	0	132
27485	138	0	0	0	0	138
27486	136	0	0	0	0	136
27487	135	0	0	0	0	135
27488	128	0	0	0	0	128
27489	0	0	128	0	0	128
27490	134	0	0	1	0	135
27491	135	0	0	0	0	135
27492	0	134	0	0	0	134
27493	0	129	0	0	0	129
27494	0	0	0	131	0	131
27495	0	0	0	142	0	142
27496	0	0	139	0	0	139
27497	0	137	0	1	0	138
27498	0	0	0	146	0	146
27499	0	142	0	0	0	142
27500	0	0	0	148	0	148
27501	0	0	0	144	0	144
27502	0	145	0	0	0	145
27503	0	0	0	142	0	142
27504	0	0	139	0	0	139
27505	0	0	134	0	0	134
27506	140	0	0	1	0	141
27507	141	0	0	0	0	141
27508	0	143	0	0	0	143
27509	145	0	0	0	0	145
27510	0	0	0	145	0	145
27511	136	1	0	0	0	137
27512	0	134	0	1	0	135
27513	0	0	134	0	0	134
27514	140	0	0	0	0	140
27515	0	0	137	0	0	137
27516	0	0	118	0	0	118
27517	0	1	129	0	0	130
27518	0	130	0	0	0	130
27519	136	0	0	0	0	136
27520	132	0	0	0	0	132
27521	0	0	0	132	0	132
27522	0	0	0	126	0	126
27523	0	129	0	0	0	129
27524	124	0	0	1	0	125
27525	0	123	1	0	0	124
27526	0	129	0	0	0	129
27527	132	0	0	0	0	132
27528	0	0	0	128	0	128
27529	1	0	0	128	0	129
27530	0	0	0	131	0	131
27531	0	131	0	0	0	131
27532	135	0	0	0	0	135
27533	0	0	0	128	0	128
27534	0	128	0	0	0	128
27535	0	130	0	0	0	130
27536	0	0	0	132	0	132
27537	0	132	0	0	0	132
27538	0	0	0	137	0	137
27539	129	0	0	0	0	129
27540	0	0	127	0	0	127
27541	0	129	0	0	0	129
27542	0	0	0	138	0	138
27543	0	0	132	0	0	132
27544	139	0	2	0	0	141
27545	0	0	0	136	0	136
27546	136	0	0	1	0	137
27547	132	0	1	0	0	133
27548	0	144	0	0	0	144
27549	146	0	0	2	0	148
27550	144	0	0	0	0	144
27551	144	0	0	0	0	144
27552	0	0	0	146	0	146
27553	0	0	0	146	0	146
27554	0	0	0	155	0	155
27555	0	0	136	0	0	136
27556	0	142	0	0	0	142
27557	149	0	0	0	0	149
27558	0	142	0	0	0	142
27559	0	0	0	144	0	144
27560	0	0	141	0	0	141
27561	149	0	0	0	0	149
27562	0	134	0	0	0	134
27563	0	0	0	142	0	142
27564	0	0	0	151	0	151
27565	0	0	144	0	0	144
27566	0	140	0	0	0	140
27567	0	0	0	152	0	152
27568	0	0	0	151	0	151
27569	0	0	0	150	0	150
27570	144	0	0	0	0	144
27571	0	0	144	0	0	144
27572	0	144	0	0	0	144
27573	147	0	0	0	0	147
27574	0	140	0	0	0	140
27575	0	0	0	138	0	138
27576	0	137	0	0	0	137
27577	139	0	0	0	0	139
27578	137	0	0	0	0	137
27579	0	0	0	138	0	138
27580	0	0	0	138	0	138
27581	0	0	0	143	0	143
27582	0	0	139	0	0	139
27583	0	142	0	0	0	142
27584	0	0	0	149	0	149
27585	0	0	0	151	0	151
27586	0	0	0	154	0	154
27587	0	0	0	146	0	146
27588	0	0	140	0	0	140
27589	0	146	0	0	0	146
27590	0	0	0	145	0	145
27591	0	0	0	146	0	146
27592	0	1	146	0	0	147
27593	0	0	0	143	0	143
27594	0	144	0	0	0	144
27595	0	142	0	0	0	142
27596	0	0	0	148	0	148
27597	0	0	144	0	0	144
27598	145	0	0	0	0	145
27599	0	145	0	0	0	145
27600	0	0	141	1	0	142
27601	0	0	143	0	0	143
27602	0	150	0	0	0	150
27603	0	0	159	0	0	159
27604	0	0	0	150	0	150
27605	162	0	0	0	0	162
27606	154	0	0	0	0	154
27607	158	0	0	0	0	158
27608	159	0	0	0	0	159
27609	0	164	0	0	0	164
27610	162	0	0	0	0	162
27611	0	158	0	0	0	158
27612	0	0	160	0	0	160
27613	1	0	0	162	0	163
27614	0	165	0	0	0	165
27615	0	0	0	169	0	169
27616	169	0	0	0	0	169
27617	0	0	0	173	0	173
27618	0	170	0	0	0	170
27619	179	0	1	0	0	180
27620	0	1	185	0	0	186
27621	0	0	0	183	0	183
27622	4	0	0	187	0	191
27623	188	0	0	0	0	188
27624	0	189	0	0	0	189
27625	0	0	170	4	0	174
27626	0	0	0	181	0	181
27627	0	0	184	0	0	184
27628	0	173	0	2	0	175
27629	0	184	0	0	0	184
27630	188	0	0	0	0	188
27631	0	0	186	0	0	186
27632	189	0	0	0	0	189
27633	0	0	0	193	0	193
27634	0	179	0	0	0	179
27635	191	0	0	0	0	191
27636	0	0	189	0	0	189
27637	0	0	0	185	0	185
27638	0	0	0	187	0	187
27639	3	0	0	191	0	194
27640	0	193	0	0	0	193
27641	175	0	0	0	0	175
27642	0	172	0	0	0	172
27643	1	180	0	0	0	181
27644	0	0	0	181	0	181
27645	178	0	0	0	0	178
27646	173	0	0	1	0	174
27647	174	0	0	0	0	174
27648	0	172	0	0	0	172
27649	0	0	0	172	0	172
27650	0	0	174	0	0	174
27651	0	0	0	166	0	166
27652	0	1	0	169	0	170
27653	0	175	1	0	0	176
27654	172	0	0	0	0	172
27655	0	0	0	164	0	164
27656	0	167	0	0	0	167
27657	169	0	0	0	0	169
27658	1	0	162	0	0	163
27659	166	0	0	0	0	166
27660	1	169	0	0	0	170
27661	170	0	0	0	0	170
27662	172	0	0	0	0	172
27663	0	0	165	0	0	165
27664	172	0	0	0	0	172
27665	0	0	171	0	0	171
27666	0	0	168	2	0	170
27667	175	0	0	0	0	175
27668	174	0	0	0	0	174
27669	0	0	170	0	0	170
27670	0	0	0	164	0	164
27671	0	0	0	167	0	167
27672	1	163	0	0	0	164
27673	170	0	0	0	0	170
27674	171	0	0	0	0	171
27675	0	0	162	0	0	162
27676	166	0	0	0	0	166
27677	157	0	0	1	0	158
27678	3	149	0	0	0	152
27679	0	0	3	150	0	153
27680	0	0	0	157	0	157
27681	0	0	0	153	0	153
27682	155	0	0	0	0	155
27683	0	151	0	0	0	151
27684	0	0	0	149	0	149
27685	0	144	0	0	0	144
27686	0	0	0	145	0	145
27687	0	136	1	0	0	137
27688	0	145	0	0	0	145
27689	154	0	0	0	0	154
27690	150	0	0	0	0	150
27691	0	0	0	148	0	148
27692	0	0	0	149	0	149
27693	0	0	0	141	0	141
27694	0	0	0	149	0	149
27695	0	0	0	142	0	142
27696	0	142	0	0	0	142
27697	0	0	0	145	0	145
27698	0	0	0	141	0	141
27699	138	0	0	0	0	138
27700	0	0	0	135	0	135
27701	3	0	0	141	0	144
27702	0	0	137	0	0	137
27703	1	0	0	144	0	145
27704	0	0	0	148	0	148
27705	1	0	140	0	0	141
27706	0	143	0	0	0	143
27707	0	0	134	0	0	134
27708	0	0	138	0	0	138
27709	0	132	0	0	0	132
27710	146	0	0	0	0	146
27711	139	0	0	0	0	139
27712	0	0	0	141	0	141
27713	138	0	0	0	0	138
27714	0	0	134	0	0	134
27715	0	0	0	132	0	132
27716	0	0	134	0	0	134
27717	0	0	0	133	0	133
27718	0	0	0	133	0	133
27719	0	0	0	135	0	135
27720	133	0	0	0	0	133
27721	0	0	0	129	0	129
27722	131	0	0	0	0	131
27723	133	0	0	0	0	133
27724	0	131	0	0	0	131
27725	133	0	0	0	0	133
27726	0	133	0	0	0	133
27727	0	0	0	138	0	138
27728	0	0	0	143	0	143
27729	0	0	0	144	0	144
27730	0	0	140	0	0	140
27731	0	141	0	0	0	141
27732	0	0	0	144	0	144
27733	0	0	0	142	0	142
27734	0	141	0	0	0	141
27735	143	0	0	0	0	143
27736	0	137	0	0	0	137
27737	138	0	0	0	0	138
27738	0	138	0	0	0	138
27739	0	0	0	141	0	141
27740	0	140	0	0	0	140
27741	144	0	0	0	0	144
27742	143	1	0	0	0	144
27743	144	0	0	0	0	144
27744	145	0	0	0	0	145
27745	0	0	138	0	0	138
27746	148	0	0	0	0	148
27747	148	0	0	0	0	148
27748	153	0	0	0	0	153
27749	0	0	141	0	0	141
27750	142	0	0	0	0	142
27751	0	141	0	0	0	141
27752	146	0	0	0	0	146
27753	0	0	137	0	0	137
27754	142	0	0	0	0	142
27755	135	0	0	0	0	135
27756	0	0	0	141	0	141
27757	0	0	138	0	0	138
27758	135	0	0	0	0	135
27759	0	0	0	143	0	143
27760	0	0	0	138	0	138
27761	0	0	137	0	0	137
27762	149	0	0	0	0	149
27763	151	0	0	0	0	151
27764	0	148	0	0	0	148
27765	0	0	0	154	0	154
27766	0	0	0	157	0	157
27767	0	0	0	152	0	152
27768	0	145	0	0	0	145
27769	154	0	0	0	0	154
27770	0	0	0	163	0	163
27771	0	0	0	165	0	165
27772	163	0	0	0	0	163
27773	160	0	0	1	0	161
27774	1	0	0	161	0	162
27775	0	0	0	157	0	157
27776	0	0	142	0	0	142
27777	148	0	0	0	0	148
27778	0	148	0	0	0	148
27779	0	0	0	160	0	160
27780	0	0	0	150	0	150
27781	0	148	1	2	0	151
27782	0	0	0	157	0	157
27783	155	0	0	0	0	155
27784	0	0	0	155	0	155
27785	0	0	0	152	0	152
27786	0	0	0	163	0	163
27787	0	0	160	0	0	160
27788	0	0	0	160	0	160
27789	0	0	149	0	0	149
27790	0	157	0	0	0	157
27791	0	0	0	171	0	171
27792	0	0	0	172	0	172
27793	0	0	0	170	0	170
27794	0	0	0	162	0	162
27795	0	0	0	162	0	162
27796	157	0	0	1	0	158
27797	0	0	152	0	0	152
27798	0	137	0	0	0	137
27799	0	151	0	0	0	151
27800	0	0	0	162	0	162
27801	0	0	0	160	0	160
27802	0	0	0	160	0	160
27803	0	158	0	0	0	158
27804	0	0	0	169	0	169
27805	0	0	159	0	0	159
27806	0	164	0	0	0	164
27807	0	0	0	169	0	169
27808	167	0	0	0	0	167
27809	0	0	0	165	0	165
27810	1	0	0	170	0	171
27811	0	144	0	0	0	144
27812	0	159	0	0	0	159
27813	0	0	0	172	0	172
27814	0	0	0	171	0	171
27815	0	0	166	0	0	166
27816	0	0	0	168	0	168
27817	0	0	0	171	0	171
27818	1	0	0	170	0	171
27819	0	0	0	168	0	168
27820	164	0	0	0	0	164
27821	155	0	0	0	0	155
27822	0	0	0	158	0	158
27823	0	0	0	158	0	158
27824	145	0	0	0	0	145
27825	0	0	0	152	0	152
27826	0	0	148	0	0	148
27827	0	141	1	0	0	142
27828	0	0	2	152	0	154
27829	0	0	0	161	0	161
27830	152	0	1	0	0	153
27831	0	0	0	157	0	157
27832	0	0	0	158	0	158
27833	161	0	0	0	0	161
27834	0	0	0	160	0	160
27835	0	155	0	0	0	155
27836	0	0	0	160	0	160
27837	0	0	0	162	0	162
27838	1	0	0	166	0	167
27839	0	0	0	164	0	164
27840	0	0	160	0	0	160
27841	0	0	157	1	0	158
27842	0	0	0	164	0	164
27843	1	0	0	173	0	174
27844	0	168	1	0	0	169
27845	0	0	0	173	0	173
27846	0	174	0	0	0	174
27847	176	0	0	0	0	176
27848	0	180	0	0	0	180
27849	0	0	0	182	0	182
27850	0	0	1	183	0	184
27851	0	0	178	0	0	178
27852	189	0	0	0	0	189
27853	182	0	0	0	0	182
27854	0	179	0	0	0	179
27855	0	0	0	175	0	175
27856	0	0	173	0	0	173
27857	0	174	0	0	0	174
27858	181	0	0	0	0	181
27859	175	0	0	0	0	175
27860	0	0	174	0	0	174
27861	179	0	0	0	0	179
27862	0	0	0	179	0	179
27863	0	177	0	0	0	177
27864	181	0	0	1	0	182
27865	1	0	1	179	0	181
27866	180	0	0	0	0	180
27867	181	0	0	0	0	181
27868	0	0	0	178	0	178
27869	0	0	180	0	0	180
27870	180	0	0	0	0	180
27871	181	0	0	0	0	181
27872	168	0	0	0	0	168
27873	0	172	1	0	0	173
27874	0	0	0	172	0	172
27875	3	0	0	177	0	180
27876	0	0	172	1	0	173
27877	2	0	0	170	0	172
27878	1	162	0	3	0	166
27879	170	0	0	0	0	170
27880	1	165	0	0	0	166
27881	0	0	164	1	0	165
27882	0	165	0	0	0	165
27883	1	160	0	0	0	161
27884	0	0	0	168	0	168
27885	165	0	0	0	0	165
27886	166	0	0	0	0	166
27887	167	0	0	0	0	167
27888	0	164	0	0	0	164
27889	1	1	172	0	0	174
27890	168	0	0	0	0	168
27891	166	0	0	0	0	166
27892	0	170	0	0	0	170
27893	175	0	0	0	0	175
27894	1	0	0	170	0	171
27895	1	0	170	0	0	171
27896	174	0	0	0	0	174
27897	177	0	0	0	0	177
27898	171	0	0	2	0	173
27899	0	0	0	169	0	169
27900	0	0	0	176	0	176
27901	0	0	0	179	0	179
27902	1	173	0	0	0	174
27903	0	0	0	176	0	176
27904	0	0	0	177	0	177
27905	0	1	175	0	0	176
27906	0	0	0	175	0	175
27907	0	0	0	178	0	178
27908	0	0	0	176	0	176
27909	0	0	0	176	0	176
27910	0	174	0	0	0	174
27911	0	0	0	175	0	175
27912	0	0	0	183	0	183
27913	185	0	0	0	0	185
27914	0	0	179	0	0	179
27915	0	0	171	0	0	171
27916	182	0	0	0	0	182
27917	186	0	0	1	0	187
27918	1	0	0	188	0	189
27919	0	192	0	0	0	192
27920	190	0	0	1	0	191
27921	0	0	0	196	0	196
27922	0	191	0	0	0	191
27923	200	0	0	0	0	200
27924	0	197	1	0	0	198
27925	193	0	0	1	0	194
27926	192	0	0	0	0	192
27927	1	190	0	0	0	191
27928	0	0	0	195	0	195
27929	0	0	192	0	0	192
27930	1	0	0	189	0	190
27931	192	0	0	0	0	192
27932	0	0	187	0	0	187
27933	0	184	0	0	0	184
27934	0	0	0	189	0	189
27935	0	0	184	0	0	184
27936	0	183	0	0	0	183
27937	185	0	0	0	0	185
27938	0	0	0	192	0	192
27939	1	0	0	187	0	188
27940	0	1	0	184	0	185
27941	0	185	1	0	0	186
27942	185	0	0	0	0	185
27943	0	173	0	0	0	173
27944	0	181	0	0	0	181
27945	196	0	0	0	0	196
27946	195	0	0	0	0	195
27947	0	0	194	0	0	194
27948	197	0	0	0	0	197
27949	188	0	1	0	0	189
27950	0	0	0	189	0	189
27951	0	0	185	1	0	186
27952	0	0	0	193	0	193
27953	191	0	0	0	0	191
27954	0	0	184	0	0	184
27955	0	0	0	191	0	191
27956	1	0	0	190	0	191
27957	0	0	0	195	0	195
27958	185	0	0	1	0	186
27959	0	186	1	0	0	187
27960	193	0	0	0	0	193
27961	0	0	190	0	0	190
27962	0	0	0	199	0	199
27963	0	191	0	0	0	191
27964	202	0	0	0	0	202
27965	0	0	0	199	0	199
27966	0	0	195	0	0	195
27967	0	0	0	199	0	199
27968	195	0	0	0	0	195
27969	0	202	0	1	0	203
27970	0	0	0	209	0	209
27971	0	211	1	0	0	212
27972	213	0	0	0	0	213
27973	210	0	0	0	0	210
27974	0	213	0	0	0	213
27975	210	0	0	0	0	210
27976	0	0	0	211	0	211
27977	0	202	0	0	0	202
27978	210	0	0	0	0	210
27979	210	0	0	0	0	210
27980	0	190	0	0	0	190
27981	0	203	0	0	0	203
27982	205	0	0	0	0	205
27983	0	0	0	207	0	207
27984	206	0	0	1	0	207
27985	0	0	0	211	0	211
27986	0	0	199	0	0	199
27987	0	0	0	203	0	203
27988	207	0	0	0	0	207
27989	0	0	209	0	0	209
27990	0	0	0	210	0	210
27991	0	0	0	212	0	212
27992	0	0	209	0	0	209
27993	203	0	0	0	0	203
27994	0	2	0	203	0	205
27995	0	0	203	0	0	203
27996	190	0	0	0	0	190
27997	0	197	0	0	0	197
27998	1	179	0	1	0	181
27999	0	193	0	0	0	193
28000	0	0	195	0	0	195
28001	0	0	0	204	0	204
28002	0	0	195	0	0	195
28003	0	0	0	208	0	208
28004	0	204	0	1	0	205
28005	0	201	0	0	0	201
28006	0	0	0	206	0	206
28007	202	0	0	0	0	202
28008	1	0	0	203	0	204
28009	0	0	0	200	0	200
28010	1	203	0	0	0	204
28011	198	0	0	0	0	198
28012	0	195	0	0	0	195
28013	0	0	0	199	0	199
28014	0	0	0	202	0	202
28015	0	192	0	0	0	192
28016	0	0	0	197	0	197
28017	199	0	0	0	0	199
28018	0	2	0	197	0	199
28019	0	0	0	195	0	195
28020	0	192	0	0	0	192
28021	0	0	0	194	0	194
28022	202	0	0	0	0	202
28023	192	0	0	0	0	192
28024	187	0	0	0	0	187
28025	0	0	0	188	0	188
28026	0	0	178	0	0	178
28027	0	0	169	0	0	169
28028	0	0	0	180	0	180
28029	183	0	0	0	0	183
28030	1	0	0	176	0	177
28031	183	0	0	0	0	183
28032	0	0	0	182	0	182
28033	0	0	0	181	0	181
28034	177	0	0	0	0	177
28035	0	0	169	0	0	169
28036	176	1	0	0	0	177
28037	1	0	164	0	0	165
28038	0	0	0	164	0	164
28039	161	0	0	0	0	161
28040	0	0	153	0	0	153
28041	0	0	146	0	0	146
28042	155	0	0	0	0	155
28043	0	0	160	0	0	160
28044	0	161	0	0	0	161
28045	0	0	0	175	0	175
28046	189	0	0	1	0	190
28047	0	0	186	0	0	186
28048	188	0	0	0	0	188
28049	197	0	0	0	0	197
28050	192	0	0	0	0	192
28051	192	0	1	0	0	193
28052	0	0	0	190	0	190
28053	0	183	0	0	0	183
28054	189	0	0	0	0	189
28055	0	0	173	0	0	173
28056	1	181	0	0	0	182
28057	183	0	0	1	0	184
28058	0	179	0	0	0	179
28059	0	171	0	0	0	171
28060	0	0	0	178	0	178
28061	0	0	0	173	0	173
28062	0	0	0	184	0	184
28063	183	0	0	0	0	183
28064	182	0	0	0	0	182
28065	0	0	0	189	0	189
28066	0	0	0	188	0	188
28067	0	0	184	0	0	184
28068	193	1	0	0	0	194
28069	193	0	0	0	0	193
28070	0	0	0	193	0	193
28071	0	1	0	193	0	194
28072	0	0	191	0	0	191
28073	0	0	1	190	0	191
28074	0	0	191	0	0	191
28075	0	179	0	0	0	179
28076	0	0	193	0	0	193
28077	0	0	0	203	0	203
28078	0	0	192	0	0	192
28079	0	0	190	0	0	190
28080	207	0	0	0	0	207
28081	0	0	0	201	0	201
28082	1	0	204	0	0	205
28083	198	0	0	1	0	199
28084	0	0	196	0	0	196
28085	0	0	183	0	0	183
28086	0	204	0	0	0	204
28087	0	0	0	210	0	210
28088	0	0	203	0	0	203
28089	0	0	202	0	0	202
28090	0	0	0	212	0	212
28091	0	0	0	213	0	213
28092	0	212	0	0	0	212
28093	0	0	0	219	0	219
28094	221	0	0	0	0	221
28095	217	0	0	0	0	217
28096	205	2	0	1	0	208
28097	0	0	0	212	0	212
28098	0	212	0	1	0	213
28099	213	0	0	0	0	213
28100	0	206	0	0	0	206
28101	1	198	0	0	0	199
28102	0	215	0	0	0	215
28103	216	0	0	0	0	216
28104	0	0	0	216	0	216
28105	0	0	0	213	0	213
28106	0	217	0	0	0	217
28107	218	0	0	0	0	218
28108	0	0	219	0	0	219
28109	0	0	0	220	0	220
28110	211	0	0	0	0	211
28111	0	219	0	0	0	219
28112	220	0	0	0	0	220
28113	0	0	0	225	0	225
28114	0	220	0	0	0	220
28115	0	0	220	1	0	221
28116	226	0	0	0	0	226
28117	0	0	0	225	0	225
28118	221	0	0	1	0	222
28119	0	0	0	226	0	226
28120	0	220	0	1	0	221
28121	0	0	215	1	0	216
28122	0	1	210	0	0	211
28123	0	0	0	229	0	229
28124	231	0	0	0	0	231
28125	231	0	0	0	0	231
28126	0	0	0	230	0	230
28127	0	0	0	227	0	227
28128	231	1	0	0	0	232
28129	0	0	0	227	0	227
28130	225	0	0	0	0	225
28131	0	224	0	0	0	224
28132	226	0	1	0	0	227
28133	0	0	222	0	0	222
28134	0	0	0	220	0	220
28135	0	0	0	224	0	224
28136	2	0	0	228	0	230
28137	0	218	0	1	0	219
28138	0	198	0	0	0	198
28139	0	0	0	201	0	201
28140	1	0	198	0	0	199
28141	0	0	1	185	0	186
28142	0	0	0	192	0	192
28143	0	180	0	1	0	181
28144	193	0	0	0	0	193
28145	0	183	0	0	0	183
28146	0	188	0	1	0	189
28147	0	0	0	188	0	188
28148	0	0	0	187	0	187
28149	0	0	0	191	0	191
28150	0	0	0	189	0	189
28151	193	0	0	0	0	193
28152	0	197	0	0	0	197
28153	194	0	0	0	0	194
28154	194	1	0	0	0	195
28155	0	0	0	189	0	189
28156	0	0	0	195	0	195
28157	194	0	0	0	0	194
28158	184	0	0	0	0	184
28159	0	0	0	186	0	186
28160	0	0	0	181	0	181
28161	1	0	175	0	0	176
28162	0	154	1	2	0	157
28163	0	178	0	0	0	178
28164	186	0	0	0	0	186
28165	0	0	171	0	0	171
28166	0	0	163	2	0	165
28167	187	0	0	0	0	187
28168	176	0	0	1	0	177
28169	0	164	0	1	0	165
28170	0	175	0	1	0	176
28171	0	0	0	188	0	188
28172	188	0	0	1	0	189
28173	194	0	0	0	0	194
28174	192	0	0	0	0	192
28175	0	0	0	183	0	183
28176	0	0	0	190	0	190
28177	1	0	177	0	0	178
28178	3	0	162	0	0	165
28179	2	0	170	0	0	172
28180	0	0	0	185	0	185
28181	186	0	0	0	0	186
28182	0	0	179	1	0	180
28183	0	0	0	184	0	184
28184	0	171	0	0	0	171
28185	0	0	0	190	0	190
28186	0	0	0	192	0	192
28187	0	0	188	0	0	188
28188	0	0	0	195	0	195
28189	194	0	0	0	0	194
28190	1	0	185	0	0	186
28191	0	0	0	198	0	198
28192	0	0	196	0	0	196
28193	0	180	0	2	0	182
28194	0	0	194	0	0	194
28195	0	0	0	206	0	206
28196	0	0	0	200	0	200
28197	1	0	203	0	0	204
28198	0	0	0	200	0	200
28199	0	0	0	203	0	203
28200	1	190	1	2	0	194
28201	0	0	184	0	0	184
28202	0	0	0	190	0	190
28203	0	0	0	199	0	199
28204	0	196	0	0	0	196
28205	0	0	0	199	0	199
28206	202	0	0	0	0	202
28207	0	0	0	199	0	199
28208	0	0	201	0	0	201
28209	214	0	0	0	0	214
28210	215	1	0	0	0	216
28211	0	0	210	0	0	210
28212	225	0	0	0	0	225
28213	0	222	0	0	0	222
28214	0	0	0	233	0	233
28215	0	0	0	242	0	242
28216	0	0	0	242	0	242
28217	0	0	0	249	0	249
28218	0	0	0	256	0	256
28219	253	0	0	0	0	253
28220	0	0	254	0	0	254
28221	249	0	0	1	0	250
28222	0	0	246	0	0	246
28223	0	0	0	257	0	257
28224	253	0	0	2	0	255
28225	2	1	0	259	0	262
28226	0	249	0	0	0	249
28227	257	0	0	2	0	259
28228	0	0	0	255	0	255
28229	2	0	240	1	0	243
28230	254	0	0	1	0	255
28231	0	249	0	0	0	249
28232	0	0	243	0	0	243
28233	2	0	0	253	0	255
28234	1	0	0	255	0	256
28235	0	245	0	0	0	245
28236	0	0	252	0	0	252
28237	0	0	0	257	0	257
28238	0	0	259	0	0	259
28239	0	0	0	261	0	261
28240	0	0	0	261	0	261
28241	0	0	249	0	0	249
28242	0	0	2	265	0	267
28243	2	0	0	261	0	263
28244	0	0	0	274	0	274
28245	0	0	0	268	0	268
28246	268	0	0	0	0	268
28247	0	0	266	0	0	266
28248	261	0	0	0	0	261
28249	0	0	0	263	0	263
28250	0	0	0	258	0	258
28251	0	0	0	271	0	271
28252	0	260	0	2	0	262
28253	276	0	0	0	0	276
28254	0	0	0	286	0	286
28255	1	281	1	0	0	283
28256	0	0	0	287	0	287
28257	291	0	0	0	0	291
28258	287	0	0	1	0	288
28259	279	0	0	1	0	280
28260	0	276	0	0	0	276
28261	0	0	277	0	0	277
28262	297	0	0	0	0	297
28263	298	0	0	0	0	298
28264	0	296	0	0	0	296
28265	290	0	0	0	0	290
28266	292	0	0	0	0	292
28267	290	0	0	0	0	290
28268	0	273	2	0	0	275
28269	1	0	0	293	0	294
28270	292	0	0	1	0	293
28271	297	0	0	1	0	298
28272	286	1	0	0	0	287
28273	287	0	0	0	0	287
28274	0	0	0	290	0	290
28275	0	0	269	0	0	269
28276	1	0	0	279	0	280
28277	0	263	0	0	0	263
28278	0	0	0	277	0	277
28279	0	0	259	1	0	260
28280	269	0	0	0	0	269
28281	0	0	0	264	0	264
28282	265	0	0	0	0	265
28283	263	1	0	0	0	264
28284	0	0	0	264	0	264
28285	0	0	255	0	0	255
28286	3	0	230	0	0	233
28287	249	0	0	0	0	249
28288	0	239	1	0	0	240
28289	0	231	3	0	0	234
28290	0	230	0	1	0	231
28291	0	258	0	0	0	258
28292	260	0	0	0	0	260
28293	259	0	0	1	0	260
28294	262	0	0	0	0	262
28295	257	0	0	0	0	257
28296	0	0	0	259	0	259
28297	0	257	0	0	0	257
28298	261	0	0	0	0	261
28299	0	0	254	0	0	254
28300	0	246	0	0	0	246
28301	0	0	251	0	0	251
28302	253	0	0	0	0	253
28303	254	0	0	1	0	255
28304	238	0	0	0	0	238
28305	0	1	0	231	0	232
28306	0	0	224	0	0	224
28307	0	229	0	0	0	229
28308	224	0	0	0	0	224
28309	0	219	0	0	0	219
28310	0	202	0	0	0	202
28311	0	211	0	0	0	211
28312	0	211	0	0	0	211
28313	0	0	195	0	0	195
28314	0	209	0	0	0	209
28315	215	0	0	0	0	215
28316	0	0	0	215	0	215
28317	0	0	0	215	0	215
28318	217	0	0	0	0	217
28319	0	209	0	1	0	210
28320	0	0	196	0	0	196
28321	0	0	0	192	0	192
28322	0	0	0	196	0	196
28323	0	0	0	201	0	201
28324	0	0	194	0	0	194
28325	0	0	183	0	0	183
28326	0	0	0	190	0	190
28327	0	0	190	0	0	190
28328	0	0	183	0	0	183
28329	184	0	0	1	0	185
28330	0	178	0	0	0	178
28331	0	175	0	0	0	175
28332	0	179	0	0	0	179
28333	0	0	0	189	0	189
28334	0	186	0	0	0	186
28335	185	0	0	0	0	185
28336	0	0	185	0	0	185
28337	183	0	0	0	0	183
28338	0	0	0	180	0	180
28339	0	0	0	179	0	179
28340	0	181	0	1	0	182
28341	188	0	0	0	0	188
28342	192	0	0	0	0	192
28343	0	199	0	0	0	199
28344	0	0	0	204	0	204
28345	0	0	205	1	0	206
28346	0	0	207	0	0	207
28347	0	216	0	0	0	216
28348	210	0	0	0	0	210
28349	0	0	214	0	0	214
28350	0	0	0	228	0	228
28351	228	0	0	0	0	228
28352	225	0	0	0	0	225
28353	0	218	0	0	0	218
28354	0	214	0	2	0	216
28355	219	0	0	0	0	219
28356	0	0	217	0	0	217
28357	216	0	0	0	0	216
28358	213	0	0	0	0	213
28359	0	0	0	212	0	212
28360	0	0	213	0	0	213
28361	0	0	216	0	0	216
28362	219	0	0	0	0	219
28363	0	0	216	0	0	216
28364	220	0	0	0	0	220
28365	214	0	0	0	0	214
28366	0	219	0	0	0	219
28367	0	0	221	0	0	221
28368	0	217	0	0	0	217
28369	221	0	0	0	0	221
28370	0	0	221	0	0	221
28371	0	0	1	214	0	215
28372	0	0	213	0	0	213
28373	0	0	209	0	0	209
28374	0	0	206	1	0	207
28375	0	0	216	0	0	216
28376	0	215	0	0	0	215
28377	0	0	221	0	0	221
28378	0	211	0	0	0	211
28379	0	0	218	0	0	218
28380	217	0	0	0	0	217
28381	0	0	0	213	0	213
28382	0	218	0	0	0	218
28383	205	1	0	0	0	206
28384	200	0	0	1	0	201
28385	199	0	0	0	0	199
28386	193	0	0	0	0	193
28387	0	194	0	0	0	194
28388	193	0	0	1	0	194
28389	196	0	0	0	0	196
28390	0	194	0	0	0	194
28391	0	0	196	0	0	196
28392	0	0	0	194	0	194
28393	1	198	0	0	0	199
28394	0	0	198	0	0	198
28395	0	0	198	0	0	198
28396	0	198	0	0	0	198
28397	1	195	0	0	0	196
28398	1	187	0	0	0	188
28399	0	214	0	0	0	214
28400	217	0	0	1	0	218
28401	222	0	0	0	0	222
28402	0	1	219	0	0	220
28403	1	0	218	0	0	219
28404	2	0	1	220	0	223
28405	0	0	0	220	0	220
28406	0	0	0	236	0	236
28407	230	0	0	0	0	230
28408	0	220	0	2	0	222
28409	1	203	0	0	0	204
28410	0	232	0	0	0	232
28411	240	0	0	0	0	240
28412	239	0	0	0	0	239
28413	0	0	0	236	0	236
28414	248	0	0	0	0	248
28415	242	0	0	0	0	242
28416	0	0	0	242	0	242
28417	241	0	0	1	0	242
28418	0	240	0	0	0	240
28419	0	0	0	241	0	241
28420	0	0	233	0	0	233
28421	0	234	0	0	0	234
28422	0	0	237	0	0	237
28423	0	0	0	246	0	246
28424	0	244	0	0	0	244
28425	0	0	0	249	0	249
28426	1	0	0	251	0	252
28427	0	0	239	0	0	239
28428	0	0	235	0	0	235
28429	1	0	0	237	0	238
28430	1	0	0	248	0	249
28431	0	234	0	0	0	234
28432	241	0	0	0	0	241
28433	0	241	0	0	0	241
28434	1	235	0	1	0	237
28435	0	0	223	1	0	224
28436	0	227	0	0	0	227
28437	0	0	0	222	0	222
28438	0	219	0	0	0	219
28439	0	0	0	203	0	203
28440	1	211	0	1	0	213
28441	208	0	0	0	0	208
28442	0	214	0	0	0	214
28443	0	0	0	205	0	205
28444	0	205	0	0	0	205
28445	204	0	0	0	0	204
28446	195	0	0	0	0	195
28447	0	193	0	1	0	194
28448	196	0	0	0	0	196
28449	0	0	0	192	0	192
28450	0	0	192	0	0	192
28451	0	0	175	0	0	175
28452	0	180	0	0	0	180
28453	184	0	0	0	0	184
28454	183	0	0	0	0	183
28455	0	0	172	0	0	172
28456	0	1	161	0	0	162
28457	173	0	0	0	0	173
28458	169	0	0	0	0	169
28459	0	0	173	0	0	173
28460	170	0	0	0	0	170
28461	0	163	0	2	0	165
28462	0	181	0	0	0	181
28463	0	0	0	190	0	190
28464	0	0	0	189	0	189
28465	191	0	0	0	0	191
28466	189	0	0	0	0	189
28467	184	0	0	0	0	184
28468	0	0	1	184	0	185
28469	0	0	0	182	0	182
28470	0	171	0	1	0	172
28471	0	170	0	0	0	170
28472	0	170	0	0	0	170
28473	0	0	0	181	0	181
28474	0	176	0	0	0	176
28475	0	0	172	0	0	172
28476	184	0	0	0	0	184
28477	1	0	183	0	0	184
28478	0	0	178	0	0	178
28479	183	0	0	0	0	183
28480	0	190	0	0	0	190
28481	198	0	0	0	0	198
28482	198	0	0	0	0	198
28483	1	0	184	1	0	186
28484	0	0	178	0	0	178
28485	1	176	0	0	0	177
28486	0	0	185	1	0	186
28487	1	0	0	182	0	183
28488	0	0	0	181	0	181
28489	1	176	0	1	0	178
28490	1	182	0	0	0	183
28491	188	0	0	0	0	188
28492	180	0	2	0	0	182
28493	0	0	3	184	0	187
28494	1	0	0	182	0	183
28495	184	0	0	0	0	184
28496	179	0	1	0	0	180
28497	0	179	0	0	0	179
28498	173	0	0	3	0	176
28499	0	167	0	0	0	167
28500	0	182	0	0	0	182
28501	189	0	0	0	0	189
28502	178	0	0	0	0	178
28503	0	0	0	180	0	180
28504	178	0	0	0	0	178
28505	0	0	172	0	0	172
28506	0	168	0	0	0	168
28507	172	0	0	0	0	172
28508	0	0	168	0	0	168
28509	1	0	0	171	0	172
28510	0	163	0	0	0	163
28511	0	169	1	0	0	170
28512	176	0	0	0	0	176
28513	0	0	171	0	0	171
28514	172	0	0	0	0	172
28515	0	0	0	170	0	170
28516	0	0	167	0	0	167
28517	163	0	0	0	0	163
28518	0	165	0	0	0	165
28519	0	165	0	0	0	165
28520	174	0	0	0	0	174
28521	173	0	0	0	0	173
28522	167	0	1	0	0	168
28523	0	0	0	171	0	171
28524	0	0	0	169	0	169
28525	1	0	160	0	0	161
28526	0	0	144	0	0	144
28527	0	159	0	1	0	160
28528	0	0	0	167	0	167
28529	165	0	0	0	0	165
28530	0	165	0	1	0	166
28531	0	0	0	164	0	164
28532	161	0	0	0	0	161
28533	0	154	0	0	0	154
28534	0	155	0	0	0	155
28535	0	0	162	0	0	162
28536	168	0	0	0	0	168
28537	167	0	0	0	0	167
28538	1	0	166	0	0	167
28539	169	0	0	0	0	169
28540	1	0	158	0	0	159
28541	0	151	1	0	0	152
28542	0	0	0	163	0	163
28543	164	0	0	0	0	164
28544	0	155	0	0	0	155
28545	0	163	0	0	0	163
28546	165	0	0	0	0	165
28547	1	0	165	0	0	166
28548	165	0	0	1	0	166
28549	0	169	0	0	0	169
28550	0	0	167	0	0	167
28551	177	0	0	0	0	177
28552	171	0	0	0	0	171
28553	0	0	0	172	0	172
28554	0	0	0	176	0	176
28555	0	156	0	0	0	156
28556	0	0	159	0	0	159
28557	0	0	0	157	0	157
28558	0	0	154	0	0	154
28559	0	0	157	0	0	157
28560	0	0	0	166	0	166
28561	0	0	160	0	0	160
28562	0	0	161	0	0	161
28563	1	0	0	156	0	157
28564	0	0	161	0	0	161
28565	159	0	0	0	0	159
28566	0	158	0	1	0	159
28567	0	0	155	0	0	155
28568	1	0	154	0	0	155
28569	1	0	1	151	0	153
28570	159	0	0	0	0	159
28571	163	0	0	0	0	163
28572	151	4	0	0	0	155
28573	157	0	0	4	0	161
28574	0	0	0	152	0	152
28575	0	0	152	0	0	152
28576	157	0	0	0	0	157
28577	155	0	0	0	0	155
28578	154	0	0	0	0	154
28579	0	0	150	0	0	150
28580	157	0	0	0	0	157
28581	0	0	0	157	0	157
28582	0	153	0	0	0	153
28583	0	0	0	167	0	167
28584	0	161	0	0	0	161
28585	165	0	0	0	0	165
28586	0	0	154	0	0	154
28587	0	0	0	154	0	154
28588	0	147	0	1	0	148
28589	0	156	0	0	0	156
28590	160	0	0	0	0	160
28591	166	0	0	0	0	166
28592	0	0	159	0	0	159
28593	161	0	0	0	0	161
28594	0	0	0	161	0	161
28595	0	0	161	0	0	161
28596	0	1	149	0	0	150
28597	0	0	0	161	0	161
28598	167	0	0	0	0	167
28599	0	0	0	169	0	169
28600	1	0	0	174	0	175
28601	0	0	0	174	0	174
28602	0	174	0	0	0	174
28603	0	0	0	176	0	176
28604	174	0	0	0	0	174
28605	0	176	0	0	0	176
28606	0	0	0	182	0	182
28607	182	0	0	0	0	182
28608	0	180	0	0	0	180
28609	0	179	0	0	0	179
28610	0	0	0	183	0	183
28611	184	0	0	0	0	184
28612	0	1	175	0	0	176
28613	0	0	177	1	0	178
28614	183	0	0	0	0	183
28615	176	0	0	0	0	176
28616	0	182	0	1	0	183
28617	0	0	0	187	0	187
28618	0	0	179	0	0	179
28619	0	0	169	0	0	169
28620	0	0	177	0	0	177
28621	1	177	0	0	0	178
28622	0	187	0	0	0	187
28623	188	0	0	0	0	188
28624	0	0	183	0	0	183
28625	184	0	0	0	0	184
28626	184	0	0	0	0	184
28627	0	0	178	0	0	178
28628	0	174	0	0	0	174
28629	0	0	0	183	0	183
28630	0	0	178	0	0	178
28631	0	0	160	0	0	160
28632	172	0	0	0	0	172
28633	0	175	0	0	0	175
28634	0	0	0	180	0	180
28635	0	0	0	187	0	187
28636	0	185	0	0	0	185
28637	0	179	0	0	0	179
28638	0	178	0	0	0	178
28639	0	0	0	187	0	187
28640	181	0	0	0	0	181
28641	0	0	0	173	0	173
28642	0	0	173	0	0	173
28643	0	0	165	0	0	165
28644	0	0	0	174	0	174
28645	0	0	172	0	0	172
28646	0	173	2	0	0	175
28647	0	0	0	172	0	172
28648	176	0	0	0	0	176
28649	171	0	0	0	0	171
28650	0	180	0	0	0	180
28651	184	0	1	2	0	187
28652	183	0	0	0	0	183
28653	187	0	0	0	0	187
28654	0	0	187	0	0	187
28655	200	0	0	0	0	200
28656	0	193	0	1	0	194
28657	0	0	185	0	0	185
28658	0	0	181	0	0	181
28659	0	187	0	0	0	187
28660	198	0	0	0	0	198
28661	0	0	0	193	0	193
28662	0	194	0	0	0	194
28663	195	0	0	0	0	195
28664	0	0	0	191	0	191
28665	196	0	0	0	0	196
28666	0	0	0	194	0	194
28667	1	0	186	0	0	187
28668	3	0	169	0	0	172
28669	0	0	186	0	0	186
28670	0	0	0	179	0	179
28671	0	0	0	193	0	193
28672	3	0	182	0	0	185
28673	0	182	0	0	0	182
28674	182	1	0	0	0	183
28675	174	0	0	0	0	174
28676	0	173	0	0	0	173
28677	0	0	0	178	0	178
28678	0	0	172	0	0	172
28679	178	0	0	0	0	178
28680	0	0	173	1	0	174
28681	0	0	163	0	0	163
28682	0	0	171	0	0	171
28683	176	0	0	0	0	176
28684	0	0	177	0	0	177
28685	0	161	0	0	0	161
28686	0	172	0	0	0	172
28687	0	0	0	184	0	184
28688	0	0	0	182	0	182
28689	0	0	175	0	0	175
28690	181	0	0	0	0	181
28691	183	0	0	0	0	183
28692	0	0	0	186	0	186
28693	175	0	0	0	0	175
28694	0	176	0	0	0	176
28695	176	1	0	0	0	177
28696	0	154	0	0	0	154
28697	0	172	0	0	0	172
28698	179	0	0	0	0	179
28699	181	0	0	0	0	181
28700	182	0	0	0	0	182
28701	181	0	0	0	0	181
28702	0	0	173	0	0	173
28703	178	0	0	0	0	178
28704	0	0	0	177	0	177
28705	0	183	0	0	0	183
28706	186	0	0	0	0	186
28707	0	185	0	0	0	185
28708	186	0	0	0	0	186
28709	0	0	0	191	0	191
28710	0	0	0	191	0	191
28711	0	0	184	0	0	184
28712	0	0	168	0	0	168
28713	0	191	0	0	0	191
28714	193	0	0	0	0	193
28715	0	189	0	0	0	189
28716	0	191	0	1	0	192
28717	1	199	0	0	0	200
28718	1	0	195	0	0	196
28719	0	211	0	1	0	212
28720	203	0	0	0	0	203
28721	207	0	0	0	0	207
28722	0	0	0	210	0	210
28723	1	200	0	0	0	201
28724	0	208	0	0	0	208
28725	0	0	0	217	0	217
28726	1	0	205	0	0	206
28727	0	208	0	0	0	208
28728	0	0	0	210	0	210
28729	209	0	0	0	0	209
28730	204	0	0	1	0	205
28731	0	216	0	0	0	216
28732	223	0	0	0	0	223
28733	224	0	0	0	0	224
28734	0	0	0	231	0	231
28735	0	0	216	0	0	216
28736	0	227	0	0	0	227
28737	0	1	0	235	0	236
28738	0	0	224	0	0	224
28739	0	227	0	0	0	227
28740	234	0	0	0	0	234
28741	229	0	0	0	0	229
28742	0	0	0	233	0	233
28743	0	229	0	0	0	229
28744	0	1	225	0	0	226
28745	4	0	0	236	0	240
28746	0	0	230	0	0	230
28747	0	230	0	4	0	234
28748	0	0	0	239	0	239
28749	231	0	0	1	0	232
28750	0	231	0	0	0	231
28751	235	0	0	0	0	235
28752	237	0	0	0	0	237
28753	0	242	0	0	0	242
28754	0	0	0	240	0	240
28755	0	0	0	240	0	240
28756	0	240	0	0	0	240
28757	0	235	0	1	0	236
28758	1	0	0	244	0	245
28759	0	245	0	0	0	245
28760	251	0	0	0	0	251
28761	254	0	0	0	0	254
28762	0	0	250	0	0	250
28763	0	1	229	3	0	233
28764	254	0	0	0	0	254
28765	247	0	0	0	0	247
28766	0	260	0	0	0	260
28767	255	0	0	3	0	258
28768	251	0	0	1	0	252
28769	0	260	0	0	0	260
28770	262	0	0	0	0	262
28771	0	1	0	267	0	268
28772	0	0	0	266	0	266
28773	0	0	256	0	0	256
28774	0	240	1	0	0	241
28775	0	276	0	0	0	276
28776	280	0	0	0	0	280
28777	272	0	0	0	0	272
28778	274	1	0	0	0	275
28779	276	0	0	0	0	276
28780	0	0	268	0	0	268
28781	3	0	257	0	0	260
28782	0	276	0	0	0	276
28783	0	0	0	278	0	278
28784	0	0	0	274	0	274
28785	0	276	0	0	0	276
28786	0	0	0	283	0	283
28787	276	0	0	0	0	276
28788	0	272	1	0	0	273
28789	0	0	272	0	0	272
28790	0	275	0	2	0	277
28791	277	0	0	0	0	277
28792	0	0	273	0	0	273
28793	278	0	0	1	0	279
28794	275	0	0	0	0	275
28795	0	0	273	0	0	273
28796	0	0	260	0	0	260
28797	0	0	263	0	0	263
28798	269	0	0	0	0	269
28799	0	0	271	0	0	271
28800	1	263	0	0	0	264
28801	267	0	0	0	0	267
28802	0	0	259	0	0	259
28803	252	0	0	0	0	252
28804	0	0	243	0	0	243
28805	0	0	240	0	0	240
28806	1	244	0	0	0	245
28807	1	0	240	0	0	241
28808	0	0	235	0	0	235
28809	1	207	0	0	0	208
28810	240	0	0	0	0	240
28811	0	0	242	0	0	242
28812	0	0	0	232	0	232
28813	0	232	0	0	0	232
28814	239	0	0	0	0	239
28815	238	0	0	0	0	238
28816	0	0	225	0	0	225
28817	1	214	0	0	0	215
28818	0	228	0	0	0	228
28819	0	1	0	231	0	232
28820	0	223	0	0	0	223
28821	1	0	0	230	0	231
28822	0	0	0	236	0	236
28823	0	229	0	0	0	229
28824	0	0	0	229	0	229
28825	4	214	0	1	0	219
28826	0	1	220	0	0	221
28827	0	0	0	222	0	222
28828	0	0	0	227	0	227
28829	3	214	0	0	0	217
28830	0	219	0	0	0	219
28831	0	0	0	220	0	220
28832	0	216	0	0	0	216
28833	211	0	0	0	0	211
28834	0	0	0	213	0	213
28835	0	212	0	0	0	212
28836	210	0	0	0	0	210
28837	0	204	0	0	0	204
28838	0	0	202	0	0	202
28839	0	0	0	213	0	213
28840	204	0	0	0	0	204
28841	0	0	198	0	0	198
28842	1	0	0	199	0	200
28843	0	206	0	0	0	206
28844	0	0	196	0	0	196
28845	0	205	0	0	0	205
28846	199	0	0	0	0	199
28847	196	0	0	1	0	197
28848	0	202	0	0	0	202
28849	200	0	0	0	0	200
28850	0	1	190	0	0	191
28851	0	0	0	187	0	187
28852	0	0	0	197	0	197
28853	0	196	0	0	0	196
28854	201	0	0	0	0	201
28855	200	0	0	0	0	200
28856	0	0	199	0	0	199
28857	191	0	0	0	0	191
28858	191	1	0	0	0	192
28859	186	0	0	0	0	186
28860	0	0	1	186	0	187
28861	0	0	0	188	0	188
28862	0	186	0	0	0	186
28863	184	0	0	1	0	185
28864	184	0	0	0	0	184
28865	0	181	0	0	0	181
28866	0	0	0	183	0	183
28867	0	174	0	0	0	174
28868	0	172	0	0	0	172
28869	174	0	0	0	0	174
28870	0	0	163	0	0	163
28871	1	1	158	0	0	160
28872	0	171	0	0	0	171
28873	174	0	0	0	0	174
28874	0	0	167	0	0	167
28875	0	166	0	0	0	166
28876	176	0	0	0	0	176
28877	0	0	170	0	0	170
28878	0	0	0	163	0	163
28879	174	0	0	0	0	174
28880	1	0	167	1	0	169
28881	0	0	162	0	0	162
28882	0	0	156	0	0	156
28883	0	0	170	0	0	170
28884	172	0	0	0	0	172
28885	162	0	0	0	0	162
28886	0	172	0	0	0	172
28887	0	0	0	174	0	174
28888	1	0	0	176	0	177
28889	0	175	0	0	0	175
28890	0	0	0	183	0	183
28891	0	173	0	0	0	173
28892	0	170	0	0	0	170
28893	0	0	0	182	0	182
28894	0	0	180	0	0	180
28895	0	181	0	0	0	181
28896	0	0	0	185	0	185
28897	185	0	0	0	0	185
28898	0	0	177	1	0	178
28899	179	0	0	0	0	179
28900	177	0	0	0	0	177
28901	0	0	0	172	0	172
28902	0	0	172	0	0	172
28903	0	0	165	0	0	165
28904	0	171	0	0	0	171
28905	0	0	0	173	0	173
28906	0	0	175	0	0	175
28907	0	0	174	0	0	174
28908	0	173	0	0	0	173
28909	176	0	0	0	0	176
28910	169	0	0	0	0	169
28911	0	0	0	176	0	176
28912	0	0	168	0	0	168
28913	0	0	163	1	0	164
28914	0	169	0	0	0	169
28915	0	0	170	0	0	170
28916	0	0	168	0	0	168
28917	0	0	0	175	0	175
28918	1	0	176	0	0	177
28919	178	0	0	0	0	178
28920	0	0	0	177	0	177
28921	0	0	175	0	0	175
28922	0	177	0	0	0	177
28923	0	0	0	182	0	182
28924	0	0	170	0	0	170
28925	0	174	0	0	0	174
28926	0	0	0	189	0	189
28927	0	185	0	0	0	185
28928	0	0	0	192	0	192
28929	0	0	0	194	0	194
28930	0	0	184	1	0	185
28931	0	194	1	0	0	195
28932	0	0	0	192	0	192
28933	0	0	1	199	0	200
28934	0	0	0	202	0	202
28935	0	0	192	0	0	192
28936	0	189	0	0	0	189
28937	0	0	0	196	0	196
28938	0	0	186	0	0	186
28939	0	198	0	0	0	198
28940	0	0	0	202	0	202
28941	0	0	197	0	0	197
28942	0	201	0	0	0	201
28943	0	0	0	208	0	208
28944	0	0	0	208	0	208
28945	0	0	196	0	0	196
28946	202	0	0	1	0	203
28947	0	207	0	0	0	207
28948	213	0	0	0	0	213
28949	0	0	207	0	0	207
28950	217	0	0	0	0	217
28951	0	0	0	224	0	224
28952	0	0	0	226	0	226
28953	0	0	218	1	0	219
28954	221	0	0	0	0	221
28955	227	0	0	0	0	227
28956	0	208	0	0	0	208
28957	1	226	0	0	0	227
28958	221	0	0	0	0	221
28959	1	0	227	0	0	228
28960	0	226	0	0	0	226
28961	0	0	0	229	0	229
28962	0	0	0	235	0	235
28963	0	0	236	0	0	236
28964	227	0	0	0	0	227
28965	0	0	233	0	0	233
28966	231	0	0	0	0	231
28967	0	0	227	0	0	227
28968	0	233	0	0	0	233
28969	238	0	0	0	0	238
28970	241	0	0	0	0	241
28971	237	0	0	0	0	237
28972	238	0	0	0	0	238
28973	0	0	0	230	0	230
28974	0	0	228	0	0	228
28975	0	0	0	229	0	229
28976	0	221	0	0	0	221
28977	0	0	0	228	0	228
28978	0	0	223	0	0	223
28979	1	0	228	0	0	229
28980	0	0	0	234	0	234
28981	236	0	0	0	0	236
28982	229	0	0	0	0	229
28983	229	1	0	0	0	230
28984	0	0	219	1	0	220
28985	0	0	225	0	0	225
28986	0	221	0	0	0	221
28987	0	241	0	0	0	241
28988	238	1	0	0	0	239
28989	240	0	0	0	0	240
28990	0	245	0	1	0	246
28991	255	0	0	0	0	255
28992	258	0	0	0	0	258
28993	0	260	0	0	0	260
28994	259	0	0	0	0	259
28995	265	0	0	0	0	265
28996	0	267	0	0	0	267
28997	263	0	0	1	0	264
28998	261	0	0	0	0	261
28999	1	0	252	0	0	253
29000	1	0	229	0	0	230
29001	0	239	0	0	0	239
29002	0	266	0	0	0	266
29003	270	0	0	1	0	271
29004	270	0	0	0	0	270
29005	264	0	0	0	0	264
29006	0	267	1	0	0	268
29007	1	0	0	265	0	266
29008	0	0	253	0	0	253
29009	0	0	0	258	0	258
29010	1	263	0	1	0	265
29011	271	0	0	0	0	271
29012	0	264	0	0	0	264
29013	0	0	0	267	0	267
29014	271	0	0	0	0	271
29015	267	0	0	0	0	267
29016	0	0	268	0	0	268
29017	276	0	0	0	0	276
29018	272	0	0	0	0	272
29019	272	1	0	1	0	274
29020	1	0	0	272	0	273
29021	0	273	0	0	0	273
29022	0	0	0	283	0	283
29023	1	0	269	0	0	270
29024	0	269	0	0	0	269
29025	0	0	0	276	0	276
29026	0	0	267	0	0	267
29027	0	272	0	0	0	272
29028	0	0	0	262	0	262
29029	0	0	256	0	0	256
29030	260	0	0	0	0	260
29031	0	1	261	0	0	262
29032	0	0	246	0	0	246
29033	0	262	0	0	0	262
29034	1	0	0	273	0	274
29035	0	0	0	261	0	261
29036	0	236	0	0	0	236
29037	0	0	0	263	0	263
29038	260	0	0	1	0	261
29039	259	0	0	0	0	259
29040	0	2	232	0	0	234
29041	257	0	0	0	0	257
29042	253	0	0	0	0	253
29043	0	0	248	0	0	248
29044	0	228	0	0	0	228
29045	0	237	0	0	0	237
29046	1	0	0	239	0	240
29047	0	242	0	0	0	242
29048	0	0	236	0	0	236
29049	0	0	223	0	0	223
29050	0	246	0	0	0	246
29051	240	0	0	0	0	240
29052	243	0	0	0	0	243
29053	243	0	0	0	0	243
29054	244	1	0	0	0	245
29055	237	0	0	0	0	237
29056	1	241	0	0	0	242
29057	0	0	238	1	0	239
29058	0	0	0	246	0	246
29059	247	0	0	0	0	247
29060	0	247	0	0	0	247
29061	0	0	0	239	0	239
29062	0	0	236	0	0	236
29063	1	218	0	1	0	220
29064	0	237	2	0	0	239
29065	240	0	0	0	0	240
29066	0	238	0	0	0	238
29067	0	0	0	249	0	249
29068	237	0	0	1	0	238
29069	249	0	0	0	0	249
29070	233	0	0	0	0	233
29071	0	0	225	0	0	225
29072	0	223	0	0	0	223
29073	233	0	0	0	0	233
29074	0	0	0	225	0	225
29075	223	0	0	0	0	223
29076	0	232	0	0	0	232
29077	234	0	0	0	0	234
29078	234	0	0	0	0	234
29079	0	0	0	228	0	228
29080	0	0	227	0	0	227
29081	0	0	0	217	0	217
29082	231	0	0	0	0	231
29083	215	0	0	0	0	215
29084	0	218	1	0	0	219
29085	207	0	0	0	0	207
29086	0	206	0	0	0	206
29087	211	0	0	0	0	211
29088	207	0	0	0	0	207
29089	0	1	191	0	0	192
29090	1	199	0	0	0	200
29091	0	0	0	216	0	216
29092	0	0	0	205	0	205
29093	0	0	0	211	0	211
29094	0	200	0	0	0	200
29095	0	0	196	0	0	196
29096	0	0	175	0	0	175
29097	0	190	0	0	0	190
29098	202	0	0	0	0	202
29099	0	0	196	0	0	196
29100	192	0	0	1	0	193
29101	0	187	0	1	0	188
29102	1	0	187	0	0	188
29103	0	0	0	195	0	195
29104	0	1	200	0	0	201
29105	0	0	191	0	0	191
29106	2	0	0	186	0	188
29107	0	185	1	0	0	186
29108	0	192	0	0	0	192
29109	191	0	0	0	0	191
29110	0	0	190	0	0	190
29111	181	1	0	0	0	182
29112	178	0	0	0	0	178
29113	0	182	0	0	0	182
29114	178	0	0	0	0	178
29115	173	0	0	1	0	174
29116	170	0	0	0	0	170
29117	0	161	0	0	0	161
29118	2	146	0	0	0	148
29119	0	161	0	0	0	161
29120	168	0	0	0	0	168
29121	167	0	0	0	0	167
29122	0	0	154	0	0	154
29123	2	0	149	0	0	151
29124	164	0	0	0	0	164
29125	162	0	0	0	0	162
29126	162	0	0	0	0	162
29127	0	0	0	154	0	154
29128	0	0	0	156	0	156
29129	0	1	0	160	0	161
29130	0	1	0	158	0	159
29131	0	0	143	0	0	143
29132	1	0	138	0	0	139
29133	0	0	145	0	0	145
29134	0	0	146	0	0	146
29135	154	0	0	0	0	154
29136	1	141	0	0	0	142
29137	0	153	0	0	0	153
29138	153	0	0	1	0	154
29139	1	0	149	0	0	150
29140	0	0	145	1	0	146
29141	158	0	0	0	0	158
29142	148	0	0	0	0	148
29143	0	142	0	0	0	142
29144	0	0	0	149	0	149
29145	150	0	0	0	0	150
29146	147	0	0	0	0	147
29147	1	0	0	135	0	136
29148	0	147	0	0	0	147
29149	146	0	0	0	0	146
29150	0	0	140	0	0	140
29151	138	0	0	0	0	138
29152	0	137	0	0	0	137
29153	140	0	0	0	0	140
29154	145	0	0	0	0	145
29155	1	0	134	0	0	135
29156	0	0	131	2	0	133
29157	145	0	0	1	0	146
29158	151	0	0	0	0	151
29159	0	156	0	0	0	156
29160	0	0	0	154	0	154
29161	1	0	154	1	0	156
29162	153	0	1	0	0	154
29163	0	0	0	154	0	154
29164	0	0	0	164	0	164
29165	156	1	0	0	0	157
29166	0	165	0	0	0	165
29167	161	0	0	0	0	161
29168	164	0	0	0	0	164
29169	164	0	0	0	0	164
29170	0	167	0	0	0	167
29171	162	0	0	0	0	162
29172	0	0	0	162	0	162
29173	0	0	0	160	0	160
29174	0	0	154	0	0	154
29175	0	0	141	0	0	141
29176	0	154	0	0	0	154
29177	1	152	0	0	0	153
29178	0	0	157	1	0	158
29179	0	166	0	0	0	166
29180	168	0	0	0	0	168
29181	168	0	0	0	0	168
29182	170	0	0	0	0	170
29183	0	0	0	174	0	174
29184	0	0	0	174	0	174
29185	0	0	170	0	0	170
29186	0	177	0	0	0	177
29187	171	0	0	0	0	171
29188	0	168	0	0	0	168
29189	175	0	0	0	0	175
29190	174	0	0	0	0	174
29191	0	0	0	167	0	167
29192	0	0	0	170	0	170
29193	0	0	0	174	0	174
29194	0	0	160	0	0	160
29195	0	159	0	0	0	159
29196	0	165	0	0	0	165
29197	0	151	0	0	0	151
29198	1	147	0	0	0	148
29199	0	154	0	0	0	154
29200	156	0	0	0	0	156
29201	0	0	156	0	0	156
29202	0	150	0	0	0	150
29203	0	0	148	0	0	148
29204	0	150	0	0	0	150
29205	0	0	0	146	0	146
29206	0	0	0	152	0	152
29207	0	153	0	0	0	153
29208	156	0	0	0	0	156
29209	0	0	139	0	0	139
29210	0	144	0	0	0	144
29211	0	0	144	0	0	144
29212	1	0	0	135	0	136
29213	0	0	0	145	0	145
29214	0	140	0	0	0	140
29215	0	0	0	139	0	139
29216	0	0	0	141	0	141
29217	0	138	0	0	0	138
29218	0	0	135	0	0	135
29219	0	0	129	0	0	129
29220	133	0	0	0	0	133
29221	135	0	0	0	0	135
29222	0	0	0	129	0	129
29223	0	0	132	0	0	132
29224	0	0	0	130	0	130
29225	0	132	0	0	0	132
29226	0	0	125	0	0	125
29227	0	127	0	0	0	127
29228	0	0	121	0	0	121
29229	0	121	0	0	0	121
29230	123	0	0	0	0	123
29231	0	0	0	121	0	121
29232	0	0	0	123	0	123
29233	0	0	116	1	0	117
29234	1	0	113	0	0	114
29235	0	117	0	0	0	117
29236	116	0	0	0	0	116
29237	0	0	0	118	0	118
29238	0	0	118	0	0	118
29239	0	0	115	0	0	115
29240	117	0	0	0	0	117
29241	111	1	0	0	0	112
29242	0	0	113	0	0	113
29243	0	0	0	107	0	107
29244	1	109	0	0	0	110
29245	115	0	0	0	0	115
29246	0	113	0	0	0	113
29247	115	0	0	2	0	117
29248	0	118	0	0	0	118
29249	0	119	0	0	0	119
29250	0	0	0	123	0	123
29251	0	0	0	118	0	118
29252	0	110	0	1	0	111
29253	0	0	106	0	0	106
29254	0	0	110	0	0	110
29255	0	0	126	0	0	126
29256	139	0	0	0	0	139
29257	137	0	0	0	0	137
29258	0	141	0	0	0	141
29259	0	0	132	0	0	132
29260	0	0	0	133	0	133
29261	0	0	130	0	0	130
29262	0	0	130	0	0	130
29263	0	0	0	138	0	138
29264	0	0	0	135	0	135
29265	0	0	158	0	0	158
29266	159	0	0	0	0	159
29267	0	159	1	0	0	160
29268	0	160	0	0	0	160
29269	0	0	0	160	0	160
29270	164	0	0	0	0	164
29271	0	162	0	0	0	162
29272	161	0	0	0	0	161
29273	0	160	0	0	0	160
29274	162	0	0	0	0	162
29275	0	0	159	0	0	159
29276	0	0	149	0	0	149
29277	0	0	0	156	0	156
29278	0	0	155	0	0	155
29279	0	143	0	0	0	143
29280	0	151	0	0	0	151
29281	154	0	0	0	0	154
29282	0	0	0	150	0	150
29283	0	146	1	0	0	147
29284	150	0	0	0	0	150
29285	144	0	0	1	0	145
29286	148	0	0	0	0	148
29287	0	0	0	149	0	149
29288	0	0	0	148	0	148
29289	0	0	146	0	0	146
29290	0	0	145	0	0	145
29291	147	0	0	0	0	147
29292	0	0	0	145	0	145
29293	0	0	143	0	0	143
29294	147	0	0	0	0	147
29295	0	151	0	0	0	151
29296	148	0	0	0	0	148
29297	148	0	0	0	0	148
29298	142	1	0	0	0	143
29299	0	0	142	0	0	142
29300	143	0	0	0	0	143
29301	0	0	0	140	0	140
29302	1	126	0	0	0	127
29303	1	139	0	0	0	140
29304	147	0	0	0	0	147
29305	147	0	0	1	0	148
29306	146	0	0	0	0	146
29307	0	0	0	144	0	144
29308	0	0	0	147	0	147
29309	1	0	0	145	0	146
29310	0	143	0	0	0	143
29311	145	0	0	0	0	145
29312	147	0	0	0	0	147
29313	145	0	0	0	0	145
29314	0	0	143	0	0	143
29315	147	0	0	0	0	147
29316	0	1	0	144	0	145
29317	1	141	0	0	0	142
29318	142	0	0	0	0	142
29319	142	0	0	0	0	142
29320	0	0	144	0	0	144
29321	0	0	0	141	0	141
29322	1	142	0	0	0	143
29323	145	0	0	0	0	145
29324	0	0	0	139	0	139
29325	1	0	1	133	0	135
29326	0	0	0	140	0	140
29327	0	0	0	143	0	143
29328	0	0	136	0	0	136
29329	0	130	0	0	0	130
29330	0	0	0	136	0	136
29331	0	0	140	0	0	140
29332	139	0	0	0	0	139
29333	130	0	0	0	0	130
29334	0	0	0	139	0	139
29335	138	0	0	0	0	138
29336	143	0	0	0	0	143
29337	0	0	132	0	0	132
29338	0	129	0	0	0	129
29339	133	0	0	0	0	133
29340	0	0	0	120	0	120
29341	126	0	0	0	0	126
29342	0	0	0	126	0	126
29343	0	0	0	114	0	114
29344	0	0	124	0	0	124
29345	123	0	0	0	0	123
29346	0	113	0	0	0	113
29347	0	0	118	1	0	119
29348	0	96	0	0	0	96
29349	108	0	0	0	0	108
29350	0	0	0	83	0	83
29351	87	0	0	0	0	87
29352	0	85	0	0	0	85
29353	79	0	0	0	0	79
29354	87	0	0	0	0	87
29355	81	0	0	0	0	81
29356	77	0	0	0	0	77
29357	0	67	0	0	0	67
29358	52	0	0	0	0	52
29359	0	0	0	54	0	54
29360	0	0	0	43	0	43
29361	0	40	0	0	0	40
29362	1	37	0	0	0	38
29363	0	33	0	0	0	33
29364	35	0	0	0	0	35
29365	0	25	0	1	0	26
29366	0	32	0	0	0	32
29367	33	0	0	0	0	33
29368	30	0	0	0	0	30
29369	0	30	0	0	0	30
29370	31	0	0	0	0	31
29371	0	0	29	0	0	29
29372	30	0	0	0	0	30
29373	0	0	26	0	0	26
29374	0	24	0	0	0	24
29375	0	26	0	0	0	26
29376	0	0	0	25	0	25
29377	26	0	0	0	0	26
29378	27	0	0	0	0	27
29379	25	0	0	0	0	25
29380	25	0	0	0	0	25
29381	26	0	0	0	0	26
29382	0	0	21	0	0	21
29383	0	0	21	0	0	21
29384	27	0	0	0	0	27
29385	0	27	0	0	0	27
29386	26	0	0	0	0	26
29387	25	0	0	0	0	25
29388	26	0	0	0	0	26
29389	24	0	0	0	0	24
29390	26	0	0	0	0	26
29391	0	0	27	0	0	27
29392	26	0	0	0	0	26
29393	25	0	0	0	0	25
29394	0	0	23	0	0	23
29395	24	0	0	0	0	24
29396	25	0	0	0	0	25
29397	0	0	21	0	0	21
29398	0	0	24	0	0	24
29399	0	23	0	0	0	23
29400	0	0	0	26	0	26
29401	0	0	22	0	0	22
29402	23	0	0	0	0	23
29403	0	0	0	25	0	25
29404	0	0	23	0	0	23
29405	25	0	0	0	0	25
29406	26	0	0	0	0	26
29407	26	0	0	0	0	26
29408	0	26	0	0	0	26
29409	0	0	0	23	0	23
29410	0	25	0	0	0	25
29411	25	0	0	0	0	25
29412	23	0	0	0	0	23
29413	0	1	22	0	0	23
29414	0	22	0	0	0	22
29415	0	21	0	0	0	21
29416	0	0	0	23	0	23
29417	0	0	0	23	0	23
29418	23	0	0	0	0	23
29419	0	22	0	0	0	22
29420	0	25	0	0	0	25
29421	0	0	23	0	0	23
29422	0	26	0	0	0	26
29423	26	0	0	0	0	26
29424	0	0	23	0	0	23
29425	26	0	0	0	0	26
29426	0	0	24	0	0	24
29427	25	0	0	0	0	25
29428	0	24	0	0	0	24
29429	22	0	0	0	0	22
29430	0	0	20	0	0	20
29431	23	0	0	0	0	23
29432	22	0	0	0	0	22
29433	0	0	25	0	0	25
29434	21	0	0	0	0	21
29435	25	0	0	0	0	25
29436	21	0	0	0	0	21
29437	0	25	0	0	0	25
29438	24	0	0	1	0	25
29439	0	0	24	0	0	24
29440	0	24	0	0	0	24
29441	24	0	0	0	0	24
29442	24	0	0	0	0	24
29443	24	0	0	0	0	24
29444	0	24	0	0	0	24
29445	0	0	0	25	0	25
29446	0	0	24	0	0	24
29447	1	0	0	27	0	28
29448	0	0	25	0	0	25
29449	28	0	0	0	0	28
29450	0	27	0	0	0	27
29451	0	0	0	27	0	27
29452	0	29	0	0	0	29
29453	0	0	0	29	0	29
29454	0	0	0	28	0	28
29455	0	28	0	0	0	28
29456	0	0	0	30	0	30
29457	0	0	0	31	0	31
29458	0	30	0	0	0	30
29459	0	31	0	0	0	31
29460	0	0	0	32	0	32
29461	0	0	30	0	0	30
29462	0	30	0	0	0	30
29463	0	0	0	31	0	31
29464	0	0	30	0	0	30
29465	0	30	0	0	0	30
29466	30	0	0	0	0	30
29467	0	0	29	0	0	29
29468	30	0	0	0	0	30
29469	0	0	0	29	0	29
29470	0	0	0	31	0	31
29471	0	0	0	31	0	31
29472	0	0	31	0	0	31
29473	1	0	27	0	0	28
29474	27	0	0	0	0	27
29475	0	0	0	30	0	30
29476	0	0	27	0	0	27
29477	26	0	0	0	0	26
29478	0	0	0	27	0	27
29479	0	0	0	25	0	25
29480	0	0	0	27	0	27
29481	0	25	0	0	0	25
29482	0	0	0	26	0	26
29483	0	21	0	0	0	21
29484	0	24	0	0	0	24
29485	25	0	0	0	0	25
29486	26	0	0	0	0	26
29487	27	0	0	0	0	27
29488	0	28	0	0	0	28
29489	26	0	0	0	0	26
29490	28	0	0	0	0	28
29491	0	0	0	29	0	29
29492	0	0	0	30	0	30
29493	0	0	29	0	0	29
29494	0	33	0	0	0	33
29495	33	0	0	0	0	33
29496	33	0	0	0	0	33
29497	0	31	0	0	0	31
29498	33	0	0	0	0	33
29499	30	0	0	0	0	30
29500	0	0	0	31	0	31
29501	0	28	0	0	0	28
29502	0	31	0	0	0	31
29503	33	0	0	0	0	33
29504	0	0	0	33	0	33
29505	0	0	30	0	0	30
29506	34	0	0	0	0	34
29507	0	0	31	0	0	31
29508	0	33	1	0	0	34
29509	33	0	0	0	0	33
29510	0	0	30	1	0	31
29511	0	0	0	31	0	31
29512	0	0	33	0	0	33
29513	0	34	0	0	0	34
29514	0	0	0	33	0	33
29515	0	0	31	0	0	31
29516	31	0	0	0	0	31
29517	0	32	0	0	0	32
29518	0	0	0	35	0	35
29519	0	34	0	0	0	34
29520	33	0	0	0	0	33
29521	35	0	0	0	0	35
29522	0	32	0	0	0	32
29523	0	0	0	34	0	34
29524	0	32	0	0	0	32
29525	33	0	0	0	0	33
29526	0	0	34	0	0	34
29527	0	0	29	0	0	29
29528	0	32	0	0	0	32
29529	0	30	0	0	0	30
29530	0	0	0	34	0	34
29531	33	0	0	0	0	33
29532	32	0	0	0	0	32
29533	31	0	0	0	0	31
29534	0	32	0	0	0	32
29535	0	0	0	31	0	31
29536	0	29	0	0	0	29
29537	30	0	0	0	0	30
29538	0	0	0	30	0	30
29539	0	0	27	0	0	27
29540	0	25	0	0	0	25
29541	26	0	1	0	0	27
29542	0	0	24	0	0	24
29543	25	0	0	0	0	25
29544	0	24	0	0	0	24
29545	0	24	0	0	0	24
29546	27	0	0	0	0	27
29547	0	26	0	0	0	26
29548	28	0	0	0	0	28
29549	0	27	0	0	0	27
29550	28	0	0	0	0	28
29551	27	0	0	0	0	27
29552	0	0	21	0	0	21
29553	0	0	24	0	0	24
29554	0	25	0	0	0	25
29555	27	0	0	0	0	27
29556	0	0	25	0	0	25
29557	28	0	0	0	0	28
29558	0	0	0	26	0	26
29559	0	0	28	0	0	28
29560	0	0	27	0	0	27
29561	0	0	31	0	0	31
29562	0	31	0	0	0	31
29563	0	0	0	31	0	31
29564	30	0	0	0	0	30
29565	0	0	0	32	0	32
29566	27	0	0	0	0	27
29567	0	0	0	35	0	35
29568	35	0	0	0	0	35
29569	36	0	0	0	0	36
29570	36	0	0	0	0	36
29571	0	38	0	0	0	38
29572	0	0	42	0	0	42
29573	0	0	0	38	0	38
29574	0	0	0	37	0	37
29575	0	0	0	39	0	39
29576	0	0	0	41	0	41
29577	0	41	0	0	0	41
29578	0	0	39	0	0	39
29579	0	38	0	0	0	38
29580	0	0	0	43	0	43
29581	0	0	0	43	0	43
29582	0	0	0	42	0	42
29583	0	0	0	43	0	43
29584	1	42	0	0	0	43
29585	0	42	0	0	0	42
29586	0	0	41	0	0	41
29587	0	0	0	39	0	39
29588	0	0	0	35	0	35
29589	0	0	0	40	0	40
29590	38	0	0	0	0	38
29591	0	38	0	0	0	38
29592	0	0	37	0	0	37
29593	40	0	0	0	0	40
29594	0	0	0	36	0	36
29595	40	0	0	0	0	40
29596	0	0	0	39	0	39
29597	39	0	0	0	0	39
29598	0	0	0	38	0	38
29599	38	0	0	0	0	38
29600	0	0	38	0	0	38
29601	0	0	0	38	0	38
29602	0	39	0	0	0	39
29603	0	0	0	39	0	39
29604	38	0	0	0	0	38
29605	0	35	0	0	0	35
29606	0	0	0	37	0	37
29607	0	34	0	0	0	34
29608	0	0	0	37	0	37
29609	0	0	0	37	0	37
29610	0	0	35	0	0	35
29611	0	0	0	37	0	37
29612	0	0	33	0	0	33
29613	0	36	0	0	0	36
29614	36	0	0	0	0	36
29615	0	0	35	0	0	35
29616	35	0	0	0	0	35
29617	36	0	0	0	0	36
29618	0	0	0	35	0	35
29619	0	0	35	0	0	35
29620	35	0	0	0	0	35
29621	36	0	0	0	0	36
29622	0	0	0	32	0	32
29623	0	0	0	35	0	35
29624	0	34	0	0	0	34
29625	0	0	0	36	0	36
29626	0	36	0	0	0	36
29627	0	0	36	0	0	36
29628	0	0	0	36	0	36
29629	36	0	0	0	0	36
29630	37	0	0	0	0	37
29631	0	34	0	0	0	34
29632	0	0	0	35	0	35
29633	35	0	0	0	0	35
29634	0	34	0	0	0	34
29635	34	0	0	0	0	34
29636	0	0	0	36	0	36
29637	41	0	0	0	0	41
29638	0	0	45	0	0	45
29639	0	49	0	0	0	49
29640	48	0	0	0	0	48
29641	0	49	0	0	0	49
29642	50	0	0	0	0	50
29643	53	0	0	0	0	53
29644	0	0	52	0	0	52
29645	0	0	0	51	0	51
29646	54	0	0	0	0	54
29647	0	0	52	0	0	52
29648	54	0	0	0	0	54
29649	1	0	0	52	0	53
29650	0	0	54	0	0	54
29651	0	0	0	53	0	53
29652	51	0	0	0	0	51
29653	0	0	50	0	0	50
29654	0	0	2	50	0	52
29655	0	0	0	51	0	51
29656	52	0	0	0	0	52
29657	50	0	0	0	0	50
29658	0	49	0	0	0	49
29659	0	0	0	52	0	52
29660	0	0	0	49	0	49
29661	0	0	0	46	0	46
29662	45	0	0	0	0	45
29663	43	0	0	0	0	43
29664	0	0	0	44	0	44
29665	0	40	0	0	0	40
29666	0	0	0	38	0	38
29667	0	38	0	0	0	38
29668	39	0	0	0	0	39
29669	0	38	0	0	0	38
29670	38	0	0	0	0	38
29671	0	0	0	40	0	40
29672	39	0	0	0	0	39
29673	0	1	38	0	0	39
29674	0	38	0	0	0	38
29675	41	0	0	0	0	41
29676	41	0	0	0	0	41
29677	0	0	0	42	0	42
29678	0	39	0	0	0	39
29679	0	0	0	42	0	42
29680	0	0	0	43	0	43
29681	0	0	0	43	0	43
29682	44	0	0	0	0	44
29683	42	0	0	0	0	42
29684	0	0	0	44	0	44
29685	0	40	0	0	0	40
29686	41	0	0	0	0	41
29687	0	0	41	0	0	41
29688	0	0	0	40	0	40
29689	0	0	40	0	0	40
29690	0	0	0	40	0	40
29691	0	0	39	0	0	39
29692	0	0	0	39	0	39
29693	41	0	0	0	0	41
29694	40	0	0	0	0	40
29695	0	37	0	0	0	37
29696	41	0	0	0	0	41
29697	0	0	0	41	0	41
29698	0	0	0	40	0	40
29699	40	0	0	0	0	40
29700	0	0	40	0	0	40
29701	0	0	41	0	0	41
29702	0	0	34	0	0	34
29703	38	0	0	0	0	38
29704	0	0	38	0	0	38
29705	0	0	39	0	0	39
29706	32	0	0	0	0	32
29707	0	37	0	0	0	37
29708	0	0	0	37	0	37
29709	0	0	0	38	0	38
29710	0	0	38	0	0	38
29711	39	0	0	0	0	39
29712	35	0	1	0	0	36
29713	38	0	0	0	0	38
29714	0	0	37	0	0	37
29715	39	0	0	0	0	39
29716	0	0	29	0	0	29
29717	0	24	0	0	0	24
29718	0	34	0	0	0	34
29719	34	0	0	0	0	34
29720	0	28	0	0	0	28
29721	0	29	0	0	0	29
29722	31	0	0	0	0	31
29723	0	32	0	0	0	32
29724	32	0	0	0	0	32
29725	0	0	0	35	0	35
29726	0	0	0	36	0	36
29727	0	0	0	37	0	37
29728	0	0	0	36	0	36
29729	0	34	0	0	0	34
29730	34	0	0	0	0	34
29731	0	23	0	0	0	23
29732	0	17	0	0	0	17
29733	0	0	18	0	0	18
29734	19	0	0	0	0	19
29735	0	0	18	0	0	18
29736	0	0	13	0	0	13
29737	0	16	0	0	0	16
29738	0	13	0	0	0	13
29739	13	0	1	0	0	14
29740	0	14	0	0	0	14
29741	0	0	14	0	0	14
29742	0	12	0	0	0	12
29743	0	0	12	0	0	12
29744	0	0	12	0	0	12
29745	12	0	0	0	0	12
29746	0	0	12	0	0	12
29747	0	0	0	12	0	12
29748	11	0	0	0	0	11
29749	0	10	0	0	0	10
29750	0	0	12	0	0	12
29751	12	0	0	0	0	12
29752	0	0	0	12	0	12
29753	0	9	0	0	0	9
29754	0	0	12	0	0	12
29755	12	0	0	0	0	12
29756	0	0	12	0	0	12
29757	0	0	0	12	0	12
29758	0	0	11	0	0	11
29759	0	0	0	11	0	11
29760	11	0	0	0	0	11
29761	0	13	0	0	0	13
29762	13	0	0	0	0	13
29763	0	0	12	0	0	12
29764	0	0	0	12	0	12
29765	0	0	12	0	0	12
29766	9	0	0	0	0	9
29767	10	0	0	0	0	10
29768	0	11	0	0	0	11
29769	11	0	0	0	0	11
29770	10	0	0	0	0	10
29771	0	0	0	11	0	11
29772	0	0	11	0	0	11
29773	0	9	0	0	0	9
29774	0	0	0	10	0	10
29775	11	0	0	0	0	11
29776	0	0	11	0	0	11
29777	0	0	10	0	0	10
29778	0	0	10	0	0	10
29779	10	0	0	0	0	10
29780	0	0	10	0	0	10
29781	10	0	0	0	0	10
29782	0	0	9	0	0	9
29783	0	10	0	0	0	10
29784	0	0	0	10	0	10
29785	0	0	9	0	0	9
29786	0	9	0	0	0	9
29787	0	11	0	0	0	11
29788	0	0	0	11	0	11
29789	11	0	0	0	0	11
29790	0	0	0	10	0	10
29791	9	0	0	0	0	9
29792	0	0	0	10	0	10
29793	0	0	10	0	0	10
29794	0	0	9	0	0	9
29795	10	0	0	0	0	10
29796	10	0	0	0	0	10
29797	0	0	10	0	0	10
29798	10	0	0	0	0	10
29799	0	0	10	0	0	10
29800	0	9	0	1	0	10
29801	0	9	0	0	0	9
29802	0	10	0	0	0	10
29803	0	0	0	10	0	10
29804	10	0	0	0	0	10
29805	8	0	0	0	0	8
29806	0	0	0	10	0	10
29807	0	0	10	0	0	10
29808	0	0	0	9	0	9
29809	0	0	9	0	0	9
29810	0	0	0	9	0	9
29811	9	0	0	0	0	9
29812	8	0	0	0	0	8
29813	9	0	0	0	0	9
29814	9	0	0	0	0	9
29815	0	0	0	9	0	9
29816	0	0	0	8	0	8
29817	9	0	0	0	0	9
29818	8	0	0	0	0	8
29819	0	0	0	7	0	7
29820	0	0	0	4	0	4
29821	0	0	0	4	0	4
29822	0	0	0	4	0	4
29823	4	0	0	0	0	4
29824	0	0	4	0	0	4
29825	0	0	0	4	0	4
29826	4	0	0	0	0	4
29827	0	0	4	0	0	4
29828	0	0	0	4	0	4
29829	0	0	4	0	0	4
29830	0	2	0	0	0	2
29831	0	0	0	2	0	2
29832	2	0	0	0	0	2
29833	0	0	0	2	0	2
29834	0	2	0	0	0	2
29835	0	2	0	0	0	2
29836	0	2	0	0	0	2
29837	0	2	0	0	0	2
29838	2	0	0	0	0	2
29839	0	0	0	2	0	2
29840	0	0	2	0	0	2
29841	0	0	0	2	0	2
29842	0	0	2	0	0	2
29843	2	0	0	0	0	2
29844	0	0	0	2	0	2
29845	0	0	0	2	0	2
29846	0	0	0	2	0	2
29847	0	0	0	2	0	2
29848	2	0	0	0	0	2
29849	2	0	0	0	0	2
29850	0	0	0	0	0
29851	2	0	0	0	0	2
29852	0	0	2	0	0	2
29853	0	1	0	0	0	1
29854	0	0	0	1	0	1
29855	0	0	0	1	0	1
29856	0	1	0	0	0	1
29857	0	0	0	1	0	1
29858	0	0	0	1	0	1
29859	1	0	0	0	0	1
29860	0	0	1	0	0	1
29861	0	0	1	0	0	1
29862	1	0	0	0	0	1
29863	0	0	1	0	0	1
29864	1	0	0	0	0	1
29865	0	0	0	0	0
29866	0	0	0	1	0	1
29867	0	0	1	0	0	1
29868	1	0	0	0	0	1
29869	0	1	0	0	0	1
29870	1	0	0	0	0	1
29871	0	0	0	0	0
29872	1	0	0	0	0	1
29873	1	0	0	0	0	1
29874	1	0	0	0	0	1
29875	1	0	0	0	0	1
29876	1	0	0	0	0	1
29877	1	0	0	0	0	1
29878	1	0	0	0	0	1
29879	0	0	0	0	0
29880	1	0	0	0	0	1
