Pos	A	C	G	T	Other	Total
0	0	0	0	0	0
1	0	0	0	0	0
2	0	0	0	0	0
3	0	0	0	0	0
4	0	0	0	0	0
5	0	0	0	0	0
6	0	0	0	0	0
7	0	0	0	0	0
8	0	0	0	0	0
9	0	0	0	0	0
10	0	0	0	0	0
11	0	0	0	0	0
12	0	0	0	0	0
13	0	0	0	0	0
14	0	0	0	0	0
15	0	0	0	0	0
16	0	0	0	0	0
17	0	0	0	0	0
18	0	0	0	0	0
19	0	1	0	0	0	1
20	0	0	0	0	0
21	3	0	0	0	0	3
22	0	0	3	0	0	3
23	0	0	3	0	0	3
24	0	0	0	4	0	4
25	6	0	0	0	0	6
26	6	0	0	0	0	6
27	0	11	0	0	0	11
28	12	0	0	0	0	12
29	22	0	0	0	0	22
30	21	0	0	0	0	21
31	0	21	0	0	0	21
32	0	19	0	0	0	19
33	22	0	0	0	0	22
34	22	0	0	0	0	22
35	0	20	0	0	0	20
36	0	21	0	0	0	21
37	26	0	0	0	0	26
38	26	0	0	0	0	26
39	0	25	0	0	0	25
40	0	0	0	29	0	29
41	0	0	0	29	0	29
42	1	0	0	25	0	26
43	0	27	0	0	0	27
44	0	0	24	0	0	24
45	31	0	0	0	0	31
46	0	0	0	31	0	31
47	0	30	0	0	0	30
48	0	0	0	34	0	34
49	0	34	0	0	0	34
50	0	0	0	34	0	34
51	0	0	0	34	0	34
52	0	0	32	0	0	32
53	0	0	0	34	0	34
54	32	0	0	0	0	32
55	0	1	30	0	0	31
56	32	0	0	0	0	32
57	0	0	0	31	0	31
58	0	31	0	0	0	31
59	0	0	0	33	0	33
60	0	0	32	0	0	32
61	0	0	0	30	0	30
62	0	0	0	33	0	33
63	0	32	0	0	0	32
64	0	0	0	31	0	31
65	0	32	0	0	0	32
66	0	0	0	33	0	33
67	30	0	0	0	0	30
68	30	0	0	0	0	30
69	30	0	0	1	0	31
70	0	32	0	0	0	32
71	0	1	33	0	0	34
72	34	0	0	0	0	34
73	36	0	0	0	0	36
74	0	35	0	0	0	35
75	0	0	0	30	0	30
76	1	0	0	28	0	29
77	0	0	0	31	0	31
78	30	0	0	0	0	30
79	30	0	0	0	0	30
80	31	0	0	0	0	31
81	31	0	0	0	0	31
82	0	0	0	30	0	30
83	0	31	0	0	0	31
84	0	0	0	31	0	31
85	0	0	28	0	0	28
86	0	0	0	30	0	30
87	0	0	31	0	0	31
88	0	0	0	28	0	28
89	0	0	30	0	0	30
90	0	0	29	0	0	29
91	0	27	1	0	0	28
92	0	0	0	31	0	31
93	0	0	30	0	0	30
94	0	0	0	31	0	31
95	0	28	0	0	0	28
96	30	0	0	0	0	30
97	0	35	0	0	0	35
98	0	0	0	35	0	35
99	0	36	0	0	0	36
100	0	0	33	0	0	33
101	0	0	35	0	0	35
102	0	35	0	0	0	35
103	0	0	0	36	0	36
104	0	0	32	0	0	32
105	0	34	0	0	0	34
106	36	0	0	0	0	36
107	0	0	0	36	0	36
108	0	0	36	0	0	36
109	0	37	0	0	0	37
110	0	0	0	36	0	36
111	0	0	0	34	0	34
112	36	0	0	0	0	36
113	0	0	35	0	0	35
114	0	0	0	34	0	34
115	0	0	36	0	0	36
116	0	36	0	0	0	36
117	34	0	0	0	0	34
118	0	34	0	0	0	34
119	0	0	0	36	0	36
120	0	36	0	0	0	36
121	28	0	0	0	0	28
122	0	20	0	0	0	20
123	0	0	21	0	0	21
124	0	19	0	0	0	19
125	21	0	0	0	0	21
126	0	0	19	0	0	19
127	0	0	0	20	0	20
128	21	0	0	0	0	21
129	0	0	0	17	0	17
130	17	0	0	0	0	17
131	18	0	0	0	0	18
132	0	0	0	18	0	18
133	0	0	0	16	0	16
134	15	0	0	0	0	15
135	15	0	0	0	0	15
136	0	0	0	14	0	14
137	15	0	0	0	0	15
138	14	0	0	0	0	14
139	0	14	0	0	0	14
140	0	0	0	12	0	12
141	12	0	0	0	0	12
142	12	0	0	0	0	12
143	0	0	0	12	0	12
144	0	0	0	12	0	12
145	12	0	0	0	0	12
146	0	14	0	0	0	14
147	0	0	0	14	0	14
148	0	0	14	0	0	14
149	0	0	0	13	0	13
150	0	15	0	0	0	15
151	0	0	14	0	0	14
152	0	0	0	14	0	14
153	0	0	0	14	0	14
154	0	0	16	0	0	16
155	14	0	0	0	0	14
156	0	18	0	0	0	18
157	18	0	0	0	0	18
158	0	0	19	0	0	19
159	0	0	18	0	0	18
160	18	0	0	0	0	18
161	0	19	0	0	0	19
162	19	0	0	0	0	19
163	0	19	0	0	0	19
164	0	0	15	0	0	15
165	14	0	0	0	0	14
166	0	0	14	0	0	14
167	0	0	0	14	0	14
168	15	0	0	0	0	15
169	16	0	0	0	0	16
170	0	21	0	0	0	21
171	0	0	0	17	0	17
172	0	19	0	0	0	19
173	0	0	18	0	0	18
174	1	0	0	20	0	21
175	0	21	0	0	0	21
176	0	0	0	20	0	20
177	23	0	0	0	0	23
178	0	0	0	24	0	24
179	0	24	0	0	0	24
180	0	0	0	25	0	25
181	0	0	0	25	0	25
182	0	25	0	0	0	25
183	0	0	0	26	0	26
184	0	0	25	0	0	25
185	0	27	0	0	0	27
186	27	0	0	0	0	27
187	0	0	26	0	0	26
188	0	0	26	0	0	26
189	0	27	0	0	0	27
190	0	0	0	23	0	23
191	0	0	23	0	0	23
192	0	19	0	0	0	19
193	1	0	0	19	0	20
194	0	0	0	22	0	22
195	22	0	0	0	0	22
196	0	21	0	0	0	21
197	0	0	20	0	0	20
198	0	0	24	0	0	24
199	0	0	0	27	0	27
200	0	0	0	26	0	26
201	0	0	0	26	0	26
202	0	29	0	0	0	29
203	0	0	30	0	0	30
204	0	0	0	28	0	28
205	0	26	0	0	0	26
206	0	31	0	0	0	31
207	0	0	35	0	0	35
208	0	0	0	37	0	37
209	0	0	40	0	0	40
210	0	0	0	39	0	39
211	0	0	0	40	0	40
212	0	0	36	0	0	36
213	0	39	0	0	0	39
214	37	0	0	0	0	37
215	0	0	41	0	0	41
216	0	38	0	0	0	38
217	0	41	0	0	0	41
218	0	0	41	0	0	41
219	51	0	0	0	0	51
220	0	0	0	51	0	51
221	0	52	0	0	0	52
222	53	0	0	0	0	53
223	0	0	0	53	0	53
224	0	53	0	0	0	53
225	55	0	0	0	0	55
226	1	0	51	0	0	52
227	0	56	0	0	0	56
228	57	0	0	0	0	57
229	0	57	0	0	0	57
230	58	0	0	0	0	58
231	0	0	0	56	0	56
232	0	55	0	0	0	55
233	0	0	0	57	0	57
234	57	0	0	0	0	57
235	0	0	54	0	0	54
236	0	0	58	0	0	58
237	0	0	0	59	0	59
238	0	0	0	57	0	57
239	0	0	0	52	0	52
240	0	54	0	0	0	54
241	0	0	56	0	0	56
242	0	0	0	53	0	53
243	0	53	0	0	0	53
244	0	54	0	0	0	54
245	0	0	56	0	0	56
246	0	0	51	0	0	51
247	0	0	57	0	0	57
248	0	0	1	52	0	53
249	0	0	55	0	0	55
250	0	0	0	53	0	53
251	0	0	53	0	0	53
252	51	0	0	0	0	51
253	0	48	0	0	0	48
254	0	48	1	0	0	49
255	0	0	56	0	0	56
256	56	0	0	0	0	56
257	56	0	0	0	0	56
258	53	0	0	0	0	53
259	0	0	54	0	0	54
260	0	0	52	0	0	52
261	0	0	0	54	0	54
262	57	0	0	0	0	57
263	55	0	0	0	0	55
264	0	0	53	0	0	53
265	50	0	0	0	0	50
266	0	0	0	52	0	52
267	0	0	57	0	0	57
268	0	0	53	0	0	53
269	54	0	0	0	0	54
270	0	0	54	0	0	54
271	50	0	0	2	0	52
272	0	0	55	0	0	55
273	0	53	0	0	0	53
274	0	54	1	0	0	55
275	0	0	2	54	0	56
276	0	0	0	56	0	56
277	0	0	57	0	0	57
278	0	0	0	57	0	57
279	0	57	0	0	0	57
280	0	50	0	0	0	50
281	0	58	0	0	0	58
282	0	0	0	58	0	58
283	0	0	56	0	0	56
284	0	0	56	0	0	56
285	0	0	0	57	0	57
286	0	0	0	59	0	59
287	0	0	0	58	0	58
288	0	58	0	0	0	58
289	58	0	0	0	0	58
290	57	0	0	0	0	57
291	0	56	0	0	0	56
292	0	0	52	0	0	52
293	55	0	0	1	0	56
294	0	0	56	0	0	56
295	57	0	0	0	0	57
296	55	0	0	1	0	56
297	54	0	0	0	0	54
298	53	0	0	0	0	53
299	0	54	0	0	0	54
300	49	0	0	0	0	49
301	0	50	0	0	0	50
302	42	0	0	0	0	42
303	0	47	0	0	0	47
304	0	0	43	1	0	44
305	0	0	0	40	0	40
306	0	40	0	0	0	40
307	0	39	0	0	0	39
308	38	0	0	0	0	38
309	38	0	0	0	0	38
310	0	38	0	0	0	38
311	0	0	0	39	0	39
312	0	27	0	0	0	27
313	28	0	0	0	0	28
314	0	0	26	0	0	26
315	0	0	0	28	0	28
316	0	0	0	27	0	27
317	0	0	0	28	0	28
318	0	0	27	0	0	27
319	0	25	0	0	0	25
320	0	26	0	0	0	26
321	0	0	0	26	0	26
322	0	0	27	0	0	27
323	0	0	0	29	0	29
324	0	0	0	29	0	29
325	0	0	0	29	0	29
326	0	0	0	28	0	28
327	28	0	0	0	0	28
328	0	27	0	0	0	27
329	27	0	0	0	0	27
330	0	0	29	0	0	29
331	0	0	28	0	0	28
332	0	0	0	26	0	26
333	0	0	0	29	0	29
334	0	28	0	0	0	28
335	0	0	29	0	0	29
336	0	27	0	0	0	27
337	0	0	27	0	0	27
338	27	0	0	0	0	27
339	0	28	0	0	0	28
340	0	0	28	0	0	28
341	1	0	0	25	0	26
342	0	0	26	0	0	26
343	0	26	0	0	0	26
344	0	0	0	27	0	27
345	0	25	0	0	0	25
346	0	0	28	0	0	28
347	0	0	0	26	0	26
348	26	0	0	0	0	26
349	0	25	0	0	0	25
350	0	0	27	0	0	27
351	0	0	0	26	0	26
352	2	0	25	0	0	27
353	0	0	27	0	0	27
354	0	31	0	0	0	31
355	0	2	0	31	0	33
356	0	0	0	33	0	33
357	0	0	0	34	0	34
358	0	0	33	0	0	33
359	0	0	33	0	0	33
360	32	0	0	0	0	32
361	0	0	37	0	0	37
362	30	0	0	0	0	30
363	0	33	0	0	0	33
364	0	1	0	29	0	30
365	0	27	0	0	0	27
366	0	28	0	0	0	28
367	0	0	30	0	0	30
368	0	0	0	29	0	29
369	0	0	28	0	0	28
370	0	0	30	0	0	30
371	28	0	0	0	0	28
372	0	0	32	0	0	32
373	0	0	34	0	0	34
374	35	0	0	0	0	35
375	0	0	36	0	0	36
376	0	0	36	0	0	36
377	0	0	0	36	0	36
378	0	35	0	0	0	35
379	0	0	0	38	0	38
380	0	0	0	37	0	37
381	38	0	0	0	0	38
382	0	0	0	40	0	40
383	0	39	0	0	0	39
384	39	0	0	0	0	39
385	0	0	43	0	0	43
386	38	0	0	0	0	38
387	0	0	38	0	0	38
388	0	0	36	0	0	36
389	0	40	0	0	0	40
390	41	0	0	0	0	41
391	0	42	0	0	0	42
392	0	0	38	0	0	38
393	0	0	0	36	0	36
394	0	36	0	0	0	36
395	34	0	0	0	0	34
396	36	0	0	0	0	36
397	0	36	0	0	0	36
398	36	0	0	0	0	36
399	1	0	0	37	0	38
400	0	39	0	0	0	39
401	0	0	0	37	0	37
402	0	0	0	39	0	39
403	43	0	0	0	0	43
404	43	0	0	0	0	43
405	42	0	0	0	0	42
406	0	0	42	0	0	42
407	41	0	0	0	0	41
408	0	0	0	41	0	41
409	0	0	38	0	0	38
410	0	0	39	0	0	39
411	1	40	0	0	0	41
412	41	0	0	0	0	41
413	0	40	0	0	0	40
414	0	0	0	37	0	37
415	0	0	0	42	0	42
416	0	0	38	0	0	38
417	0	0	0	38	0	38
418	0	0	36	0	0	36
419	0	0	33	0	0	33
420	0	37	0	0	0	37
421	0	0	0	37	0	37
422	0	0	0	39	0	39
423	38	0	0	0	0	38
424	0	0	39	0	0	39
425	0	0	0	35	0	35
426	38	0	0	0	0	38
427	0	0	36	0	0	36
428	38	0	0	0	0	38
429	37	0	0	0	0	37
430	0	0	40	0	0	40
431	0	0	0	37	0	37
432	0	0	0	38	0	38
433	0	0	38	0	0	38
434	34	0	0	0	0	34
435	37	0	0	0	0	37
436	38	0	0	0	0	38
437	38	0	0	0	0	38
438	39	0	0	0	0	39
439	0	0	36	0	0	36
440	1	0	32	0	0	33
441	0	36	0	0	0	36
442	0	1	40	0	0	41
443	0	0	1	35	0	36
444	1	0	0	36	0	37
445	0	0	0	39	0	39
446	0	0	0	40	0	40
447	0	0	35	0	0	35
448	0	35	0	0	0	35
449	0	31	0	0	0	31
450	0	0	0	30	0	30
451	0	32	0	0	0	32
452	31	0	0	0	0	31
453	26	0	0	0	0	26
454	0	30	0	0	0	30
455	0	0	0	27	0	27
456	0	0	0	27	0	27
457	0	0	28	0	0	28
458	29	0	0	0	0	29
459	29	0	0	0	0	29
460	0	26	0	0	0	26
461	28	0	0	0	0	28
462	0	0	33	0	0	33
463	0	31	0	0	0	31
464	0	35	0	0	0	35
465	0	38	0	0	0	38
466	0	0	0	37	0	37
467	35	0	0	0	0	35
468	0	0	0	37	0	37
469	0	0	37	0	0	37
470	0	0	0	35	0	35
471	0	0	34	0	0	34
472	0	0	0	35	0	35
473	0	0	0	35	0	35
474	0	41	0	0	0	41
475	40	0	0	0	0	40
476	0	0	0	41	0	41
477	0	43	0	0	0	43
478	45	0	0	0	0	45
479	39	0	0	1	0	40
480	46	0	0	1	0	47
481	0	47	0	0	0	47
482	0	0	49	0	0	49
483	0	0	0	48	0	48
484	0	0	0	49	0	49
485	0	50	0	0	0	50
486	0	0	46	0	0	46
487	0	0	47	0	0	47
488	49	0	0	0	0	49
489	0	0	0	47	0	47
490	0	0	50	0	0	50
491	0	48	0	0	0	48
492	0	0	0	47	0	47
493	0	45	0	0	0	45
494	0	0	48	0	0	48
495	43	0	0	0	0	43
496	43	0	0	0	0	43
497	0	47	0	0	0	47
498	0	0	0	45	0	45
499	0	0	45	0	0	45
500	0	45	0	0	0	45
501	43	0	0	0	0	43
502	0	43	0	0	0	43
503	0	44	0	0	0	44
504	1	0	0	45	0	46
505	0	44	0	0	0	44
506	45	0	0	0	0	45
507	0	0	0	43	0	43
508	0	0	44	0	0	44
509	0	0	43	0	0	43
510	0	0	0	45	0	45
511	0	45	0	0	0	45
512	46	0	0	0	0	46
513	0	0	0	46	0	46
514	0	0	45	0	0	45
515	0	0	0	46	0	46
516	0	0	0	42	0	42
517	46	0	0	0	0	46
518	0	0	0	44	0	44
519	0	0	44	0	0	44
520	0	0	40	0	0	40
521	0	0	0	42	0	42
522	0	0	0	43	0	43
523	0	0	43	0	0	43
524	39	0	0	0	0	39
525	0	0	41	0	0	41
526	0	40	0	0	0	40
527	0	0	0	42	0	42
528	0	0	43	0	0	43
529	0	0	41	0	0	41
530	0	0	0	42	0	42
531	43	0	0	0	0	43
532	0	0	44	0	0	44
533	0	40	0	0	0	40
534	47	0	0	0	0	47
535	0	0	43	0	0	43
536	43	0	0	0	0	43
537	47	0	0	0	0	47
538	0	53	0	0	0	53
539	0	0	0	49	0	49
540	0	51	0	0	0	51
541	0	0	48	0	0	48
542	53	0	0	0	0	53
543	53	0	0	0	0	53
544	0	0	52	0	0	52
545	0	0	47	0	0	47
546	0	53	0	0	0	53
547	56	0	0	0	0	56
548	0	0	0	56	0	56
549	0	0	0	54	0	54
550	0	52	0	0	0	52
551	54	0	0	0	0	54
552	0	0	55	0	0	55
553	0	0	0	56	0	56
554	49	0	0	0	0	49
555	0	52	0	0	0	52
556	1	1	49	0	0	51
557	0	0	47	0	0	47
558	0	0	0	45	0	45
559	0	44	0	0	0	44
560	0	0	44	0	0	44
561	0	0	0	44	0	44
562	50	0	0	0	0	50
563	0	0	50	0	0	50
564	0	0	0	48	0	48
565	0	0	48	0	0	48
566	0	0	46	0	0	46
567	1	0	0	42	0	43
568	0	0	46	0	0	46
569	44	0	0	0	0	44
570	0	0	41	0	0	41
571	40	0	0	0	0	40
572	0	40	0	0	0	40
573	33	0	0	0	0	33
574	0	37	0	0	0	37
575	0	0	0	33	0	33
576	0	0	0	33	0	33
577	0	0	32	0	0	32
578	0	0	33	0	0	33
579	0	0	0	32	0	32
580	0	0	32	0	0	32
581	0	0	0	30	0	30
582	0	32	0	0	0	32
583	0	32	0	0	0	32
584	0	0	0	34	0	34
585	0	0	0	34	0	34
586	0	0	33	0	0	33
587	0	0	0	34	0	34
588	0	34	0	0	0	34
589	0	29	0	0	0	29
590	0	32	0	0	0	32
591	0	0	0	33	0	33
592	0	32	0	0	0	32
593	33	0	0	0	0	33
594	0	0	0	32	0	32
595	0	0	33	0	0	33
596	0	0	0	33	0	33
597	0	0	32	0	0	32
598	0	0	32	0	0	32
599	0	0	32	0	0	32
600	0	34	0	0	0	34
601	0	0	35	0	0	35
602	36	0	0	0	0	36
603	36	0	0	0	0	36
604	36	0	0	0	0	36
605	0	0	0	36	0	36
606	37	0	0	0	0	37
607	0	37	0	0	0	37
608	0	38	0	0	0	38
609	37	0	0	0	0	37
610	0	0	39	0	0	39
611	0	0	0	39	0	39
612	0	0	36	0	0	36
613	0	0	37	0	0	37
614	0	34	0	0	0	34
615	0	0	0	37	0	37
616	0	0	0	37	0	37
617	39	0	0	0	0	39
618	0	35	0	0	0	35
619	0	41	0	0	0	41
620	0	0	39	0	0	39
621	0	41	0	0	0	41
622	40	0	0	0	0	40
623	38	0	0	0	0	38
624	0	0	40	0	0	40
625	0	0	40	0	0	40
626	0	0	0	39	0	39
627	0	0	0	39	0	39
628	0	38	0	0	0	38
629	0	0	0	39	0	39
630	0	0	0	36	0	36
631	0	29	0	0	0	29
632	0	0	0	28	0	28
633	0	0	0	28	0	28
634	0	27	0	0	0	27
635	0	0	27	0	0	27
636	0	0	0	28	0	28
637	24	0	0	0	0	24
638	26	0	0	0	0	26
639	0	0	27	0	0	27
640	27	0	0	0	0	27
641	27	0	0	0	0	27
642	0	27	0	0	0	27
643	0	0	27	0	0	27
644	0	1	27	0	0	28
645	0	0	0	32	0	32
646	30	0	0	0	0	30
647	38	0	0	0	0	38
648	0	0	0	38	0	38
649	39	0	0	0	0	39
650	38	0	0	0	0	38
651	39	0	0	0	0	39
652	0	0	46	0	0	46
653	0	0	46	0	0	46
654	50	0	0	0	0	50
655	0	0	52	0	0	52
656	0	49	0	0	0	49
657	0	0	0	51	0	51
658	0	0	51	0	0	51
659	0	0	48	0	0	48
660	0	0	0	48	0	48
661	0	0	50	0	0	50
662	0	0	46	0	0	46
663	0	44	0	0	0	44
664	0	51	0	0	0	51
665	51	0	0	0	0	51
666	0	0	0	51	0	51
667	51	0	0	0	0	51
668	0	0	51	0	0	51
669	0	0	0	49	0	49
670	0	0	0	51	0	51
671	51	0	0	0	0	51
672	0	50	0	0	0	50
673	0	0	45	0	0	45
674	1	0	48	0	0	49
675	0	48	0	0	0	48
676	0	0	51	0	0	51
677	0	50	0	0	0	50
678	0	50	0	0	0	50
679	0	0	50	0	0	50
680	50	0	0	0	0	50
681	0	0	0	50	0	50
682	0	51	0	0	0	51
683	0	0	0	51	0	51
684	48	0	0	0	0	48
685	41	0	0	0	0	41
686	47	0	0	0	0	47
687	0	0	47	0	0	47
688	0	0	0	47	0	47
689	0	47	0	0	0	47
690	46	0	0	0	0	46
691	0	0	0	46	0	46
692	0	0	0	44	0	44
693	0	0	0	48	0	48
694	0	0	47	0	0	47
695	49	0	0	0	0	49
696	0	48	0	0	0	48
697	0	0	0	49	0	49
698	0	0	0	47	0	47
699	47	0	0	0	0	47
700	0	0	42	0	0	42
701	0	0	46	0	0	46
702	0	44	0	0	0	44
703	0	0	47	0	0	47
704	46	0	0	0	0	46
705	0	48	0	0	0	48
706	0	0	49	0	0	49
707	50	0	0	0	0	50
708	0	0	48	0	0	48
709	0	48	0	0	0	48
710	0	0	0	50	0	50
711	0	0	0	50	0	50
712	0	0	47	0	0	47
713	0	0	45	0	0	45
714	0	49	0	0	0	49
715	42	0	0	0	0	42
716	0	48	0	0	0	48
717	0	0	0	48	0	48
718	0	0	47	0	0	47
719	48	0	0	0	0	48
720	0	0	0	48	0	48
721	0	42	0	0	0	42
722	0	42	0	0	0	42
723	0	0	0	44	0	44
724	0	0	0	48	0	48
725	51	0	0	0	0	51
726	0	0	0	51	0	51
727	0	0	49	0	0	49
728	50	0	0	0	0	50
729	52	0	0	0	0	52
730	0	0	44	0	0	44
731	50	0	0	0	0	50
732	0	0	0	47	0	47
733	0	0	0	47	0	47
734	0	0	0	52	0	52
735	0	0	0	50	0	50
736	0	44	0	0	0	44
737	44	0	0	0	0	44
738	43	0	0	0	0	43
739	0	0	39	0	0	39
740	38	0	0	0	0	38
741	36	0	0	0	0	36
742	35	0	0	0	0	35
743	36	0	0	0	0	36
744	0	34	0	0	0	34
745	0	0	0	22	0	22
746	0	0	30	0	0	30
747	0	0	24	0	0	24
748	23	0	0	0	0	23
749	23	0	0	0	0	23
750	0	26	0	0	0	26
751	24	0	0	0	0	24
752	0	25	0	0	0	25
753	0	0	0	27	0	27
754	26	0	0	0	0	26
755	27	0	0	0	0	27
756	26	0	0	0	0	26
757	0	27	0	0	0	27
758	29	0	0	0	0	29
759	0	0	0	28	0	28
760	28	0	0	0	0	28
761	0	0	26	0	0	26
762	0	28	0	0	0	28
763	30	0	0	0	0	30
764	0	0	30	0	0	30
765	0	0	0	28	0	28
766	0	0	29	0	0	29
767	0	0	29	0	0	29
768	0	0	0	29	0	29
769	0	0	34	0	0	34
770	0	0	0	32	0	32
771	0	0	0	33	0	33
772	31	0	0	0	0	31
773	0	32	0	0	0	32
774	0	30	0	0	0	30
775	0	34	0	0	0	34
776	1	0	33	0	0	34
777	0	0	0	38	0	38
778	0	0	38	0	0	38
779	36	0	0	0	0	36
780	37	0	0	0	0	37
781	0	36	0	0	0	36
782	0	0	0	35	0	35
783	0	37	0	0	0	37
784	37	0	0	0	0	37
785	0	0	0	36	0	36
786	0	0	41	0	0	41
787	0	36	0	0	0	36
788	0	0	41	0	0	41
789	0	0	0	38	0	38
790	0	0	39	0	0	39
791	40	0	0	0	0	40
792	0	0	41	0	0	41
793	0	41	0	0	0	41
794	0	0	0	38	0	38
795	0	0	0	39	0	39
796	40	0	0	0	0	40
797	38	0	0	0	0	38
798	0	36	0	0	0	36
799	0	0	37	0	0	37
800	1	0	40	0	0	41
801	38	0	0	0	0	38
802	0	0	39	0	0	39
803	0	0	45	0	0	45
804	0	0	45	0	0	45
805	0	0	46	0	0	46
806	0	48	0	0	0	48
807	48	0	0	0	0	48
808	0	0	0	49	0	49
809	46	0	0	0	0	46
810	0	47	0	0	0	47
811	45	0	0	1	0	46
812	0	48	0	0	0	48
813	0	0	0	51	0	51
814	0	50	0	0	0	50
815	0	0	47	0	0	47
816	0	47	0	0	0	47
817	0	0	0	51	0	51
818	51	0	0	0	0	51
819	0	0	0	49	0	49
820	0	0	51	0	0	51
821	0	0	0	59	0	59
822	0	58	0	0	0	58
823	0	0	58	0	0	58
824	62	0	0	0	0	62
825	0	0	0	62	0	62
826	59	0	0	0	0	59
827	57	0	0	0	0	57
828	0	60	0	0	0	60
829	60	0	0	0	0	60
830	55	0	0	0	0	55
831	0	59	0	0	0	59
832	0	0	0	57	0	57
833	0	0	0	58	0	58
834	0	56	0	0	0	56
835	0	0	0	59	0	59
836	0	0	56	0	0	56
837	0	0	0	58	0	58
838	0	0	57	0	0	57
839	0	0	53	0	0	53
840	0	55	0	0	0	55
841	0	52	0	0	0	52
842	0	55	0	0	0	55
843	0	0	0	52	0	52
844	0	0	54	0	0	54
845	53	0	0	0	0	53
846	0	0	0	53	0	53
847	0	0	53	0	0	53
848	0	0	53	0	0	53
849	0	56	0	0	0	56
850	0	0	0	59	0	59
851	56	0	0	0	0	56
852	0	57	0	0	0	57
853	0	57	0	0	0	57
854	0	57	0	0	0	57
855	0	0	0	56	0	56
856	0	56	0	0	0	56
857	0	0	0	62	0	62
858	0	0	0	62	0	62
859	0	0	63	0	0	63
860	58	0	0	0	0	58
861	0	0	62	0	0	62
862	0	0	0	61	0	61
863	0	0	57	0	0	57
864	0	59	0	0	0	59
865	61	1	0	0	0	62
866	0	0	1	59	0	60
867	0	0	0	60	0	60
868	57	0	0	0	0	57
869	56	0	0	0	0	56
870	57	0	0	0	0	57
871	0	0	56	0	0	56
872	56	0	0	0	0	56
873	0	56	0	0	0	56
874	0	57	0	0	0	57
875	0	0	0	57	0	57
876	0	0	0	58	0	58
877	0	58	0	0	0	58
878	0	0	0	57	0	57
879	56	0	0	0	0	56
880	0	0	60	0	0	60
881	0	51	0	0	0	51
882	56	2	0	0	0	58
883	0	60	0	0	0	60
884	0	0	64	0	0	64
885	0	0	0	68	0	68
886	0	0	69	0	0	69
887	0	66	0	0	0	66
888	0	0	0	69	0	69
889	0	0	67	0	0	67
890	1	1	68	0	0	70
891	0	0	0	65	0	65
892	68	0	0	0	0	68
893	67	0	0	0	0	67
894	68	0	0	0	0	68
895	0	0	63	0	0	63
896	0	56	0	0	0	56
897	0	0	0	58	0	58
898	0	0	0	59	0	59
899	0	58	1	0	0	59
900	59	0	0	0	0	59
901	0	0	0	59	0	59
902	0	0	57	0	0	57
903	0	55	0	0	0	55
904	55	0	0	0	0	55
905	0	54	0	0	0	54
906	0	0	0	54	0	54
907	0	0	0	55	0	55
908	0	0	0	57	0	57
909	0	0	56	0	0	56
910	2	0	0	51	0	53
911	0	49	0	0	0	49
912	0	50	0	0	0	50
913	0	0	54	0	0	54
914	47	0	0	0	0	47
915	41	0	0	0	0	41
916	0	46	0	0	0	46
917	43	0	0	0	0	43
918	42	0	0	0	0	42
919	0	46	0	0	0	46
920	0	0	0	46	0	46
921	0	0	46	0	0	46
922	0	0	42	0	0	42
923	43	0	0	0	0	43
924	0	45	0	0	0	45
925	0	0	0	49	0	49
926	0	0	0	48	0	48
927	0	0	1	47	0	48
928	48	0	0	0	0	48
929	0	0	0	48	0	48
930	0	0	0	47	0	47
931	1	0	45	0	0	46
932	42	0	0	0	0	42
933	0	44	0	0	0	44
934	43	0	0	0	0	43
935	0	44	0	0	0	44
936	0	0	0	41	0	41
937	42	0	0	0	0	42
938	45	0	0	0	0	45
939	0	0	42	0	0	42
940	45	0	0	0	0	45
941	0	0	44	0	0	44
942	0	0	38	0	0	38
943	1	0	37	0	0	38
944	0	0	41	0	0	41
945	0	0	0	37	0	37
946	0	0	41	0	0	41
947	0	0	1	38	0	39
948	41	0	0	0	0	41
949	0	0	0	41	0	41
950	38	0	0	0	0	38
951	0	40	0	0	0	40
952	0	0	0	38	0	38
953	0	1	32	0	0	33
954	0	36	0	0	0	36
955	0	0	0	34	0	34
956	0	0	34	0	0	34
957	0	32	0	0	0	32
958	0	32	0	0	0	32
959	0	0	33	0	0	33
960	0	0	0	31	0	31
961	0	0	38	0	0	38
962	38	0	0	0	0	38
963	33	0	0	0	0	33
964	0	34	0	0	0	34
965	34	0	0	0	0	34
966	0	0	0	35	0	35
967	0	0	34	0	0	34
968	35	0	0	0	0	35
969	0	0	32	0	0	32
970	0	33	0	0	0	33
971	35	0	0	0	0	35
972	0	0	0	34	0	34
973	0	0	31	0	0	31
974	33	0	0	0	0	33
975	29	0	0	0	0	29
976	26	0	0	0	0	26
977	0	0	0	23	0	23
978	0	0	0	19	0	19
979	0	0	21	0	0	21
980	0	19	0	0	0	19
981	0	0	0	18	0	18
982	0	0	0	19	0	19
983	0	0	19	0	0	19
984	0	0	19	0	0	19
985	1	0	0	19	0	20
986	17	0	0	0	0	17
987	0	18	0	0	0	18
988	20	0	0	0	0	20
989	0	19	0	0	0	19
990	0	0	19	0	0	19
991	0	0	22	0	0	22
992	22	0	0	0	0	22
993	20	0	0	0	0	20
994	0	21	0	0	0	21
995	0	0	20	0	0	20
996	0	0	0	21	0	21
997	0	0	0	17	0	17
998	0	25	0	0	0	25
999	0	0	0	21	0	21
1000	0	0	28	0	0	28
1001	31	0	0	0	0	31
1002	31	0	0	0	0	31
1003	30	0	0	0	0	30
1004	31	0	0	0	0	31
1005	0	0	32	0	0	32
1006	28	0	0	0	0	28
1007	0	0	30	0	0	30
1008	0	29	0	0	0	29
1009	0	0	0	28	0	28
1010	30	0	0	0	0	30
1011	0	0	0	29	0	29
1012	0	0	28	0	0	28
1013	30	0	0	0	0	30
1014	28	0	0	0	0	28
1015	0	0	0	26	0	26
1016	0	0	0	29	0	29
1017	0	0	26	0	0	26
1018	0	25	0	0	0	25
1019	28	1	0	0	0	29
1020	0	0	26	0	0	26
1021	28	0	1	0	0	29
1022	0	26	0	0	0	26
1023	28	0	0	0	0	28
1024	0	26	0	0	0	26
1025	0	26	0	0	0	26
1026	0	0	0	26	0	26
1027	0	0	0	28	0	28
1028	0	0	0	30	0	30
1029	0	0	0	29	0	29
1030	0	0	31	0	0	31
1031	30	0	0	0	0	30
1032	30	0	0	0	0	30
1033	31	0	0	0	0	31
1034	0	0	0	29	0	29
1035	0	0	0	31	0	31
1036	31	0	0	0	0	31
1037	28	0	0	0	0	28
1038	26	0	0	0	0	26
1039	0	0	0	26	0	26
1040	0	0	0	27	0	27
1041	0	0	26	0	0	26
1042	0	0	23	0	0	23
1043	0	29	0	0	0	29
1044	28	0	0	0	0	28
1045	29	0	0	0	0	29
1046	31	0	0	0	0	31
1047	0	0	30	0	0	30
1048	32	0	0	0	0	32
1049	31	0	0	0	0	31
1050	31	0	0	1	0	32
1051	0	0	0	31	0	31
1052	0	0	0	31	0	31
1053	0	0	0	32	0	32
1054	0	0	25	0	0	25
1055	26	0	0	0	0	26
1056	0	34	0	0	0	34
1057	36	0	0	0	0	36
1058	0	35	0	0	0	35
1059	0	34	0	0	0	34
1060	0	0	0	35	0	35
1061	0	0	0	36	0	36
1062	0	38	0	0	0	38
1063	38	0	0	0	0	38
1064	37	0	0	0	0	37
1065	0	0	0	37	0	37
1066	0	0	37	0	0	37
1067	0	0	32	1	0	33
1068	0	0	36	0	0	36
1069	0	0	35	0	0	35
1070	37	0	0	0	0	37
1071	38	0	0	0	0	38
1072	0	0	0	37	0	37
1073	0	0	37	0	0	37
1074	0	0	0	37	0	37
1075	0	35	0	0	0	35
1076	0	40	0	0	0	40
1077	41	0	0	0	0	41
1078	40	0	0	0	0	40
1079	40	0	0	0	0	40
1080	0	0	0	42	0	42
1081	0	0	0	47	0	47
1082	0	1	0	47	0	48
1083	0	0	0	47	0	47
1084	0	0	46	0	0	46
1085	0	0	0	45	0	45
1086	48	0	0	0	0	48
1087	0	0	0	45	0	45
1088	0	0	0	45	0	45
1089	0	0	0	48	0	48
1090	0	46	0	0	0	46
1091	0	45	0	0	0	45
1092	0	49	0	0	0	49
1093	0	0	0	44	0	44
1094	0	0	0	44	0	44
1095	43	0	0	0	0	43
1096	42	0	0	0	0	42
1097	41	0	0	0	0	41
1098	0	0	0	41	0	41
1099	0	0	0	41	0	41
1100	0	40	0	0	0	40
1101	0	41	0	0	0	41
1102	40	0	0	0	0	40
1103	0	0	0	42	0	42
1104	41	0	0	0	0	41
1105	41	0	0	0	0	41
1106	0	0	0	48	0	48
1107	0	46	0	0	0	46
1108	51	0	0	0	0	51
1109	51	0	0	0	0	51
1110	0	0	52	0	0	52
1111	53	0	0	0	0	53
1112	0	52	0	0	0	52
1113	0	0	0	54	0	54
1114	55	0	0	0	0	55
1115	0	0	0	53	0	53
1116	0	0	0	54	0	54
1117	0	52	0	0	0	52
1118	54	0	0	0	0	54
1119	51	0	0	0	0	51
1120	0	45	0	0	0	45
1121	0	44	0	0	0	44
1122	51	0	0	0	0	51
1123	49	0	0	0	0	49
1124	0	0	51	0	0	51
1125	0	1	45	0	0	46
1126	0	0	49	0	0	49
1127	0	0	0	53	0	53
1128	0	0	0	54	0	54
1129	0	0	55	0	0	55
1130	57	0	0	0	0	57
1131	60	0	1	0	0	61
1132	61	0	0	0	0	61
1133	61	0	0	0	0	61
1134	0	0	61	0	0	61
1135	61	0	0	0	0	61
1136	58	0	0	0	0	58
1137	62	0	0	0	0	62
1138	60	0	0	0	0	60
1139	58	0	0	0	0	58
1140	0	0	55	0	0	55
1141	0	56	0	0	0	56
1142	0	0	0	57	0	57
1143	0	0	0	56	0	56
1144	0	0	58	0	0	58
1145	56	0	0	0	0	56
1146	0	0	0	59	0	59
1147	0	0	59	0	0	59
1148	0	0	52	0	0	52
1149	0	46	0	0	0	46
1150	11	0	0	48	0	59
1151	0	0	0	58	0	58
1152	0	0	0	59	0	59
1153	57	0	0	0	0	57
1154	10	0	0	44	0	54
1155	0	0	57	0	0	57
1156	0	0	41	0	0	41
1157	0	0	43	0	0	43
1158	0	0	0	44	0	44
1159	46	0	0	0	0	46
1160	0	0	46	0	0	46
1161	48	0	0	0	0	48
1162	50	0	0	0	0	50
1163	0	0	0	49	0	49
1164	0	0	0	48	0	48
1165	0	45	0	0	0	45
1166	0	0	50	0	0	50
1167	49	0	0	0	0	49
1168	0	0	0	50	0	50
1169	0	48	0	0	0	48
1170	0	0	0	46	0	46
1171	0	0	48	0	0	48
1172	0	0	0	45	0	45
1173	0	47	0	0	0	47
1174	0	0	0	42	0	42
1175	41	0	0	0	0	41
1176	0	0	0	43	0	43
1177	0	42	0	0	0	42
1178	0	43	0	0	0	43
1179	43	0	0	0	0	43
1180	0	0	43	0	0	43
1181	0	0	0	44	0	44
1182	0	0	0	43	0	43
1183	0	0	44	0	0	44
1184	0	45	0	0	0	45
1185	0	0	44	0	0	44
1186	0	0	0	42	0	42
1187	0	46	0	0	0	46
1188	46	0	0	0	0	46
1189	0	45	0	0	0	45
1190	0	46	0	0	0	46
1191	46	0	0	0	0	46
1192	48	0	0	0	0	48
1193	49	0	0	0	0	49
1194	0	0	0	46	0	46
1195	0	0	45	0	0	45
1196	47	0	0	0	0	47
1197	45	0	0	0	0	45
1198	0	0	0	45	0	45
1199	0	0	41	0	0	41
1200	0	43	0	0	0	43
1201	37	0	0	0	0	37
1202	34	0	0	0	0	34
1203	0	36	0	0	0	36
1204	0	36	0	0	0	36
1205	35	0	0	0	0	35
1206	35	0	0	0	0	35
1207	34	0	0	0	0	34
1208	0	0	0	36	0	36
1209	0	0	39	0	0	39
1210	0	0	0	42	0	42
1211	0	0	41	0	0	41
1212	0	37	0	0	0	37
1213	0	42	0	0	0	42
1214	0	0	0	42	0	42
1215	0	0	0	40	0	40
1216	0	0	0	39	0	39
1217	0	43	0	0	0	43
1218	43	0	0	0	0	43
1219	40	0	0	0	0	40
1220	0	42	0	0	0	42
1221	0	0	0	43	0	43
1222	0	40	0	0	0	40
1223	0	0	0	35	0	35
1224	0	35	0	0	0	35
1225	35	0	0	0	0	35
1226	0	0	0	33	0	33
1227	0	0	37	0	0	37
1228	36	0	0	0	0	36
1229	36	0	0	0	0	36
1230	0	0	36	0	0	36
1231	0	0	0	35	0	35
1232	0	0	35	0	0	35
1233	0	0	0	35	0	35
1234	0	0	36	0	0	36
1235	36	0	0	0	0	36
1236	0	0	0	36	0	36
1237	0	36	0	0	0	36
1238	36	0	0	0	0	36
1239	0	0	0	31	0	31
1240	0	0	0	33	0	33
1241	0	0	36	0	0	36
1242	0	0	0	36	0	36
1243	0	0	39	0	0	39
1244	0	0	41	0	0	41
1245	0	0	0	39	0	39
1246	0	0	44	0	0	44
1247	47	0	0	0	0	47
1248	47	0	0	0	0	47
1249	48	0	0	0	0	48
1250	0	49	0	0	0	49
1251	0	0	0	49	0	49
1252	0	0	0	49	0	49
1253	0	49	0	0	0	49
1254	45	0	0	0	0	45
1255	0	1	0	46	0	47
1256	0	0	46	0	0	46
1257	0	0	44	0	0	44
1258	0	46	0	0	0	46
1259	48	0	0	0	0	48
1260	0	1	45	0	0	46
1261	44	0	0	0	0	44
1262	0	46	0	0	0	46
1263	0	0	44	0	0	44
1264	0	0	38	0	0	38
1265	0	0	44	0	0	44
1266	0	45	0	0	0	45
1267	0	0	43	0	0	43
1268	44	0	0	0	0	44
1269	0	0	0	43	0	43
1270	0	0	0	43	0	43
1271	1	0	0	44	0	45
1272	0	0	0	43	0	43
1273	0	0	40	0	0	40
1274	1	0	0	44	0	45
1275	0	0	0	45	0	45
1276	45	0	0	0	0	45
1277	43	0	0	0	0	43
1278	44	0	0	0	0	44
1279	0	0	42	0	0	42
1280	0	38	0	0	0	38
1281	0	42	0	0	0	42
1282	42	0	0	0	0	42
1283	0	45	0	0	0	45
1284	0	0	0	45	0	45
1285	0	0	0	47	0	47
1286	0	0	46	0	0	46
1287	0	45	0	0	0	45
1288	0	0	45	0	0	45
1289	48	0	0	0	0	48
1290	47	0	0	0	0	47
1291	0	0	0	49	0	49
1292	0	0	0	49	0	49
1293	0	0	0	48	0	48
1294	0	0	0	50	0	50
1295	0	0	50	0	0	50
1296	0	0	0	47	0	47
1297	0	0	49	0	0	49
1298	0	0	43	0	0	43
1299	0	46	1	0	0	47
1300	49	0	0	0	0	49
1301	0	49	0	0	0	49
1302	0	0	0	43	0	43
1303	0	0	42	0	0	42
1304	44	0	0	0	0	44
1305	0	0	41	0	0	41
1306	45	0	0	0	0	45
1307	38	0	0	0	0	38
1308	0	0	0	45	0	45
1309	0	0	0	43	0	43
1310	0	0	0	41	0	41
1311	0	0	44	0	0	44
1312	41	0	0	0	0	41
1313	0	43	0	0	0	43
1314	0	0	0	45	0	45
1315	44	0	0	0	0	44
1316	45	0	0	0	0	45
1317	45	0	0	0	0	45
1318	0	0	48	0	0	48
1319	49	0	0	0	0	49
1320	45	0	0	0	0	45
1321	0	0	39	0	0	39
1322	0	0	47	0	0	47
1323	0	0	0	46	0	46
1324	0	0	41	0	0	41
1325	0	36	0	0	0	36
1326	0	43	1	0	0	44
1327	47	0	0	0	0	47
1328	0	45	1	0	0	46
1329	0	0	0	48	0	48
1330	45	0	0	1	0	46
1331	0	48	0	0	0	48
1332	0	0	0	49	0	49
1333	0	0	0	46	0	46
1334	0	0	49	0	0	49
1335	1	0	0	45	0	46
1336	0	0	42	0	0	42
1337	0	0	40	0	0	40
1338	0	0	0	37	0	37
1339	0	0	0	28	0	28
1340	22	0	0	0	0	22
1341	0	23	0	0	0	23
1342	0	0	0	22	0	22
1343	0	0	0	21	0	21
1344	22	0	0	0	0	22
1345	0	19	0	0	0	19
1346	0	19	0	0	0	19
1347	0	16	0	0	0	16
1348	0	19	0	0	0	19
1349	19	0	0	0	0	19
1350	16	0	0	0	0	16
1351	18	0	0	0	0	18
1352	16	0	0	0	0	16
1353	0	0	0	18	0	18
1354	0	0	17	0	0	17
1355	0	15	0	0	0	15
1356	0	0	0	17	0	17
1357	0	0	15	0	0	15
1358	0	0	0	17	0	17
1359	0	0	0	17	0	17
1360	0	0	16	0	0	16
1361	0	0	0	17	0	17
1362	0	0	0	15	0	15
1363	15	0	0	0	0	15
1364	14	0	0	0	0	14
1365	17	0	0	0	0	17
1366	17	0	0	0	0	17
1367	0	0	0	17	0	17
1368	0	0	0	17	0	17
1369	0	0	0	16	0	16
1370	17	0	0	0	0	17
1371	0	0	0	16	0	16
1372	0	0	0	17	0	17
1373	0	0	16	0	0	16
1374	0	0	0	17	0	17
1375	0	14	1	0	0	15
1376	0	15	0	0	0	15
1377	15	0	0	0	0	15
1378	0	0	17	0	0	17
1379	0	17	0	0	0	17
1380	17	0	0	0	0	17
1381	0	1	0	17	0	18
1382	0	0	18	0	0	18
1383	0	0	1	17	0	18
1384	0	20	0	0	0	20
1385	19	0	0	0	0	19
1386	0	20	0	0	0	20
1387	19	0	0	0	0	19
1388	18	0	0	0	0	18
1389	0	0	0	20	0	20
1390	0	0	0	22	0	22
1391	0	20	0	0	0	20
1392	20	0	0	0	0	20
1393	0	0	19	0	0	19
1394	18	0	0	1	0	19
1395	21	0	0	0	0	21
1396	0	0	21	0	0	21
1397	0	0	0	19	0	19
1398	18	0	0	0	0	18
1399	0	0	18	0	0	18
1400	0	0	18	0	0	18
1401	18	0	0	0	0	18
1402	0	18	0	0	0	18
1403	0	19	0	0	0	19
1404	0	0	0	21	0	21
1405	0	0	20	0	0	20
1406	21	0	0	0	0	21
1407	0	0	21	0	0	21
1408	0	18	0	0	0	18
1409	14	0	0	0	0	14
1410	0	0	0	18	0	18
1411	17	0	0	0	0	17
1412	0	0	17	0	0	17
1413	0	0	0	16	0	16
1414	0	15	0	0	0	15
1415	0	0	0	17	0	17
1416	0	0	0	14	0	14
1417	0	0	15	0	0	15
1418	0	16	0	0	0	16
1419	0	16	0	0	0	16
1420	0	0	16	0	0	16
1421	15	0	0	1	0	16
1422	15	0	0	0	0	15
1423	0	0	0	16	0	16
1424	12	0	0	0	0	12
1425	0	15	0	0	0	15
1426	0	13	0	0	0	13
1427	13	0	0	0	0	13
1428	0	0	0	13	0	13
1429	13	0	0	0	0	13
1430	13	0	0	0	0	13
1431	0	0	0	13	0	13
1432	0	0	13	0	0	13
1433	11	0	0	0	0	11
1434	12	0	0	0	0	12
1435	0	0	0	11	0	11
1436	0	10	0	0	0	10
1437	0	0	0	11	0	11
1438	0	0	11	0	0	11
1439	0	0	11	0	0	11
1440	0	9	0	0	0	9
1441	0	0	0	11	0	11
1442	0	0	0	7	0	7
1443	0	0	11	0	0	11
1444	11	0	0	0	0	11
1445	11	0	0	0	0	11
1446	9	0	0	1	0	10
1447	12	0	0	0	0	12
1448	0	11	0	0	0	11
1449	0	12	0	1	0	13
1450	12	0	0	0	0	12
1451	0	0	0	13	0	13
1452	0	0	0	13	0	13
1453	0	13	0	0	0	13
1454	0	0	0	15	0	15
1455	0	0	0	14	0	14
1456	0	13	0	0	0	13
1457	0	0	15	0	0	15
1458	0	0	0	16	0	16
1459	16	0	0	0	0	16
1460	15	0	0	0	0	15
1461	0	0	19	0	0	19
1462	0	0	18	0	0	18
1463	0	0	19	0	0	19
1464	0	0	0	16	0	16
1465	0	0	18	0	0	18
1466	0	0	19	0	0	19
1467	0	0	0	17	0	17
1468	0	19	0	0	0	19
1469	0	0	19	0	0	19
1470	0	19	0	0	0	19
1471	18	0	0	0	0	18
1472	0	16	0	0	0	16
1473	0	0	0	22	0	22
1474	22	0	0	0	0	22
1475	0	0	0	19	0	19
1476	0	0	0	20	0	20
1477	0	0	20	0	0	20
1478	0	17	0	0	0	17
1479	0	20	0	0	0	20
1480	0	0	0	20	0	20
1481	0	0	0	20	0	20
1482	0	0	0	17	0	17
1483	0	0	19	0	0	19
1484	0	0	14	0	0	14
1485	20	0	0	0	0	20
1486	0	0	19	0	0	19
1487	0	0	18	0	0	18
1488	0	17	0	0	0	17
1489	0	0	0	20	0	20
1490	0	0	19	0	0	19
1491	0	0	0	22	0	22
1492	0	0	23	0	0	23
1493	0	0	0	23	0	23
1494	0	0	24	0	0	24
1495	0	0	0	27	0	27
1496	0	0	0	27	0	27
1497	0	25	0	0	0	25
1498	0	0	0	25	0	25
1499	0	24	0	0	0	24
1500	0	0	0	25	0	25
1501	0	0	0	24	0	24
1502	25	0	0	0	0	25
1503	0	0	0	23	0	23
1504	0	0	24	0	0	24
1505	0	0	0	24	0	24
1506	0	0	0	24	0	24
1507	0	0	24	0	0	24
1508	0	0	24	0	0	24
1509	0	0	0	23	0	23
1510	0	0	0	24	0	24
1511	0	0	22	0	0	22
1512	0	24	0	0	0	24
1513	0	28	0	0	0	28
1514	27	0	0	0	0	27
1515	0	0	0	29	0	29
1516	29	0	0	0	0	29
1517	29	0	0	0	0	29
1518	0	30	0	0	0	30
1519	30	0	0	0	0	30
1520	32	0	0	0	0	32
1521	0	0	32	0	0	32
1522	0	0	0	38	0	38
1523	0	0	39	0	0	39
1524	0	0	0	39	0	39
1525	0	0	39	0	0	39
1526	0	35	0	0	0	35
1527	0	37	0	0	0	37
1528	0	0	0	38	0	38
1529	39	0	0	0	0	39
1530	1	0	0	37	0	38
1531	0	0	0	40	0	40
1532	0	0	39	0	0	39
1533	0	0	42	0	0	42
1534	0	0	42	0	0	42
1535	0	0	0	41	0	41
1536	0	0	0	42	0	42
1537	0	40	0	0	0	40
1538	0	41	0	0	0	41
1539	47	0	0	0	0	47
1540	0	47	0	0	0	47
1541	0	0	46	0	0	46
1542	0	0	0	47	0	47
1543	0	0	47	0	0	47
1544	0	46	0	0	0	46
1545	0	1	0	47	0	48
1546	44	0	1	0	0	45
1547	0	0	42	0	0	42
1548	0	49	0	0	0	49
1549	0	0	43	0	0	43
1550	0	50	0	0	0	50
1551	0	0	0	49	0	49
1552	51	0	0	0	0	51
1553	50	0	0	0	0	50
1554	0	49	0	0	0	49
1555	47	0	0	0	0	47
1556	0	0	0	47	0	47
1557	48	0	0	0	0	48
1558	0	0	49	0	0	49
1559	0	0	48	0	0	48
1560	0	0	0	49	0	49
1561	0	0	0	50	0	50
1562	0	0	49	0	0	49
1563	0	0	0	51	0	51
1564	55	0	0	0	0	55
1565	51	0	0	1	0	52
1566	0	50	0	0	0	50
1567	0	49	1	0	0	50
1568	54	0	0	0	0	54
1569	0	0	0	53	0	53
1570	54	0	0	0	0	54
1571	0	54	0	0	0	54
1572	55	0	0	0	0	55
1573	0	0	52	0	0	52
1574	0	0	52	0	0	52
1575	0	0	0	53	0	53
1576	0	0	58	0	0	58
1577	0	0	0	54	0	54
1578	1	0	0	56	0	57
1579	0	0	56	0	0	56
1580	0	0	0	55	0	55
1581	0	0	0	59	0	59
1582	0	0	58	0	0	58
1583	0	0	53	0	0	53
1584	57	0	0	0	0	57
1585	0	0	54	0	0	54
1586	52	0	0	0	0	52
1587	54	0	0	0	0	54
1588	0	0	51	0	0	51
1589	0	0	52	0	0	52
1590	0	0	0	51	0	51
1591	0	0	0	51	0	51
1592	0	51	0	0	0	51
1593	0	53	0	0	0	53
1594	0	0	50	0	0	50
1595	53	0	0	0	0	53
1596	53	0	0	0	0	53
1597	0	0	53	0	0	53
1598	0	0	53	0	0	53
1599	0	0	0	51	0	51
1600	0	50	0	0	0	50
1601	0	0	0	54	0	54
1602	0	0	0	54	0	54
1603	53	0	0	0	0	53
1604	54	0	0	0	0	54
1605	0	0	0	51	0	51
1606	0	0	49	1	0	50
1607	48	0	0	0	0	48
1608	0	52	0	0	0	52
1609	51	0	0	0	0	51
1610	50	0	0	0	0	50
1611	0	47	0	0	0	47
1612	0	51	0	0	0	51
1613	0	0	0	50	0	50
1614	0	0	0	51	0	51
1615	0	43	0	0	0	43
1616	0	0	0	43	0	43
1617	1	0	0	40	0	41
1618	0	0	39	0	0	39
1619	39	0	0	0	0	39
1620	41	0	0	0	0	41
1621	41	0	0	0	0	41
1622	0	0	0	41	0	41
1623	40	0	0	0	0	40
1624	0	40	0	0	0	40
1625	0	0	0	41	0	41
1626	0	39	0	0	0	39
1627	0	41	0	0	0	41
1628	39	0	0	0	0	39
1629	37	0	0	0	0	37
1630	40	0	0	0	0	40
1631	39	0	0	0	0	39
1632	33	0	0	0	0	33
1633	0	0	34	0	0	34
1634	36	0	0	0	0	36
1635	0	0	36	0	0	36
1636	36	0	0	0	0	36
1637	36	0	0	0	0	36
1638	36	0	0	0	0	36
1639	0	0	36	0	0	36
1640	0	0	0	36	0	36
1641	0	35	0	0	0	35
1642	35	0	0	0	0	35
1643	31	0	0	0	0	31
1644	0	34	0	0	0	34
1645	31	0	0	1	0	32
1646	0	0	0	32	0	32
1647	0	30	1	0	0	31
1648	36	0	0	0	0	36
1649	32	0	0	0	0	32
1650	0	0	0	32	0	32
1651	33	0	0	0	0	33
1652	0	0	0	35	0	35
1653	0	0	0	32	0	32
1654	0	0	32	0	0	32
1655	0	0	0	30	0	30
1656	0	0	0	32	0	32
1657	0	0	27	0	0	27
1658	0	0	31	0	0	31
1659	0	1	0	29	0	30
1660	0	0	29	0	0	29
1661	28	0	0	0	0	28
1662	0	27	0	0	0	27
1663	0	0	0	26	0	26
1664	0	0	0	29	0	29
1665	0	0	0	29	0	29
1666	29	0	0	0	0	29
1667	29	0	0	0	0	29
1668	30	0	0	0	0	30
1669	0	31	0	0	0	31
1670	0	0	0	30	0	30
1671	0	0	0	24	0	24
1672	26	0	0	0	0	26
1673	26	0	0	0	0	26
1674	0	0	0	26	0	26
1675	0	0	26	0	0	26
1676	27	0	0	0	0	27
1677	27	0	0	0	0	27
1678	0	0	25	0	0	25
1679	26	0	0	0	0	26
1680	0	0	27	0	0	27
1681	26	0	0	0	0	26
1682	0	0	0	25	0	25
1683	0	25	0	0	0	25
1684	0	0	23	0	0	23
1685	0	23	0	0	0	23
1686	0	22	0	0	0	22
1687	26	0	0	0	0	26
1688	0	0	0	24	0	24
1689	0	0	0	27	0	27
1690	27	0	0	0	0	27
1691	0	0	0	28	0	28
1692	0	0	0	27	0	27
1693	0	0	0	29	0	29
1694	0	0	0	29	0	29
1695	0	0	27	0	0	27
1696	0	0	28	0	0	28
1697	0	29	0	0	0	29
1698	27	0	0	0	0	27
1699	0	0	0	30	0	30
1700	0	26	0	0	0	26
1701	0	0	0	28	0	28
1702	0	0	0	31	0	31
1703	0	0	0	31	0	31
1704	0	0	0	30	0	30
1705	0	0	0	30	0	30
1706	0	33	0	0	0	33
1707	0	0	0	30	0	30
1708	0	0	33	0	0	33
1709	0	34	0	0	0	34
1710	0	0	0	34	0	34
1711	0	0	0	32	0	32
1712	0	35	0	0	0	35
1713	0	37	0	0	0	37
1714	36	0	0	0	0	36
1715	0	38	0	0	0	38
1716	38	0	0	0	0	38
1717	38	0	0	0	0	38
1718	0	0	41	0	0	41
1719	0	0	0	40	0	40
1720	0	0	40	0	0	40
1721	0	41	0	0	0	41
1722	0	0	0	41	0	41
1723	0	0	0	42	0	42
1724	0	0	0	41	0	41
1725	0	0	0	42	0	42
1726	0	0	42	0	0	42
1727	0	0	0	40	0	40
1728	0	0	38	0	0	38
1729	0	0	34	0	0	34
1730	40	0	0	0	0	40
1731	39	0	0	0	0	39
1732	39	0	0	0	0	39
1733	0	40	0	0	0	40
1734	0	0	0	40	0	40
1735	0	0	40	0	0	40
1736	0	0	0	38	0	38
1737	0	0	39	0	0	39
1738	40	0	0	0	0	40
1739	37	0	0	0	0	37
1740	39	0	0	0	0	39
1741	0	0	38	0	0	38
1742	0	0	34	0	0	34
1743	0	0	0	38	0	38
1744	0	0	0	38	0	38
1745	0	0	0	38	0	38
1746	0	0	38	0	0	38
1747	0	0	38	0	0	38
1748	42	0	0	0	0	42
1749	0	0	0	42	0	42
1750	0	0	0	43	0	43
1751	43	0	0	0	0	43
1752	0	0	0	42	0	42
1753	46	0	0	0	0	46
1754	47	0	0	0	0	47
1755	47	0	0	0	0	47
1756	0	0	48	0	0	48
1757	0	43	0	0	0	43
1758	47	0	0	0	0	47
1759	0	0	0	44	0	44
1760	0	0	0	46	0	46
1761	0	42	0	0	0	42
1762	43	0	0	0	0	43
1763	41	0	0	0	0	41
1764	39	0	0	0	0	39
1765	0	41	0	0	0	41
1766	40	0	0	0	0	40
1767	39	0	0	0	0	39
1768	38	0	0	0	0	38
1769	0	0	0	38	0	38
1770	0	0	0	36	0	36
1771	0	0	39	0	0	39
1772	0	0	0	39	0	39
1773	0	0	0	38	0	38
1774	0	0	35	0	0	35
1775	38	0	0	0	0	38
1776	41	0	0	0	0	41
1777	0	0	0	43	0	43
1778	0	42	0	0	0	42
1779	0	43	0	0	0	43
1780	0	0	0	42	0	42
1781	0	0	41	0	0	41
1782	0	0	0	42	0	42
1783	0	0	42	0	0	42
1784	0	0	42	0	0	42
1785	0	0	0	44	0	44
1786	46	0	0	0	0	46
1787	49	0	0	0	0	49
1788	0	0	0	48	0	48
1789	0	0	0	49	0	49
1790	0	0	0	42	0	42
1791	0	0	0	47	0	47
1792	47	0	0	0	0	47
1793	45	0	1	0	0	46
1794	41	0	0	0	0	41
1795	0	0	42	0	0	42
1796	0	0	0	41	0	41
1797	0	0	0	42	0	42
1798	40	0	0	0	0	40
1799	0	40	0	0	0	40
1800	42	0	0	0	0	42
1801	40	0	0	0	0	40
1802	40	0	0	1	0	41
1803	41	0	0	0	0	41
1804	0	0	37	0	0	37
1805	0	0	37	0	0	37
1806	41	0	0	0	0	41
1807	38	0	0	0	0	38
1808	41	0	0	0	0	41
1809	41	0	0	0	0	41
1810	0	0	47	0	0	47
1811	0	38	0	0	0	38
1812	0	0	0	46	0	46
1813	48	0	0	0	0	48
1814	47	0	0	0	0	47
1815	46	0	0	1	0	47
1816	47	0	0	0	0	47
1817	45	0	0	0	0	45
1818	48	0	0	0	0	48
1819	0	0	41	0	0	41
1820	0	0	42	0	0	42
1821	0	0	0	46	0	46
1822	0	0	49	0	0	49
1823	0	47	0	0	0	47
1824	0	43	0	0	0	43
1825	0	0	0	49	0	49
1826	0	0	45	0	0	45
1827	0	0	46	0	0	46
1828	50	0	0	0	0	50
1829	53	0	0	0	0	53
1830	0	0	0	51	0	51
1831	51	0	0	0	0	51
1832	0	0	0	51	0	51
1833	0	0	0	53	0	53
1834	0	0	50	0	0	50
1835	0	0	47	0	0	47
1836	0	0	0	53	0	53
1837	0	0	53	0	0	53
1838	52	1	0	0	0	53
1839	51	0	0	0	0	51
1840	0	51	0	0	0	51
1841	51	0	0	0	0	51
1842	0	0	50	0	0	50
1843	52	0	0	0	0	52
1844	52	0	0	0	0	52
1845	52	0	0	0	0	52
1846	0	0	0	48	0	48
1847	0	50	0	0	0	50
1848	51	0	0	0	0	51
1849	49	0	0	0	0	49
1850	0	0	0	53	0	53
1851	51	0	0	0	0	51
1852	0	54	0	0	0	54
1853	0	0	0	52	0	52
1854	0	0	51	0	0	51
1855	52	0	0	0	0	52
1856	0	1	49	0	0	50
1857	0	0	0	55	0	55
1858	0	59	0	0	0	59
1859	0	55	0	0	0	55
1860	0	0	0	59	0	59
1861	0	56	0	0	0	56
1862	0	0	0	61	0	61
1863	0	0	1	61	0	62
1864	0	0	0	64	0	64
1865	58	0	0	0	0	58
1866	0	0	0	66	0	66
1867	0	0	68	0	0	68
1868	0	68	0	0	0	68
1869	76	0	0	0	0	76
1870	0	0	0	79	0	79
1871	0	0	0	78	0	78
1872	0	0	0	80	0	80
1873	0	0	78	0	0	78
1874	0	81	0	0	0	81
1875	80	0	0	0	0	80
1876	0	0	0	82	0	82
1877	0	75	0	0	0	75
1878	77	0	0	0	0	77
1879	0	0	78	0	0	78
1880	73	0	0	0	0	73
1881	0	0	78	0	0	78
1882	0	0	75	0	0	75
1883	0	78	0	0	0	78
1884	0	0	0	79	0	79
1885	2	0	75	0	0	77
1886	0	75	0	0	0	75
1887	0	0	0	78	0	78
1888	0	73	0	0	0	73
1889	1	0	75	0	0	76
1890	0	0	0	76	0	76
1891	0	0	78	0	0	78
1892	0	0	0	76	0	76
1893	0	0	0	75	0	75
1894	0	0	77	0	0	77
1895	0	0	0	73	0	73
1896	71	0	3	0	0	74
1897	0	73	0	0	0	73
1898	0	0	71	0	0	71
1899	72	0	0	0	0	72
1900	1	2	0	72	0	75
1901	0	77	0	0	0	77
1902	74	0	0	0	0	74
1903	60	0	0	0	0	60
1904	0	0	0	65	0	65
1905	0	1	0	63	0	64
1906	0	0	0	62	0	62
1907	0	0	0	63	0	63
1908	0	64	0	0	0	64
1909	0	0	0	65	0	65
1910	0	61	0	0	0	61
1911	0	62	0	0	0	62
1912	0	65	0	0	0	65
1913	0	0	69	0	0	69
1914	0	65	0	0	0	65
1915	67	0	0	0	0	67
1916	0	67	0	0	0	67
1917	0	0	0	68	0	68
1918	0	67	0	0	0	67
1919	0	0	0	67	0	67
1920	0	0	0	67	0	67
1921	0	0	65	0	0	65
1922	65	0	0	0	0	65
1923	63	0	0	0	0	63
1924	62	0	0	0	0	62
1925	0	63	0	0	0	63
1926	0	0	0	62	0	62
1927	0	0	64	0	0	64
1928	0	61	0	0	0	61
1929	0	0	0	61	0	61
1930	0	60	0	0	0	60
1931	61	0	0	0	0	61
1932	59	0	0	1	0	60
1933	61	0	0	0	0	61
1934	60	0	0	0	0	60
1935	0	0	0	59	0	59
1936	0	0	0	58	0	58
1937	0	53	0	0	0	53
1938	0	0	0	58	0	58
1939	0	0	54	0	0	54
1940	0	0	0	53	0	53
1941	0	0	54	0	0	54
1942	0	53	0	0	0	53
1943	0	0	51	0	0	51
1944	0	0	0	51	0	51
1945	0	0	51	0	0	51
1946	0	0	0	53	0	53
1947	0	0	0	49	0	49
1948	0	0	0	51	0	51
1949	0	0	0	51	0	51
1950	48	0	0	0	0	48
1951	0	49	0	0	0	49
1952	48	0	0	0	0	48
1953	0	0	44	0	0	44
1954	44	0	0	0	0	44
1955	43	0	0	0	0	43
1956	0	0	43	0	0	43
1957	0	0	36	0	0	36
1958	0	42	0	0	0	42
1959	0	38	0	0	0	38
1960	0	0	35	0	0	35
1961	0	40	0	0	0	40
1962	0	0	0	27	0	27
1963	28	0	0	0	0	28
1964	0	0	0	27	0	27
1965	26	0	0	0	0	26
1966	26	0	0	0	0	26
1967	0	25	0	0	0	25
1968	28	0	0	0	0	28
1969	29	0	0	0	0	29
1970	0	0	0	27	0	27
1971	25	0	0	0	0	25
1972	0	26	0	0	0	26
1973	0	0	0	26	0	26
1974	26	0	0	0	0	26
1975	0	0	26	0	0	26
1976	27	0	0	0	0	27
1977	0	0	0	25	0	25
1978	0	0	24	0	0	24
1979	0	0	27	0	0	27
1980	25	0	0	0	0	25
1981	24	0	0	0	0	24
1982	0	0	0	26	0	26
1983	0	0	0	23	0	23
1984	0	0	0	25	0	25
1985	0	24	0	0	0	24
1986	26	0	0	0	0	26
1987	0	22	0	1	0	23
1988	23	0	0	0	0	23
1989	0	0	21	0	0	21
1990	0	0	0	21	0	21
1991	22	0	0	0	0	22
1992	0	0	0	22	0	22
1993	0	0	0	22	0	22
1994	0	20	0	0	0	20
1995	20	0	0	0	0	20
1996	0	19	0	0	0	19
1997	0	0	0	17	0	17
1998	0	0	19	0	0	19
1999	18	0	0	0	0	18
2000	0	0	19	0	0	19
2001	17	0	0	0	0	17
2002	0	18	0	0	0	18
2003	0	0	0	19	0	19
2004	0	15	0	0	0	15
2005	15	0	0	0	0	15
2006	0	0	0	15	0	15
2007	0	0	0	14	0	14
2008	0	0	14	0	0	14
2009	15	0	0	0	0	15
2010	0	0	0	17	0	17
2011	0	0	17	0	0	17
2012	0	15	0	0	0	15
2013	0	0	0	18	0	18
2014	17	0	0	0	0	17
2015	0	0	0	15	0	15
2016	0	0	17	0	0	17
2017	15	0	0	0	0	15
2018	0	0	0	13	0	13
2019	0	0	16	0	0	16
2020	0	0	0	16	0	16
2021	0	0	0	16	0	16
2022	0	17	0	0	0	17
2023	16	0	0	0	0	16
2024	0	18	0	0	0	18
2025	16	0	0	0	0	16
2026	0	0	0	16	0	16
2027	0	14	0	0	0	14
2028	0	0	0	17	0	17
2029	0	0	19	0	0	19
2030	19	0	0	0	0	19
2031	0	0	0	18	0	18
2032	0	0	0	18	0	18
2033	0	0	0	18	0	18
2034	0	0	18	0	0	18
2035	0	0	17	0	0	17
2036	0	16	0	0	0	16
2037	0	0	0	18	0	18
2038	17	0	0	0	0	17
2039	0	17	0	0	0	17
2040	0	0	0	18	0	18
2041	20	0	0	0	0	20
2042	18	0	0	0	0	18
2043	0	20	0	0	0	20
2044	22	0	0	0	0	22
2045	23	0	0	0	0	23
2046	0	0	0	22	0	22
2047	0	23	0	0	0	23
2048	0	0	0	21	0	21
2049	23	0	0	0	0	23
2050	0	0	22	0	0	22
2051	0	0	0	23	0	23
2052	0	0	0	23	0	23
2053	0	0	24	0	0	24
2054	0	0	0	22	0	22
2055	22	0	0	1	0	23
2056	22	0	0	0	0	22
2057	0	0	0	23	0	23
2058	0	0	20	0	0	20
2059	0	0	20	0	0	20
2060	0	20	0	0	0	20
2061	0	26	0	0	0	26
2062	0	0	0	25	0	25
2063	25	0	0	0	0	25
2064	0	27	0	0	0	27
2065	27	0	0	0	0	27
2066	0	0	0	25	0	25
2067	0	0	0	30	0	30
2068	30	0	0	0	0	30
2069	0	28	0	0	0	28
2070	28	0	0	0	0	28
2071	0	0	26	0	0	26
2072	0	0	22	0	0	22
2073	0	0	0	26	0	26
2074	0	0	26	0	0	26
2075	0	0	24	0	0	24
2076	1	0	0	25	0	26
2077	0	0	26	0	0	26
2078	0	0	0	23	0	23
2079	0	0	0	27	0	27
2080	0	0	26	0	0	26
2081	0	0	0	26	0	26
2082	0	0	0	28	0	28
2083	0	27	0	0	0	27
2084	30	0	0	0	0	30
2085	0	0	31	0	0	31
2086	0	0	0	29	0	29
2087	1	0	0	27	0	28
2088	0	0	26	0	0	26
2089	29	0	0	0	0	29
2090	0	28	0	0	0	28
2091	0	0	0	27	0	27
2092	0	0	0	28	0	28
2093	0	26	0	0	0	26
2094	1	0	26	0	0	27
2095	0	27	0	0	0	27
2096	27	0	0	0	0	27
2097	0	0	25	0	0	25
2098	0	0	0	29	0	29
2099	0	0	31	0	0	31
2100	0	0	28	0	0	28
2101	0	31	0	0	0	31
2102	0	0	0	29	0	29
2103	28	0	0	0	0	28
2104	28	0	0	0	0	28
2105	0	27	0	0	0	27
2106	0	0	0	28	0	28
2107	27	0	0	0	0	27
2108	27	0	0	0	0	27
2109	0	28	0	0	0	28
2110	28	0	0	0	0	28
2111	0	0	0	28	0	28
2112	0	28	0	0	0	28
2113	0	0	0	32	0	32
2114	1	0	0	31	0	32
2115	0	0	0	30	0	30
2116	0	0	27	0	0	27
2117	0	0	25	0	0	25
2118	0	31	0	0	0	31
2119	30	0	0	0	0	30
2120	0	30	0	0	0	30
2121	0	0	0	31	0	31
2122	0	0	29	0	0	29
2123	0	0	0	28	0	28
2124	0	0	0	28	0	28
2125	0	0	0	29	0	29
2126	27	0	0	0	0	27
2127	0	0	0	28	0	28
2128	0	0	31	0	0	31
2129	30	0	0	1	0	31
2130	33	0	0	0	0	33
2131	31	0	0	0	0	31
2132	33	0	0	0	0	33
2133	32	0	0	0	0	32
2134	0	30	0	0	0	30
2135	0	0	0	28	0	28
2136	0	29	0	0	0	29
2137	26	0	0	0	0	26
2138	26	0	0	0	0	26
2139	24	0	0	0	0	24
2140	0	24	0	0	0	24
2141	0	26	0	0	0	26
2142	0	24	0	0	0	24
2143	0	0	28	0	0	28
2144	0	0	0	28	0	28
2145	0	24	0	0	0	24
2146	0	28	0	0	0	28
2147	0	0	0	27	0	27
2148	0	0	0	30	0	30
2149	0	0	30	0	0	30
2150	35	0	0	0	0	35
2151	0	0	0	34	0	34
2152	0	0	0	35	0	35
2153	0	0	34	0	0	34
2154	0	0	28	0	0	28
2155	0	28	0	0	0	28
2156	0	0	0	31	0	31
2157	0	0	0	28	0	28
2158	0	0	31	0	0	31
2159	31	0	0	0	0	31
2160	27	0	0	0	0	27
2161	0	0	27	0	0	27
2162	23	0	0	0	0	23
2163	0	0	27	0	0	27
2164	25	0	0	0	0	25
2165	33	0	0	0	0	33
2166	0	0	31	0	0	31
2167	0	0	0	30	0	30
2168	1	0	0	31	0	32
2169	0	0	0	32	0	32
2170	33	0	0	0	0	33
2171	32	0	0	0	0	32
2172	0	0	32	0	0	32
2173	0	0	29	0	0	29
2174	30	0	0	0	0	30
2175	28	0	0	0	0	28
2176	0	0	27	0	0	27
2177	0	0	25	0	0	25
2178	0	0	0	28	0	28
2179	0	0	28	0	0	28
2180	0	0	0	26	0	26
2181	28	0	0	0	0	28
2182	0	0	29	0	0	29
2183	26	0	0	0	0	26
2184	0	0	30	0	0	30
2185	0	0	0	29	0	29
2186	0	0	0	29	0	29
2187	0	0	0	30	0	30
2188	0	32	0	0	0	32
2189	0	0	0	32	0	32
2190	1	0	0	30	0	31
2191	34	0	0	0	0	34
2192	0	0	35	0	0	35
2193	37	0	0	0	0	37
2194	0	0	37	0	0	37
2195	41	0	0	0	0	41
2196	0	39	0	0	0	39
2197	0	0	40	0	0	40
2198	0	0	37	0	0	37
2199	0	0	0	39	0	39
2200	0	0	0	41	0	41
2201	0	0	41	0	0	41
2202	0	0	43	0	0	43
2203	0	0	46	0	0	46
2204	43	0	0	0	0	43
2205	38	0	0	0	0	38
2206	40	0	0	0	0	40
2207	1	0	0	37	0	38
2208	0	0	0	39	0	39
2209	0	0	40	0	0	40
2210	0	0	0	38	0	38
2211	0	0	0	35	0	35
2212	38	0	0	0	0	38
2213	38	0	0	0	0	38
2214	37	0	0	0	0	37
2215	0	0	0	36	0	36
2216	0	0	0	38	0	38
2217	0	0	0	37	0	37
2218	37	0	0	0	0	37
2219	0	0	0	38	0	38
2220	0	37	0	0	0	37
2221	0	0	0	37	0	37
2222	0	36	0	0	0	36
2223	35	0	0	0	0	35
2224	34	0	0	0	0	34
2225	0	32	0	0	0	32
2226	0	33	0	0	0	33
2227	0	0	0	36	0	36
2228	0	0	35	0	0	35
2229	0	0	0	36	0	36
2230	0	0	35	0	0	35
2231	0	35	0	0	0	35
2232	0	0	0	36	0	36
2233	0	0	0	35	0	35
2234	0	0	35	0	0	35
2235	0	0	0	38	0	38
2236	0	0	40	0	0	40
2237	40	0	0	0	0	40
2238	36	0	0	0	0	36
2239	39	0	0	0	0	39
2240	0	0	0	37	0	37
2241	0	0	0	36	0	36
2242	0	0	37	0	0	37
2243	0	0	0	27	0	27
2244	0	31	0	0	0	31
2245	0	0	30	0	0	30
2246	0	0	29	0	0	29
2247	0	0	0	30	0	30
2248	0	0	30	0	0	30
2249	0	0	28	0	0	28
2250	34	0	0	0	0	34
2251	0	35	0	0	0	35
2252	35	0	0	0	0	35
2253	36	0	0	0	0	36
2254	34	0	0	0	0	34
2255	0	0	0	35	0	35
2256	0	0	0	36	0	36
2257	0	0	34	0	0	34
2258	0	0	0	30	0	30
2259	0	28	0	0	0	28
2260	31	0	0	0	0	31
2261	0	29	0	0	0	29
2262	0	30	0	0	0	30
2263	0	0	0	31	0	31
2264	0	0	32	0	0	32
2265	0	0	0	30	0	30
2266	0	0	34	0	0	34
2267	0	32	0	0	0	32
2268	33	1	0	0	0	34
2269	29	0	1	0	0	30
2270	32	0	0	0	0	32
2271	0	0	34	0	0	34
2272	0	0	31	0	0	31
2273	33	0	0	0	0	33
2274	35	0	0	0	0	35
2275	37	0	0	0	0	37
2276	0	0	0	33	0	33
2277	0	0	1	31	0	32
2278	31	0	0	0	0	31
2279	33	0	0	0	0	33
2280	0	0	33	0	0	33
2281	0	0	31	0	0	31
2282	31	0	0	0	0	31
2283	0	0	32	0	0	32
2284	29	0	0	0	0	29
2285	0	0	33	0	0	33
2286	0	0	0	27	0	27
2287	0	0	27	0	0	27
2288	0	0	0	24	0	24
2289	0	0	0	24	0	24
2290	0	24	0	0	0	24
2291	24	0	0	0	0	24
2292	0	0	25	0	0	25
2293	22	0	0	0	0	22
2294	0	22	0	0	0	22
2295	20	0	0	0	0	20
2296	0	0	0	19	0	19
2297	0	0	0	20	0	20
2298	0	21	0	0	0	21
2299	0	0	0	20	0	20
2300	0	0	0	21	0	21
2301	0	0	0	21	0	21
2302	23	0	0	0	0	23
2303	23	0	0	0	0	23
2304	0	0	20	0	0	20
2305	0	23	0	0	0	23
2306	0	0	0	24	0	24
2307	0	0	0	24	0	24
2308	0	0	23	0	0	23
2309	0	0	0	24	0	24
2310	24	0	0	0	0	24
2311	24	0	0	0	0	24
2312	23	0	0	0	0	23
2313	0	0	0	21	0	21
2314	22	0	0	0	0	22
2315	22	0	0	0	0	22
2316	23	0	0	0	0	23
2317	0	0	0	23	0	23
2318	0	0	0	23	0	23
2319	0	0	0	22	0	22
2320	0	0	0	21	0	21
2321	0	0	0	21	0	21
2322	0	0	21	0	0	21
2323	0	0	23	0	0	23
2324	0	23	0	0	0	23
2325	0	0	0	26	0	26
2326	0	0	0	28	0	28
2327	0	0	0	28	0	28
2328	0	0	23	0	0	23
2329	0	0	0	22	0	22
2330	0	0	24	0	0	24
2331	0	0	0	22	0	22
2332	0	0	22	0	0	22
2333	0	20	0	0	0	20
2334	0	0	0	22	0	22
2335	0	0	22	0	0	22
2336	22	0	0	0	0	22
2337	0	25	0	0	0	25
2338	0	0	0	22	0	22
2339	0	24	0	0	0	24
2340	0	0	0	24	0	24
2341	25	0	0	0	0	25
2342	0	0	0	25	0	25
2343	0	28	0	0	0	28
2344	25	0	0	0	0	25
2345	0	0	0	27	0	27
2346	0	0	0	28	0	28
2347	27	0	0	0	0	27
2348	0	0	0	28	0	28
2349	0	0	0	28	0	28
2350	0	0	29	0	0	29
2351	0	0	28	0	0	28
2352	0	0	0	28	0	28
2353	0	0	26	0	0	26
2354	0	0	31	0	0	31
2355	32	0	0	0	0	32
2356	0	0	33	0	0	33
2357	0	35	0	0	0	35
2358	0	0	0	36	0	36
2359	34	0	0	0	0	34
2360	34	0	0	0	0	34
2361	35	0	0	0	0	35
2362	0	33	0	0	0	33
2363	0	0	0	34	0	34
2364	0	0	0	33	0	33
2365	33	0	0	0	0	33
2366	34	0	0	0	0	34
2367	35	0	0	0	0	35
2368	0	0	34	0	0	34
2369	0	32	0	0	0	32
2370	0	32	0	0	0	32
2371	0	0	0	31	0	31
2372	0	0	0	36	0	36
2373	0	0	33	0	0	33
2374	35	0	0	0	0	35
2375	36	0	0	0	0	36
2376	0	0	0	36	0	36
2377	0	0	0	40	0	40
2378	0	0	0	40	0	40
2379	40	0	0	0	0	40
2380	0	0	39	0	0	39
2381	0	0	36	0	0	36
2382	0	0	0	37	0	37
2383	0	0	39	0	0	39
2384	38	0	0	0	0	38
2385	37	0	0	0	0	37
2386	39	0	0	0	0	39
2387	0	35	0	0	0	35
2388	36	0	0	0	0	36
2389	0	0	0	35	0	35
2390	0	0	0	36	0	36
2391	0	0	0	35	0	35
2392	0	0	32	0	0	32
2393	0	0	0	29	0	29
2394	0	33	0	0	0	33
2395	32	0	0	0	0	32
2396	0	33	0	0	0	33
2397	0	0	30	0	0	30
2398	0	32	0	0	0	32
2399	32	0	0	0	0	32
2400	0	32	0	0	0	32
2401	0	0	0	30	0	30
2402	0	31	0	0	0	31
2403	31	0	0	0	0	31
2404	32	0	0	0	0	32
2405	31	0	0	0	0	31
2406	0	0	31	0	0	31
2407	0	0	25	0	0	25
2408	0	0	29	0	0	29
2409	30	0	0	0	0	30
2410	0	0	0	29	0	29
2411	0	0	0	29	0	29
2412	0	0	29	0	0	29
2413	0	0	0	29	0	29
2414	29	0	0	0	0	29
2415	0	29	0	0	0	29
2416	26	0	0	0	0	26
2417	0	0	26	0	0	26
2418	26	0	0	0	0	26
2419	26	0	0	0	0	26
2420	25	0	0	0	0	25
2421	0	0	24	0	0	24
2422	0	0	0	23	0	23
2423	0	0	25	0	0	25
2424	0	0	0	24	0	24
2425	0	0	21	0	0	21
2426	0	0	0	21	0	21
2427	0	0	0	23	0	23
2428	22	0	0	0	0	22
2429	21	0	0	0	0	21
2430	19	0	0	0	0	19
2431	0	0	0	22	0	22
2432	0	17	0	0	0	17
2433	0	21	0	0	0	21
2434	21	0	0	0	0	21
2435	0	0	20	0	0	20
2436	20	0	0	0	0	20
2437	0	0	15	0	0	15
2438	15	0	0	0	0	15
2439	16	0	0	0	0	16
2440	0	0	16	0	0	16
2441	18	0	0	0	0	18
2442	18	0	0	0	0	18
2443	14	0	0	0	0	14
2444	0	18	0	0	0	18
2445	0	0	0	18	0	18
2446	0	0	17	0	0	17
2447	0	0	17	0	0	17
2448	0	17	0	0	0	17
2449	0	18	0	0	0	18
2450	0	0	0	18	0	18
2451	18	0	0	0	0	18
2452	0	18	0	0	0	18
2453	0	0	0	17	0	17
2454	0	17	0	0	0	17
2455	16	0	0	0	0	16
2456	0	0	0	17	0	17
2457	0	0	15	0	0	15
2458	0	17	0	0	0	17
2459	0	13	0	0	0	13
2460	0	0	0	15	0	15
2461	0	15	0	0	0	15
2462	0	0	0	19	0	19
2463	19	0	0	0	0	19
2464	18	0	0	0	0	18
2465	18	0	0	0	0	18
2466	17	0	0	0	0	17
2467	0	0	13	0	0	13
2468	0	14	0	0	0	14
2469	0	15	0	0	0	15
2470	0	8	0	0	0	8
2471	0	9	0	0	0	9
2472	11	0	0	0	0	11
2473	11	0	0	0	0	11
2474	11	0	0	0	0	11
2475	10	0	0	0	0	10
2476	0	0	8	0	0	8
2477	11	0	0	0	0	11
2478	11	0	0	0	0	11
2479	11	0	0	0	0	11
2480	0	0	0	13	0	13
2481	0	0	0	13	0	13
2482	13	0	0	0	0	13
2483	0	0	0	13	0	13
2484	0	13	0	0	0	13
2485	0	0	0	13	0	13
2486	0	0	0	13	0	13
2487	0	13	0	0	0	13
2488	0	0	0	12	0	12
2489	0	0	0	13	0	13
2490	13	0	0	0	0	13
2491	0	0	14	0	0	14
2492	11	0	0	0	0	11
2493	0	0	11	1	0	12
2494	0	0	11	0	0	11
2495	0	0	11	0	0	11
2496	12	0	0	0	0	12
2497	0	0	11	0	0	11
2498	11	0	0	0	0	11
2499	10	0	0	0	0	10
2500	10	0	0	0	0	10
2501	0	11	0	0	0	11
2502	10	0	0	0	0	10
2503	0	10	0	0	0	10
2504	0	0	0	11	0	11
2505	0	0	0	12	0	12
2506	0	12	0	0	0	12
2507	0	9	0	0	0	9
2508	0	12	0	0	0	12
2509	14	0	0	0	0	14
2510	0	17	0	0	0	17
2511	16	0	0	0	0	16
2512	0	0	16	0	0	16
2513	17	0	0	0	0	17
2514	18	0	0	0	0	18
2515	0	0	20	0	0	20
2516	0	0	0	20	0	20
2517	0	0	20	0	0	20
2518	0	0	0	20	0	20
2519	0	0	0	19	0	19
2520	18	0	0	0	0	18
2521	17	0	0	0	0	17
2522	0	17	0	0	0	17
2523	17	0	0	0	0	17
2524	0	0	18	0	0	18
2525	18	0	0	0	0	18
2526	0	0	18	0	0	18
2527	0	0	16	0	0	16
2528	18	0	0	0	0	18
2529	18	0	0	0	0	18
2530	0	0	19	0	0	19
2531	0	0	0	20	0	20
2532	0	0	0	20	0	20
2533	0	0	20	0	0	20
2534	0	0	0	19	0	19
2535	0	20	0	0	0	20
2536	0	0	0	22	0	22
2537	0	0	0	21	0	21
2538	0	0	21	0	0	21
2539	24	0	0	0	0	24
2540	22	0	0	0	0	22
2541	22	0	0	0	0	22
2542	20	0	0	0	0	20
2543	0	19	0	0	0	19
2544	0	0	0	19	0	19
2545	0	0	17	0	0	17
2546	0	0	18	0	0	18
2547	0	0	0	20	0	20
2548	0	0	20	0	0	20
2549	20	0	0	0	0	20
2550	0	0	0	20	0	20
2551	0	0	0	20	0	20
2552	0	0	0	19	0	19
2553	19	0	0	0	0	19
2554	0	19	0	0	0	19
2555	21	0	0	0	0	21
2556	21	0	0	0	0	21
2557	0	21	0	0	0	21
2558	0	20	0	0	0	20
2559	22	0	0	0	0	22
2560	0	0	0	22	0	22
2561	0	0	0	22	0	22
2562	21	0	0	0	0	21
2563	0	0	21	0	0	21
2564	20	0	0	0	0	20
2565	20	0	0	1	0	21
2566	0	22	0	0	0	22
2567	24	0	0	0	0	24
2568	28	0	0	0	0	28
2569	0	28	0	0	0	28
2570	0	27	0	0	0	27
2571	0	0	0	27	0	27
2572	27	0	0	0	0	27
2573	0	29	0	0	0	29
2574	0	0	0	29	0	29
2575	29	0	0	0	0	29
2576	0	0	30	0	0	30
2577	0	0	0	29	0	29
2578	0	0	29	0	0	29
2579	30	0	0	0	0	30
2580	31	0	0	0	0	31
2581	0	0	31	0	0	31
2582	0	32	0	0	0	32
2583	0	0	0	32	0	32
2584	0	0	30	0	0	30
2585	0	0	0	29	0	29
2586	0	0	0	32	0	32
2587	0	0	32	0	0	32
2588	31	0	0	0	0	31
2589	32	0	0	0	0	32
2590	0	0	32	0	0	32
2591	0	31	0	0	0	31
2592	0	0	0	31	0	31
2593	0	31	0	0	0	31
2594	0	30	0	0	0	30
2595	30	0	0	0	0	30
2596	0	0	0	31	0	31
2597	0	0	0	32	0	32
2598	0	0	33	0	0	33
2599	0	0	32	0	0	32
2600	0	0	0	33	0	33
2601	0	0	0	32	0	32
2602	1	0	31	0	0	32
2603	0	0	29	0	0	29
2604	0	0	0	29	0	29
2605	29	0	0	0	0	29
2606	0	29	0	0	0	29
2607	29	0	0	0	0	29
2608	0	28	0	0	0	28
2609	0	27	0	0	0	27
2610	29	0	0	0	0	29
2611	0	0	28	0	0	28
2612	0	0	0	28	0	28
2613	0	0	0	28	0	28
2614	0	0	0	26	0	26
2615	0	0	28	0	0	28
2616	0	0	0	28	0	28
2617	28	0	0	0	0	28
2618	0	0	0	28	0	28
2619	0	0	0	28	0	28
2620	28	0	0	0	0	28
2621	25	0	0	0	0	25
2622	0	25	0	0	0	25
2623	0	0	27	0	0	27
2624	0	0	24	0	0	24
2625	0	0	24	0	0	24
2626	0	26	0	0	0	26
2627	0	0	0	25	0	25
2628	0	0	0	23	0	23
2629	25	0	0	0	0	25
2630	0	0	0	23	0	23
2631	0	0	23	0	0	23
2632	0	0	0	19	0	19
2633	0	0	0	20	0	20
2634	0	0	21	0	0	21
2635	0	21	0	0	0	21
2636	1	0	0	20	0	21
2637	0	22	0	0	0	22
2638	0	0	23	0	0	23
2639	23	0	0	0	0	23
2640	23	0	0	0	0	23
2641	22	0	0	0	0	22
2642	0	0	0	22	0	22
2643	0	22	0	0	0	22
2644	23	0	0	0	0	23
2645	22	0	0	0	0	22
2646	23	0	0	0	0	23
2647	0	0	20	0	0	20
2648	20	0	0	0	0	20
2649	0	20	0	0	0	20
2650	20	0	0	0	0	20
2651	0	16	0	0	0	16
2652	20	0	0	0	0	20
2653	0	1	20	0	0	21
2654	21	0	0	0	0	21
2655	21	0	0	0	0	21
2656	19	0	0	0	0	19
2657	20	0	0	0	0	20
2658	0	0	19	0	0	19
2659	0	0	0	21	0	21
2660	18	0	0	0	0	18
2661	0	16	0	0	0	16
2662	0	0	0	12	0	12
2663	0	0	14	0	0	14
2664	1	0	0	15	0	16
2665	0	0	20	0	0	20
2666	0	20	0	0	0	20
2667	0	23	0	0	0	23
2668	0	21	0	0	0	21
2669	0	0	0	20	0	20
2670	0	0	0	22	0	22
2671	0	0	22	0	0	22
2672	0	23	0	0	0	23
2673	23	0	0	0	0	23
2674	0	22	0	0	0	22
2675	0	23	0	0	0	23
2676	0	0	0	18	0	18
2677	22	0	0	0	0	22
2678	22	0	0	0	0	22
2679	0	0	0	21	0	21
2680	22	0	0	0	0	22
2681	0	0	0	22	0	22
2682	0	0	22	0	0	22
2683	20	0	0	0	0	20
2684	0	0	0	22	0	22
2685	0	0	23	0	0	23
2686	0	0	20	0	0	20
2687	0	0	0	21	0	21
2688	23	0	0	0	0	23
2689	23	0	0	0	0	23
2690	0	25	0	0	0	25
2691	24	0	0	0	0	24
2692	23	0	0	0	0	23
2693	24	0	0	0	0	24
2694	0	24	0	0	0	24
2695	23	0	0	0	0	23
2696	23	0	0	0	0	23
2697	0	0	0	22	0	22
2698	20	0	0	0	0	20
2699	0	24	0	0	0	24
2700	0	24	0	0	0	24
2701	0	0	0	26	0	26
2702	0	0	0	26	0	26
2703	0	26	0	0	0	26
2704	28	0	0	0	0	28
2705	0	28	0	0	0	28
2706	28	0	0	0	0	28
2707	0	28	0	0	0	28
2708	0	0	0	30	0	30
2709	0	32	0	0	0	32
2710	32	0	0	0	0	32
2711	30	0	0	0	0	30
2712	32	0	0	0	0	32
2713	0	0	32	0	0	32
2714	0	0	32	0	0	32
2715	0	33	0	0	0	33
2716	0	0	33	0	0	33
2717	0	0	34	0	0	34
2718	0	0	0	32	0	32
2719	0	0	31	0	0	31
2720	0	32	0	2	0	34
2721	32	0	0	0	0	32
2722	0	32	0	0	0	32
2723	0	33	0	0	0	33
2724	34	0	0	0	0	34
2725	34	0	0	0	0	34
2726	0	33	0	0	0	33
2727	33	0	0	0	0	33
2728	33	0	0	0	0	33
2729	34	0	0	0	0	34
2730	0	0	31	0	0	31
2731	0	0	31	0	0	31
2732	0	0	0	31	0	31
2733	0	0	0	35	0	35
2734	35	0	0	0	0	35
2735	0	35	0	0	0	35
2736	0	0	0	35	0	35
2737	0	0	0	36	0	36
2738	0	0	0	36	0	36
2739	0	0	0	36	0	36
2740	0	0	32	0	0	32
2741	0	0	32	0	0	32
2742	0	0	0	33	0	33
2743	0	0	30	0	0	30
2744	33	0	0	0	0	33
2745	0	0	0	32	0	32
2746	0	0	32	0	0	32
2747	31	0	0	0	0	31
2748	0	31	0	0	0	31
2749	28	0	0	0	0	28
2750	0	29	0	0	0	29
2751	0	0	0	30	0	30
2752	0	0	31	0	0	31
2753	0	0	0	32	0	32
2754	0	0	32	0	0	32
2755	31	0	0	0	0	31
2756	0	0	0	31	0	31
2757	32	0	0	0	0	32
2758	0	0	32	0	0	32
2759	25	0	0	0	0	25
2760	26	0	0	0	0	26
2761	0	0	30	0	0	30
2762	0	0	0	27	0	27
2763	0	0	29	0	0	29
2764	0	30	0	0	0	30
2765	31	0	0	0	0	31
2766	31	0	0	0	0	31
2767	0	0	32	0	0	32
2768	0	0	24	0	0	24
2769	0	0	0	31	0	31
2770	0	0	0	32	0	32
2771	32	0	0	0	0	32
2772	0	35	0	0	0	35
2773	38	0	0	0	0	38
2774	38	0	0	0	0	38
2775	0	0	35	0	0	35
2776	38	0	0	0	0	38
2777	0	0	38	0	0	38
2778	0	0	0	38	0	38
2779	0	0	33	0	0	33
2780	1	0	0	35	0	36
2781	0	0	38	0	0	38
2782	38	0	0	0	0	38
2783	37	0	0	0	0	37
2784	0	0	0	38	0	38
2785	37	0	0	0	0	37
2786	0	0	0	35	0	35
2787	0	38	0	0	0	38
2788	38	0	0	0	0	38
2789	0	36	0	0	0	36
2790	0	0	0	35	0	35
2791	0	0	0	38	0	38
2792	0	0	0	37	0	37
2793	0	0	0	34	0	34
2794	0	0	39	0	0	39
2795	33	0	0	0	0	33
2796	38	0	0	0	0	38
2797	0	39	0	0	0	39
2798	0	0	0	39	0	39
2799	0	0	0	38	0	38
2800	0	0	38	0	0	38
2801	35	0	0	0	0	35
2802	0	0	0	36	0	36
2803	0	0	33	0	0	33
2804	36	0	0	0	0	36
2805	34	0	0	0	0	34
2806	33	0	0	2	0	35
2807	0	0	33	0	0	33
2808	0	0	31	0	0	31
2809	34	0	0	0	0	34
2810	0	0	0	31	0	31
2811	0	0	0	34	0	34
2812	0	0	33	0	0	33
2813	35	0	0	0	0	35
2814	0	0	0	35	0	35
2815	35	0	0	0	0	35
2816	35	0	0	0	0	35
2817	36	0	0	0	0	36
2818	0	0	34	0	0	34
2819	0	0	0	32	0	32
2820	36	0	0	0	0	36
2821	0	34	0	0	0	34
2822	0	0	0	36	0	36
2823	0	0	0	35	0	35
2824	36	0	0	0	0	36
2825	34	0	0	0	0	34
2826	0	0	0	32	0	32
2827	0	0	33	0	0	33
2828	34	0	0	0	0	34
2829	0	0	33	0	0	33
2830	34	0	0	0	0	34
2831	34	0	0	0	0	34
2832	0	0	31	0	0	31
2833	0	0	0	33	0	33
2834	0	0	33	0	0	33
2835	0	34	0	0	0	34
2836	0	0	0	36	0	36
2837	0	36	0	0	0	36
2838	0	0	0	36	0	36
2839	0	0	33	0	0	33
2840	0	34	0	0	0	34
2841	0	35	0	0	0	35
2842	0	0	0	38	0	38
2843	38	0	0	0	0	38
2844	0	0	0	36	0	36
2845	34	0	0	0	0	34
2846	0	35	0	0	0	35
2847	36	0	0	0	0	36
2848	0	0	34	0	0	34
2849	0	0	0	38	0	38
2850	0	0	0	37	0	37
2851	0	0	38	0	0	38
2852	37	0	0	0	0	37
2853	38	0	0	0	0	38
2854	0	32	0	0	0	32
2855	0	0	0	33	0	33
2856	0	27	0	0	0	27
2857	0	0	26	0	0	26
2858	0	0	24	0	0	24
2859	2	0	0	24	0	26
2860	27	0	0	0	0	27
2861	0	28	0	0	0	28
2862	28	0	0	0	0	28
2863	0	0	26	0	0	26
2864	28	0	0	0	0	28
2865	24	0	0	0	0	24
2866	0	0	29	0	0	29
2867	0	0	0	31	0	31
2868	30	0	0	0	0	30
2869	30	0	0	0	0	30
2870	27	0	0	0	0	27
2871	0	0	0	29	0	29
2872	0	0	31	0	0	31
2873	31	0	0	0	0	31
2874	0	0	32	0	0	32
2875	0	0	0	32	0	32
2876	0	0	0	31	0	31
2877	0	27	0	0	0	27
2878	0	0	27	0	0	27
2879	0	23	0	0	0	23
2880	0	26	0	0	0	26
2881	0	0	0	28	0	28
2882	0	0	26	0	0	26
2883	0	0	0	26	0	26
2884	0	0	27	0	0	27
2885	0	0	0	26	0	26
2886	0	0	0	26	0	26
2887	0	0	27	0	0	27
2888	0	0	0	26	0	26
2889	0	0	21	0	0	21
2890	0	0	20	0	0	20
2891	0	21	0	0	0	21
2892	22	0	0	0	0	22
2893	0	0	22	0	0	22
2894	21	0	0	0	0	21
2895	0	0	0	21	0	21
2896	0	0	20	0	0	20
2897	0	21	0	0	0	21
2898	0	0	0	18	0	18
2899	0	0	21	0	0	21
2900	0	0	0	22	0	22
2901	0	27	0	0	0	27
2902	32	0	0	0	0	32
2903	0	0	0	33	0	33
2904	33	0	0	0	0	33
2905	33	0	0	0	0	33
2906	33	0	0	0	0	33
2907	31	0	0	0	0	31
2908	32	0	0	0	0	32
2909	0	31	0	0	0	31
2910	0	0	0	31	0	31
2911	0	0	0	33	0	33
2912	0	0	0	33	0	33
2913	0	0	29	0	0	29
2914	0	31	0	0	0	31
2915	35	0	0	0	0	35
2916	33	0	0	0	0	33
2917	0	34	0	0	0	34
2918	0	35	0	0	0	35
2919	38	0	0	0	0	38
2920	0	0	39	0	0	39
2921	0	0	0	37	0	37
2922	40	0	0	0	0	40
2923	0	0	0	40	0	40
2924	0	39	0	0	0	39
2925	0	0	0	40	0	40
2926	0	0	39	0	0	39
2927	37	0	0	0	0	37
2928	37	0	0	0	0	37
2929	0	0	0	35	0	35
2930	0	0	0	34	0	34
2931	35	0	0	0	0	35
2932	0	37	0	0	0	37
2933	0	0	0	38	0	38
2934	0	0	0	38	0	38
2935	36	0	0	0	0	36
2936	1	37	0	0	0	38
2937	36	0	0	0	0	36
2938	0	34	0	0	0	34
2939	0	30	0	0	0	30
2940	32	0	0	0	0	32
2941	0	32	0	0	0	32
2942	0	0	0	31	0	31
2943	0	3	31	0	0	34
2944	0	0	32	0	0	32
2945	0	0	35	0	0	35
2946	0	36	0	0	0	36
2947	37	0	0	0	0	37
2948	0	2	0	34	0	36
2949	0	0	0	33	0	33
2950	0	0	33	0	0	33
2951	32	0	0	0	0	32
2952	0	0	0	34	0	34
2953	0	0	0	35	0	35
2954	0	0	0	37	0	37
2955	35	0	0	0	0	35
2956	0	0	37	0	0	37
2957	37	0	0	0	0	37
2958	0	0	0	36	0	36
2959	0	0	30	0	0	30
2960	29	0	0	0	0	29
2961	0	0	30	0	0	30
2962	0	0	0	29	0	29
2963	0	0	33	0	0	33
2964	0	0	29	0	0	29
2965	31	0	0	0	0	31
2966	0	0	33	0	0	33
2967	0	0	0	31	0	31
2968	31	0	0	0	0	31
2969	0	0	0	30	0	30
2970	0	0	31	0	0	31
2971	0	0	28	0	0	28
2972	0	34	0	0	0	34
2973	0	0	0	35	0	35
2974	35	0	0	0	0	35
2975	0	36	0	0	0	36
2976	36	0	0	0	0	36
2977	0	0	0	36	0	36
2978	35	0	0	0	0	35
2979	0	36	0	0	0	36
2980	0	0	0	34	0	34
2981	35	0	0	0	0	35
2982	0	35	0	0	0	35
2983	0	0	0	34	0	34
2984	0	0	0	35	0	35
2985	34	0	0	0	0	34
2986	0	0	0	35	0	35
2987	0	0	0	35	0	35
2988	0	0	0	37	0	37
2989	0	0	36	0	0	36
2990	35	0	0	0	0	35
2991	0	0	0	37	0	37
2992	0	0	39	0	0	39
2993	37	0	0	0	0	37
2994	0	0	32	0	0	32
2995	0	0	0	29	0	29
2996	0	28	1	0	0	29
2997	0	0	0	29	0	29
2998	0	0	33	0	0	33
2999	0	0	34	0	0	34
3000	0	0	0	34	0	34
3001	0	0	34	0	0	34
3002	32	0	0	0	0	32
3003	0	0	35	0	0	35
3004	0	0	0	32	0	32
3005	0	0	0	33	0	33
3006	0	0	0	29	0	29
3007	29	0	0	0	0	29
3008	27	0	0	0	0	27
3009	28	0	0	0	0	28
3010	0	0	0	28	0	28
3011	0	0	0	26	0	26
3012	0	0	24	0	0	24
3013	0	0	25	0	0	25
3014	0	26	0	0	0	26
3015	0	0	0	24	0	24
3016	0	0	0	27	0	27
3017	0	27	0	0	0	27
3018	27	0	0	0	0	27
3019	0	29	0	0	0	29
3020	29	0	0	0	0	29
3021	0	0	0	29	0	29
3022	29	0	0	0	0	29
3023	0	0	0	29	0	29
3024	0	0	28	0	0	28
3025	0	0	0	29	0	29
3026	27	0	0	1	0	28
3027	0	0	0	29	0	29
3028	0	0	0	29	0	29
3029	0	0	29	0	0	29
3030	0	0	0	26	0	26
3031	0	0	0	26	0	26
3032	0	29	0	0	0	29
3033	0	0	0	29	0	29
3034	0	0	0	29	0	29
3035	0	0	0	28	0	28
3036	0	29	0	0	0	29
3037	0	0	0	31	0	31
3038	27	0	0	0	0	27
3039	0	31	0	0	0	31
3040	0	26	0	0	0	26
3041	0	32	0	0	0	32
3042	0	0	0	32	0	32
3043	0	29	0	0	0	29
3044	0	31	0	0	0	31
3045	31	0	0	0	0	31
3046	0	0	29	0	0	29
3047	30	0	0	0	0	30
3048	0	0	0	31	0	31
3049	0	0	30	0	0	30
3050	31	0	0	0	0	31
3051	0	0	29	0	0	29
3052	0	1	28	0	0	29
3053	30	0	0	0	0	30
3054	0	0	0	30	0	30
3055	0	0	32	0	0	32
3056	33	0	0	0	0	33
3057	32	0	0	0	0	32
3058	0	0	29	1	0	30
3059	29	0	0	0	0	29
3060	30	0	0	0	0	30
3061	0	0	29	0	0	29
3062	30	0	0	0	0	30
3063	29	0	0	0	0	29
3064	0	0	27	0	0	27
3065	0	0	29	0	0	29
3066	0	0	0	24	0	24
3067	0	0	26	0	0	26
3068	27	0	0	0	0	27
3069	0	0	0	25	0	25
3070	0	0	0	27	0	27
3071	0	0	29	0	0	29
3072	0	0	0	25	0	25
3073	0	0	28	0	0	28
3074	29	0	0	0	0	29
3075	30	0	0	0	0	30
3076	0	0	28	0	0	28
3077	30	0	0	0	0	30
3078	30	0	0	0	0	30
3079	0	0	29	0	0	29
3080	31	0	0	0	0	31
3081	27	0	0	0	0	27
3082	0	0	30	0	0	30
3083	25	0	0	0	0	25
3084	0	0	24	0	0	24
3085	0	0	0	25	0	25
3086	0	0	0	23	0	23
3087	0	0	0	25	0	25
3088	0	0	28	0	0	28
3089	29	0	0	0	0	29
3090	0	0	27	0	0	27
3091	0	22	0	0	0	22
3092	0	24	0	0	0	24
3093	24	0	0	0	0	24
3094	0	0	0	20	0	20
3095	0	21	0	0	0	21
3096	26	0	0	0	0	26
3097	25	0	0	0	0	25
3098	0	26	0	0	0	26
3099	0	0	0	28	0	28
3100	0	26	0	0	0	26
3101	29	0	0	0	0	29
3102	24	0	0	0	0	24
3103	0	0	0	28	0	28
3104	26	0	0	0	0	26
3105	0	0	0	29	0	29
3106	0	0	27	0	0	27
3107	28	0	0	1	0	29
3108	0	0	29	0	0	29
3109	0	0	0	24	0	24
3110	27	0	0	0	0	27
3111	0	0	0	28	0	28
3112	0	0	25	0	0	25
3113	0	0	22	0	0	22
3114	0	0	0	24	0	24
3115	24	0	0	0	0	24
3116	0	22	0	0	0	22
3117	0	0	0	23	0	23
3118	0	0	23	0	0	23
3119	24	0	0	0	0	24
3120	23	0	0	1	0	24
3121	0	0	24	0	0	24
3122	25	0	0	0	0	25
3123	0	0	0	25	0	25
3124	0	0	25	0	0	25
3125	24	0	0	0	0	24
3126	0	0	0	28	0	28
3127	0	0	0	29	0	29
3128	27	0	0	0	0	27
3129	0	27	0	0	0	27
3130	0	28	0	0	0	28
3131	26	0	0	0	0	26
3132	24	0	0	0	0	24
3133	0	0	23	0	0	23
3134	0	0	20	0	0	20
3135	0	0	0	22	0	22
3136	22	0	0	0	0	22
3137	20	0	0	0	0	20
3138	21	0	0	0	0	21
3139	0	21	0	0	0	21
3140	0	21	0	0	0	21
3141	0	0	0	24	0	24
3142	0	0	0	24	0	24
3143	0	0	0	24	0	24
3144	0	0	24	0	0	24
3145	0	0	24	0	0	24
3146	26	0	0	0	0	26
3147	26	0	0	0	0	26
3148	0	0	0	22	0	22
3149	0	0	0	23	0	23
3150	0	0	0	23	0	23
3151	0	0	23	0	0	23
3152	0	0	22	0	0	22
3153	0	0	0	22	0	22
3154	0	0	23	0	0	23
3155	0	21	0	1	0	22
3156	0	24	0	0	0	24
3157	23	0	0	0	0	23
3158	0	25	0	0	0	25
3159	0	0	0	29	0	29
3160	0	0	0	29	0	29
3161	0	32	0	0	0	32
3162	0	0	0	30	0	30
3163	0	0	31	0	0	31
3164	0	27	0	0	0	27
3165	0	0	0	28	0	28
3166	0	0	27	0	0	27
3167	0	28	0	0	0	28
3168	0	0	0	27	0	27
3169	0	26	0	0	0	26
3170	0	0	0	27	0	27
3171	0	0	0	25	0	25
3172	0	26	0	0	0	26
3173	26	0	0	0	0	26
3174	25	0	0	0	0	25
3175	0	26	0	0	0	26
3176	0	26	0	0	0	26
3177	0	0	0	26	0	26
3178	0	0	27	0	0	27
3179	27	0	0	0	0	27
3180	27	0	0	0	0	27
3181	0	0	24	0	0	24
3182	24	0	0	0	0	24
3183	24	0	0	0	0	24
3184	0	0	23	0	0	23
3185	24	0	0	0	0	24
3186	0	0	24	0	0	24
3187	0	24	0	0	0	24
3188	24	0	0	0	0	24
3189	23	0	0	0	0	23
3190	0	0	23	0	0	23
3191	20	0	0	0	0	20
3192	21	0	0	0	0	21
3193	0	0	21	0	0	21
3194	21	0	0	0	0	21
3195	22	0	0	0	0	22
3196	0	0	25	0	0	25
3197	25	0	0	0	0	25
3198	0	0	0	26	0	26
3199	0	0	0	26	0	26
3200	0	0	24	0	0	24
3201	0	0	23	0	0	23
3202	0	0	0	25	0	25
3203	0	0	0	24	0	24
3204	24	0	0	0	0	24
3205	0	0	24	0	0	24
3206	24	0	0	0	0	24
3207	0	0	0	24	0	24
3208	0	0	24	0	0	24
3209	24	0	0	0	0	24
3210	0	0	0	23	0	23
3211	0	0	24	0	0	24
3212	23	0	0	0	0	23
3213	0	0	0	23	0	23
3214	22	0	0	0	0	22
3215	0	0	23	0	0	23
3216	0	0	0	21	0	21
3217	0	23	0	0	0	23
3218	26	0	0	0	0	26
3219	25	0	0	0	0	25
3220	0	26	0	0	0	26
3221	25	0	0	0	0	25
3222	23	0	0	0	0	23
3223	24	0	0	0	0	24
3224	0	26	0	0	0	26
3225	0	0	0	24	0	24
3226	0	0	26	0	0	26
3227	0	0	0	24	0	24
3228	0	0	0	28	0	28
3229	0	0	28	0	0	28
3230	0	0	27	0	0	27
3231	0	0	0	27	0	27
3232	0	27	0	0	0	27
3233	28	0	0	0	0	28
3234	34	0	0	0	0	34
3235	0	36	0	0	0	36
3236	37	0	0	0	0	37
3237	34	0	0	0	0	34
3238	0	0	36	0	0	36
3239	35	0	0	0	0	35
3240	0	35	0	0	0	35
3241	0	0	33	0	0	33
3242	2	0	33	0	0	35
3243	0	36	0	0	0	36
3244	35	0	0	0	0	35
3245	0	0	37	0	0	37
3246	0	0	0	36	0	36
3247	0	0	37	0	0	37
3248	37	0	0	0	0	37
3249	0	0	35	0	0	35
3250	0	0	34	0	0	34
3251	37	0	0	0	0	37
3252	0	31	0	0	0	31
3253	34	0	0	0	0	34
3254	31	0	0	0	0	31
3255	0	0	0	31	0	31
3256	0	28	0	0	0	28
3257	28	0	0	0	0	28
3258	0	0	27	0	0	27
3259	28	0	0	0	0	28
3260	0	27	0	0	0	27
3261	27	0	0	0	0	27
3262	28	0	0	0	0	28
3263	0	32	0	0	0	32
3264	0	0	0	30	0	30
3265	31	0	0	0	0	31
3266	0	31	0	0	0	31
3267	0	0	0	31	0	31
3268	31	0	0	0	0	31
3269	0	0	0	31	0	31
3270	0	0	0	31	0	31
3271	0	30	0	0	0	30
3272	30	0	0	0	0	30
3273	31	0	0	0	0	31
3274	30	0	0	0	0	30
3275	0	33	0	0	0	33
3276	34	0	0	0	0	34
3277	32	0	0	0	0	32
3278	0	0	0	33	0	33
3279	0	0	0	34	0	34
3280	0	0	35	0	0	35
3281	0	0	0	32	0	32
3282	0	0	0	34	0	34
3283	0	0	34	0	0	34
3284	35	0	0	0	0	35
3285	0	0	33	0	0	33
3286	0	0	36	0	0	36
3287	0	0	0	32	0	32
3288	0	0	0	34	0	34
3289	0	31	0	0	0	31
3290	33	0	0	0	0	33
3291	33	0	0	0	0	33
3292	0	32	0	0	0	32
3293	0	32	0	0	0	32
3294	0	0	0	32	0	32
3295	0	33	0	0	0	33
3296	33	0	0	0	0	33
3297	34	0	0	0	0	34
3298	0	0	0	36	0	36
3299	0	0	0	36	0	36
3300	36	0	0	0	0	36
3301	0	0	39	0	0	39
3302	41	0	0	0	0	41
3303	0	0	40	0	0	40
3304	41	0	0	0	0	41
3305	0	0	0	41	0	41
3306	1	0	41	0	0	42
3307	0	0	39	0	0	39
3308	42	0	0	0	0	42
3309	40	0	0	0	0	40
3310	0	42	0	0	0	42
3311	0	0	0	39	0	39
3312	0	0	0	38	0	38
3313	36	0	0	0	0	36
3314	0	37	0	0	0	37
3315	36	0	0	0	0	36
3316	0	35	0	0	0	35
3317	0	38	0	0	0	38
3318	38	0	0	0	0	38
3319	0	0	37	0	0	37
3320	0	0	0	38	0	38
3321	0	0	0	36	0	36
3322	0	0	36	0	0	36
3323	0	0	0	36	0	36
3324	1	0	0	34	0	35
3325	0	36	0	0	0	36
3326	37	0	0	0	0	37
3327	0	0	33	0	0	33
3328	28	0	0	0	0	28
3329	0	28	0	0	0	28
3330	0	0	0	28	0	28
3331	27	0	0	0	0	27
3332	0	0	0	27	0	27
3333	0	0	0	27	0	27
3334	0	0	26	0	0	26
3335	28	0	0	0	0	28
3336	28	0	0	0	0	28
3337	0	0	27	0	0	27
3338	0	0	0	28	0	28
3339	0	0	26	1	0	27
3340	27	0	0	0	0	27
3341	28	0	0	0	0	28
3342	0	0	0	28	0	28
3343	28	0	0	0	0	28
3344	0	0	26	0	0	26
3345	0	0	0	25	0	25
3346	0	0	0	26	0	26
3347	0	0	0	25	0	25
3348	0	0	0	27	0	27
3349	27	0	0	0	0	27
3350	0	0	25	0	0	25
3351	0	0	0	26	0	26
3352	0	0	24	0	0	24
3353	0	0	26	0	0	26
3354	0	0	0	26	0	26
3355	0	0	0	26	0	26
3356	26	0	0	0	0	26
3357	0	0	0	24	0	24
3358	0	0	0	26	0	26
3359	0	0	0	28	0	28
3360	28	0	0	0	0	28
3361	28	0	0	0	0	28
3362	27	0	0	0	0	27
3363	29	0	0	0	0	29
3364	0	28	0	0	0	28
3365	0	0	0	29	0	29
3366	0	0	0	27	0	27
3367	28	0	0	0	0	28
3368	0	25	0	0	0	25
3369	0	0	0	27	0	27
3370	0	0	26	0	0	26
3371	32	0	0	0	0	32
3372	0	32	0	0	0	32
3373	32	0	0	0	0	32
3374	31	0	0	1	0	32
3375	0	0	0	34	0	34
3376	0	0	31	0	0	31
3377	0	0	0	34	0	34
3378	34	0	0	0	0	34
3379	0	0	0	32	0	32
3380	33	0	0	0	0	33
3381	0	34	0	0	0	34
3382	34	0	0	0	0	34
3383	0	0	0	29	0	29
3384	0	0	0	31	0	31
3385	34	0	0	0	0	34
3386	34	0	0	0	0	34
3387	38	0	0	0	0	38
3388	38	0	0	0	0	38
3389	35	0	0	0	0	35
3390	0	0	0	38	0	38
3391	0	0	36	0	0	36
3392	0	38	0	0	0	38
3393	43	0	0	0	0	43
3394	0	0	37	0	0	37
3395	36	0	0	0	0	36
3396	0	33	0	0	0	33
3397	36	0	0	0	0	36
3398	0	0	0	36	0	36
3399	0	0	0	30	0	30
3400	0	0	34	0	0	34
3401	0	0	0	35	0	35
3402	0	0	34	0	0	34
3403	1	0	29	0	0	30
3404	36	0	0	0	0	36
3405	36	0	0	0	0	36
3406	0	0	32	0	0	32
3407	37	0	0	0	0	37
3408	35	0	0	0	0	35
3409	0	0	38	0	0	38
3410	0	34	0	0	0	34
3411	0	0	0	38	0	38
3412	40	0	0	0	0	40
3413	39	0	0	0	0	39
3414	40	0	0	0	0	40
3415	38	0	0	0	0	38
3416	37	1	0	1	0	39
3417	0	0	36	0	0	36
3418	0	0	38	0	0	38
3419	0	0	0	37	0	37
3420	38	0	0	0	0	38
3421	36	1	0	0	0	37
3422	35	1	0	0	0	36
3423	34	0	0	0	0	34
3424	0	35	0	0	0	35
3425	0	36	0	0	0	36
3426	35	0	0	0	0	35
3427	36	0	0	0	0	36
3428	0	34	0	0	0	34
3429	36	0	0	0	0	36
3430	0	0	34	0	0	34
3431	0	0	0	35	0	35
3432	0	0	33	0	0	33
3433	0	0	30	0	0	30
3434	0	0	0	32	0	32
3435	0	0	0	35	0	35
3436	0	0	35	0	0	35
3437	0	0	0	32	0	32
3438	0	0	0	35	0	35
3439	35	0	0	0	0	35
3440	35	0	0	0	0	35
3441	0	0	0	32	0	32
3442	0	0	34	0	0	34
3443	0	33	0	0	0	33
3444	33	0	0	0	0	33
3445	0	0	34	0	0	34
3446	0	25	0	0	0	25
3447	0	33	0	0	0	33
3448	38	0	0	0	0	38
3449	39	0	0	0	0	39
3450	0	0	0	40	0	40
3451	0	0	38	0	0	38
3452	0	0	0	38	0	38
3453	0	0	0	38	0	38
3454	0	0	0	37	0	37
3455	37	0	0	0	0	37
3456	0	33	0	1	0	34
3457	0	36	0	0	0	36
3458	0	0	0	37	0	37
3459	0	0	0	37	0	37
3460	37	0	0	0	0	37
3461	35	0	0	0	0	35
3462	33	0	0	0	0	33
3463	0	30	0	0	0	30
3464	30	0	0	0	0	30
3465	0	0	0	27	0	27
3466	0	0	27	0	0	27
3467	1	0	25	0	0	26
3468	29	0	0	0	0	29
3469	0	0	30	0	0	30
3470	0	0	24	0	0	24
3471	27	0	0	0	0	27
3472	1	0	28	0	0	29
3473	0	0	29	0	0	29
3474	0	0	0	29	0	29
3475	0	0	30	0	0	30
3476	0	0	1	27	0	28
3477	0	0	0	31	0	31
3478	0	0	26	0	0	26
3479	0	24	0	0	0	24
3480	25	0	0	0	0	25
3481	0	0	24	0	0	24
3482	0	0	25	0	0	25
3483	22	0	0	0	0	22
3484	0	0	25	0	0	25
3485	0	19	0	1	0	20
3486	0	12	0	0	0	12
3487	0	0	0	18	0	18
3488	0	0	0	20	0	20
3489	20	0	0	0	0	20
3490	20	0	0	0	0	20
3491	20	0	0	0	0	20
3492	0	0	0	18	0	18
3493	19	0	0	0	0	19
3494	19	0	0	0	0	19
3495	0	0	20	0	0	20
3496	0	0	17	0	0	17
3497	0	18	0	0	0	18
3498	0	0	0	19	0	19
3499	20	0	0	0	0	20
3500	0	19	0	0	0	19
3501	0	0	0	17	0	17
3502	19	0	0	0	0	19
3503	19	0	0	0	0	19
3504	0	18	0	0	0	18
3505	16	0	0	0	0	16
3506	17	0	0	0	0	17
3507	0	0	0	17	0	17
3508	0	0	17	0	0	17
3509	0	18	0	0	0	18
3510	0	17	0	0	0	17
3511	18	0	0	0	0	18
3512	0	0	0	17	0	17
3513	0	0	17	0	0	17
3514	0	20	0	0	0	20
3515	19	0	0	0	0	19
3516	20	0	0	0	0	20
3517	0	0	24	0	0	24
3518	0	0	0	27	0	27
3519	0	0	0	27	0	27
3520	0	0	26	0	0	26
3521	30	0	0	0	0	30
3522	30	0	0	0	0	30
3523	0	0	0	31	0	31
3524	0	27	0	0	0	27
3525	0	0	0	33	0	33
3526	0	0	33	0	0	33
3527	43	0	0	0	0	43
3528	0	0	0	45	0	45
3529	0	0	48	0	0	48
3530	48	0	0	0	0	48
3531	0	0	0	44	0	44
3532	0	0	0	48	0	48
3533	48	0	0	0	0	48
3534	0	50	0	0	0	50
3535	50	0	0	0	0	50
3536	0	0	0	51	0	51
3537	53	0	0	0	0	53
3538	0	0	51	0	0	51
3539	0	50	0	0	0	50
3540	0	0	0	53	0	53
3541	46	0	0	0	0	46
3542	0	44	0	0	0	44
3543	0	0	0	46	0	46
3544	44	0	0	0	0	44
3545	46	0	0	0	0	46
3546	0	0	0	42	0	42
3547	0	0	45	0	0	45
3548	0	0	43	0	0	43
3549	45	0	0	0	0	45
3550	0	42	0	0	0	42
3551	0	45	0	0	0	45
3552	44	0	0	0	0	44
3553	0	45	0	0	0	45
3554	0	0	0	45	0	45
3555	0	0	0	46	0	46
3556	46	0	0	0	0	46
3557	44	0	0	0	0	44
3558	49	0	0	0	0	49
3559	0	0	48	0	0	48
3560	0	0	0	48	0	48
3561	0	0	46	0	0	46
3562	0	0	41	0	0	41
3563	0	0	44	0	0	44
3564	0	0	0	41	0	41
3565	0	0	42	0	0	42
3566	0	0	44	0	0	44
3567	0	0	0	44	0	44
3568	44	0	0	0	0	44
3569	0	0	44	0	0	44
3570	0	0	0	43	0	43
3571	0	0	0	44	0	44
3572	0	0	47	0	0	47
3573	0	0	0	44	0	44
3574	0	0	48	0	0	48
3575	0	0	0	46	0	46
3576	0	0	0	45	0	45
3577	0	0	0	48	0	48
3578	0	0	0	49	0	49
3579	49	0	0	0	0	49
3580	52	0	0	0	0	52
3581	0	0	51	0	0	51
3582	0	49	0	0	0	49
3583	0	0	54	0	0	54
3584	0	0	50	0	0	50
3585	54	0	0	0	0	54
3586	0	54	0	0	0	54
3587	55	0	0	0	0	55
3588	0	51	0	0	0	51
3589	54	0	0	0	0	54
3590	49	0	0	0	0	49
3591	0	0	0	54	0	54
3592	0	46	0	0	0	46
3593	0	0	0	53	0	53
3594	0	0	0	54	0	54
3595	0	0	49	0	0	49
3596	0	53	0	0	0	53
3597	0	0	0	54	0	54
3598	52	0	0	0	0	52
3599	53	0	0	0	0	53
3600	51	0	0	0	0	51
3601	0	51	0	0	0	51
3602	52	0	0	0	0	52
3603	0	50	0	0	0	50
3604	0	0	0	53	0	53
3605	0	0	48	0	0	48
3606	0	0	0	50	0	50
3607	0	47	0	0	0	47
3608	0	0	0	49	0	49
3609	0	0	0	52	0	52
3610	0	44	0	0	0	44
3611	44	0	0	0	0	44
3612	0	0	0	40	0	40
3613	0	0	43	0	0	43
3614	1	0	0	41	0	42
3615	0	0	0	43	0	43
3616	0	0	41	0	0	41
3617	0	0	0	42	0	42
3618	0	39	0	0	0	39
3619	0	0	38	1	0	39
3620	0	0	26	0	0	26
3621	0	29	0	1	0	30
3622	0	27	0	0	0	27
3623	0	28	0	0	0	28
3624	27	0	0	0	0	27
3625	29	0	0	0	0	29
3626	27	0	0	0	0	27
3627	0	0	0	26	0	26
3628	0	0	25	0	0	25
3629	0	0	0	26	0	26
3630	0	0	0	25	0	25
3631	25	0	0	0	0	25
3632	23	0	0	0	0	23
3633	0	27	0	0	0	27
3634	26	0	0	0	0	26
3635	27	0	0	0	0	27
3636	25	0	0	0	0	25
3637	0	0	26	0	0	26
3638	0	0	24	0	0	24
3639	0	4	0	22	0	26
3640	0	0	28	0	0	28
3641	29	0	0	0	0	29
3642	30	0	0	0	0	30
3643	0	0	30	0	0	30
3644	31	0	0	0	0	31
3645	0	34	0	0	0	34
3646	27	0	0	0	0	27
3647	0	0	0	35	0	35
3648	0	0	0	38	0	38
3649	0	35	0	0	0	35
3650	38	0	0	0	0	38
3651	38	0	0	0	0	38
3652	0	38	0	0	0	38
3653	0	0	0	38	0	38
3654	0	0	0	35	0	35
3655	0	40	0	0	0	40
3656	0	0	0	39	0	39
3657	0	0	0	39	0	39
3658	40	0	0	0	0	40
3659	40	0	0	0	0	40
3660	0	0	35	0	0	35
3661	35	0	0	0	0	35
3662	0	0	37	0	0	37
3663	0	0	0	35	0	35
3664	0	0	33	0	0	33
3665	0	33	0	0	0	33
3666	0	0	0	35	0	35
3667	0	0	0	31	0	31
3668	32	0	0	0	0	32
3669	0	0	0	29	0	29
3670	0	0	31	0	0	31
3671	31	0	0	0	0	31
3672	30	0	0	0	0	30
3673	31	0	0	0	0	31
3674	28	0	0	0	0	28
3675	0	0	0	27	0	27
3676	0	0	0	26	0	26
3677	0	0	0	27	0	27
3678	0	0	0	27	0	27
3679	28	0	0	0	0	28
3680	28	0	0	0	0	28
3681	0	0	0	33	0	33
3682	0	34	0	0	0	34
3683	32	0	0	0	0	32
3684	0	0	32	0	0	32
3685	0	34	0	0	0	34
3686	33	0	0	0	0	33
3687	0	35	0	0	0	35
3688	0	0	32	0	0	32
3689	32	0	0	0	0	32
3690	34	0	0	0	0	34
3691	0	0	34	0	0	34
3692	0	0	0	35	0	35
3693	0	0	0	35	0	35
3694	0	34	0	0	0	34
3695	0	0	0	35	0	35
3696	33	0	0	0	0	33
3697	0	34	0	0	0	34
3698	0	0	0	34	0	34
3699	0	0	0	34	0	34
3700	0	0	36	0	0	36
3701	0	32	0	0	0	32
3702	34	0	0	0	0	34
3703	0	33	0	0	0	33
3704	0	31	0	0	0	31
3705	33	0	0	0	0	33
3706	0	0	0	31	0	31
3707	0	0	0	33	0	33
3708	32	0	0	0	0	32
3709	0	0	0	32	0	32
3710	0	0	0	32	0	32
3711	31	0	0	0	0	31
3712	0	0	0	30	0	30
3713	0	29	0	0	0	29
3714	27	0	0	0	0	27
3715	0	0	26	0	0	26
3716	0	29	0	0	0	29
3717	0	0	0	28	0	28
3718	0	0	26	0	0	26
3719	0	0	25	0	0	25
3720	0	0	0	27	0	27
3721	26	0	0	0	0	26
3722	0	0	0	27	0	27
3723	0	0	0	27	0	27
3724	0	0	0	25	0	25
3725	0	0	0	27	0	27
3726	0	0	0	27	0	27
3727	0	0	27	0	0	27
3728	0	0	26	0	0	26
3729	0	0	0	27	0	27
3730	0	0	22	0	0	22
3731	0	30	0	0	0	30
3732	0	0	0	30	0	30
3733	0	0	28	0	0	28
3734	26	0	0	0	0	26
3735	0	27	0	0	0	27
3736	0	26	0	0	0	26
3737	0	27	0	0	0	27
3738	0	0	0	28	0	28
3739	30	0	0	0	0	30
3740	0	0	0	25	0	25
3741	22	0	0	0	0	22
3742	0	27	0	0	0	27
3743	20	0	0	0	0	20
3744	0	0	0	20	0	20
3745	1	0	0	19	0	20
3746	0	19	0	0	0	19
3747	0	0	0	20	0	20
3748	0	0	0	19	0	19
3749	0	0	0	19	0	19
3750	18	0	0	0	0	18
3751	19	0	0	0	0	19
3752	0	0	19	0	0	19
3753	19	0	0	0	0	19
3754	0	0	19	0	0	19
3755	0	0	0	19	0	19
3756	0	0	0	19	0	19
3757	0	0	0	19	0	19
3758	0	0	19	0	0	19
3759	0	0	0	21	0	21
3760	0	0	21	0	0	21
3761	0	0	0	21	0	21
3762	22	0	0	0	0	22
3763	0	0	22	0	0	22
3764	23	0	0	0	0	23
3765	0	0	0	22	0	22
3766	21	0	0	0	0	21
3767	0	27	0	0	0	27
3768	0	0	0	28	0	28
3769	0	0	28	0	0	28
3770	0	0	0	27	0	27
3771	0	0	0	28	0	28
3772	0	26	0	0	0	26
3773	0	0	26	0	0	26
3774	0	19	0	0	0	19
3775	21	0	0	0	0	21
3776	0	22	0	0	0	22
3777	22	0	0	0	0	22
3778	21	0	0	0	0	21
3779	23	0	0	0	0	23
3780	0	0	0	24	0	24
3781	0	0	23	0	0	23
3782	0	0	0	24	0	24
3783	0	23	0	0	0	23
3784	0	0	0	24	0	24
3785	23	0	0	0	0	23
3786	0	24	0	0	0	24
3787	0	0	0	23	0	23
3788	0	0	0	25	0	25
3789	25	0	0	0	0	25
3790	0	0	24	0	0	24
3791	0	24	0	0	0	24
3792	0	0	0	30	0	30
3793	0	0	29	0	0	29
3794	0	0	0	29	0	29
3795	0	29	0	0	0	29
3796	0	0	0	28	0	28
3797	0	0	0	29	0	29
3798	0	0	0	29	0	29
3799	0	0	30	0	0	30
3800	29	0	0	0	0	29
3801	0	0	0	30	0	30
3802	30	0	0	0	0	30
3803	28	0	0	0	0	28
3804	31	0	0	0	0	31
3805	29	0	0	0	0	29
3806	29	0	0	0	0	29
3807	0	0	0	31	0	31
3808	0	30	0	0	0	30
3809	0	0	0	30	0	30
3810	0	31	0	0	0	31
3811	0	0	0	30	0	30
3812	31	0	0	0	0	31
3813	0	0	0	30	0	30
3814	0	0	34	0	0	34
3815	34	0	0	0	0	34
3816	0	34	0	0	0	34
3817	34	0	0	0	0	34
3818	34	0	0	0	0	34
3819	33	0	0	0	0	33
3820	0	31	0	0	0	31
3821	0	0	0	33	0	33
3822	0	0	0	33	0	33
3823	0	0	33	0	0	33
3824	0	0	0	28	0	28
3825	0	0	0	29	0	29
3826	0	0	0	30	0	30
3827	0	31	0	0	0	31
3828	30	0	0	0	0	30
3829	29	0	0	0	0	29
3830	0	0	30	0	0	30
3831	0	29	0	0	0	29
3832	0	0	0	26	0	26
3833	0	0	0	29	0	29
3834	0	0	0	28	0	28
3835	0	0	0	27	0	27
3836	0	0	0	26	0	26
3837	0	0	27	0	0	27
3838	0	0	28	0	0	28
3839	29	0	0	0	0	29
3840	29	0	0	0	0	29
3841	27	0	0	0	0	27
3842	0	0	0	30	0	30
3843	0	0	30	0	0	30
3844	29	0	0	0	0	29
3845	29	0	0	0	0	29
3846	0	0	33	0	0	33
3847	33	0	0	0	0	33
3848	0	0	33	0	0	33
3849	0	0	0	33	0	33
3850	0	0	33	0	0	33
3851	33	0	0	0	0	33
3852	29	0	0	0	0	29
3853	30	0	0	0	0	30
3854	28	0	0	0	0	28
3855	0	0	28	0	0	28
3856	0	29	0	0	0	29
3857	31	0	0	0	0	31
3858	31	0	0	0	0	31
3859	0	0	30	0	0	30
3860	0	0	0	25	0	25
3861	0	0	0	31	0	31
3862	0	0	26	0	0	26
3863	28	0	0	0	0	28
3864	27	0	0	0	0	27
3865	0	27	0	0	0	27
3866	27	0	0	1	0	28
3867	28	0	0	0	0	28
3868	26	0	0	0	0	26
3869	27	0	0	0	0	27
3870	0	0	26	0	0	26
3871	27	0	0	0	0	27
3872	0	0	0	26	0	26
3873	0	24	0	0	0	24
3874	0	0	28	0	0	28
3875	0	27	0	0	0	27
3876	0	0	0	25	0	25
3877	0	0	25	0	0	25
3878	27	0	0	0	0	27
3879	0	0	26	0	0	26
3880	26	0	0	0	0	26
3881	0	0	0	27	0	27
3882	0	0	0	26	0	26
3883	0	30	0	0	0	30
3884	0	26	0	0	0	26
3885	0	0	0	25	0	25
3886	25	0	0	0	0	25
3887	26	0	0	0	0	26
3888	29	0	0	0	0	29
3889	0	0	29	0	0	29
3890	31	0	0	0	0	31
3891	0	0	30	0	0	30
3892	0	0	25	0	0	25
3893	33	0	0	0	0	33
3894	32	0	0	0	0	32
3895	0	0	34	0	0	34
3896	0	0	0	34	0	34
3897	0	0	0	35	0	35
3898	36	0	0	0	0	36
3899	34	0	0	0	0	34
3900	0	0	34	0	0	34
3901	0	36	0	0	0	36
3902	0	34	0	0	0	34
3903	35	0	0	0	0	35
3904	0	0	0	33	0	33
3905	0	0	0	32	0	32
3906	0	0	0	35	0	35
3907	33	0	0	0	0	33
3908	0	0	0	31	0	31
3909	29	0	0	0	0	29
3910	32	0	0	0	0	32
3911	0	32	0	0	0	32
3912	0	0	0	30	0	30
3913	0	0	32	0	0	32
3914	31	0	0	0	0	31
3915	31	0	0	0	0	31
3916	31	0	0	0	0	31
3917	0	0	32	0	0	32
3918	0	0	0	32	0	32
3919	32	0	0	0	0	32
3920	29	0	0	0	0	29
3921	32	0	0	0	0	32
3922	0	32	0	0	0	32
3923	0	32	1	0	0	33
3924	0	0	0	31	0	31
3925	0	0	0	34	0	34
3926	0	32	0	0	0	32
3927	34	0	0	0	0	34
3928	0	0	36	0	0	36
3929	0	0	0	37	0	37
3930	0	0	0	36	0	36
3931	0	0	31	0	0	31
3932	35	0	0	0	0	35
3933	35	0	0	0	0	35
3934	0	35	0	0	0	35
3935	33	0	0	0	0	33
3936	0	0	36	0	0	36
3937	35	0	0	0	0	35
3938	0	0	34	0	0	34
3939	33	0	0	0	0	33
3940	32	0	0	0	0	32
3941	33	0	0	0	0	33
3942	33	0	0	0	0	33
3943	0	31	0	0	0	31
3944	31	0	0	0	0	31
3945	32	0	0	0	0	32
3946	0	0	31	0	0	31
3947	33	0	0	0	0	33
3948	0	0	0	32	0	32
3949	0	0	32	0	0	32
3950	32	0	0	0	0	32
3951	0	0	0	33	0	33
3952	34	0	0	0	0	34
3953	32	0	0	0	0	32
3954	0	0	31	0	0	31
3955	37	0	0	0	0	37
3956	33	1	0	0	0	34
3957	34	0	0	0	0	34
3958	32	0	0	0	0	32
3959	0	0	0	31	0	31
3960	0	33	0	0	0	33
3961	33	0	0	0	0	33
3962	32	0	0	0	0	32
3963	33	0	0	0	0	33
3964	0	0	35	0	0	35
3965	0	32	0	0	0	32
3966	0	0	0	34	0	34
3967	0	0	0	34	0	34
3968	0	0	33	0	0	33
3969	0	0	0	30	0	30
3970	0	0	29	0	0	29
3971	0	0	0	29	0	29
3972	0	0	0	29	0	29
3973	0	0	35	0	0	35
3974	37	0	0	0	0	37
3975	37	0	0	0	0	37
3976	0	0	34	0	0	34
3977	39	0	0	0	0	39
3978	35	1	0	0	0	36
3979	1	0	36	0	0	37
3980	0	0	0	35	0	35
3981	0	0	0	32	0	32
3982	30	0	0	0	0	30
3983	0	31	0	0	0	31
3984	27	0	0	0	0	27
3985	30	0	0	0	0	30
3986	0	30	0	0	0	30
3987	31	0	0	0	0	31
3988	31	0	0	0	0	31
3989	0	30	0	0	0	30
3990	0	0	0	32	0	32
3991	0	29	0	0	0	29
3992	0	0	0	33	0	33
3993	0	0	34	0	0	34
3994	0	0	26	0	0	26
3995	35	0	0	0	0	35
3996	34	0	0	0	0	34
3997	0	0	34	0	0	34
3998	34	0	0	0	0	34
3999	34	0	0	0	0	34
4000	35	0	0	0	0	35
4001	0	33	0	0	0	33
4002	0	0	0	35	0	35
4003	36	0	0	0	0	36
4004	34	0	0	0	0	34
4005	0	0	33	0	0	33
4006	0	0	0	35	0	35
4007	0	0	0	35	0	35
4008	0	35	0	0	0	35
4009	0	33	0	0	0	33
4010	1	0	0	35	0	36
4011	0	36	0	0	0	36
4012	37	0	0	1	0	38
4013	0	37	0	0	0	37
4014	41	0	0	0	0	41
4015	0	0	38	0	0	38
4016	39	0	0	0	0	39
4017	37	0	0	0	0	37
4018	37	0	0	0	0	37
4019	34	0	0	0	0	34
4020	0	33	0	0	0	33
4021	0	0	0	35	0	35
4022	0	0	0	39	0	39
4023	0	0	38	0	0	38
4024	0	0	0	36	0	36
4025	0	0	0	38	0	38
4026	39	0	0	0	0	39
4027	0	41	0	0	0	41
4028	0	0	0	40	0	40
4029	0	0	0	40	0	40
4030	0	0	0	39	0	39
4031	40	0	0	0	0	40
4032	0	0	0	39	0	39
4033	38	0	0	0	0	38
4034	0	0	0	38	0	38
4035	0	0	0	41	0	41
4036	0	0	42	0	0	42
4037	41	0	0	0	0	41
4038	0	43	0	0	0	43
4039	43	0	0	0	0	43
4040	0	0	0	42	0	42
4041	0	0	0	43	0	43
4042	42	0	0	0	0	42
4043	42	0	0	0	0	42
4044	0	0	0	46	0	46
4045	0	0	43	0	0	43
4046	0	0	38	0	0	38
4047	0	47	0	0	0	47
4048	45	0	0	0	0	45
4049	42	0	0	1	0	43
4050	0	0	0	44	0	44
4051	0	44	0	0	0	44
4052	0	0	0	45	0	45
4053	0	0	0	45	0	45
4054	0	44	0	0	0	44
4055	45	0	0	0	0	45
4056	0	0	0	40	0	40
4057	0	44	0	0	0	44
4058	0	48	0	0	0	48
4059	46	0	0	0	0	46
4060	0	0	47	0	0	47
4061	44	1	0	0	0	45
4062	0	0	0	48	0	48
4063	0	0	0	44	0	44
4064	0	45	0	0	0	45
4065	0	0	0	43	0	43
4066	0	0	41	0	0	41
4067	0	34	0	0	0	34
4068	0	38	0	0	0	38
4069	38	0	0	0	0	38
4070	0	39	0	0	0	39
4071	0	0	0	40	0	40
4072	0	39	0	0	0	39
4073	0	0	0	43	0	43
4074	0	0	0	43	0	43
4075	0	0	44	0	0	44
4076	0	1	0	42	0	43
4077	0	0	0	43	0	43
4078	42	0	0	0	0	42
4079	0	0	42	0	0	42
4080	0	0	0	41	0	41
4081	0	0	39	0	0	39
4082	39	0	0	0	0	39
4083	0	41	0	0	0	41
4084	41	0	0	0	0	41
4085	0	0	0	39	0	39
4086	0	0	0	40	0	40
4087	0	0	43	0	0	43
4088	38	0	0	0	0	38
4089	0	37	0	1	0	38
4090	40	0	0	0	0	40
4091	0	0	0	41	0	41
4092	0	42	0	0	0	42
4093	39	0	0	0	0	39
4094	0	37	0	0	0	37
4095	0	0	0	40	0	40
4096	0	0	0	38	0	38
4097	0	0	0	39	0	39
4098	0	37	0	0	0	37
4099	0	0	0	39	0	39
4100	0	0	0	38	0	38
4101	39	0	0	0	0	39
4102	36	0	0	0	0	36
4103	39	0	0	0	0	39
4104	0	0	41	0	0	41
4105	41	0	0	0	0	41
4106	41	0	0	0	0	41
4107	39	0	0	0	0	39
4108	0	0	38	0	0	38
4109	39	0	0	0	0	39
4110	0	0	0	39	0	39
4111	0	0	36	0	0	36
4112	0	38	0	0	0	38
4113	0	0	0	39	0	39
4114	0	39	0	0	0	39
4115	0	34	0	0	0	34
4116	33	0	0	0	0	33
4117	0	0	0	33	0	33
4118	34	0	0	0	0	34
4119	0	0	0	34	0	34
4120	31	0	0	0	0	31
4121	0	0	0	33	0	33
4122	32	0	0	0	0	32
4123	1	0	29	0	0	30
4124	0	0	0	30	0	30
4125	0	0	29	0	0	29
4126	0	0	25	0	0	25
4127	0	0	30	0	0	30
4128	0	0	0	29	0	29
4129	0	0	28	0	0	28
4130	28	0	0	0	0	28
4131	0	0	0	27	0	27
4132	0	0	26	0	0	26
4133	0	0	0	26	0	26
4134	0	0	0	26	0	26
4135	0	0	26	0	0	26
4136	0	0	0	27	0	27
4137	0	0	0	24	0	24
4138	0	24	0	0	0	24
4139	25	0	0	0	0	25
4140	22	0	0	0	0	22
4141	0	0	22	0	0	22
4142	22	0	0	0	0	22
4143	0	0	20	0	0	20
4144	0	0	18	0	0	18
4145	0	0	20	0	0	20
4146	0	0	0	24	0	24
4147	0	0	24	0	0	24
4148	0	0	0	26	0	26
4149	0	0	0	28	0	28
4150	0	0	0	29	0	29
4151	0	0	0	27	0	27
4152	27	0	0	0	0	27
4153	26	0	0	0	0	26
4154	0	25	0	0	0	25
4155	0	0	0	27	0	27
4156	0	0	33	0	0	33
4157	0	32	0	0	0	32
4158	0	0	0	35	0	35
4159	0	0	34	0	0	34
4160	0	0	0	33	0	33
4161	0	0	32	0	0	32
4162	0	0	33	0	0	33
4163	0	0	0	33	0	33
4164	0	0	0	33	0	33
4165	32	0	0	0	0	32
4166	0	0	0	31	0	31
4167	31	0	1	0	0	32
4168	1	28	1	0	0	30
4169	0	30	0	0	0	30
4170	0	0	0	32	0	32
4171	32	0	0	0	0	32
4172	0	29	0	0	0	29
4173	0	0	0	31	0	31
4174	31	0	0	0	0	31
4175	31	0	0	0	0	31
4176	30	0	0	0	0	30
4177	35	0	0	0	0	35
4178	35	0	0	0	0	35
4179	0	0	34	0	0	34
4180	0	0	32	0	0	32
4181	0	31	0	0	0	31
4182	0	0	0	30	0	30
4183	0	0	32	0	0	32
4184	0	0	31	0	0	31
4185	0	0	0	32	0	32
4186	0	1	33	0	0	34
4187	0	0	33	0	0	33
4188	0	31	0	0	0	31
4189	35	0	0	0	0	35
4190	0	37	0	0	0	37
4191	0	0	0	36	0	36
4192	35	0	0	0	0	35
4193	0	34	0	1	0	35
4194	0	0	0	37	0	37
4195	0	0	42	0	0	42
4196	42	0	0	0	0	42
4197	39	0	0	0	0	39
4198	39	0	0	0	0	39
4199	0	0	0	42	0	42
4200	0	0	43	0	0	43
4201	0	46	0	0	0	46
4202	0	0	0	45	0	45
4203	47	0	0	0	0	47
4204	0	0	46	0	0	46
4205	0	52	0	0	0	52
4206	0	0	52	0	0	52
4207	50	0	0	0	0	50
4208	58	0	0	0	0	58
4209	61	0	0	0	0	61
4210	0	0	58	0	0	58
4211	0	54	0	0	0	54
4212	0	0	0	60	0	60
4213	0	0	0	61	0	61
4214	0	0	0	59	0	59
4215	0	0	58	0	0	58
4216	59	0	0	0	0	59
4217	0	0	59	0	0	59
4218	62	0	0	0	0	62
4219	59	0	0	0	0	59
4220	59	0	0	0	0	59
4221	61	0	0	0	0	61
4222	0	0	56	0	0	56
4223	0	0	0	57	0	57
4224	0	1	57	0	0	58
4225	0	60	0	0	0	60
4226	0	61	0	0	0	61
4227	60	0	0	0	0	60
4228	57	0	0	0	0	57
4229	0	64	0	0	0	64
4230	62	0	0	0	0	62
4231	0	0	57	0	0	57
4232	57	0	0	0	0	57
4233	0	60	0	0	0	60
4234	58	0	0	0	0	58
4235	61	0	0	0	0	61
4236	0	0	0	59	0	59
4237	0	0	0	58	0	58
4238	59	0	0	0	0	59
4239	0	0	0	60	0	60
4240	58	0	0	0	0	58
4241	0	0	0	58	0	58
4242	59	0	0	0	0	59
4243	58	0	0	0	0	58
4244	0	56	0	0	0	56
4245	0	59	0	0	0	59
4246	61	0	0	0	0	61
4247	0	59	0	0	0	59
4248	0	0	0	57	0	57
4249	0	0	0	54	0	54
4250	52	0	0	0	0	52
4251	0	46	0	0	0	46
4252	0	48	0	0	0	48
4253	0	49	0	0	0	49
4254	0	0	49	0	0	49
4255	0	0	40	0	0	40
4256	0	0	48	0	0	48
4257	0	0	0	49	0	49
4258	0	52	0	0	0	52
4259	51	0	0	0	0	51
4260	0	0	51	0	0	51
4261	0	1	49	0	0	50
4262	0	0	50	0	0	50
4263	0	0	0	54	0	54
4264	0	0	0	55	0	55
4265	0	0	0	59	0	59
4266	59	0	0	0	0	59
4267	60	0	0	0	0	60
4268	57	0	0	0	0	57
4269	0	0	0	57	0	57
4270	0	0	53	0	0	53
4271	0	0	56	0	0	56
4272	0	0	0	56	0	56
4273	0	0	0	57	0	57
4274	55	0	0	0	0	55
4275	0	58	0	0	0	58
4276	56	0	0	0	0	56
4277	0	56	0	0	0	56
4278	0	0	0	60	0	60
4279	0	0	59	0	0	59
4280	0	0	1	56	0	57
4281	60	0	0	0	0	60
4282	0	0	57	0	0	57
4283	56	0	0	0	0	56
4284	0	0	54	0	0	54
4285	1	0	56	0	0	57
4286	60	0	0	0	0	60
4287	0	0	56	0	0	56
4288	0	0	52	0	0	52
4289	0	56	0	0	0	56
4290	55	0	0	0	0	55
4291	55	0	0	0	0	55
4292	46	0	0	0	0	46
4293	0	0	48	0	0	48
4294	43	0	0	0	0	43
4295	0	43	0	0	0	43
4296	43	0	0	0	0	43
4297	0	0	44	0	0	44
4298	0	0	0	38	0	38
4299	0	0	39	0	0	39
4300	0	38	0	0	0	38
4301	0	0	0	41	0	41
4302	0	0	0	43	0	43
4303	43	0	0	0	0	43
4304	43	0	0	0	0	43
4305	41	0	0	0	0	41
4306	42	1	0	0	0	43
4307	44	0	0	0	0	44
4308	0	0	46	0	0	46
4309	0	0	0	45	0	45
4310	0	0	45	0	0	45
4311	0	0	0	44	0	44
4312	46	0	0	0	0	46
4313	46	0	0	0	0	46
4314	46	0	0	0	0	46
4315	47	0	0	0	0	47
4316	0	0	46	0	0	46
4317	0	0	0	44	0	44
4318	0	0	42	0	0	42
4319	0	40	0	0	0	40
4320	0	46	0	0	0	46
4321	0	0	0	45	0	45
4322	0	0	0	45	0	45
4323	0	0	0	44	0	44
4324	0	0	0	46	0	46
4325	46	0	0	0	0	46
4326	0	42	0	0	0	42
4327	43	0	0	0	0	43
4328	0	0	0	42	0	42
4329	0	0	0	44	0	44
4330	0	43	0	0	0	43
4331	0	0	0	43	0	43
4332	42	0	0	0	0	42
4333	0	41	0	0	0	41
4334	0	45	0	0	0	45
4335	45	0	0	0	0	45
4336	0	0	0	48	0	48
4337	0	44	0	0	0	44
4338	0	0	0	46	0	46
4339	46	0	0	0	0	46
4340	0	0	0	46	0	46
4341	0	0	0	45	0	45
4342	47	0	0	0	0	47
4343	0	0	0	46	0	46
4344	0	46	0	0	0	46
4345	0	0	0	45	0	45
4346	0	43	1	0	0	44
4347	0	0	0	48	0	48
4348	49	0	0	0	0	49
4349	49	0	0	0	0	49
4350	0	0	0	48	0	48
4351	0	0	46	0	0	46
4352	49	0	0	0	0	49
4353	0	0	50	0	0	50
4354	51	0	0	0	0	51
4355	47	0	0	0	0	47
4356	0	0	40	0	0	40
4357	0	45	0	0	0	45
4358	43	0	0	0	0	43
4359	43	0	0	0	0	43
4360	0	0	47	0	0	47
4361	49	0	0	0	0	49
4362	49	0	0	0	0	49
4363	49	0	0	0	0	49
4364	0	0	0	46	0	46
4365	0	0	0	49	0	49
4366	0	45	0	1	0	46
4367	0	0	0	47	0	47
4368	0	0	0	47	0	47
4369	0	0	45	0	0	45
4370	0	0	46	0	0	46
4371	47	0	0	0	0	47
4372	48	0	0	0	0	48
4373	0	47	0	0	0	47
4374	0	0	0	46	0	46
4375	0	0	48	0	0	48
4376	0	0	0	46	0	46
4377	1	0	0	46	0	47
4378	0	0	0	47	0	47
4379	0	47	0	0	0	47
4380	0	0	0	47	0	47
4381	0	0	0	44	0	44
4382	0	0	44	0	0	44
4383	0	0	44	0	0	44
4384	42	0	0	0	0	42
4385	45	0	0	0	0	45
4386	1	0	0	43	0	44
4387	0	0	0	44	0	44
4388	0	0	0	45	0	45
4389	0	0	44	0	0	44
4390	0	43	0	0	0	43
4391	0	0	43	0	0	43
4392	41	0	0	0	0	41
4393	0	0	40	0	0	40
4394	41	0	0	0	0	41
4395	37	0	0	0	0	37
4396	41	0	0	0	0	41
4397	0	0	0	41	0	41
4398	0	0	39	0	0	39
4399	0	39	0	0	0	39
4400	0	0	0	39	0	39
4401	0	0	0	35	0	35
4402	0	0	37	0	0	37
4403	0	37	0	0	0	37
4404	38	0	0	0	0	38
4405	0	35	0	0	0	35
4406	37	0	0	0	0	37
4407	0	0	0	36	0	36
4408	0	0	38	0	0	38
4409	1	38	0	0	0	39
4410	36	0	0	0	0	36
4411	0	0	39	0	0	39
4412	39	0	0	0	0	39
4413	40	0	0	0	0	40
4414	0	0	38	0	0	38
4415	39	0	0	0	0	39
4416	36	0	0	0	0	36
4417	40	0	0	0	0	40
4418	0	40	0	0	0	40
4419	38	0	0	0	0	38
4420	0	38	0	0	0	38
4421	0	0	39	0	0	39
4422	0	42	0	0	0	42
4423	41	0	0	0	0	41
4424	42	0	0	0	0	42
4425	41	0	0	0	0	41
4426	0	0	0	37	0	37
4427	0	0	0	41	0	41
4428	41	0	0	0	0	41
4429	42	0	0	0	0	42
4430	0	0	0	40	0	40
4431	0	0	41	0	0	41
4432	1	43	0	0	0	44
4433	0	45	0	0	0	45
4434	0	0	0	49	0	49
4435	0	0	46	0	0	46
4436	0	0	0	45	0	45
4437	0	45	0	0	0	45
4438	0	0	0	49	0	49
4439	0	0	48	0	0	48
4440	0	0	0	47	0	47
4441	0	0	42	0	0	42
4442	0	0	0	43	0	43
4443	0	0	47	0	0	47
4444	0	0	48	0	0	48
4445	50	0	0	0	0	50
4446	47	0	0	0	0	47
4447	52	0	0	0	0	52
4448	0	51	0	0	0	51
4449	0	0	0	54	0	54
4450	51	0	0	0	0	51
4451	51	0	0	0	0	51
4452	53	0	0	0	0	53
4453	1	0	50	0	0	51
4454	0	47	0	0	0	47
4455	0	50	0	0	0	50
4456	51	0	0	0	0	51
4457	0	0	0	52	0	52
4458	54	0	0	0	0	54
4459	0	0	58	0	0	58
4460	0	0	0	56	0	56
4461	0	0	0	54	0	54
4462	0	0	0	57	0	57
4463	0	52	0	0	0	52
4464	55	0	0	0	0	55
4465	51	0	0	0	0	51
4466	0	53	0	0	0	53
4467	0	0	0	48	0	48
4468	52	0	0	0	0	52
4469	0	0	0	51	0	51
4470	47	0	0	0	0	47
4471	0	51	0	0	0	51
4472	51	0	0	0	0	51
4473	0	0	44	0	0	44
4474	0	49	0	0	0	49
4475	0	0	52	0	0	52
4476	0	0	0	51	0	51
4477	56	0	0	0	0	56
4478	54	0	0	0	0	54
4479	51	0	0	0	0	51
4480	0	0	0	51	0	51
4481	53	0	0	0	0	53
4482	0	0	0	52	0	52
4483	52	0	0	0	0	52
4484	51	0	0	0	0	51
4485	0	0	46	0	0	46
4486	0	0	44	0	0	44
4487	0	0	48	0	0	48
4488	0	0	0	49	0	49
4489	49	0	0	0	0	49
4490	0	0	0	48	0	48
4491	0	0	0	48	0	48
4492	48	0	0	1	0	49
4493	49	0	0	0	0	49
4494	50	0	0	0	0	50
4495	49	0	0	0	0	49
4496	0	0	0	47	0	47
4497	48	0	0	0	0	48
4498	0	47	0	0	0	47
4499	50	0	0	0	0	50
4500	49	0	0	0	0	49
4501	0	0	47	0	0	47
4502	47	0	0	0	0	47
4503	0	0	46	0	0	46
4504	0	0	41	0	0	41
4505	0	0	40	0	0	40
4506	0	0	0	46	0	46
4507	0	0	46	0	0	46
4508	0	0	0	49	0	49
4509	0	0	49	0	0	49
4510	0	0	46	0	0	46
4511	0	0	0	43	0	43
4512	1	0	0	44	0	45
4513	0	0	43	0	0	43
4514	46	0	0	0	0	46
4515	0	0	0	44	0	44
4516	0	0	0	45	0	45
4517	44	0	0	0	0	44
4518	0	0	0	46	0	46
4519	0	0	45	0	0	45
4520	0	0	44	0	0	44
4521	0	0	0	44	0	44
4522	0	0	40	0	0	40
4523	0	45	0	0	0	45
4524	0	0	0	46	0	46
4525	41	0	0	0	0	41
4526	0	0	41	0	0	41
4527	39	0	0	0	0	39
4528	0	0	0	34	0	34
4529	0	0	0	40	0	40
4530	0	0	0	37	0	37
4531	0	0	0	41	0	41
4532	40	0	0	0	0	40
4533	0	39	0	0	0	39
4534	0	0	0	41	0	41
4535	0	0	0	39	0	39
4536	0	0	0	39	0	39
4537	0	0	0	29	0	29
4538	33	0	0	0	0	33
4539	0	35	0	0	0	35
4540	35	0	0	0	0	35
4541	0	33	0	0	0	33
4542	0	33	0	0	0	33
4543	42	0	0	0	0	42
4544	0	0	37	0	0	37
4545	0	0	0	41	0	41
4546	38	0	0	0	0	38
4547	44	0	0	0	0	44
4548	42	0	0	0	0	42
4549	42	0	0	0	0	42
4550	0	43	0	0	0	43
4551	44	0	0	0	0	44
4552	39	0	0	0	0	39
4553	0	40	0	0	0	40
4554	0	0	0	37	0	37
4555	0	0	37	0	0	37
4556	0	0	0	38	0	38
4557	37	0	0	0	0	37
4558	0	0	37	0	0	37
4559	0	41	0	0	0	41
4560	0	0	38	0	0	38
4561	0	0	0	38	0	38
4562	0	41	0	0	0	41
4563	41	0	0	0	0	41
4564	0	41	0	0	0	41
4565	0	0	0	42	0	42
4566	0	0	0	45	0	45
4567	41	0	0	0	0	41
4568	0	0	0	41	0	41
4569	0	41	0	0	0	41
4570	41	0	0	0	0	41
4571	38	0	0	1	0	39
4572	0	42	0	0	0	42
4573	42	0	0	0	0	42
4574	0	41	0	0	0	41
4575	47	0	0	0	0	47
4576	0	46	0	0	0	46
4577	0	0	0	48	0	48
4578	0	0	0	49	0	49
4579	46	0	0	0	0	46
4580	46	0	0	0	0	46
4581	0	44	0	0	0	44
4582	0	0	46	0	0	46
4583	49	0	0	0	0	49
4584	0	0	0	54	0	54
4585	0	53	0	0	0	53
4586	0	0	0	54	0	54
4587	52	0	0	0	0	52
4588	54	0	0	0	0	54
4589	54	0	0	0	0	54
4590	0	0	0	57	0	57
4591	0	0	54	0	0	54
4592	58	0	0	0	0	58
4593	57	0	0	0	0	57
4594	55	0	0	0	0	55
4595	0	55	0	0	0	55
4596	0	0	0	58	0	58
4597	0	55	0	0	0	55
4598	0	0	0	58	0	58
4599	0	0	0	59	0	59
4600	0	0	69	0	0	69
4601	0	0	0	66	0	66
4602	0	0	0	67	0	67
4603	67	0	0	0	0	67
4604	0	72	0	0	0	72
4605	73	0	0	0	0	73
4606	73	0	0	0	0	73
4607	1	1	0	71	0	73
4608	0	0	73	0	0	73
4609	1	70	1	0	0	72
4610	0	79	0	0	0	79
4611	78	0	0	0	0	78
4612	0	77	0	0	0	77
4613	0	0	0	78	0	78
4614	0	0	0	76	0	76
4615	0	0	75	0	0	75
4616	0	0	70	0	0	70
4617	0	70	0	0	0	70
4618	0	0	0	74	0	74
4619	73	0	0	0	0	73
4620	0	0	0	74	0	74
4621	2	0	70	0	0	72
4622	0	0	0	73	0	73
4623	75	0	0	0	0	75
4624	67	0	0	0	0	67
4625	0	70	0	0	0	70
4626	72	0	0	0	0	72
4627	0	72	0	0	0	72
4628	68	0	0	0	0	68
4629	0	0	0	71	0	71
4630	0	0	72	0	0	72
4631	0	0	64	0	0	64
4632	0	65	0	0	0	65
4633	0	0	0	72	0	72
4634	0	0	0	75	0	75
4635	75	0	0	0	0	75
4636	67	0	0	0	0	67
4637	61	0	0	0	0	61
4638	0	0	0	66	0	66
4639	0	0	0	63	0	63
4640	0	0	0	60	0	60
4641	0	0	60	0	0	60
4642	1	0	65	0	0	66
4643	68	0	0	0	0	68
4644	71	0	0	0	0	71
4645	0	0	71	0	0	71
4646	72	0	0	0	0	72
4647	73	0	0	0	0	73
4648	0	0	72	0	0	72
4649	0	73	0	0	0	73
4650	0	0	0	76	0	76
4651	0	0	75	0	0	75
4652	0	74	0	0	0	74
4653	0	0	0	75	0	75
4654	0	76	0	0	0	76
4655	0	0	73	0	0	73
4656	0	0	73	0	0	73
4657	0	0	0	75	0	75
4658	72	0	0	0	0	72
4659	0	0	0	68	0	68
4660	70	0	0	0	0	70
4661	0	0	0	69	0	69
4662	0	0	72	0	0	72
4663	72	0	0	0	0	72
4664	0	0	74	0	0	74
4665	73	0	0	0	0	73
4666	0	0	0	73	0	73
4667	0	76	0	0	0	76
4668	0	0	0	67	0	67
4669	0	72	0	0	0	72
4670	0	0	0	69	0	69
4671	0	67	0	0	0	67
4672	68	0	0	0	0	68
4673	70	0	0	0	0	70
4674	70	0	0	0	0	70
4675	0	0	76	0	0	76
4676	0	0	0	74	0	74
4677	0	0	67	1	0	68
4678	0	66	0	0	0	66
4679	0	69	0	0	0	69
4680	67	0	5	0	0	72
4681	0	0	66	0	0	66
4682	1	67	0	0	0	68
4683	0	0	0	67	0	67
4684	67	0	0	1	0	68
4685	0	69	0	0	0	69
4686	67	0	0	0	0	67
4687	0	0	67	0	0	67
4688	0	0	0	64	0	64
4689	0	0	0	66	0	66
4690	0	0	0	69	0	69
4691	0	71	0	0	0	71
4692	0	0	0	71	0	71
4693	0	0	56	1	0	57
4694	0	0	0	56	0	56
4695	0	0	0	54	0	54
4696	0	0	0	55	0	55
4697	0	50	0	0	0	50
4698	0	0	0	55	0	55
4699	0	0	0	53	0	53
4700	0	50	0	0	0	50
4701	51	0	0	0	0	51
4702	0	51	0	0	0	51
4703	0	48	0	0	0	48
4704	0	0	0	50	0	50
4705	0	0	52	0	0	52
4706	52	0	0	0	0	52
4707	0	0	0	54	0	54
4708	0	0	57	0	0	57
4709	0	56	0	0	0	56
4710	0	0	0	58	0	58
4711	0	0	56	0	0	56
4712	0	0	0	58	0	58
4713	0	0	0	58	0	58
4714	55	0	0	0	0	55
4715	0	57	0	0	0	57
4716	60	0	0	0	0	60
4717	0	0	60	0	0	60
4718	0	57	0	0	0	57
4719	0	0	58	0	0	58
4720	0	0	0	58	0	58
4721	61	0	0	0	0	61
4722	0	0	0	56	0	56
4723	68	0	0	0	0	68
4724	67	0	0	0	0	67
4725	0	0	0	66	0	66
4726	0	0	64	0	0	64
4727	0	0	62	0	0	62
4728	0	0	0	67	0	67
4729	0	0	0	68	0	68
4730	67	0	0	0	0	67
4731	0	0	0	67	0	67
4732	0	70	0	0	0	70
4733	0	0	0	69	0	69
4734	0	0	0	68	0	68
4735	61	0	0	0	0	61
4736	0	62	0	0	0	62
4737	0	0	0	61	0	61
4738	0	0	0	60	0	60
4739	0	54	0	0	0	54
4740	0	0	0	53	0	53
4741	0	0	0	55	0	55
4742	0	56	0	0	0	56
4743	0	0	0	55	0	55
4744	0	0	0	55	0	55
4745	0	54	0	0	0	54
4746	0	0	0	55	0	55
4747	51	0	0	0	0	51
4748	53	0	0	0	0	53
4749	54	0	0	0	0	54
4750	51	0	0	0	0	51
4751	0	53	0	0	0	53
4752	51	0	0	0	0	51
4753	0	48	0	0	0	48
4754	0	53	0	0	0	53
4755	0	0	0	52	0	52
4756	0	0	52	0	0	52
4757	50	0	0	0	0	50
4758	49	0	0	0	0	49
4759	0	0	52	0	0	52
4760	49	0	0	0	0	49
4761	51	0	0	0	0	51
4762	0	49	0	0	0	49
4763	53	0	0	0	0	53
4764	0	0	0	53	0	53
4765	1	0	0	50	0	51
4766	0	0	0	54	0	54
4767	0	0	0	50	0	50
4768	52	0	0	0	0	52
4769	0	0	0	51	0	51
4770	0	0	0	54	0	54
4771	0	0	51	0	0	51
4772	53	0	0	0	0	53
4773	51	0	0	0	0	51
4774	52	0	0	0	0	52
4775	0	49	0	0	0	49
4776	0	48	0	0	0	48
4777	49	0	0	0	0	49
4778	0	0	0	50	0	50
4779	0	48	0	0	0	48
4780	0	0	0	47	0	47
4781	0	45	0	0	0	45
4782	47	0	0	0	0	47
4783	0	49	0	0	0	49
4784	0	0	0	48	0	48
4785	0	0	0	48	0	48
4786	0	0	47	0	0	47
4787	0	48	0	0	0	48
4788	0	0	0	48	0	48
4789	0	0	50	0	0	50
4790	0	0	47	0	0	47
4791	0	0	0	50	0	50
4792	0	0	0	48	0	48
4793	0	49	0	0	0	49
4794	0	50	0	0	0	50
4795	0	0	0	55	0	55
4796	56	0	0	0	0	56
4797	0	0	0	56	0	56
4798	51	0	0	0	0	51
4799	55	0	0	0	0	55
4800	54	0	0	0	0	54
4801	0	0	47	0	0	47
4802	48	0	0	0	0	48
4803	0	0	0	50	0	50
4804	0	0	0	50	0	50
4805	0	1	48	0	0	49
4806	0	0	47	0	0	47
4807	0	0	0	49	0	49
4808	0	46	0	0	0	46
4809	0	46	0	0	0	46
4810	0	0	0	49	0	49
4811	49	1	0	0	0	50
4812	0	0	0	47	0	47
4813	0	0	0	48	0	48
4814	0	51	0	0	0	51
4815	0	0	0	47	0	47
4816	0	0	43	0	0	43
4817	0	0	44	0	0	44
4818	41	0	0	0	0	41
4819	0	43	0	0	0	43
4820	42	0	0	0	0	42
4821	41	0	0	0	0	41
4822	0	0	0	41	0	41
4823	0	40	0	0	0	40
4824	0	0	0	43	0	43
4825	37	0	0	0	0	37
4826	0	44	0	0	0	44
4827	42	0	0	0	0	42
4828	0	40	0	0	0	40
4829	36	0	0	0	0	36
4830	34	0	0	0	0	34
4831	0	36	0	0	0	36
4832	0	0	0	38	0	38
4833	36	0	0	0	0	36
4834	0	0	34	0	0	34
4835	0	0	34	0	0	34
4836	0	0	0	35	0	35
4837	35	0	0	0	0	35
4838	0	0	0	34	0	34
4839	35	0	0	0	0	35
4840	0	0	33	0	0	33
4841	34	0	0	0	0	34
4842	34	0	0	0	0	34
4843	0	0	0	35	0	35
4844	0	0	0	35	0	35
4845	0	0	0	35	0	35
4846	0	34	0	0	0	34
4847	0	0	0	35	0	35
4848	0	0	0	34	0	34
4849	36	0	0	0	0	36
4850	37	0	0	0	0	37
4851	0	0	36	0	0	36
4852	35	0	0	0	0	35
4853	0	0	36	0	0	36
4854	37	0	0	0	0	37
4855	0	0	35	0	0	35
4856	0	0	32	0	0	32
4857	0	0	0	33	0	33
4858	0	0	35	0	0	35
4859	33	0	0	0	0	33
4860	0	0	0	37	0	37
4861	37	0	0	0	0	37
4862	42	0	0	0	0	42
4863	40	0	0	0	0	40
4864	41	0	0	0	0	41
4865	0	0	40	0	0	40
4866	0	0	0	39	0	39
4867	0	0	43	0	0	43
4868	0	0	0	42	0	42
4869	39	0	0	0	0	39
4870	0	0	0	39	0	39
4871	40	0	0	0	0	40
4872	0	0	0	41	0	41
4873	0	0	0	42	0	42
4874	40	0	0	0	0	40
4875	0	39	0	0	0	39
4876	37	0	0	0	0	37
4877	0	41	0	0	0	41
4878	0	0	0	37	0	37
4879	36	0	0	0	0	36
4880	0	0	36	0	0	36
4881	0	0	0	34	0	34
4882	35	0	0	0	0	35
4883	30	0	0	0	0	30
4884	0	0	0	36	0	36
4885	0	33	0	0	0	33
4886	0	36	0	0	0	36
4887	0	0	0	38	0	38
4888	43	0	0	0	0	43
4889	0	38	0	0	0	38
4890	0	43	0	0	0	43
4891	42	0	0	0	0	42
4892	0	41	0	0	0	41
4893	42	0	0	0	0	42
4894	0	0	0	42	0	42
4895	0	0	0	42	0	42
4896	0	38	0	0	0	38
4897	0	41	0	0	0	41
4898	42	0	0	0	0	42
4899	0	40	0	0	0	40
4900	0	43	0	0	0	43
4901	0	0	0	45	0	45
4902	44	0	0	0	0	44
4903	0	0	44	0	0	44
4904	43	0	0	0	0	43
4905	0	0	0	44	0	44
4906	0	0	43	0	0	43
4907	0	0	42	0	0	42
4908	0	0	0	46	0	46
4909	0	0	43	0	0	43
4910	46	0	0	0	0	46
4911	43	0	0	0	0	43
4912	0	0	45	0	0	45
4913	0	0	0	43	0	43
4914	0	0	0	46	0	46
4915	43	0	0	0	0	43
4916	0	0	0	44	0	44
4917	0	45	0	0	0	45
4918	46	0	0	0	0	46
4919	0	42	0	0	0	42
4920	0	48	0	0	0	48
4921	0	0	0	49	0	49
4922	0	0	0	47	0	47
4923	0	0	0	48	0	48
4924	0	0	47	0	0	47
4925	48	0	0	0	0	48
4926	0	49	0	0	0	49
4927	47	0	1	0	0	48
4928	49	0	0	0	0	49
4929	0	0	0	51	0	51
4930	0	50	0	0	0	50
4931	0	0	0	51	0	51
4932	0	0	0	52	0	52
4933	49	0	0	0	0	49
4934	49	0	0	0	0	49
4935	0	0	49	0	0	49
4936	53	0	0	0	0	53
4937	0	55	0	0	0	55
4938	55	0	0	0	0	55
4939	0	53	0	0	0	53
4940	0	0	0	54	0	54
4941	0	0	0	54	0	54
4942	0	56	0	0	0	56
4943	0	0	0	57	0	57
4944	0	0	0	54	0	54
4945	0	0	0	57	0	57
4946	0	55	0	0	0	55
4947	0	0	0	56	0	56
4948	0	0	0	58	0	58
4949	0	0	0	58	0	58
4950	0	0	61	0	0	61
4951	65	0	0	0	0	65
4952	0	0	64	0	0	64
4953	62	0	0	0	0	62
4954	0	0	60	0	0	60
4955	57	0	0	0	0	57
4956	53	0	0	0	0	53
4957	0	0	55	0	0	55
4958	0	0	0	56	0	56
4959	0	0	53	0	0	53
4960	54	0	0	0	0	54
4961	0	0	53	0	0	53
4962	0	0	54	0	0	54
4963	53	0	0	0	0	53
4964	0	51	0	0	0	51
4965	0	0	0	52	0	52
4966	58	0	0	0	0	58
4967	0	0	0	57	0	57
4968	0	0	0	56	0	56
4969	58	0	0	0	0	58
4970	57	0	0	0	0	57
4971	0	0	54	0	0	54
4972	0	0	53	1	0	54
4973	0	0	0	57	0	57
4974	0	0	57	0	0	57
4975	0	0	0	56	0	56
4976	0	0	0	53	0	53
4977	0	0	0	60	0	60
4978	59	0	0	0	0	59
4979	0	60	0	0	0	60
4980	58	0	0	0	0	58
4981	50	0	0	0	0	50
4982	0	54	0	0	0	54
4983	53	0	0	0	0	53
4984	0	0	51	0	0	51
4985	1	0	0	48	0	49
4986	52	0	0	0	0	52
4987	0	0	52	0	0	52
4988	55	0	0	0	0	55
4989	0	55	0	0	0	55
4990	57	0	0	0	0	57
4991	55	0	0	0	0	55
4992	0	57	0	0	0	57
4993	56	0	0	0	0	56
4994	0	0	0	51	0	51
4995	0	0	0	54	0	54
4996	54	0	0	0	0	54
4997	58	0	0	0	0	58
4998	0	57	0	0	0	57
4999	0	56	0	0	0	56
5000	0	0	0	57	0	57
5001	0	56	0	0	0	56
5002	0	57	0	0	0	57
5003	57	0	0	0	0	57
5004	0	58	0	0	0	58
5005	56	0	0	0	0	56
5006	0	53	0	0	0	53
5007	0	0	59	0	0	59
5008	0	59	0	0	0	59
5009	59	0	0	0	0	59
5010	60	0	0	0	0	60
5011	0	0	58	0	0	58
5012	1	0	0	58	0	59
5013	0	0	0	57	0	57
5014	0	0	56	0	0	56
5015	0	0	0	56	0	56
5016	0	0	53	0	0	53
5017	0	0	55	0	0	55
5018	52	0	0	0	0	52
5019	0	55	0	0	0	55
5020	54	0	0	0	0	54
5021	0	0	0	55	0	55
5022	0	0	55	0	0	55
5023	0	0	1	54	0	55
5024	0	56	0	0	0	56
5025	55	0	0	0	0	55
5026	57	0	0	0	0	57
5027	0	0	0	56	0	56
5028	0	0	55	0	0	55
5029	50	0	0	0	0	50
5030	0	53	0	0	0	53
5031	52	0	0	0	0	52
5032	0	0	0	53	0	53
5033	52	0	0	0	0	52
5034	0	0	0	53	0	53
5035	0	0	48	0	0	48
5036	0	0	51	0	0	51
5037	46	0	0	0	0	46
5038	0	48	0	0	0	48
5039	49	0	0	0	0	49
5040	47	0	0	0	0	47
5041	0	44	0	0	0	44
5042	44	0	0	1	0	45
5043	0	0	44	0	0	44
5044	0	0	0	39	0	39
5045	0	0	0	40	0	40
5046	0	0	0	41	0	41
5047	0	0	41	0	0	41
5048	0	0	38	0	0	38
5049	0	0	0	38	0	38
5050	0	35	0	0	0	35
5051	0	38	0	0	0	38
5052	39	0	0	0	0	39
5053	38	0	0	0	0	38
5054	0	38	0	0	0	38
5055	0	0	0	39	0	39
5056	0	0	0	38	0	38
5057	40	0	0	0	0	40
5058	0	0	0	42	0	42
5059	0	0	0	38	0	38
5060	0	0	0	37	0	37
5061	0	0	37	0	0	37
5062	0	0	32	0	0	32
5063	39	0	0	0	0	39
5064	0	0	0	36	0	36
5065	0	0	38	0	0	38
5066	0	0	42	0	0	42
5067	44	0	0	0	0	44
5068	0	0	47	0	0	47
5069	0	50	0	0	0	50
5070	0	0	0	50	0	50
5071	0	0	50	0	0	50
5072	53	0	0	0	0	53
5073	0	0	0	54	0	54
5074	0	0	57	0	0	57
5075	0	0	0	55	0	55
5076	0	0	0	54	0	54
5077	55	0	0	0	0	55
5078	0	55	0	0	0	55
5079	0	0	0	54	0	54
5080	53	0	0	0	0	53
5081	50	0	0	0	0	50
5082	49	0	0	0	0	49
5083	51	0	0	0	0	51
5084	0	0	0	52	0	52
5085	48	0	0	0	0	48
5086	52	0	0	0	0	52
5087	50	0	0	0	0	50
5088	49	0	0	0	0	49
5089	0	50	0	1	0	51
5090	0	43	0	0	0	43
5091	0	0	0	46	0	46
5092	0	45	0	0	0	45
5093	51	0	0	0	0	51
5094	0	0	0	51	0	51
5095	55	0	0	0	0	55
5096	50	0	0	0	0	50
5097	0	0	0	56	0	56
5098	0	0	0	57	0	57
5099	0	57	0	0	0	57
5100	52	0	0	1	0	53
5101	0	57	0	0	0	57
5102	58	0	0	0	0	58
5103	0	0	0	56	0	56
5104	0	0	57	0	0	57
5105	57	0	0	0	0	57
5106	53	1	0	0	0	54
5107	0	0	54	0	0	54
5108	0	0	54	0	0	54
5109	0	0	0	55	0	55
5110	56	0	0	0	0	56
5111	60	0	0	0	0	60
5112	59	0	0	0	0	59
5113	58	0	0	0	0	58
5114	0	59	1	0	0	60
5115	60	0	0	0	0	60
5116	0	0	0	60	0	60
5117	0	0	1	64	0	65
5118	0	0	0	65	0	65
5119	0	0	0	62	0	62
5120	61	0	0	0	0	61
5121	0	0	0	62	0	62
5122	0	0	61	0	0	61
5123	0	0	0	60	0	60
5124	0	0	0	64	0	64
5125	0	0	0	63	0	63
5126	0	0	0	63	0	63
5127	64	0	0	0	0	64
5128	0	62	0	0	0	62
5129	0	60	0	0	0	60
5130	0	0	0	66	0	66
5131	68	0	0	0	0	68
5132	64	0	1	0	0	65
5133	0	0	0	67	0	67
5134	0	0	66	0	0	66
5135	68	0	0	0	0	68
5136	0	0	0	69	0	69
5137	0	0	67	0	0	67
5138	63	0	0	0	0	63
5139	0	70	0	0	0	70
5140	70	0	0	0	0	70
5141	0	70	0	0	0	70
5142	0	0	0	75	0	75
5143	0	71	0	0	0	71
5144	1	0	0	74	0	75
5145	72	0	0	0	0	72
5146	0	73	0	0	0	73
5147	0	0	76	0	0	76
5148	0	0	0	76	0	76
5149	0	0	77	0	0	77
5150	0	0	0	76	0	76
5151	0	0	0	73	0	73
5152	0	0	72	0	0	72
5153	76	0	0	0	0	76
5154	0	0	72	0	0	72
5155	0	0	66	1	0	67
5156	0	70	0	0	0	70
5157	0	0	0	73	0	73
5158	0	0	0	74	0	74
5159	0	0	0	70	0	70
5160	0	0	0	66	0	66
5161	0	0	59	0	0	59
5162	59	0	0	0	0	59
5163	0	0	48	0	0	48
5164	0	0	5	50	0	55
5165	52	0	6	0	0	58
5166	0	56	0	0	0	56
5167	0	0	0	55	0	55
5168	46	0	0	0	0	46
5169	0	52	0	0	0	52
5170	0	44	0	0	0	44
5171	44	0	0	0	0	44
5172	0	45	0	0	0	45
5173	43	0	0	0	0	43
5174	0	47	0	0	0	47
5175	46	0	0	0	0	46
5176	43	0	0	0	0	43
5177	0	42	0	0	0	42
5178	0	0	0	45	0	45
5179	0	0	45	0	0	45
5180	46	0	0	0	0	46
5181	0	0	0	44	0	44
5182	0	43	0	0	0	43
5183	0	45	0	0	0	45
5184	0	0	0	47	0	47
5185	45	0	0	0	0	45
5186	0	0	41	0	0	41
5187	1	0	0	41	0	42
5188	0	0	0	33	0	33
5189	0	0	0	35	0	35
5190	0	0	0	36	0	36
5191	0	32	0	0	0	32
5192	0	0	0	35	0	35
5193	0	0	35	0	0	35
5194	0	0	33	0	0	33
5195	0	0	32	0	0	32
5196	0	0	0	31	0	31
5197	34	0	0	0	0	34
5198	0	0	33	0	0	33
5199	0	0	35	0	0	35
5200	0	0	0	31	0	31
5201	35	0	0	0	0	35
5202	0	33	0	0	0	33
5203	35	0	0	0	0	35
5204	0	0	0	30	0	30
5205	0	0	29	0	0	29
5206	0	0	0	30	0	30
5207	0	29	0	0	0	29
5208	30	0	0	0	0	30
5209	0	0	29	0	0	29
5210	0	23	0	0	0	23
5211	23	0	0	0	0	23
5212	0	0	0	24	0	24
5213	0	0	0	24	0	24
5214	26	0	0	0	0	26
5215	28	0	0	0	0	28
5216	25	0	0	0	0	25
5217	0	0	0	27	0	27
5218	0	26	0	0	0	26
5219	27	0	0	0	0	27
5220	0	24	0	0	0	24
5221	25	0	0	0	0	25
5222	0	26	0	0	0	26
5223	0	0	0	26	0	26
5224	25	0	0	0	0	25
5225	25	0	0	0	0	25
5226	23	0	0	0	0	23
5227	24	0	0	0	0	24
5228	25	0	0	0	0	25
5229	0	0	23	0	0	23
5230	0	0	0	23	0	23
5231	0	0	25	0	0	25
5232	0	0	26	0	0	26
5233	22	0	0	0	0	22
5234	23	0	0	0	0	23
5235	21	0	0	0	0	21
5236	0	0	0	21	0	21
5237	19	0	0	0	0	19
5238	0	20	0	0	0	20
5239	0	17	0	0	0	17
5240	0	19	0	0	0	19
5241	17	0	0	0	0	17
5242	0	18	0	0	0	18
5243	19	0	0	0	0	19
5244	20	0	0	0	0	20
5245	0	0	19	0	0	19
5246	0	0	0	19	0	19
5247	0	0	0	20	0	20
5248	19	0	0	0	0	19
5249	20	0	0	0	0	20
5250	0	0	0	19	0	19
5251	0	0	19	0	0	19
5252	0	0	19	0	0	19
5253	0	0	0	19	0	19
5254	0	0	0	19	0	19
5255	0	0	0	19	0	19
5256	19	0	0	0	0	19
5257	16	1	0	0	0	17
5258	0	19	0	0	0	19
5259	0	0	0	19	0	19
5260	0	0	0	18	0	18
5261	0	18	0	0	0	18
5262	0	0	0	18	0	18
5263	18	0	0	0	0	18
5264	0	0	0	19	0	19
5265	0	0	0	18	0	18
5266	19	0	0	0	0	19
5267	19	0	0	0	0	19
5268	19	0	0	0	0	19
5269	0	0	0	19	0	19
5270	0	0	19	0	0	19
5271	0	0	16	0	0	16
5272	0	0	16	0	0	16
5273	0	19	0	0	0	19
5274	22	0	0	0	0	22
5275	0	0	21	0	0	21
5276	22	0	0	0	0	22
5277	0	0	0	22	0	22
5278	21	0	0	0	0	21
5279	19	0	0	1	0	20
5280	0	21	0	0	0	21
5281	23	0	0	0	0	23
5282	23	0	0	0	0	23
5283	0	22	0	0	0	22
5284	0	0	0	24	0	24
5285	0	0	24	0	0	24
5286	0	0	0	24	0	24
5287	0	0	0	24	0	24
5288	24	0	0	1	0	25
5289	0	0	0	24	0	24
5290	0	24	0	0	0	24
5291	0	0	0	24	0	24
5292	0	0	0	25	0	25
5293	0	0	23	0	0	23
5294	0	19	0	0	0	19
5295	0	25	0	0	0	25
5296	26	0	0	0	0	26
5297	0	30	0	0	0	30
5298	0	0	0	33	0	33
5299	0	0	31	0	0	31
5300	0	32	0	0	0	32
5301	32	0	0	0	0	32
5302	0	0	0	31	0	31
5303	0	0	0	33	0	33
5304	0	0	32	0	0	32
5305	0	0	0	33	0	33
5306	0	0	0	32	0	32
5307	31	0	0	0	0	31
5308	27	0	0	0	0	27
5309	0	32	0	0	0	32
5310	25	0	0	0	0	25
5311	0	29	0	0	0	29
5312	0	0	0	26	0	26
5313	0	28	0	0	0	28
5314	0	27	0	0	0	27
5315	29	0	0	0	0	29
5316	28	0	0	0	0	28
5317	0	28	0	0	0	28
5318	27	0	0	0	0	27
5319	30	0	0	0	0	30
5320	31	0	0	0	0	31
5321	0	0	0	32	0	32
5322	31	0	0	0	0	31
5323	0	0	34	0	0	34
5324	30	0	0	0	0	30
5325	0	0	31	0	0	31
5326	1	0	0	28	0	29
5327	0	0	0	32	0	32
5328	0	0	30	0	0	30
5329	32	0	0	0	0	32
5330	33	0	0	0	0	33
5331	0	0	46	0	0	46
5332	0	0	0	44	0	44
5333	0	0	0	41	0	41
5334	0	0	0	44	0	44
5335	46	1	0	0	0	47
5336	44	0	0	0	0	44
5337	0	0	0	45	0	45
5338	0	44	0	0	0	44
5339	0	45	0	0	0	45
5340	44	0	0	0	0	44
5341	0	41	0	0	0	41
5342	0	42	0	0	0	42
5343	0	0	0	47	0	47
5344	0	0	47	0	0	47
5345	0	44	0	0	0	44
5346	0	0	0	46	0	46
5347	0	49	0	0	0	49
5348	0	0	0	48	0	48
5349	48	0	0	0	0	48
5350	0	47	0	0	0	47
5351	46	0	0	0	0	46
5352	47	0	0	0	0	47
5353	0	0	45	0	0	45
5354	47	0	0	0	0	47
5355	0	0	0	48	0	48
5356	0	0	53	0	0	53
5357	0	50	0	0	0	50
5358	0	0	0	50	0	50
5359	0	0	0	53	0	53
5360	52	0	0	0	0	52
5361	0	0	0	52	0	52
5362	0	0	0	53	0	53
5363	51	0	0	0	0	51
5364	0	55	0	0	0	55
5365	57	0	0	0	0	57
5366	0	0	54	0	0	54
5367	51	0	0	0	0	51
5368	0	0	53	0	0	53
5369	0	50	1	0	0	51
5370	49	0	0	0	0	49
5371	52	0	0	0	0	52
5372	0	0	52	0	0	52
5373	0	0	39	0	0	39
5374	0	0	46	0	0	46
5375	0	50	0	0	0	50
5376	0	0	0	49	0	49
5377	0	0	52	0	0	52
5378	0	0	48	0	0	48
5379	0	0	0	51	0	51
5380	0	0	51	0	0	51
5381	51	0	0	0	0	51
5382	52	0	0	0	0	52
5383	0	0	50	0	0	50
5384	0	54	0	0	0	54
5385	0	0	0	57	0	57
5386	0	0	58	0	0	58
5387	0	59	0	0	0	59
5388	0	0	0	56	0	56
5389	57	0	0	0	0	57
5390	54	0	0	0	0	54
5391	0	49	0	0	0	49
5392	0	0	0	52	0	52
5393	0	0	0	51	0	51
5394	0	0	0	56	0	56
5395	0	0	0	56	0	56
5396	0	0	57	0	0	57
5397	0	0	0	56	0	56
5398	0	0	58	0	0	58
5399	0	57	0	0	0	57
5400	59	0	0	0	0	59
5401	0	60	0	0	0	60
5402	0	0	0	60	0	60
5403	0	0	0	60	0	60
5404	59	0	0	0	0	59
5405	0	0	0	60	0	60
5406	0	55	0	0	0	55
5407	0	0	0	55	0	55
5408	0	0	0	56	0	56
5409	56	0	0	0	0	56
5410	0	0	56	0	0	56
5411	0	55	0	0	0	55
5412	0	56	0	0	0	56
5413	0	0	0	55	0	55
5414	57	0	0	0	0	57
5415	0	60	0	0	0	60
5416	0	0	0	60	0	60
5417	0	0	57	0	0	57
5418	0	0	0	52	0	52
5419	55	0	0	0	0	55
5420	55	0	0	0	0	55
5421	0	0	0	55	0	55
5422	56	0	0	0	0	56
5423	56	0	0	0	0	56
5424	0	0	43	0	0	43
5425	44	0	0	0	0	44
5426	0	44	0	0	0	44
5427	45	0	0	0	0	45
5428	0	0	44	0	0	44
5429	0	0	0	42	0	42
5430	44	0	0	0	0	44
5431	0	0	43	0	0	43
5432	0	0	44	0	0	44
5433	0	0	0	44	0	44
5434	0	0	44	0	0	44
5435	43	0	0	0	0	43
5436	0	0	43	0	0	43
5437	0	0	0	42	0	42
5438	0	0	0	44	0	44
5439	44	0	0	0	0	44
5440	0	0	41	0	0	41
5441	0	0	44	0	0	44
5442	0	0	0	39	0	39
5443	0	0	44	0	0	44
5444	44	0	0	0	0	44
5445	0	0	0	45	0	45
5446	0	0	47	0	0	47
5447	0	0	0	48	0	48
5448	0	0	0	49	0	49
5449	46	0	0	0	0	46
5450	0	0	50	0	0	50
5451	48	0	0	0	0	48
5452	0	0	47	0	0	47
5453	47	0	0	0	0	47
5454	45	0	0	0	0	45
5455	44	0	0	0	0	44
5456	0	47	0	0	0	47
5457	46	0	0	0	0	46
5458	49	0	0	0	0	49
5459	0	0	0	49	0	49
5460	0	0	51	0	0	51
5461	52	0	0	0	0	52
5462	0	0	46	0	0	46
5463	0	0	0	46	0	46
5464	0	0	0	52	0	52
5465	54	0	0	0	0	54
5466	0	52	0	0	0	52
5467	0	0	0	54	0	54
5468	0	0	0	53	0	53
5469	0	0	55	0	0	55
5470	0	0	0	51	0	51
5471	0	0	0	54	0	54
5472	0	0	0	52	0	52
5473	0	55	0	0	0	55
5474	53	0	0	0	0	53
5475	50	0	0	0	0	50
5476	0	54	0	1	0	55
5477	48	0	0	0	0	48
5478	0	0	0	49	0	49
5479	0	0	49	0	0	49
5480	0	42	0	0	0	42
5481	0	46	0	0	0	46
5482	48	0	0	0	0	48
5483	47	0	0	0	0	47
5484	0	0	0	46	0	46
5485	0	0	0	42	0	42
5486	0	0	0	45	0	45
5487	41	0	0	0	0	41
5488	0	0	45	0	0	45
5489	43	0	0	0	0	43
5490	0	0	0	43	0	43
5491	1	0	0	42	0	43
5492	0	42	0	0	0	42
5493	0	0	0	41	0	41
5494	0	0	0	41	0	41
5495	0	0	41	0	0	41
5496	0	41	0	0	0	41
5497	44	0	0	0	0	44
5498	41	0	0	0	0	41
5499	44	0	0	0	0	44
5500	45	0	0	0	0	45
5501	0	0	45	0	0	45
5502	42	0	0	0	0	42
5503	0	0	45	0	0	45
5504	0	0	0	44	0	44
5505	0	45	0	0	0	45
5506	0	0	0	46	0	46
5507	0	0	0	41	0	41
5508	0	0	43	0	0	43
5509	40	0	0	0	0	40
5510	44	0	0	0	0	44
5511	0	43	0	0	0	43
5512	0	0	44	0	0	44
5513	0	0	0	44	0	44
5514	0	0	41	0	0	41
5515	0	0	42	0	0	42
5516	0	0	0	44	0	44
5517	0	0	44	0	0	44
5518	0	1	0	41	0	42
5519	0	0	44	0	0	44
5520	0	0	0	42	0	42
5521	42	0	0	0	0	42
5522	44	0	0	0	0	44
5523	40	0	0	0	0	40
5524	36	1	0	0	0	37
5525	0	40	0	0	0	40
5526	0	0	0	42	0	42
5527	0	0	0	41	0	41
5528	0	0	43	0	0	43
5529	0	0	0	41	0	41
5530	0	0	44	0	0	44
5531	0	0	40	0	0	40
5532	40	0	0	0	0	40
5533	0	41	0	1	0	42
5534	42	0	0	0	0	42
5535	41	0	0	1	0	42
5536	0	42	0	0	0	42
5537	41	0	0	0	0	41
5538	0	0	41	0	0	41
5539	0	40	0	0	0	40
5540	42	0	0	0	0	42
5541	0	0	34	0	0	34
5542	38	0	0	0	0	38
5543	0	35	0	0	0	35
5544	37	0	0	0	0	37
5545	34	0	0	0	0	34
5546	0	32	0	0	0	32
5547	0	36	0	0	0	36
5548	0	37	0	0	0	37
5549	0	0	0	37	0	37
5550	0	0	0	38	0	38
5551	32	0	0	0	0	32
5552	34	0	0	0	0	34
5553	0	0	32	0	0	32
5554	0	0	31	0	0	31
5555	0	0	31	0	0	31
5556	0	0	0	34	0	34
5557	0	0	37	0	0	37
5558	0	0	0	38	0	38
5559	39	0	0	0	0	39
5560	0	0	38	0	0	38
5561	41	0	0	0	0	41
5562	40	0	0	0	0	40
5563	1	0	37	0	0	38
5564	0	38	0	0	0	38
5565	0	0	0	40	0	40
5566	0	0	41	0	0	41
5567	0	0	1	39	0	40
5568	0	0	0	42	0	42
5569	40	0	0	0	0	40
5570	0	0	0	43	0	43
5571	0	0	41	0	0	41
5572	0	0	0	41	0	41
5573	37	0	0	0	0	37
5574	0	41	0	0	0	41
5575	40	0	0	0	0	40
5576	0	0	0	42	0	42
5577	0	0	41	0	0	41
5578	0	0	46	0	0	46
5579	0	0	42	0	0	42
5580	0	47	0	0	0	47
5581	44	0	0	0	0	44
5582	0	45	0	0	0	45
5583	38	0	0	1	0	39
5584	0	43	0	0	0	43
5585	0	0	0	46	0	46
5586	0	0	0	48	0	48
5587	0	0	0	47	0	47
5588	0	47	0	0	0	47
5589	0	0	0	46	0	46
5590	0	0	0	45	0	45
5591	45	0	0	0	0	45
5592	0	0	0	45	0	45
5593	0	0	43	0	0	43
5594	44	0	0	0	0	44
5595	43	0	0	0	0	43
5596	0	42	0	0	0	42
5597	52	0	0	0	0	52
5598	55	0	0	0	0	55
5599	0	0	0	56	0	56
5600	0	0	0	58	0	58
5601	0	0	0	58	0	58
5602	57	0	0	0	0	57
5603	56	0	0	0	0	56
5604	0	0	58	0	0	58
5605	56	0	0	0	0	56
5606	56	0	0	0	0	56
5607	58	0	0	0	0	58
5608	0	0	54	0	0	54
5609	0	0	54	0	0	54
5610	0	0	0	55	0	55
5611	0	0	54	0	0	54
5612	0	0	0	57	0	57
5613	0	0	0	52	0	52
5614	0	53	0	0	0	53
5615	53	0	1	1	0	55
5616	0	0	53	0	0	53
5617	55	1	0	0	0	56
5618	0	0	0	53	0	53
5619	53	0	0	0	0	53
5620	0	56	0	0	0	56
5621	0	53	0	0	0	53
5622	0	0	0	53	0	53
5623	0	0	0	56	0	56
5624	0	0	56	0	0	56
5625	0	0	0	55	0	55
5626	52	0	0	0	0	52
5627	0	57	0	0	0	57
5628	0	0	53	0	0	53
5629	0	0	0	52	0	52
5630	0	0	52	0	0	52
5631	0	0	0	52	0	52
5632	0	0	54	0	0	54
5633	0	0	56	0	0	56
5634	0	0	0	56	0	56
5635	55	0	0	0	0	55
5636	55	0	0	0	0	55
5637	52	0	0	0	0	52
5638	0	51	0	0	0	51
5639	52	0	0	0	0	52
5640	54	0	0	0	0	54
5641	0	0	53	0	0	53
5642	0	51	0	0	0	51
5643	0	1	0	52	0	53
5644	52	0	0	0	0	52
5645	0	53	0	0	0	53
5646	56	0	0	0	0	56
5647	56	0	0	0	0	56
5648	53	0	0	0	0	53
5649	53	0	0	0	0	53
5650	0	0	0	58	0	58
5651	57	0	0	0	0	57
5652	0	0	0	58	0	58
5653	0	52	0	0	0	52
5654	0	0	0	55	0	55
5655	56	0	0	0	0	56
5656	0	0	55	0	0	55
5657	0	0	0	53	0	53
5658	52	1	0	0	0	53
5659	0	53	0	0	0	53
5660	48	0	0	0	0	48
5661	53	0	0	0	0	53
5662	0	56	0	0	0	56
5663	57	0	0	0	0	57
5664	0	0	57	0	0	57
5665	0	0	55	0	0	55
5666	56	0	0	0	0	56
5667	0	0	56	0	0	56
5668	0	0	0	54	0	54
5669	0	46	0	0	0	46
5670	52	0	0	0	0	52
5671	0	47	0	0	0	47
5672	0	50	0	0	0	50
5673	0	0	0	52	0	52
5674	0	0	0	51	0	51
5675	0	0	0	48	0	48
5676	0	0	0	51	0	51
5677	0	0	47	0	0	47
5678	0	0	0	45	0	45
5679	0	0	0	46	0	46
5680	46	0	0	0	0	46
5681	0	0	0	46	0	46
5682	0	0	44	0	0	44
5683	46	0	0	0	0	46
5684	0	0	0	49	0	49
5685	0	0	45	0	0	45
5686	0	0	0	47	0	47
5687	0	49	0	0	0	49
5688	50	0	0	0	0	50
5689	0	0	50	0	0	50
5690	0	40	0	0	0	40
5691	39	0	2	0	0	41
5692	0	41	0	0	0	41
5693	0	35	3	0	0	38
5694	38	0	0	0	0	38
5695	0	41	0	0	0	41
5696	0	39	0	0	0	39
5697	1	0	0	38	0	39
5698	0	0	39	0	0	39
5699	0	39	0	0	0	39
5700	0	0	0	37	0	37
5701	0	39	0	0	0	39
5702	39	0	0	0	0	39
5703	0	0	38	0	0	38
5704	0	0	0	39	0	39
5705	40	0	0	0	0	40
5706	0	0	0	39	0	39
5707	0	0	39	0	0	39
5708	38	0	0	0	0	38
5709	35	0	0	0	0	35
5710	0	37	0	0	0	37
5711	0	0	0	39	0	39
5712	0	0	0	39	0	39
5713	37	0	0	0	0	37
5714	38	0	0	0	0	38
5715	0	0	37	0	0	37
5716	0	35	0	0	0	35
5717	37	0	0	0	0	37
5718	0	0	0	39	0	39
5719	0	0	38	0	0	38
5720	0	0	36	0	0	36
5721	0	0	0	36	0	36
5722	37	0	0	0	0	37
5723	0	36	0	0	0	36
5724	34	0	0	0	0	34
5725	0	0	0	33	0	33
5726	0	0	0	30	0	30
5727	0	0	0	32	0	32
5728	28	0	0	0	0	28
5729	0	32	0	0	0	32
5730	0	0	0	32	0	32
5731	0	0	0	33	0	33
5732	0	0	33	0	0	33
5733	0	0	0	32	0	32
5734	0	0	33	0	0	33
5735	0	30	0	0	0	30
5736	0	0	0	32	0	32
5737	33	0	0	0	0	33
5738	0	0	32	0	0	32
5739	0	0	0	28	0	28
5740	0	0	26	0	0	26
5741	29	0	0	0	0	29
5742	0	0	30	0	0	30
5743	0	0	0	25	0	25
5744	26	0	0	0	0	26
5745	0	26	0	0	0	26
5746	26	0	0	0	0	26
5747	0	26	0	0	0	26
5748	0	0	0	25	0	25
5749	0	0	24	0	0	24
5750	0	0	26	0	0	26
5751	0	0	0	23	0	23
5752	26	0	0	0	0	26
5753	25	0	0	0	0	25
5754	0	0	0	25	0	25
5755	0	0	0	21	0	21
5756	21	0	0	0	0	21
5757	0	18	0	0	0	18
5758	0	21	0	0	0	21
5759	23	0	0	0	0	23
5760	0	0	23	0	0	23
5761	0	0	0	21	0	21
5762	0	0	22	0	0	22
5763	0	0	0	23	0	23
5764	0	0	23	0	0	23
5765	0	0	24	0	0	24
5766	0	0	0	20	0	20
5767	0	22	0	0	0	22
5768	25	0	0	0	0	25
5769	0	23	0	0	0	23
5770	0	0	0	21	0	21
5771	23	0	0	0	0	23
5772	0	0	0	23	0	23
5773	20	0	0	1	0	21
5774	23	0	0	0	0	23
5775	24	0	0	0	0	24
5776	0	24	0	0	0	24
5777	23	0	0	0	0	23
5778	0	0	0	23	0	23
5779	23	0	0	0	0	23
5780	0	0	0	24	0	24
5781	23	0	0	0	0	23
5782	24	0	0	0	0	24
5783	0	24	0	0	0	24
5784	0	0	0	29	0	29
5785	0	0	0	32	0	32
5786	0	32	0	0	0	32
5787	0	0	0	32	0	32
5788	33	0	0	0	0	33
5789	32	0	0	0	0	32
5790	32	0	0	0	0	32
5791	0	0	31	0	0	31
5792	33	0	0	0	0	33
5793	33	0	0	0	0	33
5794	35	0	0	0	0	35
5795	0	34	0	0	0	34
5796	0	0	0	35	0	35
5797	0	0	0	37	0	37
5798	0	0	0	35	0	35
5799	0	0	38	0	0	38
5800	0	0	0	37	0	37
5801	39	0	0	0	0	39
5802	1	0	0	37	0	38
5803	0	0	0	38	0	38
5804	0	0	38	0	0	38
5805	0	40	0	0	0	40
5806	40	0	0	0	0	40
5807	0	0	0	38	0	38
5808	38	0	1	0	0	39
5809	0	0	43	0	0	43
5810	40	0	0	0	0	40
5811	0	43	0	0	0	43
5812	0	0	38	0	0	38
5813	0	0	44	0	0	44
5814	0	0	0	42	0	42
5815	0	0	43	0	0	43
5816	0	44	0	0	0	44
5817	0	0	0	46	0	46
5818	0	0	0	44	0	44
5819	0	0	0	48	0	48
5820	48	0	0	0	0	48
5821	0	45	0	0	0	45
5822	0	0	0	48	0	48
5823	0	0	0	45	0	45
5824	47	0	0	0	0	47
5825	0	48	0	0	0	48
5826	47	0	0	0	0	47
5827	46	0	0	0	0	46
5828	45	0	0	0	0	45
5829	0	0	45	0	0	45
5830	0	0	0	44	0	44
5831	0	44	0	0	0	44
5832	0	46	0	0	0	46
5833	0	0	0	50	0	50
5834	0	50	0	0	0	50
5835	52	0	0	0	0	52
5836	0	0	50	0	0	50
5837	49	0	0	0	0	49
5838	47	0	0	0	0	47
5839	0	0	0	51	0	51
5840	51	0	0	0	0	51
5841	0	54	0	0	0	54
5842	54	0	0	0	0	54
5843	52	0	0	0	0	52
5844	54	0	0	0	0	54
5845	0	0	51	0	0	51
5846	0	0	59	0	0	59
5847	1	0	0	56	0	57
5848	0	52	0	1	0	53
5849	1	54	0	0	0	55
5850	0	0	0	57	0	57
5851	57	1	0	0	0	58
5852	0	0	0	53	0	53
5853	0	0	0	53	0	53
5854	54	0	0	0	0	54
5855	0	56	0	0	0	56
5856	0	0	56	0	0	56
5857	0	0	57	0	0	57
5858	58	0	0	0	0	58
5859	0	0	0	53	0	53
5860	0	0	59	0	0	59
5861	0	0	0	54	0	54
5862	0	0	0	50	0	50
5863	0	0	0	49	0	49
5864	0	0	0	53	0	53
5865	0	49	0	0	0	49
5866	0	0	0	52	0	52
5867	47	0	0	0	0	47
5868	0	50	0	0	0	50
5869	48	0	0	0	0	48
5870	51	0	0	0	0	51
5871	52	0	0	0	0	52
5872	0	0	48	0	0	48
5873	48	0	0	0	0	48
5874	48	0	0	0	0	48
5875	49	0	0	0	0	49
5876	47	0	0	0	0	47
5877	0	48	0	0	0	48
5878	44	0	0	0	0	44
5879	0	0	42	0	0	42
5880	0	0	0	46	0	46
5881	0	0	0	45	0	45
5882	42	0	0	0	0	42
5883	0	44	0	0	0	44
5884	43	0	0	0	0	43
5885	0	43	0	0	0	43
5886	44	0	0	0	0	44
5887	43	0	0	0	0	43
5888	0	45	0	0	0	45
5889	46	0	0	0	0	46
5890	45	0	0	0	0	45
5891	0	45	0	0	0	45
5892	0	50	0	0	0	50
5893	51	0	0	0	0	51
5894	0	0	0	49	0	49
5895	52	0	0	0	0	52
5896	54	0	0	0	0	54
5897	51	0	0	0	0	51
5898	48	0	0	0	0	48
5899	0	49	0	0	0	49
5900	0	50	0	0	0	50
5901	53	0	0	0	0	53
5902	0	0	49	0	0	49
5903	0	0	0	49	0	49
5904	0	0	0	47	0	47
5905	51	0	0	0	0	51
5906	0	50	0	0	0	50
5907	0	0	0	55	0	55
5908	0	0	0	53	0	53
5909	55	0	0	0	0	55
5910	0	0	0	55	0	55
5911	58	0	0	0	0	58
5912	57	0	0	0	0	57
5913	60	0	0	0	0	60
5914	0	0	0	58	0	58
5915	0	0	0	60	0	60
5916	0	0	63	0	0	63
5917	0	0	57	2	0	59
5918	61	0	0	0	0	61
5919	0	0	0	64	0	64
5920	0	0	65	0	0	65
5921	0	0	65	0	0	65
5922	0	0	0	66	0	66
5923	0	0	69	0	0	69
5924	0	0	0	64	0	64
5925	0	0	0	66	0	66
5926	0	0	65	0	0	65
5927	0	0	0	67	0	67
5928	0	0	0	67	0	67
5929	0	0	0	67	0	67
5930	0	0	68	0	0	68
5931	0	0	0	68	0	68
5932	67	0	0	0	0	67
5933	0	68	0	0	0	68
5934	69	0	0	0	0	69
5935	0	0	70	0	0	70
5936	71	0	0	0	0	71
5937	69	0	0	0	0	69
5938	68	0	0	0	0	68
5939	0	0	0	66	0	66
5940	0	0	0	68	0	68
5941	0	0	69	0	0	69
5942	67	0	0	0	0	67
5943	0	62	0	0	0	62
5944	0	64	0	0	0	64
5945	0	66	0	0	0	66
5946	0	0	0	69	0	69
5947	71	0	0	0	0	71
5948	68	0	0	0	0	68
5949	0	0	66	0	0	66
5950	0	0	0	68	0	68
5951	0	0	0	67	0	67
5952	0	0	67	0	0	67
5953	0	0	64	0	0	64
5954	68	0	0	0	0	68
5955	0	69	0	0	0	69
5956	71	0	0	0	0	71
5957	70	0	0	0	0	70
5958	0	0	0	68	0	68
5959	0	0	0	71	0	71
5960	70	0	0	0	0	70
5961	0	0	0	70	0	70
5962	1	0	0	64	0	65
5963	66	0	0	0	0	66
5964	0	0	0	64	0	64
5965	64	0	0	0	0	64
5966	61	0	0	0	0	61
5967	0	0	66	0	0	66
5968	65	0	0	0	0	65
5969	66	0	0	0	0	66
5970	62	0	0	0	0	62
5971	0	0	50	0	0	50
5972	61	0	0	0	0	61
5973	0	58	0	0	0	58
5974	64	0	0	0	0	64
5975	63	0	0	0	0	63
5976	0	0	0	63	0	63
5977	0	0	0	61	0	61
5978	0	63	0	0	0	63
5979	0	0	0	64	0	64
5980	0	0	0	60	0	60
5981	58	0	0	0	0	58
5982	0	0	0	55	0	55
5983	0	0	0	53	0	53
5984	0	0	0	56	0	56
5985	0	49	1	0	0	50
5986	49	0	0	0	0	49
5987	0	49	0	0	0	49
5988	50	0	0	0	0	50
5989	0	0	47	0	0	47
5990	49	0	0	0	0	49
5991	0	0	49	0	0	49
5992	0	48	0	0	0	48
5993	50	0	0	0	0	50
5994	47	0	0	0	0	47
5995	1	46	0	0	0	47
5996	0	44	0	0	0	44
5997	50	0	0	0	0	50
5998	42	0	0	0	0	42
5999	0	0	0	44	0	44
6000	0	0	0	43	0	43
6001	0	0	42	0	0	42
6002	38	0	0	0	0	38
6003	0	0	0	42	0	42
6004	0	37	0	0	0	37
6005	0	0	0	34	0	34
6006	0	0	0	36	0	36
6007	0	0	36	0	0	36
6008	0	0	0	35	0	35
6009	31	0	0	0	0	31
6010	0	29	0	0	0	29
6011	0	33	0	0	0	33
6012	32	0	0	0	0	32
6013	33	0	0	0	0	33
6014	33	0	0	0	0	33
6015	0	31	0	0	0	31
6016	0	28	0	0	0	28
6017	29	0	0	0	0	29
6018	27	0	0	0	0	27
6019	0	24	0	0	0	24
6020	0	25	0	0	0	25
6021	25	0	0	0	0	25
6022	0	0	0	27	0	27
6023	28	0	0	0	0	28
6024	0	0	0	28	0	28
6025	0	27	0	0	0	27
6026	0	26	0	0	0	26
6027	25	0	0	0	0	25
6028	22	0	0	0	0	22
6029	22	0	0	0	0	22
6030	0	23	0	0	0	23
6031	0	0	20	0	0	20
6032	0	23	0	0	0	23
6033	23	0	0	0	0	23
6034	24	0	0	0	0	24
6035	0	0	22	0	0	22
6036	0	22	0	0	0	22
6037	0	0	0	23	0	23
6038	0	0	0	24	0	24
6039	0	23	0	0	0	23
6040	0	0	22	0	0	22
6041	23	0	0	0	0	23
6042	0	0	0	22	0	22
6043	23	0	0	0	0	23
6044	20	0	0	0	0	20
6045	0	0	0	21	0	21
6046	0	0	0	21	0	21
6047	0	0	0	21	0	21
6048	0	0	0	20	0	20
6049	21	0	0	0	0	21
6050	21	0	0	0	0	21
6051	0	0	21	0	0	21
6052	0	0	0	24	0	24
6053	0	0	0	23	0	23
6054	0	0	0	24	0	24
6055	0	0	23	0	0	23
6056	0	0	0	23	0	23
6057	23	0	0	0	0	23
6058	0	0	0	22	0	22
6059	0	0	23	0	0	23
6060	0	0	0	24	0	24
6061	0	0	24	0	0	24
6062	27	0	0	0	0	27
6063	0	0	0	27	0	27
6064	26	0	0	0	0	26
6065	25	0	0	0	0	25
6066	0	0	0	27	0	27
6067	27	0	0	0	0	27
6068	0	0	0	26	0	26
6069	0	32	0	0	0	32
6070	35	0	0	0	0	35
6071	35	0	0	0	0	35
6072	37	0	0	0	0	37
6073	0	0	0	37	0	37
6074	0	0	0	36	0	36
6075	0	0	0	40	0	40
6076	0	0	40	0	0	40
6077	0	40	0	0	0	40
6078	0	0	0	40	0	40
6079	0	0	41	0	0	41
6080	41	0	0	0	0	41
6081	0	0	0	37	0	37
6082	0	0	38	0	0	38
6083	40	0	0	0	0	40
6084	0	0	0	36	0	36
6085	0	0	0	38	0	38
6086	0	0	0	37	0	37
6087	35	0	0	0	0	35
6088	35	0	0	0	0	35
6089	34	0	0	0	0	34
6090	0	37	0	0	0	37
6091	0	36	0	0	0	36
6092	35	0	0	0	0	35
6093	0	0	33	0	0	33
6094	0	0	0	34	0	34
6095	0	0	0	37	0	37
6096	40	0	0	0	0	40
6097	40	0	0	0	0	40
6098	0	39	0	0	0	39
6099	0	0	0	45	0	45
6100	0	0	43	0	0	43
6101	0	0	44	0	0	44
6102	0	0	0	44	0	44
6103	0	0	0	47	0	47
6104	46	0	0	0	0	46
6105	0	0	0	45	0	45
6106	43	0	0	0	0	43
6107	43	0	0	0	0	43
6108	0	0	44	0	0	44
6109	49	0	0	0	0	49
6110	46	0	0	0	0	46
6111	41	0	0	0	0	41
6112	0	50	0	0	0	50
6113	0	51	0	0	0	51
6114	0	0	0	52	0	52
6115	1	0	49	0	0	50
6116	0	54	0	0	0	54
6117	0	0	0	53	0	53
6118	1	0	0	51	0	52
6119	0	51	0	0	0	51
6120	55	0	0	0	0	55
6121	52	0	0	0	0	52
6122	0	0	52	0	0	52
6123	52	0	0	0	0	52
6124	0	0	52	0	0	52
6125	47	0	0	0	0	47
6126	0	0	46	0	0	46
6127	0	49	0	0	0	49
6128	0	0	0	48	0	48
6129	0	0	0	47	0	47
6130	47	0	0	0	0	47
6131	49	0	0	0	0	49
6132	51	0	0	0	0	51
6133	0	0	51	0	0	51
6134	0	0	0	51	0	51
6135	0	0	0	59	0	59
6136	60	0	0	0	0	60
6137	1	60	0	0	0	61
6138	62	0	0	0	0	62
6139	0	0	0	62	0	62
6140	0	0	0	61	0	61
6141	0	0	0	61	0	61
6142	0	0	0	64	0	64
6143	0	0	0	64	0	64
6144	0	63	0	0	0	63
6145	0	62	0	0	0	62
6146	0	61	0	0	0	61
6147	0	0	0	61	0	61
6148	0	0	61	0	0	61
6149	62	0	0	0	0	62
6150	0	66	0	0	0	66
6151	0	0	0	66	0	66
6152	0	0	0	66	0	66
6153	68	0	0	1	0	69
6154	67	0	0	0	0	67
6155	65	0	0	0	0	65
6156	0	0	0	64	0	64
6157	0	0	66	0	0	66
6158	0	0	62	0	0	62
6159	0	0	0	66	0	66
6160	0	0	64	0	0	64
6161	63	0	0	0	0	63
6162	0	0	0	62	0	62
6163	0	0	57	0	0	57
6164	0	0	0	57	0	57
6165	0	0	57	0	0	57
6166	0	0	54	0	0	54
6167	0	0	0	56	0	56
6168	0	0	52	0	0	52
6169	0	0	50	0	0	50
6170	0	47	0	0	0	47
6171	0	0	0	49	0	49
6172	51	0	0	0	0	51
6173	0	0	0	51	0	51
6174	0	0	0	51	0	51
6175	0	0	51	0	0	51
6176	49	0	0	0	0	49
6177	0	0	0	48	0	48
6178	0	0	0	50	0	50
6179	49	0	0	0	0	49
6180	0	0	0	50	0	50
6181	48	0	0	0	0	48
6182	46	0	0	0	0	46
6183	48	0	0	0	0	48
6184	0	49	0	0	0	49
6185	51	0	0	0	0	51
6186	0	55	0	0	0	55
6187	0	0	0	61	0	61
6188	58	0	0	0	0	58
6189	0	57	0	0	0	57
6190	52	0	0	0	0	52
6191	0	58	0	0	0	58
6192	56	0	0	0	0	56
6193	0	54	0	0	0	54
6194	0	48	0	0	0	48
6195	0	47	0	0	0	47
6196	0	0	0	56	0	56
6197	0	53	0	0	0	53
6198	0	0	0	55	0	55
6199	0	0	0	55	0	55
6200	0	0	0	54	0	54
6201	0	0	0	52	0	52
6202	52	0	0	0	0	52
6203	51	0	0	0	0	51
6204	0	0	51	0	0	51
6205	52	0	0	0	0	52
6206	52	0	0	0	0	52
6207	52	0	0	0	0	52
6208	0	0	48	0	0	48
6209	0	0	44	0	0	44
6210	47	0	0	0	0	47
6211	0	0	53	0	0	53
6212	0	51	0	0	0	51
6213	0	0	0	54	0	54
6214	54	0	0	0	0	54
6215	52	0	0	0	0	52
6216	53	1	0	1	0	55
6217	0	0	0	56	0	56
6218	0	0	0	56	0	56
6219	0	0	56	0	0	56
6220	0	0	0	55	0	55
6221	0	0	0	56	0	56
6222	55	0	0	0	0	55
6223	0	55	0	0	0	55
6224	63	0	0	0	0	63
6225	0	0	0	64	0	64
6226	64	0	0	0	0	64
6227	63	0	0	0	0	63
6228	58	0	0	0	0	58
6229	0	54	0	0	0	54
6230	0	58	0	0	0	58
6231	0	0	0	65	0	65
6232	62	0	0	0	0	62
6233	0	0	0	62	0	62
6234	0	0	0	64	0	64
6235	0	0	64	0	0	64
6236	1	0	0	62	0	63
6237	0	0	0	59	0	59
6238	0	0	0	61	0	61
6239	0	0	62	0	0	62
6240	0	0	57	0	0	57
6241	0	62	0	0	0	62
6242	63	0	0	0	0	63
6243	0	0	0	63	0	63
6244	0	0	59	0	0	59
6245	0	0	0	59	0	59
6246	0	0	0	59	0	59
6247	57	0	0	0	0	57
6248	55	0	0	1	0	56
6249	0	58	0	0	0	58
6250	58	0	0	0	0	58
6251	54	0	0	0	0	54
6252	1	0	0	59	0	60
6253	0	0	58	0	0	58
6254	0	58	0	0	0	58
6255	60	0	0	0	0	60
6256	60	0	0	0	0	60
6257	0	61	0	0	0	61
6258	0	0	0	59	0	59
6259	65	0	0	2	0	67
6260	64	0	0	0	0	64
6261	1	0	0	67	0	68
6262	65	0	0	0	0	65
6263	66	0	0	0	0	66
6264	65	0	0	0	0	65
6265	0	0	68	0	0	68
6266	0	59	0	0	0	59
6267	0	65	0	0	0	65
6268	68	0	0	0	0	68
6269	0	68	0	0	0	68
6270	0	0	69	0	0	69
6271	0	0	0	69	0	69
6272	68	1	0	0	0	69
6273	1	0	0	67	0	68
6274	69	0	0	0	0	69
6275	64	0	0	0	0	64
6276	60	0	0	0	0	60
6277	0	56	0	0	0	56
6278	0	67	0	0	0	67
6279	68	0	0	0	0	68
6280	63	0	0	0	0	63
6281	68	0	0	0	0	68
6282	0	0	0	70	0	70
6283	68	0	0	0	0	68
6284	0	61	0	0	0	61
6285	0	59	0	0	0	59
6286	0	0	0	65	0	65
6287	2	0	62	0	0	64
6288	0	0	61	0	0	61
6289	0	0	0	60	0	60
6290	0	0	65	0	0	65
6291	1	0	0	63	0	64
6292	67	0	0	0	0	67
6293	0	0	0	66	0	66
6294	66	0	0	0	0	66
6295	0	63	0	2	0	65
6296	0	0	65	0	0	65
6297	0	0	0	61	0	61
6298	0	0	0	62	0	62
6299	0	0	60	0	0	60
6300	0	0	0	63	0	63
6301	0	62	0	0	0	62
6302	0	0	0	64	0	64
6303	0	0	0	65	0	65
6304	0	0	0	61	0	61
6305	0	0	64	0	0	64
6306	1	0	52	0	0	53
6307	62	0	0	0	0	62
6308	0	0	60	0	0	60
6309	0	60	0	0	0	60
6310	63	0	0	0	0	63
6311	0	62	0	0	0	62
6312	66	0	0	0	0	66
6313	63	0	0	0	0	63
6314	64	0	1	0	0	65
6315	64	0	0	0	0	64
6316	0	66	0	0	0	66
6317	0	58	0	0	0	58
6318	59	0	0	0	0	59
6319	0	0	60	0	0	60
6320	0	0	0	61	0	61
6321	0	0	0	61	0	61
6322	0	0	60	0	0	60
6323	57	0	0	0	0	57
6324	58	0	0	0	0	58
6325	56	0	0	0	0	56
6326	0	55	0	0	0	55
6327	56	0	0	0	0	56
6328	0	0	0	54	0	54
6329	0	53	0	0	0	53
6330	55	0	0	0	0	55
6331	52	0	0	1	0	53
6332	56	0	0	0	0	56
6333	0	0	0	54	0	54
6334	0	0	0	54	0	54
6335	0	53	0	0	0	53
6336	0	0	60	0	0	60
6337	0	0	0	58	0	58
6338	1	0	0	57	0	58
6339	0	0	0	61	0	61
6340	0	0	60	0	0	60
6341	61	0	0	0	0	61
6342	0	0	0	61	0	61
6343	0	0	60	0	0	60
6344	0	0	0	58	0	58
6345	60	0	0	0	0	60
6346	0	59	0	0	0	59
6347	0	0	0	57	0	57
6348	0	0	57	0	0	57
6349	56	0	0	0	0	56
6350	55	0	0	0	0	55
6351	0	0	57	0	0	57
6352	0	0	0	44	0	44
6353	0	52	0	0	0	52
6354	53	0	0	0	0	53
6355	0	0	52	0	0	52
6356	53	0	0	0	0	53
6357	0	0	53	0	0	53
6358	0	0	47	0	0	47
6359	48	0	0	0	0	48
6360	0	47	0	0	0	47
6361	0	0	49	0	0	49
6362	0	48	0	0	0	48
6363	0	0	48	0	0	48
6364	0	51	0	0	0	51
6365	52	0	0	0	0	52
6366	0	0	48	0	0	48
6367	0	0	52	0	0	52
6368	0	0	53	0	0	53
6369	52	0	0	0	0	52
6370	51	0	0	0	0	51
6371	0	0	0	41	0	41
6372	0	0	42	0	0	42
6373	0	0	40	0	0	40
6374	38	0	0	0	0	38
6375	0	0	0	35	0	35
6376	38	0	0	0	0	38
6377	39	0	0	0	0	39
6378	0	0	0	36	0	36
6379	0	39	0	0	0	39
6380	0	0	0	40	0	40
6381	0	0	0	38	0	38
6382	0	0	36	0	0	36
6383	0	34	0	0	0	34
6384	0	35	0	0	0	35
6385	0	0	0	36	0	36
6386	0	0	35	0	0	35
6387	0	36	0	0	0	36
6388	0	0	37	0	0	37
6389	35	0	0	0	0	35
6390	38	0	0	0	0	38
6391	0	0	36	0	0	36
6392	38	0	0	0	0	38
6393	0	0	0	38	0	38
6394	0	36	0	0	0	36
6395	0	0	0	38	0	38
6396	37	0	0	0	0	37
6397	34	0	0	0	0	34
6398	32	0	0	0	0	32
6399	30	0	0	0	0	30
6400	0	26	0	0	0	26
6401	0	30	0	0	0	30
6402	33	0	0	0	0	33
6403	0	0	37	0	0	37
6404	0	0	0	36	0	36
6405	0	36	0	0	0	36
6406	0	0	0	34	0	34
6407	0	35	0	0	0	35
6408	0	0	0	36	0	36
6409	0	0	33	0	0	33
6410	27	0	0	0	0	27
6411	39	0	0	0	0	39
6412	0	0	43	0	0	43
6413	43	0	0	0	0	43
6414	42	0	0	0	0	42
6415	0	0	42	0	0	42
6416	0	0	0	43	0	43
6417	46	0	0	0	0	46
6418	0	0	47	0	0	47
6419	0	0	0	49	0	49
6420	0	0	50	0	0	50
6421	0	0	45	0	0	45
6422	48	0	0	0	0	48
6423	46	0	0	0	0	46
6424	47	0	0	0	0	47
6425	44	0	0	0	0	44
6426	0	0	0	45	0	45
6427	0	45	0	0	0	45
6428	0	45	0	0	0	45
6429	0	0	0	41	0	41
6430	41	0	0	0	0	41
6431	0	40	0	0	0	40
6432	0	43	0	0	0	43
6433	43	0	0	0	0	43
6434	0	0	0	44	0	44
6435	42	0	0	1	0	43
6436	0	43	0	0	0	43
6437	44	0	0	0	0	44
6438	0	0	43	0	0	43
6439	43	0	0	0	0	43
6440	42	0	0	0	0	42
6441	44	0	0	0	0	44
6442	0	0	36	0	0	36
6443	47	0	0	0	0	47
6444	0	40	1	0	0	41
6445	0	0	46	0	0	46
6446	0	0	0	48	0	48
6447	0	0	0	48	0	48
6448	0	49	0	0	0	49
6449	0	0	0	48	0	48
6450	0	0	0	54	0	54
6451	0	0	53	0	0	53
6452	50	0	0	0	0	50
6453	0	0	52	0	0	52
6454	0	0	0	53	0	53
6455	0	0	53	0	0	53
6456	0	0	0	51	0	51
6457	50	0	0	0	0	50
6458	51	0	0	0	0	51
6459	0	0	0	49	0	49
6460	0	0	51	0	0	51
6461	0	0	0	50	0	50
6462	0	0	48	0	0	48
6463	48	0	0	0	0	48
6464	48	0	0	0	0	48
6465	49	0	0	0	0	49
6466	48	0	0	0	0	48
6467	0	48	0	0	0	48
6468	0	0	0	49	0	49
6469	47	0	0	0	0	47
6470	0	42	0	0	0	42
6471	0	44	0	0	0	44
6472	0	0	45	0	0	45
6473	45	0	0	0	0	45
6474	43	0	0	0	0	43
6475	0	0	45	0	0	45
6476	0	0	0	40	0	40
6477	0	0	0	45	0	45
6478	0	0	44	0	0	44
6479	0	0	0	44	0	44
6480	43	0	0	0	0	43
6481	0	0	42	0	0	42
6482	0	0	39	0	0	39
6483	41	0	0	0	0	41
6484	0	0	43	0	0	43
6485	42	0	0	0	0	42
6486	0	41	0	0	0	41
6487	42	0	0	0	0	42
6488	0	0	0	41	0	41
6489	0	0	0	37	0	37
6490	36	0	0	0	0	36
6491	0	0	0	38	0	38
6492	41	0	0	0	0	41
6493	0	39	0	0	0	39
6494	0	0	0	40	0	40
6495	0	0	0	39	0	39
6496	33	0	0	0	0	33
6497	32	0	0	0	0	32
6498	33	0	0	0	0	33
6499	0	31	0	0	0	31
6500	0	34	0	0	0	34
6501	32	0	0	0	0	32
6502	0	0	32	0	0	32
6503	0	32	0	0	0	32
6504	23	0	0	0	0	23
6505	22	0	0	0	0	22
6506	20	0	0	0	0	20
6507	0	0	0	19	0	19
6508	19	0	0	0	0	19
6509	19	0	0	0	0	19
6510	0	0	0	15	0	15
6511	15	0	0	0	0	15
6512	0	0	13	0	0	13
6513	0	0	0	12	0	12
6514	0	0	0	13	0	13
6515	0	0	0	14	0	14
6516	15	0	0	0	0	15
6517	15	0	0	0	0	15
6518	15	0	0	0	0	15
6519	14	0	0	0	0	14
6520	14	0	0	0	0	14
6521	0	0	0	15	0	15
6522	0	0	0	17	0	17
6523	19	0	0	1	0	20
6524	0	20	0	0	0	20
6525	24	0	0	0	0	24
6526	0	0	23	0	0	23
6527	30	0	0	0	0	30
6528	28	0	0	0	0	28
6529	0	0	29	0	0	29
6530	30	0	0	0	0	30
6531	0	0	27	0	0	27
6532	0	0	28	0	0	28
6533	1	0	0	28	0	29
6534	0	0	0	29	0	29
6535	0	0	30	0	0	30
6536	0	0	29	0	0	29
6537	0	34	0	0	0	34
6538	0	31	0	0	0	31
6539	30	0	0	0	0	30
6540	0	31	0	0	0	31
6541	32	0	0	0	0	32
6542	0	32	0	0	0	32
6543	28	0	0	0	0	28
6544	0	0	32	0	0	32
6545	28	0	0	0	0	28
6546	0	0	0	26	0	26
6547	0	28	0	0	0	28
6548	0	0	0	29	0	29
6549	28	0	0	0	0	28
6550	28	0	0	0	0	28
6551	0	0	0	31	0	31
6552	0	0	30	0	0	30
6553	0	0	27	0	0	27
6554	0	29	0	0	0	29
6555	0	0	0	32	0	32
6556	0	0	32	0	0	32
6557	0	30	0	0	0	30
6558	0	0	0	31	0	31
6559	0	0	0	32	0	32
6560	30	0	0	0	0	30
6561	0	0	0	32	0	32
6562	0	0	33	0	0	33
6563	0	0	0	32	0	32
6564	31	0	0	0	0	31
6565	0	0	32	0	0	32
6566	32	0	0	0	0	32
6567	0	33	0	0	0	33
6568	34	0	0	0	0	34
6569	31	1	0	0	0	32
6570	0	0	0	34	0	34
6571	0	0	0	33	0	33
6572	0	30	0	0	0	30
6573	0	0	0	34	0	34
6574	33	0	0	0	0	33
6575	0	0	32	0	0	32
6576	0	0	0	36	0	36
6577	0	38	0	0	0	38
6578	0	0	0	36	0	36
6579	0	0	0	37	0	37
6580	37	0	0	0	0	37
6581	0	38	0	0	0	38
6582	0	0	0	38	0	38
6583	35	0	0	0	0	35
6584	0	0	0	34	0	34
6585	0	0	0	37	0	37
6586	36	0	0	0	0	36
6587	39	0	0	0	0	39
6588	0	0	39	0	0	39
6589	38	0	0	0	0	38
6590	35	0	0	0	0	35
6591	38	0	0	0	0	38
6592	0	36	0	0	0	36
6593	0	36	0	0	0	36
6594	0	0	0	36	0	36
6595	40	0	0	0	0	40
6596	40	0	0	0	0	40
6597	0	0	0	38	0	38
6598	0	0	39	0	0	39
6599	38	0	0	0	0	38
6600	37	0	0	0	0	37
6601	0	0	0	35	0	35
6602	0	0	0	40	0	40
6603	39	0	0	0	0	39
6604	0	0	0	39	0	39
6605	0	42	0	0	0	42
6606	0	0	0	42	0	42
6607	42	0	0	0	0	42
6608	0	0	38	0	0	38
6609	40	0	0	0	0	40
6610	0	0	39	0	0	39
6611	0	0	0	39	0	39
6612	40	0	0	0	0	40
6613	0	0	0	39	0	39
6614	0	0	0	39	0	39
6615	37	0	0	0	0	37
6616	0	0	35	0	0	35
6617	0	0	34	0	0	34
6618	0	0	0	26	0	26
6619	0	0	0	26	0	26
6620	0	0	0	20	0	20
6621	0	0	19	0	0	19
6622	18	0	0	0	0	18
6623	21	0	0	0	0	21
6624	20	0	0	0	0	20
6625	19	0	0	0	0	19
6626	0	20	0	0	0	20
6627	0	20	0	0	0	20
6628	0	18	0	0	0	18
6629	0	0	0	16	0	16
6630	0	0	0	16	0	16
6631	0	0	16	0	0	16
6632	0	16	0	0	0	16
6633	0	0	0	16	0	16
6634	16	0	0	0	0	16
6635	0	16	0	0	0	16
6636	0	0	0	16	0	16
6637	0	14	0	0	0	14
6638	14	0	0	0	0	14
6639	0	0	0	15	0	15
6640	0	0	14	0	0	14
6641	0	0	12	0	0	12
6642	0	0	0	15	0	15
6643	0	0	0	14	0	14
6644	0	0	0	15	0	15
6645	15	0	0	0	0	15
6646	0	0	13	0	0	13
6647	0	15	0	0	0	15
6648	0	0	0	15	0	15
6649	0	0	15	0	0	15
6650	0	15	0	0	0	15
6651	0	0	0	15	0	15
6652	0	0	13	0	0	13
6653	0	0	0	13	0	13
6654	0	0	0	14	0	14
6655	14	0	0	0	0	14
6656	14	0	0	0	0	14
6657	0	0	0	14	0	14
6658	14	0	0	0	0	14
6659	0	0	17	0	0	17
6660	0	0	0	15	0	15
6661	0	0	15	0	0	15
6662	0	1	0	15	0	16
6663	0	15	0	0	0	15
6664	0	14	1	0	0	15
6665	0	14	0	0	0	14
6666	0	0	0	18	0	18
6667	0	0	0	18	0	18
6668	0	0	18	0	0	18
6669	0	0	13	0	0	13
6670	0	0	13	0	0	13
6671	13	0	0	0	0	13
6672	0	0	0	14	0	14
6673	12	0	0	0	0	12
6674	0	15	0	0	0	15
6675	0	0	0	15	0	15
6676	15	0	0	0	0	15
6677	0	0	0	13	0	13
6678	14	0	0	0	0	14
6679	0	0	11	0	0	11
6680	0	13	0	0	0	13
6681	0	0	0	14	0	14
6682	14	0	0	0	0	14
6683	15	0	0	0	0	15
6684	0	0	0	16	0	16
6685	0	0	0	16	0	16
6686	16	0	0	0	0	16
6687	0	0	0	16	0	16
6688	0	0	14	0	0	14
6689	0	13	0	0	0	13
6690	0	0	0	12	0	12
6691	13	0	0	0	0	13
6692	13	0	0	0	0	13
6693	0	0	12	0	0	12
6694	0	10	0	0	0	10
6695	0	13	0	0	0	13
6696	0	0	1	12	0	13
6697	1	0	0	9	0	10
6698	0	0	0	10	0	10
6699	0	0	0	9	0	9
6700	0	10	0	0	0	10
6701	0	0	0	11	0	11
6702	0	0	0	11	0	11
6703	11	0	0	0	0	11
6704	11	0	0	0	0	11
6705	0	11	0	0	0	11
6706	10	0	0	0	0	10
6707	11	0	0	0	0	11
6708	11	0	0	0	0	11
6709	0	0	11	0	0	11
6710	0	0	0	9	0	9
6711	0	0	0	11	0	11
6712	0	0	11	0	0	11
6713	0	0	0	9	0	9
6714	0	0	0	9	0	9
6715	12	0	0	0	0	12
6716	0	0	11	0	0	11
6717	0	0	0	11	0	11
6718	11	0	0	0	0	11
6719	0	11	0	0	0	11
6720	11	0	0	0	0	11
6721	10	0	0	0	0	10
6722	0	10	0	0	0	10
6723	0	0	0	11	0	11
6724	11	0	0	0	0	11
6725	0	11	0	0	0	11
6726	0	0	0	11	0	11
6727	12	0	0	0	0	12
6728	12	0	0	0	0	12
6729	0	11	0	0	0	11
6730	13	0	0	0	0	13
6731	0	0	0	12	0	12
6732	13	0	0	0	0	13
6733	0	0	12	0	0	12
6734	0	0	0	12	0	12
6735	0	0	0	12	0	12
6736	11	0	0	0	0	11
6737	0	12	0	0	0	12
6738	12	0	0	0	0	12
6739	0	11	0	0	0	11
6740	0	0	12	0	0	12
6741	0	0	13	0	0	13
6742	0	0	0	13	0	13
6743	0	0	13	0	0	13
6744	0	0	0	13	0	13
6745	0	0	0	14	0	14
6746	0	0	0	15	0	15
6747	16	0	0	0	0	16
6748	16	0	0	0	0	16
6749	16	0	0	0	0	16
6750	0	17	0	0	0	17
6751	0	16	0	0	0	16
6752	0	0	15	0	0	15
6753	0	0	0	16	0	16
6754	0	0	17	0	0	17
6755	0	0	0	17	0	17
6756	0	0	0	17	0	17
6757	0	0	0	17	0	17
6758	0	0	19	0	0	19
6759	0	0	0	15	0	15
6760	18	0	0	0	0	18
6761	2	16	0	0	0	18
6762	0	0	0	19	0	19
6763	19	0	0	0	0	19
6764	19	0	0	0	0	19
6765	0	0	0	20	0	20
6766	0	0	0	20	0	20
6767	19	0	0	0	0	19
6768	0	0	0	16	0	16
6769	17	0	0	0	0	17
6770	0	0	0	19	0	19
6771	0	0	19	0	0	19
6772	0	16	0	0	0	16
6773	0	21	0	0	0	21
6774	0	0	0	19	0	19
6775	0	0	0	22	0	22
6776	23	0	0	0	0	23
6777	0	0	0	23	0	23
6778	0	0	0	22	0	22
6779	0	0	0	23	0	23
6780	0	24	0	0	0	24
6781	0	0	0	24	0	24
6782	0	0	0	26	0	26
6783	0	0	0	26	0	26
6784	23	0	0	0	0	23
6785	0	24	0	0	0	24
6786	0	0	0	26	0	26
6787	0	0	0	24	0	24
6788	0	0	0	25	0	25
6789	25	0	0	0	0	25
6790	0	0	0	26	0	26
6791	0	0	0	26	0	26
6792	0	0	26	0	0	26
6793	0	25	0	0	0	25
6794	0	0	0	25	0	25
6795	23	0	0	1	0	24
6796	0	25	0	0	0	25
6797	25	0	0	0	0	25
6798	24	0	0	0	0	24
6799	0	0	0	25	0	25
6800	0	0	0	24	0	24
6801	1	0	26	0	0	27
6802	0	0	0	27	0	27
6803	0	0	28	0	0	28
6804	0	0	0	28	0	28
6805	27	0	0	0	0	27
6806	0	29	0	0	0	29
6807	0	0	0	32	0	32
6808	0	0	0	33	0	33
6809	0	0	0	32	0	32
6810	0	0	0	33	0	33
6811	34	0	0	0	0	34
6812	0	34	0	0	0	34
6813	0	0	0	36	0	36
6814	35	0	0	0	0	35
6815	0	0	33	0	0	33
6816	36	0	0	0	0	36
6817	36	0	0	0	0	36
6818	0	0	36	0	0	36
6819	0	0	0	38	0	38
6820	37	0	0	0	0	37
6821	0	38	0	0	0	38
6822	36	0	0	0	0	36
6823	37	0	0	0	0	37
6824	33	0	0	0	0	33
6825	0	0	0	35	0	35
6826	0	0	0	36	0	36
6827	0	37	0	0	0	37
6828	0	0	0	36	0	36
6829	38	0	0	0	0	38
6830	0	0	37	0	0	37
6831	38	0	0	0	0	38
6832	39	0	0	0	0	39
6833	0	0	0	37	0	37
6834	0	0	0	39	0	39
6835	40	0	0	0	0	40
6836	39	0	0	0	0	39
6837	37	0	0	0	0	37
6838	0	0	37	0	0	37
6839	0	38	0	0	0	38
6840	38	0	0	0	0	38
6841	0	0	0	36	0	36
6842	0	36	0	0	0	36
6843	0	0	0	37	0	37
6844	37	0	1	0	0	38
6845	0	0	0	38	0	38
6846	0	0	36	0	0	36
6847	0	33	0	1	0	34
6848	0	36	0	0	0	36
6849	0	0	36	0	0	36
6850	37	0	0	0	0	37
6851	0	39	0	0	0	39
6852	0	0	0	41	0	41
6853	36	0	0	0	0	36
6854	0	34	0	0	0	34
6855	0	0	0	37	0	37
6856	34	0	0	0	0	34
6857	0	0	0	37	0	37
6858	35	0	0	0	0	35
6859	0	0	35	0	0	35
6860	0	37	0	0	0	37
6861	37	0	0	0	0	37
6862	34	0	0	0	0	34
6863	32	0	0	0	0	32
6864	0	0	33	0	0	33
6865	36	0	0	0	0	36
6866	35	0	0	0	0	35
6867	0	0	0	35	0	35
6868	37	0	0	0	0	37
6869	0	33	0	0	0	33
6870	0	0	0	37	0	37
6871	0	0	38	0	0	38
6872	0	0	0	34	0	34
6873	0	0	0	36	0	36
6874	36	0	0	0	0	36
6875	35	0	0	0	0	35
6876	0	0	37	0	0	37
6877	34	0	0	0	0	34
6878	0	0	38	0	0	38
6879	0	0	0	38	0	38
6880	0	0	37	0	0	37
6881	0	0	0	39	0	39
6882	0	35	0	0	0	35
6883	0	0	34	0	0	34
6884	0	0	35	0	0	35
6885	0	0	0	35	0	35
6886	35	0	0	0	0	35
6887	39	0	0	0	0	39
6888	40	0	0	0	0	40
6889	0	0	0	40	0	40
6890	0	0	0	39	0	39
6891	0	0	0	38	0	38
6892	0	0	0	38	0	38
6893	0	0	39	0	0	39
6894	0	0	0	38	0	38
6895	0	35	0	0	0	35
6896	0	0	0	36	0	36
6897	37	0	0	0	0	37
6898	0	0	37	0	0	37
6899	37	0	0	0	0	37
6900	0	0	31	0	0	31
6901	0	0	30	0	0	30
6902	0	32	0	0	0	32
6903	0	0	0	32	0	32
6904	0	0	0	30	0	30
6905	0	28	1	0	0	29
6906	33	0	0	0	0	33
6907	0	0	0	30	0	30
6908	0	0	0	30	0	30
6909	0	0	0	34	0	34
6910	33	0	0	0	0	33
6911	33	0	0	0	0	33
6912	0	0	0	31	0	31
6913	0	0	0	32	0	32
6914	30	0	0	0	0	30
6915	0	0	0	29	0	29
6916	0	0	0	30	0	30
6917	0	0	0	31	0	31
6918	0	0	29	0	0	29
6919	28	0	0	0	0	28
6920	28	0	0	0	0	28
6921	0	0	27	0	0	27
6922	0	0	0	28	0	28
6923	0	24	0	0	0	24
6924	25	0	0	0	0	25
6925	0	22	0	0	0	22
6926	0	26	0	0	0	26
6927	0	0	0	28	0	28
6928	26	0	0	0	0	26
6929	27	0	0	0	0	27
6930	0	0	0	26	0	26
6931	0	0	0	29	0	29
6932	0	0	0	28	0	28
6933	0	0	0	28	0	28
6934	0	0	0	29	0	29
6935	0	29	0	0	0	29
6936	0	0	0	36	0	36
6937	36	0	0	0	0	36
6938	35	0	0	0	0	35
6939	37	0	0	0	0	37
6940	0	38	0	0	0	38
6941	0	0	0	40	0	40
6942	0	0	37	0	0	37
6943	37	0	0	0	0	37
6944	0	0	0	36	0	36
6945	39	0	0	0	0	39
6946	38	0	0	0	0	38
6947	39	0	0	0	0	39
6948	0	0	0	38	0	38
6949	37	0	0	0	0	37
6950	0	0	0	39	0	39
6951	0	0	0	41	0	41
6952	39	0	0	0	0	39
6953	1	0	0	40	0	41
6954	41	0	0	0	0	41
6955	37	0	0	0	0	37
6956	0	0	0	42	0	42
6957	0	0	0	42	0	42
6958	0	0	0	39	0	39
6959	0	0	41	0	0	41
6960	0	0	33	0	0	33
6961	0	0	0	36	0	36
6962	0	0	0	34	0	34
6963	0	0	0	35	0	35
6964	0	0	0	38	0	38
6965	0	0	0	36	0	36
6966	36	0	0	0	0	36
6967	0	41	0	1	0	42
6968	0	0	0	50	0	50
6969	49	0	0	0	0	49
6970	0	0	0	47	0	47
6971	0	0	0	47	0	47
6972	44	0	0	0	0	44
6973	42	0	0	0	0	42
6974	0	0	48	0	0	48
6975	0	0	0	45	0	45
6976	0	0	48	0	0	48
6977	0	0	0	50	0	50
6978	0	0	0	48	0	48
6979	0	0	0	50	0	50
6980	0	0	45	0	0	45
6981	0	44	0	2	0	46
6982	0	39	0	0	0	39
6983	0	0	0	47	0	47
6984	46	0	0	0	0	46
6985	0	0	44	0	0	44
6986	0	0	42	0	0	42
6987	0	0	0	45	0	45
6988	0	0	0	45	0	45
6989	0	48	0	0	0	48
6990	0	0	0	48	0	48
6991	0	0	0	44	0	44
6992	0	0	0	47	0	47
6993	46	0	0	0	0	46
6994	46	0	0	0	0	46
6995	0	0	0	51	0	51
6996	0	50	0	0	0	50
6997	0	0	0	50	0	50
6998	45	0	0	0	0	45
6999	0	48	0	0	0	48
7000	0	0	0	49	0	49
7001	0	45	0	0	0	45
7002	47	0	0	0	0	47
7003	39	0	0	0	0	39
7004	0	47	0	0	0	47
7005	0	48	0	1	0	49
7006	0	0	47	0	0	47
7007	0	48	0	0	0	48
7008	0	0	0	54	0	54
7009	0	0	52	0	0	52
7010	0	52	0	0	0	52
7011	0	0	0	54	0	54
7012	0	0	0	52	0	52
7013	0	0	0	53	0	53
7014	53	0	0	0	0	53
7015	0	0	52	0	0	52
7016	0	0	45	1	0	46
7017	0	0	0	53	0	53
7018	0	0	54	0	0	54
7019	0	0	0	54	0	54
7020	0	0	0	58	0	58
7021	0	0	0	58	0	58
7022	0	0	0	60	0	60
7023	58	0	0	0	0	58
7024	60	0	0	0	0	60
7025	0	0	0	66	0	66
7026	0	1	69	0	0	70
7027	0	0	0	70	0	70
7028	0	65	0	0	0	65
7029	0	0	0	63	0	63
7030	66	0	0	0	0	66
7031	59	0	0	0	0	59
7032	0	0	1	58	0	59
7033	0	0	0	61	0	61
7034	0	0	0	58	0	58
7035	59	1	0	0	0	60
7036	0	0	54	0	0	54
7037	0	0	56	0	0	56
7038	0	56	0	0	0	56
7039	56	0	0	0	0	56
7040	1	1	0	54	0	56
7041	0	0	55	0	0	55
7042	0	49	0	0	0	49
7043	0	50	0	0	0	50
7044	0	0	0	56	0	56
7045	0	0	0	53	0	53
7046	0	54	0	0	0	54
7047	0	0	0	54	0	54
7048	0	0	0	49	0	49
7049	50	0	0	1	0	51
7050	0	49	0	0	0	49
7051	0	0	0	52	0	52
7052	0	0	51	0	0	51
7053	0	0	0	50	0	50
7054	51	0	0	0	0	51
7055	0	49	0	0	0	49
7056	0	0	0	52	0	52
7057	0	0	47	0	0	47
7058	0	0	47	0	0	47
7059	0	0	0	52	0	52
7060	0	0	0	45	0	45
7061	40	0	0	0	0	40
7062	0	39	0	0	0	39
7063	40	0	0	0	0	40
7064	0	0	38	0	0	38
7065	36	0	0	0	0	36
7066	0	0	36	0	0	36
7067	36	0	0	0	0	36
7068	34	0	0	0	0	34
7069	0	0	31	0	0	31
7070	0	0	34	0	0	34
7071	0	33	0	0	0	33
7072	0	0	0	37	0	37
7073	34	1	0	0	0	35
7074	0	0	0	38	0	38
7075	0	0	0	37	0	37
7076	0	0	0	39	0	39
7077	0	0	41	0	0	41
7078	39	0	0	0	0	39
7079	41	0	0	0	0	41
7080	0	38	0	0	0	38
7081	0	0	0	42	0	42
7082	0	39	0	0	0	39
7083	0	0	0	39	0	39
7084	35	0	0	0	0	35
7085	0	37	0	0	0	37
7086	0	0	0	38	0	38
7087	39	0	0	0	0	39
7088	36	0	0	0	0	36
7089	0	2	0	36	0	38
7090	0	0	32	0	0	32
7091	0	0	2	32	0	34
7092	0	35	0	0	0	35
7093	36	0	0	0	0	36
7094	0	37	0	0	0	37
7095	0	0	0	34	0	34
7096	36	0	0	0	0	36
7097	0	0	0	36	0	36
7098	0	0	0	36	0	36
7099	0	0	34	0	0	34
7100	0	33	0	0	0	33
7101	33	0	0	0	0	33
7102	32	0	0	0	0	32
7103	0	29	0	0	0	29
7104	0	31	0	0	0	31
7105	0	0	0	35	0	35
7106	34	0	0	0	0	34
7107	0	33	0	0	0	33
7108	0	0	0	33	0	33
7109	0	0	31	0	0	31
7110	0	0	0	33	0	33
7111	31	0	0	1	0	32
7112	0	29	0	0	0	29
7113	0	0	0	27	0	27
7114	0	0	27	0	0	27
7115	0	0	22	0	0	22
7116	0	0	0	25	0	25
7117	0	0	0	28	0	28
7118	0	21	0	0	0	21
7119	0	0	0	23	0	23
7120	23	0	0	0	0	23
7121	0	0	0	22	0	22
7122	23	0	0	0	0	23
7123	0	17	0	0	0	17
7124	0	19	0	0	0	19
7125	0	0	0	20	0	20
7126	0	0	0	20	0	20
7127	0	0	21	0	0	21
7128	0	0	0	20	0	20
7129	21	0	0	0	0	21
7130	0	0	20	0	0	20
7131	0	0	0	18	0	18
7132	0	0	20	0	0	20
7133	0	0	0	18	0	18
7134	0	0	0	20	0	20
7135	0	0	0	21	0	21
7136	0	0	18	0	0	18
7137	0	0	0	21	0	21
7138	0	21	0	0	0	21
7139	0	0	0	22	0	22
7140	0	0	0	23	0	23
7141	23	0	0	0	0	23
7142	0	0	22	0	0	22
7143	0	0	0	21	0	21
7144	0	0	23	0	0	23
7145	0	0	22	0	0	22
7146	0	0	0	23	0	23
7147	0	0	0	24	0	24
7148	0	0	0	20	0	20
7149	20	0	0	0	0	20
7150	0	0	19	0	0	19
7151	16	0	0	0	0	16
7152	0	0	0	18	0	18
7153	0	0	0	17	0	17
7154	0	21	0	0	0	21
7155	0	0	0	21	0	21
7156	0	0	0	22	0	22
7157	0	0	0	27	0	27
7158	31	0	0	0	0	31
7159	0	0	30	0	0	30
7160	30	0	0	0	0	30
7161	0	28	0	0	0	28
7162	31	0	0	0	0	31
7163	0	28	0	0	0	28
7164	1	27	0	0	0	28
7165	0	0	0	32	0	32
7166	31	0	0	0	0	31
7167	0	0	0	30	0	30
7168	0	26	0	0	0	26
7169	0	31	0	0	0	31
7170	0	0	0	29	0	29
7171	0	0	0	25	0	25
7172	0	26	0	0	0	26
7173	0	0	0	28	0	28
7174	0	0	0	28	0	28
7175	1	0	0	26	0	27
7176	28	0	0	0	0	28
7177	0	0	28	0	0	28
7178	29	0	0	0	0	29
7179	28	0	0	0	0	28
7180	28	0	0	0	0	28
7181	0	29	0	0	0	29
7182	0	0	0	28	0	28
7183	28	0	0	0	0	28
7184	0	0	0	28	0	28
7185	27	0	0	0	0	27
7186	0	30	0	0	0	30
7187	29	0	0	0	0	29
7188	28	0	0	0	0	28
7189	29	0	0	0	0	29
7190	0	0	0	32	0	32
7191	0	0	0	29	0	29
7192	31	0	0	0	0	31
7193	0	26	0	0	0	26
7194	0	32	0	0	0	32
7195	31	0	0	0	0	31
7196	0	0	0	32	0	32
7197	0	0	0	31	0	31
7198	0	0	0	33	0	33
7199	0	33	0	0	0	33
7200	33	0	0	0	0	33
7201	0	0	0	36	0	36
7202	0	36	0	0	0	36
7203	0	0	0	37	0	37
7204	0	0	0	35	0	35
7205	0	0	0	36	0	36
7206	0	0	0	37	0	37
7207	36	0	0	0	0	36
7208	36	0	0	0	0	36
7209	33	0	0	0	0	33
7210	0	0	0	32	0	32
7211	0	0	32	0	0	32
7212	0	0	32	0	0	32
7213	0	0	33	0	0	33
7214	33	0	0	0	0	33
7215	0	0	0	38	0	38
7216	0	0	0	34	0	34
7217	0	0	0	39	0	39
7218	39	0	0	0	0	39
7219	38	0	0	0	0	38
7220	0	38	0	0	0	38
7221	0	0	0	39	0	39
7222	0	0	35	0	0	35
7223	0	37	0	0	0	37
7224	0	0	0	38	0	38
7225	0	0	0	38	0	38
7226	0	0	0	38	0	38
7227	0	0	0	38	0	38
7228	0	0	38	0	0	38
7229	0	0	37	0	0	37
7230	0	38	0	0	0	38
7231	0	0	0	37	0	37
7232	0	0	0	38	0	38
7233	38	0	0	0	0	38
7234	0	0	40	0	0	40
7235	0	0	0	38	0	38
7236	0	0	0	40	0	40
7237	0	0	39	0	0	39
7238	0	39	0	0	0	39
7239	40	0	0	0	0	40
7240	0	0	39	0	0	39
7241	39	0	0	0	0	39
7242	0	0	37	0	0	37
7243	0	0	0	39	0	39
7244	0	0	45	0	0	45
7245	0	0	43	0	0	43
7246	0	0	0	43	0	43
7247	0	0	0	38	0	38
7248	0	0	0	39	0	39
7249	0	0	0	39	0	39
7250	0	0	0	35	0	35
7251	0	0	30	0	0	30
7252	0	0	28	0	0	28
7253	0	29	0	0	0	29
7254	29	0	0	1	0	30
7255	0	0	0	30	0	30
7256	29	0	0	0	0	29
7257	0	0	0	28	0	28
7258	30	0	0	0	0	30
7259	0	0	0	29	0	29
7260	0	0	0	30	0	30
7261	0	31	0	0	0	31
7262	0	0	0	31	0	31
7263	0	0	0	37	0	37
7264	0	0	0	36	0	36
7265	0	0	0	39	0	39
7266	0	36	0	0	0	36
7267	36	0	0	0	0	36
7268	0	38	0	0	0	38
7269	0	0	0	40	0	40
7270	40	0	0	0	0	40
7271	0	0	36	0	0	36
7272	0	0	39	0	0	39
7273	0	0	0	38	0	38
7274	0	0	0	40	0	40
7275	0	0	0	35	0	35
7276	0	0	0	40	0	40
7277	0	0	0	37	0	37
7278	0	42	0	0	0	42
7279	0	0	0	38	0	38
7280	36	0	0	0	0	36
7281	0	0	0	40	0	40
7282	0	0	38	0	0	38
7283	0	0	0	41	0	41
7284	37	0	0	0	0	37
7285	0	37	1	0	0	38
7286	0	0	0	41	0	41
7287	0	0	0	45	0	45
7288	0	0	46	0	0	46
7289	0	0	42	0	0	42
7290	42	0	0	0	0	42
7291	0	0	1	42	0	43
7292	0	0	0	42	0	42
7293	0	0	42	0	0	42
7294	0	0	40	0	0	40
7295	0	42	0	0	0	42
7296	0	1	0	44	0	45
7297	0	0	42	0	0	42
7298	0	44	0	0	0	44
7299	45	0	0	0	0	45
7300	42	0	0	0	0	42
7301	0	0	0	47	0	47
7302	0	47	0	0	0	47
7303	47	0	0	0	0	47
7304	0	0	0	47	0	47
7305	0	0	45	0	0	45
7306	0	44	0	0	0	44
7307	46	0	0	0	0	46
7308	39	0	0	0	0	39
7309	0	0	0	42	0	42
7310	0	0	0	43	0	43
7311	0	0	47	0	0	47
7312	0	0	0	48	0	48
7313	1	0	0	48	0	49
7314	0	0	0	49	0	49
7315	0	0	0	48	0	48
7316	0	0	0	49	0	49
7317	0	48	0	0	0	48
7318	44	0	0	0	0	44
7319	0	0	46	0	0	46
7320	0	49	0	0	0	49
7321	0	0	0	48	0	48
7322	46	0	0	0	0	46
7323	0	0	0	50	0	50
7324	0	0	0	49	0	49
7325	0	0	0	48	0	48
7326	0	0	0	50	0	50
7327	0	0	47	0	0	47
7328	0	47	0	0	0	47
7329	45	0	0	0	0	45
7330	0	0	48	0	0	48
7331	0	0	0	50	0	50
7332	47	0	0	0	0	47
7333	0	49	0	0	0	49
7334	49	0	0	0	0	49
7335	0	0	0	49	0	49
7336	0	0	0	49	0	49
7337	0	0	0	42	0	42
7338	0	0	0	43	0	43
7339	43	0	0	0	0	43
7340	0	0	0	43	0	43
7341	0	0	0	45	0	45
7342	44	0	0	0	0	44
7343	0	0	46	0	0	46
7344	0	0	0	46	0	46
7345	46	0	0	0	0	46
7346	46	0	0	0	0	46
7347	0	0	0	44	0	44
7348	0	0	0	45	0	45
7349	0	45	0	0	0	45
7350	0	0	0	46	0	46
7351	0	0	0	46	0	46
7352	0	0	45	0	0	45
7353	0	0	40	0	0	40
7354	0	44	1	0	0	45
7355	0	0	0	45	0	45
7356	0	0	0	39	0	39
7357	39	0	0	0	0	39
7358	0	0	0	38	0	38
7359	0	0	37	0	0	37
7360	0	0	0	38	0	38
7361	0	0	37	0	0	37
7362	0	0	37	0	0	37
7363	0	0	0	38	0	38
7364	0	0	0	36	0	36
7365	40	0	0	0	0	40
7366	40	0	0	0	0	40
7367	0	0	0	39	0	39
7368	39	0	0	0	0	39
7369	35	0	0	0	0	35
7370	0	0	0	38	0	38
7371	0	0	0	35	0	35
7372	35	0	0	0	0	35
7373	35	0	0	0	0	35
7374	0	0	0	32	0	32
7375	0	30	1	0	0	31
7376	0	0	0	31	0	31
7377	0	0	0	31	0	31
7378	0	0	34	0	0	34
7379	0	0	0	33	0	33
7380	29	0	0	0	0	29
7381	0	29	0	0	0	29
7382	28	0	0	0	0	28
7383	34	0	0	0	0	34
7384	35	0	0	0	0	35
7385	0	0	0	36	0	36
7386	0	0	34	0	0	34
7387	0	0	33	0	0	33
7388	0	36	0	0	0	36
7389	0	31	0	1	0	32
7390	0	34	0	1	0	35
7391	0	34	0	0	0	34
7392	0	0	33	0	0	33
7393	35	0	0	0	0	35
7394	0	0	0	35	0	35
7395	0	0	0	35	0	35
7396	0	0	0	33	0	33
7397	0	32	0	0	0	32
7398	34	0	1	0	0	35
7399	0	0	35	0	0	35
7400	0	32	0	1	0	33
7401	0	0	0	31	0	31
7402	31	0	0	0	0	31
7403	0	1	0	32	0	33
7404	0	0	23	0	0	23
7405	0	0	25	0	0	25
7406	0	0	1	23	0	24
7407	0	0	0	23	0	23
7408	25	0	0	0	0	25
7409	0	0	25	0	0	25
7410	25	0	0	0	0	25
7411	25	0	0	0	0	25
7412	0	0	0	25	0	25
7413	0	0	24	0	0	24
7414	0	0	0	24	0	24
7415	24	0	0	0	0	24
7416	0	24	0	0	0	24
7417	24	0	0	0	0	24
7418	0	0	0	25	0	25
7419	0	24	0	0	0	24
7420	0	0	0	25	0	25
7421	0	0	0	25	0	25
7422	0	28	0	0	0	28
7423	0	0	0	30	0	30
7424	0	0	0	29	0	29
7425	0	0	0	29	0	29
7426	0	0	32	0	0	32
7427	0	32	0	0	0	32
7428	33	0	0	0	0	33
7429	0	0	0	33	0	33
7430	0	32	0	0	0	32
7431	32	0	0	0	0	32
7432	0	0	0	32	0	32
7433	0	0	0	33	0	33
7434	0	0	0	29	0	29
7435	0	0	0	29	0	29
7436	32	0	0	0	0	32
7437	0	0	0	32	0	32
7438	0	0	0	30	0	30
7439	30	0	0	0	0	30
7440	0	0	0	31	0	31
7441	0	0	30	0	0	30
7442	0	0	0	31	0	31
7443	30	0	0	0	0	30
7444	0	0	0	33	0	33
7445	0	0	33	0	0	33
7446	0	0	31	0	0	31
7447	31	0	0	0	0	31
7448	33	0	0	0	0	33
7449	34	0	0	0	0	34
7450	35	0	1	0	0	36
7451	0	0	37	0	0	37
7452	0	0	0	38	0	38
7453	0	0	0	34	0	34
7454	38	0	0	0	0	38
7455	0	0	0	38	0	38
7456	0	0	37	0	0	37
7457	0	0	0	38	0	38
7458	0	0	32	0	0	32
7459	0	36	0	0	0	36
7460	37	0	0	0	0	37
7461	0	0	0	42	0	42
7462	0	0	39	0	0	39
7463	0	0	0	42	0	42
7464	0	0	0	41	0	41
7465	0	0	36	0	0	36
7466	0	0	0	38	0	38
7467	39	0	0	0	0	39
7468	0	0	37	0	0	37
7469	36	0	0	0	0	36
7470	0	38	0	0	0	38
7471	0	0	35	0	0	35
7472	0	0	38	0	0	38
7473	0	0	0	34	0	34
7474	0	0	0	34	0	34
7475	0	0	34	0	0	34
7476	0	0	0	29	0	29
7477	28	0	0	0	0	28
7478	25	0	0	1	0	26
7479	0	0	0	27	0	27
7480	0	0	0	29	0	29
7481	0	29	0	0	0	29
7482	27	0	0	0	0	27
7483	0	0	0	27	0	27
7484	0	28	0	0	0	28
7485	28	0	0	0	0	28
7486	27	0	0	0	0	27
7487	0	31	0	0	0	31
7488	0	0	0	36	0	36
7489	0	0	0	36	0	36
7490	0	0	35	0	0	35
7491	0	0	0	36	0	36
7492	37	0	0	0	0	37
7493	0	0	0	37	0	37
7494	0	0	37	0	0	37
7495	37	0	0	0	0	37
7496	0	0	0	40	0	40
7497	0	0	42	0	0	42
7498	0	0	0	41	0	41
7499	0	0	41	0	0	41
7500	0	0	0	40	0	40
7501	0	0	0	41	0	41
7502	42	0	0	0	0	42
7503	0	41	0	0	0	41
7504	42	0	0	0	0	42
7505	42	0	0	0	0	42
7506	41	0	0	0	0	41
7507	0	42	0	0	0	42
7508	0	0	42	0	0	42
7509	0	0	0	40	0	40
7510	42	0	0	0	0	42
7511	44	0	0	0	0	44
7512	0	0	0	43	0	43
7513	43	0	0	0	0	43
7514	0	0	41	0	0	41
7515	39	0	0	0	0	39
7516	0	0	40	0	0	40
7517	0	39	0	0	0	39
7518	40	0	0	0	0	40
7519	36	0	0	0	0	36
7520	0	37	0	0	0	37
7521	37	0	0	0	0	37
7522	36	0	0	0	0	36
7523	0	1	36	0	0	37
7524	35	0	0	0	0	35
7525	0	0	36	0	0	36
7526	0	2	0	35	0	37
7527	0	43	0	0	0	43
7528	0	0	44	0	0	44
7529	32	0	0	0	0	32
7530	42	0	0	0	0	42
7531	0	0	0	41	0	41
7532	0	0	41	0	0	41
7533	0	0	0	41	0	41
7534	43	0	0	0	0	43
7535	0	41	0	0	0	41
7536	43	0	0	0	0	43
7537	40	0	0	0	0	40
7538	0	42	0	0	0	42
7539	0	0	0	44	0	44
7540	44	0	0	0	0	44
7541	0	0	0	40	0	40
7542	0	0	0	41	0	41
7543	0	0	40	0	0	40
7544	0	0	0	36	0	36
7545	0	0	0	38	0	38
7546	36	0	0	1	0	37
7547	39	0	0	0	0	39
7548	0	0	0	37	0	37
7549	0	0	39	0	0	39
7550	0	1	36	0	0	37
7551	0	0	0	42	0	42
7552	0	0	43	0	0	43
7553	0	0	0	41	0	41
7554	0	0	0	40	0	40
7555	43	0	0	0	0	43
7556	0	0	40	0	0	40
7557	36	0	0	0	0	36
7558	38	0	0	0	0	38
7559	0	0	37	0	0	37
7560	0	0	37	0	0	37
7561	0	0	0	37	0	37
7562	1	37	0	0	0	38
7563	0	38	0	0	0	38
7564	0	0	0	39	0	39
7565	0	0	0	39	0	39
7566	0	0	0	38	0	38
7567	0	0	0	41	0	41
7568	39	0	0	0	0	39
7569	0	0	0	41	0	41
7570	0	0	41	0	0	41
7571	0	0	0	40	0	40
7572	0	38	0	0	0	38
7573	0	0	0	38	0	38
7574	38	0	0	0	0	38
7575	0	0	0	46	0	46
7576	0	0	46	0	0	46
7577	0	46	0	0	0	46
7578	0	0	0	47	0	47
7579	47	0	0	0	0	47
7580	44	0	0	0	0	44
7581	0	0	0	39	0	39
7582	0	0	38	0	0	38
7583	0	0	35	0	0	35
7584	39	0	0	0	0	39
7585	0	0	35	0	0	35
7586	0	0	37	0	0	37
7587	0	0	0	37	0	37
7588	43	0	0	0	0	43
7589	36	0	0	0	0	36
7590	38	0	0	0	0	38
7591	0	0	37	0	0	37
7592	0	0	33	0	0	33
7593	0	41	0	0	0	41
7594	0	0	0	47	0	47
7595	0	0	0	46	0	46
7596	0	0	0	46	0	46
7597	0	0	0	46	0	46
7598	0	0	49	0	0	49
7599	0	51	0	0	0	51
7600	52	0	0	0	0	52
7601	51	0	0	0	0	51
7602	52	0	0	0	0	52
7603	0	52	0	0	0	52
7604	0	0	0	52	0	52
7605	53	0	0	0	0	53
7606	0	52	0	0	0	52
7607	54	0	0	0	0	54
7608	0	54	0	0	0	54
7609	54	0	0	0	0	54
7610	54	0	0	0	0	54
7611	0	0	0	54	0	54
7612	0	0	0	52	0	52
7613	0	0	53	0	0	53
7614	0	0	52	0	0	52
7615	54	0	0	0	0	54
7616	54	0	0	0	0	54
7617	0	0	0	55	0	55
7618	0	0	0	55	0	55
7619	0	0	56	0	0	56
7620	0	0	0	55	0	55
7621	0	0	54	1	0	55
7622	0	0	0	54	0	54
7623	0	0	0	50	0	50
7624	52	0	0	0	0	52
7625	54	0	0	0	0	54
7626	0	0	0	52	0	52
7627	0	0	0	52	0	52
7628	0	0	53	0	0	53
7629	0	0	0	51	0	51
7630	0	0	54	0	0	54
7631	54	0	0	0	0	54
7632	0	0	0	51	0	51
7633	52	0	0	0	0	52
7634	0	52	0	0	0	52
7635	51	0	0	0	0	51
7636	0	0	0	52	0	52
7637	0	0	0	54	0	54
7638	0	60	0	0	0	60
7639	0	0	0	58	0	58
7640	0	0	60	0	0	60
7641	0	0	0	59	0	59
7642	0	0	61	0	0	61
7643	0	55	0	0	0	55
7644	0	0	0	57	0	57
7645	0	0	56	0	0	56
7646	0	0	55	0	0	55
7647	0	0	0	60	0	60
7648	60	0	0	0	0	60
7649	0	0	60	0	0	60
7650	0	0	0	60	0	60
7651	60	0	0	0	0	60
7652	0	64	0	0	0	64
7653	64	0	0	0	0	64
7654	0	0	0	63	0	63
7655	0	0	0	62	0	62
7656	0	0	0	63	0	63
7657	61	0	0	0	0	61
7658	0	0	0	63	0	63
7659	0	0	0	61	0	61
7660	63	0	0	0	0	63
7661	0	0	63	0	0	63
7662	0	0	0	64	0	64
7663	0	0	64	0	0	64
7664	63	0	0	0	0	63
7665	0	0	0	63	0	63
7666	0	0	64	0	0	64
7667	64	0	0	0	0	64
7668	55	0	0	0	0	55
7669	0	0	58	0	0	58
7670	0	0	0	58	0	58
7671	2	0	0	63	0	65
7672	1	0	71	0	0	72
7673	0	70	0	0	0	70
7674	0	2	67	0	0	69
7675	74	0	0	0	0	74
7676	1	0	76	0	0	77
7677	76	0	0	0	0	76
7678	0	0	72	0	0	72
7679	74	0	0	0	0	74
7680	0	73	0	0	0	73
7681	0	0	0	71	0	71
7682	0	3	0	72	0	75
7683	0	0	72	0	0	72
7684	0	0	3	69	0	72
7685	0	71	0	0	0	71
7686	66	0	0	0	0	66
7687	0	69	0	0	0	69
7688	0	0	0	63	0	63
7689	62	0	0	0	0	62
7690	0	64	0	0	0	64
7691	61	0	0	0	0	61
7692	0	0	62	0	0	62
7693	0	0	0	63	0	63
7694	0	0	0	62	0	62
7695	0	0	0	60	0	60
7696	61	0	0	0	0	61
7697	61	0	0	0	0	61
7698	61	0	0	0	0	61
7699	60	0	0	0	0	60
7700	0	0	61	0	0	61
7701	59	0	0	0	0	59
7702	0	60	0	0	0	60
7703	0	58	0	0	0	58
7704	66	0	0	0	0	66
7705	70	0	0	0	0	70
7706	0	0	0	70	0	70
7707	75	0	0	0	0	75
7708	72	0	0	0	0	72
7709	74	0	0	0	0	74
7710	0	0	0	74	0	74
7711	0	72	0	1	0	73
7712	0	74	0	0	0	74
7713	0	0	0	77	0	77
7714	75	0	0	0	0	75
7715	0	74	0	0	0	74
7716	1	0	0	76	0	77
7717	0	0	76	0	0	76
7718	69	0	0	0	0	69
7719	0	70	0	0	0	70
7720	0	76	0	0	0	76
7721	77	0	0	0	0	77
7722	0	0	74	0	0	74
7723	0	0	0	72	0	72
7724	0	73	0	0	0	73
7725	0	0	0	75	0	75
7726	0	0	0	72	0	72
7727	0	66	0	0	0	66
7728	0	0	0	73	0	73
7729	0	0	0	73	0	73
7730	71	0	0	0	0	71
7731	0	64	0	0	0	64
7732	65	0	0	0	0	65
7733	0	0	0	62	0	62
7734	0	61	0	0	0	61
7735	0	0	59	0	0	59
7736	0	0	0	61	0	61
7737	0	0	0	63	0	63
7738	0	0	60	0	0	60
7739	61	0	0	0	0	61
7740	0	0	0	61	0	61
7741	61	0	0	0	0	61
7742	0	0	59	0	0	59
7743	0	0	0	58	0	58
7744	0	0	58	0	0	58
7745	0	0	0	56	0	56
7746	0	0	0	56	0	56
7747	56	0	0	0	0	56
7748	0	58	0	0	0	58
7749	58	0	0	0	0	58
7750	0	0	62	0	0	62
7751	0	0	0	62	0	62
7752	0	0	62	0	0	62
7753	65	0	0	0	0	65
7754	64	0	0	0	0	64
7755	0	0	63	0	0	63
7756	62	0	0	0	0	62
7757	64	0	0	0	0	64
7758	0	0	0	63	0	63
7759	0	0	60	0	0	60
7760	0	0	60	0	0	60
7761	0	0	0	63	0	63
7762	0	0	0	66	0	66
7763	0	61	0	0	0	61
7764	0	59	0	0	0	59
7765	57	0	0	0	0	57
7766	0	0	0	58	0	58
7767	0	49	0	0	0	49
7768	0	50	0	0	0	50
7769	49	0	0	0	0	49
7770	0	0	0	49	0	49
7771	0	49	0	0	0	49
7772	0	0	0	49	0	49
7773	0	0	0	49	0	49
7774	0	0	0	49	0	49
7775	48	0	0	0	0	48
7776	0	51	0	0	0	51
7777	0	0	0	51	0	51
7778	0	0	0	46	0	46
7779	0	0	0	49	0	49
7780	0	0	48	0	0	48
7781	48	0	0	0	0	48
7782	0	0	0	48	0	48
7783	47	0	0	0	0	47
7784	48	0	0	0	0	48
7785	46	0	0	0	0	46
7786	0	0	43	0	0	43
7787	0	44	0	1	0	45
7788	0	0	0	45	0	45
7789	0	0	45	0	0	45
7790	0	0	42	0	0	42
7791	1	0	0	45	0	46
7792	0	52	0	0	0	52
7793	46	0	0	0	0	46
7794	49	0	0	0	0	49
7795	51	0	0	0	0	51
7796	47	0	0	0	0	47
7797	0	0	41	0	0	41
7798	40	0	0	0	0	40
7799	0	41	0	0	0	41
7800	1	0	0	34	0	35
7801	0	0	0	35	0	35
7802	34	0	0	0	0	34
7803	0	0	0	35	0	35
7804	0	0	35	0	0	35
7805	37	0	0	0	0	37
7806	36	0	0	0	0	36
7807	36	0	0	0	0	36
7808	0	0	33	0	0	33
7809	36	0	0	0	0	36
7810	0	37	0	0	0	37
7811	35	0	0	0	0	35
7812	0	0	0	36	0	36
7813	1	0	0	36	0	37
7814	0	41	0	0	0	41
7815	0	0	0	39	0	39
7816	0	40	0	0	0	40
7817	0	0	0	41	0	41
7818	0	43	0	0	0	43
7819	0	0	0	42	0	42
7820	0	40	0	0	0	40
7821	0	0	0	43	0	43
7822	0	42	0	0	0	42
7823	45	0	0	0	0	45
7824	0	0	0	45	0	45
7825	0	0	0	45	0	45
7826	0	0	0	44	0	44
7827	0	0	0	50	0	50
7828	0	0	55	0	0	55
7829	0	0	0	54	0	54
7830	0	0	0	54	0	54
7831	55	0	0	0	0	55
7832	52	0	0	0	0	52
7833	0	56	0	0	0	56
7834	0	0	0	55	0	55
7835	0	0	0	54	0	54
7836	59	0	0	0	0	59
7837	0	0	60	0	0	60
7838	57	0	0	0	0	57
7839	0	60	0	0	0	60
7840	63	0	0	0	0	63
7841	61	0	0	0	0	61
7842	0	53	0	0	0	53
7843	0	52	0	0	0	52
7844	0	0	0	53	0	53
7845	0	0	54	0	0	54
7846	56	0	0	1	0	57
7847	0	1	58	0	0	59
7848	61	0	0	0	0	61
7849	0	0	56	0	0	56
7850	0	58	0	0	0	58
7851	0	0	1	60	0	61
7852	61	0	0	0	0	61
7853	55	0	0	0	0	55
7854	0	0	0	54	0	54
7855	54	0	0	0	0	54
7856	52	0	0	0	0	52
7857	0	55	0	0	0	55
7858	55	0	0	0	0	55
7859	0	54	0	0	0	54
7860	0	0	0	55	0	55
7861	56	0	0	0	0	56
7862	56	0	0	0	0	56
7863	55	0	0	0	0	55
7864	0	0	54	0	0	54
7865	0	0	54	0	0	54
7866	0	0	0	52	0	52
7867	0	0	0	56	0	56
7868	0	53	0	0	0	53
7869	55	0	0	0	0	55
7870	0	0	0	55	0	55
7871	0	0	0	55	0	55
7872	0	0	54	0	0	54
7873	0	50	0	0	0	50
7874	0	54	0	0	0	54
7875	0	0	0	54	0	54
7876	58	0	0	0	0	58
7877	0	0	0	57	0	57
7878	0	0	0	57	0	57
7879	60	0	0	0	0	60
7880	59	0	0	0	0	59
7881	0	0	0	63	0	63
7882	0	0	60	0	0	60
7883	0	0	0	62	0	62
7884	0	0	0	60	0	60
7885	62	0	0	0	0	62
7886	0	0	0	58	0	58
7887	56	0	0	0	0	56
7888	0	0	54	0	0	54
7889	0	0	0	53	0	53
7890	0	0	0	55	0	55
7891	0	0	0	54	0	54
7892	0	0	0	51	0	51
7893	0	0	0	57	0	57
7894	0	0	58	0	0	58
7895	55	0	0	0	0	55
7896	0	0	0	58	0	58
7897	0	0	58	0	0	58
7898	0	0	50	0	0	50
7899	1	0	0	49	0	50
7900	54	0	0	0	0	54
7901	54	0	0	0	0	54
7902	53	0	0	0	0	53
7903	0	0	0	48	0	48
7904	0	53	0	0	0	53
7905	54	0	0	0	0	54
7906	55	0	0	0	0	55
7907	53	0	0	0	0	53
7908	53	0	0	0	0	53
7909	0	0	0	53	0	53
7910	0	0	46	0	0	46
7911	0	0	0	44	0	44
7912	0	0	44	0	0	44
7913	48	0	0	0	0	48
7914	46	0	0	0	0	46
7915	0	0	47	0	0	47
7916	47	0	0	0	0	47
7917	46	0	0	0	0	46
7918	0	0	1	45	0	46
7919	0	48	0	0	0	48
7920	46	0	0	0	0	46
7921	0	0	0	37	0	37
7922	0	45	0	0	0	45
7923	0	0	0	42	0	42
7924	0	0	43	0	0	43
7925	0	45	0	0	0	45
7926	45	0	0	0	0	45
7927	45	0	0	0	0	45
7928	44	0	0	0	0	44
7929	38	0	0	0	0	38
7930	0	0	0	40	0	40
7931	0	42	0	0	0	42
7932	42	0	0	0	0	42
7933	0	0	43	0	0	43
7934	0	43	0	0	0	43
7935	0	0	41	0	0	41
7936	0	0	0	42	0	42
7937	0	39	0	0	0	39
7938	0	0	0	46	0	46
7939	0	0	45	0	0	45
7940	0	0	0	42	0	42
7941	0	0	0	40	0	40
7942	0	0	0	42	0	42
7943	41	0	0	1	0	42
7944	0	42	0	0	0	42
7945	0	0	0	43	0	43
7946	41	0	0	0	0	41
7947	0	43	0	0	0	43
7948	42	0	0	0	0	42
7949	0	0	45	0	0	45
7950	0	0	0	46	0	46
7951	0	45	0	0	0	45
7952	45	0	0	0	0	45
7953	0	0	44	0	0	44
7954	0	47	0	0	0	47
7955	0	0	0	52	0	52
7956	0	0	0	52	0	52
7957	49	0	0	0	0	49
7958	0	0	0	52	0	52
7959	1	0	50	0	0	51
7960	0	0	0	51	0	51
7961	0	0	54	0	0	54
7962	0	0	0	51	0	51
7963	0	52	0	0	0	52
7964	53	0	0	0	0	53
7965	51	0	0	1	0	52
7966	0	49	0	0	0	49
7967	0	50	0	0	0	50
7968	0	0	0	52	0	52
7969	48	0	0	0	0	48
7970	0	0	0	50	0	50
7971	49	0	0	0	0	49
7972	0	46	0	1	0	47
7973	0	0	0	49	0	49
7974	0	0	46	0	0	46
7975	0	0	0	46	0	46
7976	0	0	0	47	0	47
7977	47	0	0	0	0	47
7978	0	47	0	0	0	47
7979	0	0	0	48	0	48
7980	49	0	0	0	0	49
7981	0	0	46	0	0	46
7982	49	0	0	0	0	49
7983	0	0	0	46	0	46
7984	0	44	0	0	0	44
7985	47	1	0	0	0	48
7986	0	0	45	0	0	45
7987	0	0	44	0	0	44
7988	0	47	0	0	0	47
7989	47	0	0	0	0	47
7990	0	0	0	46	0	46
7991	0	0	0	47	0	47
7992	48	0	0	0	0	48
7993	0	0	48	0	0	48
7994	0	0	0	49	0	49
7995	0	0	46	0	0	46
7996	0	0	0	47	0	47
7997	0	45	0	0	0	45
7998	0	0	0	46	0	46
7999	0	0	44	0	0	44
8000	47	0	0	0	0	47
8001	0	0	0	48	0	48
8002	0	0	46	0	0	46
8003	0	0	0	45	0	45
8004	0	0	0	48	0	48
8005	0	0	46	0	0	46
8006	0	0	46	0	0	46
8007	0	0	0	48	0	48
8008	0	0	48	0	0	48
8009	46	0	0	0	0	46
8010	0	0	0	49	0	49
8011	48	0	0	0	0	48
8012	0	0	44	0	0	44
8013	0	0	0	48	0	48
8014	0	0	41	0	0	41
8015	0	37	0	0	0	37
8016	0	0	39	0	0	39
8017	0	0	37	0	0	37
8018	37	0	0	0	0	37
8019	38	0	0	0	0	38
8020	0	0	37	0	0	37
8021	0	0	0	36	0	36
8022	0	0	0	38	0	38
8023	0	0	37	0	0	37
8024	0	32	0	0	0	32
8025	35	0	0	0	0	35
8026	0	0	35	0	0	35
8027	0	0	0	35	0	35
8028	0	0	0	35	0	35
8029	35	0	0	0	0	35
8030	34	0	0	0	0	34
8031	33	0	0	1	0	34
8032	35	0	0	1	0	36
8033	0	0	0	39	0	39
8034	0	0	40	0	0	40
8035	0	0	0	40	0	40
8036	0	0	0	38	0	38
8037	0	0	0	39	0	39
8038	0	0	36	0	0	36
8039	35	0	0	0	0	35
8040	0	0	0	38	0	38
8041	0	0	39	0	0	39
8042	0	35	0	0	0	35
8043	0	0	0	35	0	35
8044	0	0	0	35	0	35
8045	38	0	0	0	0	38
8046	0	37	0	0	0	37
8047	0	0	32	0	0	32
8048	0	0	0	29	0	29
8049	0	0	0	31	0	31
8050	32	0	0	0	0	32
8051	30	0	0	0	0	30
8052	0	0	0	30	0	30
8053	33	0	0	0	0	33
8054	0	30	0	0	0	30
8055	0	0	33	0	0	33
8056	0	0	0	33	0	33
8057	0	0	0	34	0	34
8058	0	0	0	33	0	33
8059	0	0	0	33	0	33
8060	0	33	0	0	0	33
8061	33	0	0	0	0	33
8062	0	0	0	33	0	33
8063	0	33	0	0	0	33
8064	35	0	0	0	0	35
8065	35	0	0	0	0	35
8066	0	35	0	0	0	35
8067	0	0	0	37	0	37
8068	0	0	0	36	0	36
8069	0	0	0	37	0	37
8070	0	0	0	36	0	36
8071	36	0	0	0	0	36
8072	35	0	0	0	0	35
8073	0	34	0	0	0	34
8074	0	0	37	0	0	37
8075	0	0	0	39	0	39
8076	39	0	0	0	0	39
8077	0	34	0	0	0	34
8078	0	39	0	0	0	39
8079	39	0	0	0	0	39
8080	37	0	0	0	0	37
8081	0	0	0	37	0	37
8082	0	0	33	0	0	33
8083	0	0	35	0	0	35
8084	36	0	0	0	0	36
8085	35	0	0	0	0	35
8086	35	0	0	0	0	35
8087	33	0	0	0	0	33
8088	34	0	0	0	0	34
8089	0	35	0	0	0	35
8090	1	0	0	32	0	33
8091	0	32	0	0	0	32
8092	34	0	0	0	0	34
8093	36	0	0	0	0	36
8094	36	0	0	0	0	36
8095	33	0	0	0	0	33
8096	0	35	0	0	0	35
8097	35	0	0	0	0	35
8098	0	32	0	0	0	32
8099	0	0	0	33	0	33
8100	33	0	0	0	0	33
8101	0	0	37	0	0	37
8102	0	0	0	35	0	35
8103	0	0	0	36	0	36
8104	0	0	32	0	0	32
8105	0	34	0	0	0	34
8106	32	0	0	0	0	32
8107	33	0	0	0	0	33
8108	0	34	0	0	0	34
8109	0	0	0	33	0	33
8110	0	0	35	0	0	35
8111	0	34	0	0	0	34
8112	36	0	0	0	0	36
8113	0	0	32	0	0	32
8114	37	0	0	1	0	38
8115	38	0	0	0	0	38
8116	0	0	38	0	0	38
8117	0	39	0	0	0	39
8118	0	0	0	40	0	40
8119	0	0	37	0	0	37
8120	42	0	0	0	0	42
8121	42	0	0	0	0	42
8122	0	40	0	0	0	40
8123	0	0	0	43	0	43
8124	0	0	0	45	0	45
8125	0	0	45	0	0	45
8126	0	44	0	0	0	44
8127	42	0	0	0	0	42
8128	42	0	0	0	0	42
8129	41	0	0	0	0	41
8130	0	0	37	0	0	37
8131	38	0	0	1	0	39
8132	41	0	0	0	0	41
8133	0	0	0	41	0	41
8134	0	0	39	0	0	39
8135	0	0	0	38	0	38
8136	0	0	44	0	0	44
8137	0	0	0	44	0	44
8138	0	42	0	0	0	42
8139	0	48	0	0	0	48
8140	0	0	0	45	0	45
8141	0	0	0	48	0	48
8142	50	0	0	0	0	50
8143	1	0	48	0	0	49
8144	47	0	0	0	0	47
8145	0	51	0	0	0	51
8146	47	0	0	0	0	47
8147	49	0	0	0	0	49
8148	0	0	0	46	0	46
8149	0	0	47	0	0	47
8150	0	0	0	46	0	46
8151	0	45	0	0	0	45
8152	0	0	0	48	0	48
8153	0	0	0	45	0	45
8154	48	0	0	0	0	48
8155	0	0	0	48	0	48
8156	0	45	0	0	0	45
8157	0	0	0	45	0	45
8158	44	0	0	0	0	44
8159	0	42	0	0	0	42
8160	0	0	0	42	0	42
8161	0	0	0	41	0	41
8162	0	0	0	42	0	42
8163	0	0	0	43	0	43
8164	42	0	0	0	0	42
8165	0	0	0	42	0	42
8166	0	0	0	41	0	41
8167	0	0	0	39	0	39
8168	0	38	0	0	0	38
8169	39	0	0	0	0	39
8170	0	0	42	0	0	42
8171	0	41	0	0	0	41
8172	41	0	0	0	0	41
8173	0	0	41	0	0	41
8174	0	47	0	0	0	47
8175	0	0	0	44	0	44
8176	0	44	0	0	0	44
8177	0	0	43	0	0	43
8178	0	0	38	0	0	38
8179	0	43	0	0	0	43
8180	43	0	0	0	0	43
8181	42	0	0	0	0	42
8182	0	0	42	0	0	42
8183	0	0	42	0	0	42
8184	0	0	41	0	0	41
8185	0	0	0	43	0	43
8186	0	0	0	43	0	43
8187	0	0	0	43	0	43
8188	0	0	42	0	0	42
8189	0	0	0	41	0	41
8190	0	0	0	41	0	41
8191	0	0	41	0	0	41
8192	42	0	0	0	0	42
8193	0	0	0	42	0	42
8194	0	0	0	41	0	41
8195	0	41	0	0	0	41
8196	40	0	0	0	0	40
8197	0	0	39	0	0	39
8198	39	0	0	0	0	39
8199	0	0	0	41	0	41
8200	0	0	40	0	0	40
8201	0	0	0	38	0	38
8202	39	0	0	0	0	39
8203	0	0	39	2	0	41
8204	43	0	0	0	0	43
8205	43	0	0	0	0	43
8206	39	0	0	0	0	39
8207	0	40	0	0	0	40
8208	0	0	0	43	0	43
8209	38	0	0	0	0	38
8210	39	0	0	0	0	39
8211	40	0	0	0	0	40
8212	0	0	37	0	0	37
8213	46	0	0	0	0	46
8214	0	0	0	42	0	42
8215	0	0	41	4	0	45
8216	2	0	0	47	0	49
8217	0	0	0	48	0	48
8218	0	0	49	0	0	49
8219	0	0	0	51	0	51
8220	0	0	0	50	0	50
8221	0	0	54	0	0	54
8222	51	0	0	0	0	51
8223	51	0	0	0	0	51
8224	0	0	0	56	0	56
8225	0	0	54	0	0	54
8226	0	0	0	57	0	57
8227	0	61	0	0	0	61
8228	0	0	0	62	0	62
8229	0	0	0	62	0	62
8230	59	0	0	0	0	59
8231	57	0	0	0	0	57
8232	58	0	0	0	0	58
8233	0	0	0	59	0	59
8234	0	0	0	55	0	55
8235	0	0	60	0	0	60
8236	0	0	0	55	0	55
8237	0	54	0	0	0	54
8238	53	0	0	0	0	53
8239	0	55	0	0	0	55
8240	55	0	0	0	0	55
8241	0	0	0	55	0	55
8242	0	54	0	0	0	54
8243	55	0	0	0	0	55
8244	52	0	0	0	0	52
8245	0	0	0	56	0	56
8246	0	55	0	0	0	55
8247	0	0	0	55	0	55
8248	0	0	55	0	0	55
8249	54	0	0	0	0	54
8250	0	56	0	0	0	56
8251	55	0	0	0	0	55
8252	0	0	0	55	0	55
8253	55	0	0	0	0	55
8254	0	0	56	0	0	56
8255	58	0	0	0	0	58
8256	57	0	0	0	0	57
8257	0	0	57	0	0	57
8258	0	0	0	56	0	56
8259	0	0	0	58	0	58
8260	57	0	0	0	0	57
8261	0	58	0	0	0	58
8262	0	0	0	56	0	56
8263	0	0	59	0	0	59
8264	0	0	58	0	0	58
8265	0	51	0	0	0	51
8266	0	0	55	0	0	55
8267	54	0	0	0	0	54
8268	0	0	0	49	0	49
8269	49	0	0	0	0	49
8270	0	0	50	0	0	50
8271	0	0	0	50	0	50
8272	0	0	0	48	0	48
8273	0	0	47	0	0	47
8274	0	0	0	46	0	46
8275	49	0	0	0	0	49
8276	48	0	0	0	0	48
8277	0	0	0	45	0	45
8278	48	0	0	0	0	48
8279	45	0	0	0	0	45
8280	0	47	0	0	0	47
8281	0	0	0	46	0	46
8282	46	0	0	0	0	46
8283	0	0	0	48	0	48
8284	46	0	0	0	0	46
8285	0	0	0	50	0	50
8286	0	0	49	0	0	49
8287	0	50	0	0	0	50
8288	0	0	0	53	0	53
8289	0	50	0	0	0	50
8290	50	0	0	0	0	50
8291	0	47	0	0	0	47
8292	0	47	0	0	0	47
8293	0	0	0	54	0	54
8294	53	0	0	0	0	53
8295	0	0	0	51	0	51
8296	50	0	0	0	0	50
8297	46	0	0	0	0	46
8298	0	51	0	0	0	51
8299	47	0	0	0	0	47
8300	52	0	0	0	0	52
8301	51	0	0	0	0	51
8302	0	0	48	0	0	48
8303	0	0	0	51	0	51
8304	0	0	0	52	0	52
8305	0	0	48	0	0	48
8306	43	0	0	0	0	43
8307	46	0	0	0	0	46
8308	46	0	0	0	0	46
8309	40	0	0	0	0	40
8310	0	46	0	0	0	46
8311	39	0	1	0	0	40
8312	0	2	0	40	0	42
8313	0	0	42	0	0	42
8314	38	0	2	0	0	40
8315	0	40	0	0	0	40
8316	40	0	0	0	0	40
8317	0	40	0	0	0	40
8318	0	40	0	0	0	40
8319	0	37	0	1	0	38
8320	0	39	0	0	0	39
8321	0	0	38	0	0	38
8322	0	0	0	36	0	36
8323	0	0	38	0	0	38
8324	38	0	0	0	0	38
8325	0	36	0	0	0	36
8326	0	35	0	0	0	35
8327	0	0	1	35	0	36
8328	0	0	0	39	0	39
8329	0	0	38	0	0	38
8330	0	0	35	0	0	35
8331	0	0	0	40	0	40
8332	0	0	36	0	0	36
8333	0	40	0	0	0	40
8334	0	0	0	41	0	41
8335	0	0	0	40	0	40
8336	0	0	40	0	0	40
8337	0	0	0	40	0	40
8338	42	0	0	0	0	42
8339	0	0	0	40	0	40
8340	0	0	0	41	0	41
8341	0	0	40	0	0	40
8342	39	0	0	0	0	39
8343	0	40	0	0	0	40
8344	0	0	0	39	0	39
8345	0	0	38	0	0	38
8346	0	0	0	40	0	40
8347	40	0	0	0	0	40
8348	0	0	35	0	0	35
8349	0	0	0	36	0	36
8350	0	0	36	0	0	36
8351	0	35	0	0	0	35
8352	0	0	36	0	0	36
8353	0	36	0	0	0	36
8354	0	0	36	0	0	36
8355	0	0	0	35	0	35
8356	0	33	0	0	0	33
8357	32	0	0	0	0	32
8358	0	0	0	29	0	29
8359	32	0	0	0	0	32
8360	0	0	0	32	0	32
8361	0	0	0	32	0	32
8362	30	0	0	0	0	30
8363	30	0	0	0	0	30
8364	0	0	0	30	0	30
8365	0	0	29	0	0	29
8366	0	28	0	0	0	28
8367	0	0	30	0	0	30
8368	0	29	0	0	0	29
8369	31	0	0	0	0	31
8370	0	0	31	0	0	31
8371	0	0	31	0	0	31
8372	0	0	0	30	0	30
8373	32	0	0	0	0	32
8374	0	0	35	0	0	35
8375	0	33	0	0	0	33
8376	36	0	0	0	0	36
8377	34	0	0	0	0	34
8378	33	0	0	0	0	33
8379	31	0	0	0	0	31
8380	32	0	0	0	0	32
8381	0	0	30	0	0	30
8382	0	0	0	30	0	30
8383	0	34	0	0	0	34
8384	30	0	0	0	0	30
8385	0	34	0	0	0	34
8386	32	0	0	0	0	32
8387	32	0	0	0	0	32
8388	0	33	0	0	0	33
8389	35	0	0	0	0	35
8390	0	0	0	34	0	34
8391	0	0	0	32	0	32
8392	0	0	32	0	0	32
8393	0	29	1	0	0	30
8394	0	0	0	34	0	34
8395	0	0	0	34	0	34
8396	0	0	0	35	0	35
8397	0	0	34	0	0	34
8398	34	0	0	0	0	34
8399	0	0	0	33	0	33
8400	33	0	0	0	0	33
8401	0	0	0	29	0	29
8402	0	0	30	0	0	30
8403	0	0	25	0	0	25
8404	29	0	0	0	0	29
8405	29	0	0	0	0	29
8406	0	29	0	0	0	29
8407	0	0	29	0	0	29
8408	0	0	0	34	0	34
8409	0	0	0	40	0	40
8410	42	0	0	0	0	42
8411	43	0	0	0	0	43
8412	44	0	0	0	0	44
8413	0	0	40	0	0	40
8414	41	0	0	0	0	41
8415	0	0	0	40	0	40
8416	0	0	0	43	0	43
8417	0	0	0	45	0	45
8418	0	46	0	0	0	46
8419	46	0	0	0	0	46
8420	0	0	0	47	0	47
8421	0	0	42	0	0	42
8422	0	0	0	41	0	41
8423	0	45	0	0	0	45
8424	41	1	0	0	0	42
8425	0	0	0	44	0	44
8426	0	0	0	42	0	42
8427	0	0	42	0	0	42
8428	0	0	0	42	0	42
8429	0	43	0	0	0	43
8430	0	0	0	44	0	44
8431	0	0	36	0	0	36
8432	41	0	0	0	0	41
8433	40	0	0	0	0	40
8434	0	43	0	0	0	43
8435	44	0	0	0	0	44
8436	46	0	0	0	0	46
8437	0	44	0	0	0	44
8438	0	0	0	46	0	46
8439	45	0	0	0	0	45
8440	0	46	0	0	0	46
8441	0	0	41	0	0	41
8442	44	0	0	0	0	44
8443	45	0	0	0	0	45
8444	44	0	0	0	0	44
8445	43	0	0	0	0	43
8446	0	45	0	0	0	45
8447	43	0	0	1	0	44
8448	43	0	0	0	0	43
8449	45	0	0	0	0	45
8450	0	0	0	45	0	45
8451	44	0	0	0	0	44
8452	0	44	0	0	0	44
8453	0	0	45	0	0	45
8454	0	0	0	45	0	45
8455	45	0	0	0	0	45
8456	0	0	51	0	0	51
8457	0	1	0	49	0	50
8458	0	1	51	0	0	52
8459	1	49	1	0	0	51
8460	0	6	0	48	0	54
8461	2	0	52	0	0	54
8462	0	48	0	0	0	48
8463	0	0	0	52	0	52
8464	57	0	0	0	0	57
8465	55	0	0	0	0	55
8466	54	0	0	0	0	54
8467	56	0	0	0	0	56
8468	56	0	0	0	0	56
8469	0	0	52	0	0	52
8470	52	0	0	0	0	52
8471	53	0	0	0	0	53
8472	0	0	1	49	0	50
8473	53	0	0	0	0	53
8474	51	0	0	0	0	51
8475	0	54	0	0	0	54
8476	0	0	0	49	0	49
8477	0	0	0	52	0	52
8478	51	0	0	0	0	51
8479	0	55	0	0	0	55
8480	0	57	0	0	0	57
8481	0	0	0	56	0	56
8482	0	0	0	58	0	58
8483	0	0	0	55	0	55
8484	0	0	0	58	0	58
8485	59	0	0	0	0	59
8486	58	0	0	0	0	58
8487	0	0	51	0	0	51
8488	0	0	0	50	0	50
8489	0	0	0	49	0	49
8490	0	0	48	0	0	48
8491	49	0	0	1	0	50
8492	0	49	0	0	0	49
8493	50	0	0	0	0	50
8494	0	0	0	50	0	50
8495	0	0	50	0	0	50
8496	0	0	0	50	0	50
8497	0	0	49	0	0	49
8498	0	50	0	0	0	50
8499	50	0	0	0	0	50
8500	50	0	0	0	0	50
8501	0	43	0	0	0	43
8502	0	0	0	39	0	39
8503	38	0	0	0	0	38
8504	0	30	0	0	0	30
8505	0	0	0	31	0	31
8506	29	0	0	0	0	29
8507	0	0	34	0	0	34
8508	34	0	0	0	0	34
8509	0	37	0	0	0	37
8510	38	0	0	0	0	38
8511	39	0	0	0	0	39
8512	0	0	37	0	0	37
8513	1	0	0	37	0	38
8514	0	0	0	37	0	37
8515	0	0	37	0	0	37
8516	0	0	0	35	0	35
8517	0	0	0	36	0	36
8518	35	0	0	0	0	35
8519	37	0	0	0	0	37
8520	0	0	0	36	0	36
8521	0	1	36	0	0	37
8522	0	0	0	37	0	37
8523	0	0	0	42	0	42
8524	0	0	41	0	0	41
8525	0	0	0	40	0	40
8526	42	0	0	0	0	42
8527	39	0	0	0	0	39
8528	0	40	0	0	0	40
8529	39	0	0	0	0	39
8530	39	0	0	0	0	39
8531	0	39	0	0	0	39
8532	39	0	0	0	0	39
8533	39	0	0	0	0	39
8534	40	0	0	0	0	40
8535	0	0	40	0	0	40
8536	39	0	0	0	0	39
8537	1	0	0	39	0	40
8538	38	0	0	0	0	38
8539	0	0	37	0	0	37
8540	0	36	0	0	0	36
8541	37	0	0	0	0	37
8542	0	35	0	0	0	35
8543	0	0	0	38	0	38
8544	0	0	0	39	0	39
8545	38	0	0	0	0	38
8546	39	0	0	0	0	39
8547	0	0	37	0	0	37
8548	0	1	35	0	0	36
8549	0	0	35	0	0	35
8550	1	0	0	37	0	38
8551	0	0	35	0	0	35
8552	0	0	37	0	0	37
8553	0	0	0	35	0	35
8554	36	0	0	0	0	36
8555	35	0	0	0	0	35
8556	28	0	0	1	0	29
8557	30	0	0	0	0	30
8558	0	0	0	29	0	29
8559	0	0	0	30	0	30
8560	0	0	29	0	0	29
8561	0	0	0	30	0	30
8562	0	0	0	30	0	30
8563	29	0	0	0	0	29
8564	30	0	0	0	0	30
8565	0	0	0	30	0	30
8566	29	0	0	0	0	29
8567	29	0	0	0	0	29
8568	0	0	0	28	0	28
8569	0	0	0	30	0	30
8570	0	0	28	0	0	28
8571	0	0	24	0	0	24
8572	0	0	0	21	0	21
8573	0	0	0	23	0	23
8574	0	0	29	0	0	29
8575	27	0	0	0	0	27
8576	27	0	0	0	0	27
8577	0	0	27	0	0	27
8578	0	25	0	0	0	25
8579	27	0	0	0	0	27
8580	0	0	26	0	0	26
8581	0	0	0	26	0	26
8582	0	0	0	28	0	28
8583	30	0	0	0	0	30
8584	29	0	0	0	0	29
8585	0	0	0	29	0	29
8586	0	0	0	29	0	29
8587	29	0	0	0	0	29
8588	30	0	0	0	0	30
8589	32	0	0	0	0	32
8590	0	0	30	0	0	30
8591	0	0	0	31	0	31
8592	0	0	0	30	0	30
8593	30	0	0	0	0	30
8594	0	29	0	0	0	29
8595	29	0	0	0	0	29
8596	0	31	0	0	0	31
8597	0	0	0	30	0	30
8598	0	0	0	31	0	31
8599	0	0	31	0	0	31
8600	0	4	0	26	0	30
8601	0	0	27	0	0	27
8602	0	0	0	27	0	27
8603	0	0	0	27	0	27
8604	0	26	0	0	0	26
8605	0	27	0	0	0	27
8606	0	0	0	27	0	27
8607	0	0	0	29	0	29
8608	0	0	0	26	0	26
8609	0	0	0	26	0	26
8610	0	0	0	28	0	28
8611	0	0	28	0	0	28
8612	0	0	0	27	0	27
8613	0	0	0	28	0	28
8614	0	0	25	0	0	25
8615	0	26	0	0	0	26
8616	0	0	0	22	0	22
8617	0	0	20	0	0	20
8618	0	22	0	0	0	22
8619	0	0	0	22	0	22
8620	22	0	0	0	0	22
8621	0	0	0	22	0	22
8622	0	0	0	21	0	21
8623	0	0	0	20	0	20
8624	0	0	0	17	0	17
8625	0	19	0	0	0	19
8626	0	0	0	18	0	18
8627	18	0	0	0	0	18
8628	0	0	0	18	0	18
8629	0	0	0	18	0	18
8630	0	0	0	17	0	17
8631	17	0	0	0	0	17
8632	17	0	0	0	0	17
8633	0	0	0	18	0	18
8634	18	0	0	0	0	18
8635	16	0	0	0	0	16
8636	0	18	0	0	0	18
8637	17	0	0	0	0	17
8638	0	16	0	0	0	16
8639	0	15	0	0	0	15
8640	0	0	0	17	0	17
8641	0	0	18	0	0	18
8642	0	0	0	16	0	16
8643	0	0	0	17	0	17
8644	0	17	0	0	0	17
8645	18	0	0	0	0	18
8646	0	0	0	19	0	19
8647	0	0	19	0	0	19
8648	0	0	0	22	0	22
8649	0	22	0	0	0	22
8650	24	0	0	0	0	24
8651	0	0	0	23	0	23
8652	0	0	21	0	0	21
8653	0	0	0	22	0	22
8654	0	21	0	0	0	21
8655	0	0	0	19	0	19
8656	23	0	0	0	0	23
8657	23	0	0	0	0	23
8658	21	0	0	0	0	21
8659	0	22	0	0	0	22
8660	23	0	0	0	0	23
8661	0	0	0	22	0	22
8662	18	0	0	0	0	18
8663	0	22	0	0	0	22
8664	0	0	0	23	0	23
8665	0	0	22	0	0	22
8666	22	0	0	0	0	22
8667	0	16	0	0	0	16
8668	0	0	0	16	0	16
8669	0	0	0	17	0	17
8670	0	0	0	12	0	12
8671	0	0	0	13	0	13
8672	0	11	0	0	0	11
8673	14	0	0	0	0	14
8674	14	0	0	0	0	14
8675	0	0	20	0	0	20
8676	0	0	0	19	0	19
8677	0	0	18	0	0	18
8678	20	0	0	0	0	20
8679	18	0	0	0	0	18
8680	19	0	0	0	0	19
8681	0	0	0	18	0	18
8682	0	18	0	0	0	18
8683	18	0	0	0	0	18
8684	0	0	0	18	0	18
8685	19	0	0	0	0	19
8686	0	0	22	0	0	22
8687	0	0	20	0	0	20
8688	22	0	0	0	0	22
8689	0	0	0	23	0	23
8690	23	0	0	0	0	23
8691	0	23	0	0	0	23
8692	22	0	0	0	0	22
8693	23	0	0	0	0	23
8694	0	0	23	0	0	23
8695	0	0	18	0	0	18
8696	0	22	0	0	0	22
8697	0	0	0	24	0	24
8698	23	0	0	0	0	23
8699	0	0	0	21	0	21
8700	0	0	0	21	0	21
8701	0	0	21	0	0	21
8702	21	0	0	0	0	21
8703	0	0	0	25	0	25
8704	0	0	27	0	0	27
8705	0	0	24	0	0	24
8706	0	0	0	26	0	26
8707	0	0	26	0	0	26
8708	0	0	26	0	0	26
8709	0	0	0	28	0	28
8710	0	0	27	0	0	27
8711	0	0	0	28	0	28
8712	0	26	0	0	0	26
8713	28	0	0	0	0	28
8714	0	28	0	0	0	28
8715	0	0	0	27	0	27
8716	0	28	0	0	0	28
8717	0	0	28	0	0	28
8718	0	0	0	27	0	27
8719	0	0	27	0	0	27
8720	29	0	0	0	0	29
8721	0	31	0	0	0	31
8722	31	0	0	0	0	31
8723	0	0	0	31	0	31
8724	29	0	2	0	0	31
8725	0	0	31	0	0	31
8726	0	33	0	0	0	33
8727	33	0	0	0	0	33
8728	0	0	0	34	0	34
8729	0	34	0	0	0	34
8730	0	0	0	35	0	35
8731	34	0	0	0	0	34
8732	0	37	0	0	0	37
8733	33	0	0	0	0	33
8734	1	0	34	0	0	35
8735	36	0	0	0	0	36
8736	0	0	0	36	0	36
8737	39	0	0	0	0	39
8738	0	39	0	0	0	39
8739	1	0	0	40	0	41
8740	0	0	0	40	0	40
8741	0	0	34	0	0	34
8742	0	0	0	35	0	35
8743	0	0	0	36	0	36
8744	0	0	0	34	0	34
8745	0	0	0	36	0	36
8746	0	0	36	0	0	36
8747	0	39	0	0	0	39
8748	0	0	0	38	0	38
8749	38	0	0	0	0	38
8750	38	0	0	0	0	38
8751	0	38	0	0	0	38
8752	37	0	0	0	0	37
8753	36	0	0	0	0	36
8754	37	0	0	0	0	37
8755	0	37	0	0	0	37
8756	37	0	0	0	0	37
8757	0	0	0	37	0	37
8758	0	0	36	0	0	36
8759	0	36	0	0	0	36
8760	0	0	0	34	0	34
8761	0	0	37	0	0	37
8762	35	0	0	1	0	36
8763	0	0	0	36	0	36
8764	0	0	0	34	0	34
8765	0	0	0	37	0	37
8766	0	0	0	37	0	37
8767	0	0	38	0	0	38
8768	32	0	0	0	0	32
8769	0	28	0	0	0	28
8770	27	0	0	0	0	27
8771	0	26	0	0	0	26
8772	27	0	1	0	0	28
8773	0	0	0	27	0	27
8774	0	0	30	0	0	30
8775	0	0	32	0	0	32
8776	0	0	0	32	0	32
8777	0	0	0	35	0	35
8778	0	0	0	34	0	34
8779	32	0	0	0	0	32
8780	0	0	28	0	0	28
8781	0	27	0	0	0	27
8782	0	29	0	0	0	29
8783	31	0	0	0	0	31
8784	0	0	30	0	0	30
8785	0	29	0	0	0	29
8786	0	0	30	0	0	30
8787	0	0	0	32	0	32
8788	0	1	30	0	0	31
8789	0	0	30	0	0	30
8790	0	0	0	30	0	30
8791	0	0	31	0	0	31
8792	0	0	32	0	0	32
8793	0	0	0	32	0	32
8794	30	0	0	0	0	30
8795	0	0	31	0	0	31
8796	0	0	0	30	0	30
8797	0	0	0	31	0	31
8798	31	0	0	0	0	31
8799	0	0	0	29	0	29
8800	29	0	0	0	0	29
8801	0	32	0	0	0	32
8802	0	0	0	30	0	30
8803	31	0	0	0	0	31
8804	37	0	0	0	0	37
8805	0	0	0	36	0	36
8806	0	0	37	0	0	37
8807	36	0	0	0	0	36
8808	0	41	0	0	0	41
8809	44	0	0	0	0	44
8810	40	0	0	1	0	41
8811	44	0	0	0	0	44
8812	0	0	37	0	0	37
8813	0	46	0	0	0	46
8814	0	0	0	48	0	48
8815	0	0	0	47	0	47
8816	0	0	46	0	0	46
8817	0	43	0	0	0	43
8818	0	45	0	0	0	45
8819	0	47	0	0	0	47
8820	45	0	0	0	0	45
8821	0	0	0	38	0	38
8822	0	0	0	43	0	43
8823	0	0	41	0	0	41
8824	43	0	0	0	0	43
8825	0	0	0	46	0	46
8826	0	0	0	46	0	46
8827	0	0	43	0	0	43
8828	0	43	0	0	0	43
8829	0	0	0	45	0	45
8830	0	1	41	0	0	42
8831	0	38	0	0	0	38
8832	41	0	0	0	0	41
8833	0	0	42	0	0	42
8834	0	0	0	40	0	40
8835	0	38	0	0	0	38
8836	39	0	0	0	0	39
8837	0	0	0	41	0	41
8838	41	0	0	0	0	41
8839	40	0	0	0	0	40
8840	0	38	0	0	0	38
8841	41	0	0	0	0	41
8842	40	0	0	0	0	40
8843	0	0	41	0	0	41
8844	41	0	0	0	0	41
8845	0	0	35	0	0	35
8846	41	0	0	0	0	41
8847	41	0	0	0	0	41
8848	0	0	41	0	0	41
8849	0	0	0	41	0	41
8850	0	0	42	0	0	42
8851	0	0	34	0	0	34
8852	0	0	38	0	0	38
8853	0	0	0	47	0	47
8854	0	0	0	48	0	48
8855	0	0	0	50	0	50
8856	0	0	0	50	0	50
8857	0	0	51	0	0	51
8858	0	0	0	51	0	51
8859	0	50	0	0	0	50
8860	0	0	55	0	0	55
8861	0	0	0	51	0	51
8862	0	0	56	0	0	56
8863	0	56	0	0	0	56
8864	0	57	0	0	0	57
8865	0	0	2	53	0	55
8866	0	0	54	1	0	55
8867	0	0	54	0	0	54
8868	1	0	0	52	0	53
8869	0	0	0	45	0	45
8870	0	0	0	52	0	52
8871	0	0	56	0	0	56
8872	0	55	0	0	0	55
8873	0	54	0	0	0	54
8874	0	0	1	54	0	55
8875	0	0	52	0	0	52
8876	0	0	54	0	0	54
8877	0	62	0	0	0	62
8878	60	0	0	0	0	60
8879	0	61	0	0	0	61
8880	0	0	59	0	0	59
8881	61	0	0	0	0	61
8882	0	0	0	58	0	58
8883	62	0	0	0	0	62
8884	0	0	0	61	0	61
8885	0	0	0	61	0	61
8886	63	0	0	0	0	63
8887	0	69	0	0	0	69
8888	0	0	67	0	0	67
8889	0	66	0	0	0	66
8890	68	0	0	0	0	68
8891	0	68	0	0	0	68
8892	71	0	0	0	0	71
8893	68	0	0	0	0	68
8894	0	72	0	0	0	72
8895	0	0	0	71	0	71
8896	69	0	0	0	0	69
8897	63	0	0	0	0	63
8898	0	0	0	67	0	67
8899	0	0	62	0	0	62
8900	0	0	61	0	0	61
8901	0	0	0	65	0	65
8902	0	0	59	0	0	59
8903	55	0	0	0	0	55
8904	0	58	0	0	0	58
8905	0	0	0	62	0	62
8906	0	0	0	52	0	52
8907	1	0	0	53	0	54
8908	0	0	0	55	0	55
8909	0	0	0	56	0	56
8910	0	0	53	0	0	53
8911	0	52	0	0	0	52
8912	50	0	0	0	0	50
8913	0	0	0	56	0	56
8914	1	0	0	54	0	55
8915	0	0	0	55	0	55
8916	0	54	0	0	0	54
8917	0	0	0	53	0	53
8918	0	0	0	51	0	51
8919	50	0	0	0	0	50
8920	0	50	0	0	0	50
8921	0	46	0	0	0	46
8922	0	0	0	52	0	52
8923	51	0	0	0	0	51
8924	0	0	50	0	0	50
8925	50	0	0	0	0	50
8926	0	0	49	0	0	49
8927	0	0	0	51	0	51
8928	0	0	0	55	0	55
8929	0	0	0	56	0	56
8930	0	0	0	54	0	54
8931	0	0	0	57	0	57
8932	57	0	0	0	0	57
8933	0	0	58	0	0	58
8934	0	0	0	57	0	57
8935	0	0	56	0	0	56
8936	0	58	1	0	0	59
8937	60	0	0	0	0	60
8938	0	0	57	0	0	57
8939	0	0	0	58	0	58
8940	0	0	0	58	0	58
8941	0	0	56	0	0	56
8942	0	0	58	0	0	58
8943	0	0	0	60	0	60
8944	62	0	0	0	0	62
8945	58	0	0	0	0	58
8946	0	58	0	0	0	58
8947	55	0	0	0	0	55
8948	0	0	0	51	0	51
8949	0	54	0	0	0	54
8950	0	0	0	52	0	52
8951	0	0	52	0	0	52
8952	0	0	0	50	0	50
8953	0	0	0	52	0	52
8954	52	0	0	0	0	52
8955	0	51	0	0	0	51
8956	49	0	0	0	0	49
8957	0	52	0	0	0	52
8958	52	0	0	0	0	52
8959	0	47	0	0	0	47
8960	0	49	0	0	0	49
8961	47	0	0	0	0	47
8962	0	0	0	48	0	48
8963	0	45	0	0	0	45
8964	45	0	0	0	0	45
8965	41	0	0	0	0	41
8966	44	0	0	0	0	44
8967	45	0	0	0	0	45
8968	0	44	0	0	0	44
8969	0	0	0	41	0	41
8970	0	0	0	38	0	38
8971	38	0	0	0	0	38
8972	0	0	0	35	0	35
8973	37	0	0	0	0	37
8974	0	0	38	0	0	38
8975	37	0	0	0	0	37
8976	0	0	35	0	0	35
8977	0	0	0	35	0	35
8978	36	0	0	0	0	36
8979	0	36	0	0	0	36
8980	34	0	0	0	0	34
8981	0	35	0	0	0	35
8982	0	0	0	36	0	36
8983	0	0	33	0	0	33
8984	32	0	0	0	0	32
8985	0	36	0	0	0	36
8986	0	0	0	36	0	36
8987	0	0	0	36	0	36
8988	0	0	0	36	0	36
8989	0	0	35	0	0	35
8990	0	36	0	0	0	36
8991	33	0	0	0	0	33
8992	32	0	0	0	0	32
8993	0	34	0	0	0	34
8994	39	0	0	0	0	39
8995	0	0	0	38	0	38
8996	1	34	0	0	0	35
8997	40	0	0	0	0	40
8998	0	0	39	0	0	39
8999	0	39	0	0	0	39
9000	0	0	0	40	0	40
9001	0	0	0	43	0	43
9002	0	0	43	0	0	43
9003	0	0	0	42	0	42
9004	0	0	44	0	0	44
9005	1	0	0	41	0	42
9006	0	0	0	44	0	44
9007	0	0	0	45	0	45
9008	0	0	0	45	0	45
9009	0	0	44	0	0	44
9010	0	0	43	0	0	43
9011	0	41	0	0	0	41
9012	0	0	0	50	0	50
9013	0	0	52	0	0	52
9014	0	49	0	0	0	49
9015	0	0	0	53	0	53
9016	0	0	53	0	0	53
9017	71	0	0	0	0	71
9018	73	0	0	0	0	73
9019	0	0	0	70	0	70
9020	0	0	69	0	0	69
9021	0	0	0	62	0	62
9022	62	0	0	0	0	62
9023	0	63	0	0	0	63
9024	64	0	0	0	0	64
9025	63	0	0	0	0	63
9026	0	0	0	63	0	63
9027	0	0	0	61	0	61
9028	0	0	0	60	0	60
9029	0	0	0	62	0	62
9030	0	0	0	62	0	62
9031	62	0	0	0	0	62
9032	61	0	0	0	0	61
9033	63	0	0	0	0	63
9034	0	0	49	0	0	49
9035	63	0	0	0	0	63
9036	0	0	0	63	0	63
9037	0	0	62	0	0	62
9038	0	58	0	0	0	58
9039	0	0	0	60	0	60
9040	0	0	0	60	0	60
9041	0	57	0	0	0	57
9042	0	0	0	60	0	60
9043	0	0	61	0	0	61
9044	0	0	60	0	0	60
9045	0	0	0	59	0	59
9046	60	0	0	0	0	60
9047	59	0	0	0	0	59
9048	0	0	61	0	0	61
9049	0	59	0	0	0	59
9050	0	62	0	0	0	62
9051	65	0	0	0	0	65
9052	0	0	66	0	0	66
9053	0	0	0	66	0	66
9054	69	0	0	0	0	69
9055	0	65	0	0	0	65
9056	0	65	0	0	0	65
9057	68	0	0	0	0	68
9058	0	0	0	69	0	69
9059	66	0	0	0	0	66
9060	0	0	1	67	0	68
9061	0	0	0	68	0	68
9062	0	0	71	0	0	71
9063	0	0	0	73	0	73
9064	0	0	0	71	0	71
9065	73	0	0	0	0	73
9066	0	0	0	73	0	73
9067	0	0	72	0	0	72
9068	75	0	0	0	0	75
9069	0	0	0	76	0	76
9070	73	0	0	0	0	73
9071	0	63	0	1	0	64
9072	0	69	0	0	0	69
9073	76	0	0	0	0	76
9074	80	0	0	0	0	80
9075	0	0	0	77	0	77
9076	0	0	76	0	0	76
9077	0	0	0	76	0	76
9078	72	0	0	0	0	72
9079	0	71	0	0	0	71
9080	0	0	0	73	0	73
9081	74	0	0	0	0	74
9082	0	0	72	0	0	72
9083	79	0	0	0	0	79
9084	81	0	0	0	0	81
9085	0	0	78	0	0	78
9086	0	0	72	0	0	72
9087	0	0	0	72	0	72
9088	0	0	0	77	0	77
9089	1	69	0	0	0	70
9090	0	0	0	78	0	78
9091	0	0	74	0	0	74
9092	0	0	0	79	0	79
9093	0	0	0	80	0	80
9094	0	0	76	1	0	77
9095	0	78	0	0	0	78
9096	0	0	0	78	0	78
9097	0	0	0	78	0	78
9098	79	0	0	0	0	79
9099	0	0	0	78	0	78
9100	0	0	77	0	0	77
9101	77	0	0	0	0	77
9102	72	0	0	0	0	72
9103	73	0	0	0	0	73
9104	0	0	73	0	0	73
9105	0	0	0	73	0	73
9106	0	0	0	72	0	72
9107	0	0	0	74	0	74
9108	68	0	0	0	0	68
9109	0	69	0	0	0	69
9110	0	0	52	0	0	52
9111	0	60	0	0	0	60
9112	0	53	0	0	0	53
9113	0	53	0	0	0	53
9114	0	0	0	53	0	53
9115	0	0	50	0	0	50
9116	52	0	0	0	0	52
9117	0	51	0	0	0	51
9118	53	0	0	0	0	53
9119	0	51	0	0	0	51
9120	51	0	0	0	0	51
9121	0	52	0	0	0	52
9122	0	0	48	0	0	48
9123	0	0	0	51	0	51
9124	0	0	0	51	0	51
9125	56	0	0	0	0	56
9126	0	0	0	54	0	54
9127	0	0	50	0	0	50
9128	0	0	0	53	0	53
9129	0	0	54	0	0	54
9130	0	51	0	0	0	51
9131	0	0	0	52	0	52
9132	0	50	0	0	0	50
9133	52	0	1	0	0	53
9134	0	0	0	55	0	55
9135	0	0	52	0	0	52
9136	0	0	51	0	0	51
9137	53	0	0	0	0	53
9138	0	0	0	52	0	52
9139	0	0	52	0	0	52
9140	1	0	50	0	0	51
9141	0	48	0	0	0	48
9142	0	0	0	46	0	46
9143	0	41	0	0	0	41
9144	0	0	0	42	0	42
9145	39	0	0	0	0	39
9146	0	0	0	38	0	38
9147	0	0	0	42	0	42
9148	40	0	0	0	0	40
9149	0	0	0	42	0	42
9150	0	0	0	42	0	42
9151	0	40	0	0	0	40
9152	41	0	0	0	0	41
9153	40	0	0	0	0	40
9154	0	0	0	42	0	42
9155	0	0	0	39	0	39
9156	0	0	0	38	0	38
9157	0	38	0	0	0	38
9158	0	41	0	0	0	41
9159	0	0	0	40	0	40
9160	38	0	0	0	0	38
9161	36	0	0	0	0	36
9162	0	39	0	0	0	39
9163	40	0	0	0	0	40
9164	0	38	0	0	0	38
9165	0	36	0	0	0	36
9166	0	0	0	36	0	36
9167	37	0	0	0	0	37
9168	0	32	0	0	0	32
9169	0	35	0	0	0	35
9170	0	0	0	37	0	37
9171	0	0	0	37	0	37
9172	0	0	34	0	0	34
9173	34	0	0	0	0	34
9174	33	0	0	0	0	33
9175	0	0	30	0	0	30
9176	0	0	30	0	0	30
9177	0	0	0	30	0	30
9178	0	0	0	30	0	30
9179	0	28	0	1	0	29
9180	0	0	0	31	0	31
9181	0	0	32	0	0	32
9182	0	0	0	32	0	32
9183	0	0	0	30	0	30
9184	30	0	0	0	0	30
9185	0	0	25	0	0	25
9186	30	0	0	0	0	30
9187	0	0	26	0	0	26
9188	0	0	0	27	0	27
9189	0	0	28	0	0	28
9190	0	0	24	0	0	24
9191	0	0	0	24	0	24
9192	26	0	0	0	0	26
9193	25	0	0	0	0	25
9194	0	28	0	0	0	28
9195	31	0	0	0	0	31
9196	30	0	0	0	0	30
9197	0	31	0	0	0	31
9198	0	0	0	33	0	33
9199	0	0	0	37	0	37
9200	0	0	0	38	0	38
9201	0	0	0	37	0	37
9202	0	0	38	0	0	38
9203	38	0	0	0	0	38
9204	0	0	0	38	0	38
9205	0	0	0	39	0	39
9206	0	37	0	0	0	37
9207	0	0	0	37	0	37
9208	0	0	36	0	0	36
9209	36	0	0	0	0	36
9210	0	1	34	0	0	35
9211	0	0	0	36	0	36
9212	34	0	0	0	0	34
9213	0	36	0	0	0	36
9214	0	0	0	36	0	36
9215	0	0	37	0	0	37
9216	0	0	0	37	0	37
9217	37	0	0	0	0	37
9218	0	0	34	0	0	34
9219	0	0	36	0	0	36
9220	0	37	0	0	0	37
9221	35	0	0	0	0	35
9222	0	37	1	0	0	38
9223	0	0	37	0	0	37
9224	0	0	36	0	0	36
9225	0	34	0	0	0	34
9226	38	0	0	0	0	38
9227	0	36	0	0	0	36
9228	0	0	0	39	0	39
9229	0	0	0	39	0	39
9230	0	0	34	0	0	34
9231	0	0	0	39	0	39
9232	0	0	37	0	0	37
9233	39	0	0	0	0	39
9234	38	0	0	0	0	38
9235	41	0	0	0	0	41
9236	0	0	40	0	0	40
9237	38	0	0	0	0	38
9238	0	0	0	39	0	39
9239	0	38	0	0	0	38
9240	36	0	0	0	0	36
9241	0	0	34	0	0	34
9242	36	0	0	0	0	36
9243	37	0	0	0	0	37
9244	0	0	36	0	0	36
9245	0	38	0	0	0	38
9246	0	0	0	41	0	41
9247	0	0	39	0	0	39
9248	0	0	39	0	0	39
9249	0	0	0	40	0	40
9250	0	0	41	0	0	41
9251	0	0	0	41	0	41
9252	0	0	0	39	0	39
9253	0	0	0	39	0	39
9254	0	0	42	0	0	42
9255	0	0	0	41	0	41
9256	0	0	39	0	0	39
9257	0	0	0	36	0	36
9258	38	0	0	0	0	38
9259	0	0	0	39	0	39
9260	0	37	0	0	0	37
9261	0	0	0	37	0	37
9262	36	0	0	0	0	36
9263	0	37	0	0	0	37
9264	0	0	0	37	0	37
9265	37	0	0	0	0	37
9266	0	0	39	0	0	39
9267	0	0	0	38	0	38
9268	0	0	38	0	0	38
9269	0	0	44	0	0	44
9270	0	0	0	44	0	44
9271	45	0	0	0	0	45
9272	0	0	47	0	0	47
9273	44	0	0	0	0	44
9274	0	0	0	45	0	45
9275	0	0	41	0	0	41
9276	0	0	40	0	0	40
9277	0	0	41	0	0	41
9278	0	0	0	43	0	43
9279	42	0	0	0	0	42
9280	0	41	0	0	0	41
9281	0	0	0	42	0	42
9282	0	0	0	43	0	43
9283	42	0	0	0	0	42
9284	35	0	0	1	0	36
9285	0	42	0	0	0	42
9286	42	0	0	0	0	42
9287	44	0	0	0	0	44
9288	0	0	0	39	0	39
9289	0	0	39	0	0	39
9290	40	0	0	0	0	40
9291	0	0	0	38	0	38
9292	0	0	0	35	0	35
9293	42	0	0	0	0	42
9294	0	0	0	41	0	41
9295	0	0	0	43	0	43
9296	43	0	0	0	0	43
9297	0	44	0	0	0	44
9298	44	0	0	0	0	44
9299	0	0	43	0	0	43
9300	46	0	0	0	0	46
9301	0	0	0	45	0	45
9302	0	44	0	0	0	44
9303	0	0	0	45	0	45
9304	0	0	0	46	0	46
9305	0	0	0	48	0	48
9306	47	0	0	0	0	47
9307	0	46	0	1	0	47
9308	0	46	0	0	0	46
9309	48	0	0	0	0	48
9310	0	0	47	0	0	47
9311	0	0	45	0	0	45
9312	48	0	0	0	0	48
9313	0	0	42	0	0	42
9314	0	0	0	45	0	45
9315	0	0	0	43	0	43
9316	0	0	0	44	0	44
9317	0	0	0	42	0	42
9318	0	46	0	0	0	46
9319	0	0	0	48	0	48
9320	0	0	48	0	0	48
9321	0	0	0	43	0	43
9322	0	0	46	0	0	46
9323	0	0	45	0	0	45
9324	0	0	0	47	0	47
9325	0	0	46	0	0	46
9326	0	0	0	47	0	47
9327	48	0	0	0	0	48
9328	0	0	46	0	0	46
9329	45	0	0	0	0	45
9330	0	0	0	46	0	46
9331	0	0	41	0	0	41
9332	0	40	0	0	0	40
9333	0	0	0	42	0	42
9334	0	0	45	0	0	45
9335	0	0	0	44	0	44
9336	47	0	0	0	0	47
9337	44	0	0	0	0	44
9338	46	0	0	0	0	46
9339	0	0	0	44	0	44
9340	0	0	0	45	0	45
9341	0	0	0	46	0	46
9342	46	0	0	0	0	46
9343	0	47	0	0	0	47
9344	0	0	0	49	0	49
9345	0	0	0	48	0	48
9346	48	0	0	0	0	48
9347	0	46	0	0	0	46
9348	0	0	0	50	0	50
9349	49	0	0	0	0	49
9350	50	0	0	0	0	50
9351	0	0	0	49	0	49
9352	49	0	0	0	0	49
9353	0	0	0	52	0	52
9354	0	0	54	0	0	54
9355	0	0	0	53	0	53
9356	0	0	0	55	0	55
9357	0	0	0	57	0	57
9358	51	0	0	0	0	51
9359	0	57	0	0	0	57
9360	54	0	0	0	0	54
9361	0	51	0	1	0	52
9362	0	47	0	0	0	47
9363	52	0	0	0	0	52
9364	0	53	0	0	0	53
9365	0	0	0	56	0	56
9366	55	0	0	0	0	55
9367	55	0	0	0	0	55
9368	0	0	0	53	0	53
9369	0	0	0	54	0	54
9370	0	54	0	0	0	54
9371	50	0	0	0	0	50
9372	52	0	0	0	0	52
9373	0	45	0	0	0	45
9374	0	44	0	0	0	44
9375	0	0	0	53	0	53
9376	51	0	0	0	0	51
9377	0	0	0	52	0	52
9378	0	0	0	51	0	51
9379	0	0	51	0	0	51
9380	0	0	48	0	0	48
9381	0	0	0	53	0	53
9382	0	0	46	0	0	46
9383	0	49	0	0	0	49
9384	0	1	0	54	0	55
9385	0	0	1	55	0	56
9386	0	0	0	48	0	48
9387	0	0	48	0	0	48
9388	0	0	44	0	0	44
9389	46	0	0	0	0	46
9390	0	45	0	0	0	45
9391	47	0	0	0	0	47
9392	0	0	0	47	0	47
9393	46	0	0	0	0	46
9394	0	0	0	43	0	43
9395	0	46	0	0	0	46
9396	48	0	0	0	0	48
9397	0	0	44	0	0	44
9398	0	46	0	0	0	46
9399	46	0	0	0	0	46
9400	0	0	0	46	0	46
9401	0	41	0	0	0	41
9402	0	0	0	43	0	43
9403	44	0	0	0	0	44
9404	0	0	0	45	0	45
9405	43	0	0	0	0	43
9406	0	0	45	0	0	45
9407	1	0	0	39	0	40
9408	39	0	0	0	0	39
9409	0	0	38	1	0	39
9410	0	39	0	0	0	39
9411	0	0	0	39	0	39
9412	0	0	46	0	0	46
9413	0	0	44	0	0	44
9414	0	0	0	47	0	47
9415	0	0	48	0	0	48
9416	0	0	47	0	0	47
9417	0	0	0	47	0	47
9418	47	0	0	0	0	47
9419	0	0	0	50	0	50
9420	0	0	0	47	0	47
9421	0	0	49	0	0	49
9422	0	0	0	49	0	49
9423	50	0	0	0	0	50
9424	0	0	50	0	0	50
9425	0	49	0	0	0	49
9426	0	0	0	50	0	50
9427	44	0	0	0	0	44
9428	0	0	1	47	0	48
9429	0	42	0	0	0	42
9430	0	0	52	0	0	52
9431	0	0	0	49	0	49
9432	52	0	0	0	0	52
9433	0	0	51	0	0	51
9434	0	0	0	51	0	51
9435	52	0	0	0	0	52
9436	51	0	1	0	0	52
9437	0	49	0	0	0	49
9438	50	1	4	1	0	56
9439	0	0	0	52	0	52
9440	0	0	49	0	0	49
9441	0	56	0	0	0	56
9442	0	59	0	0	0	59
9443	0	0	4	57	0	61
9444	0	0	0	57	0	57
9445	0	0	61	0	0	61
9446	0	55	0	0	0	55
9447	0	55	0	0	0	55
9448	0	0	0	60	0	60
9449	55	0	0	0	0	55
9450	0	57	0	0	0	57
9451	1	0	0	56	0	57
9452	53	0	0	0	0	53
9453	0	0	0	53	0	53
9454	0	0	0	54	0	54
9455	0	0	0	49	0	49
9456	0	0	0	48	0	48
9457	47	0	0	0	0	47
9458	0	0	0	47	0	47
9459	0	0	45	0	0	45
9460	47	0	0	0	0	47
9461	0	0	44	0	0	44
9462	0	0	46	0	0	46
9463	0	0	0	44	0	44
9464	0	0	0	47	0	47
9465	0	0	0	47	0	47
9466	49	0	0	0	0	49
9467	0	0	50	0	0	50
9468	50	0	0	0	0	50
9469	51	0	0	0	0	51
9470	0	0	46	0	0	46
9471	49	0	0	0	0	49
9472	0	0	51	0	0	51
9473	0	49	0	0	0	49
9474	0	0	0	50	0	50
9475	0	0	0	53	0	53
9476	0	0	0	51	0	51
9477	0	0	0	48	0	48
9478	0	0	51	0	0	51
9479	0	0	45	0	0	45
9480	0	0	0	50	0	50
9481	0	0	48	0	0	48
9482	51	0	0	0	0	51
9483	51	0	0	0	0	51
9484	0	0	0	53	0	53
9485	51	0	0	0	0	51
9486	0	52	0	0	0	52
9487	56	0	0	0	0	56
9488	0	0	51	0	0	51
9489	0	0	0	54	0	54
9490	0	60	0	0	0	60
9491	61	0	0	0	0	61
9492	0	0	0	62	0	62
9493	0	0	62	0	0	62
9494	0	0	0	62	0	62
9495	62	0	0	0	0	62
9496	0	0	63	0	0	63
9497	0	0	0	62	0	62
9498	0	0	0	63	0	63
9499	0	0	63	1	0	64
9500	0	60	0	0	0	60
9501	0	58	0	0	0	58
9502	0	0	0	64	0	64
9503	0	0	0	61	0	61
9504	0	0	0	63	0	63
9505	64	0	0	0	0	64
9506	60	0	0	0	0	60
9507	0	0	0	58	0	58
9508	55	0	0	0	0	55
9509	0	57	0	0	0	57
9510	0	0	0	57	0	57
9511	0	0	0	57	0	57
9512	0	0	0	57	0	57
9513	54	0	0	0	0	54
9514	0	55	0	0	0	55
9515	0	0	0	57	0	57
9516	56	1	0	0	0	57
9517	0	0	0	54	0	54
9518	0	0	0	59	0	59
9519	0	55	0	0	0	55
9520	0	62	0	0	0	62
9521	0	0	0	62	0	62
9522	0	0	0	64	0	64
9523	58	0	0	0	0	58
9524	0	0	0	55	0	55
9525	0	0	56	0	0	56
9526	0	0	0	59	0	59
9527	0	56	0	0	0	56
9528	56	0	0	0	0	56
9529	0	0	0	54	0	54
9530	0	0	0	53	0	53
9531	0	54	0	0	0	54
9532	53	0	0	0	0	53
9533	0	53	0	0	0	53
9534	0	0	0	52	0	52
9535	0	0	47	0	0	47
9536	0	0	0	49	0	49
9537	50	0	0	0	0	50
9538	0	48	0	0	0	48
9539	0	0	0	51	0	51
9540	0	49	0	0	0	49
9541	0	0	0	49	0	49
9542	0	0	53	0	0	53
9543	0	0	0	50	0	50
9544	0	0	0	52	0	52
9545	0	0	0	52	0	52
9546	54	0	0	0	0	54
9547	52	0	0	0	0	52
9548	0	50	0	0	0	50
9549	51	0	0	0	0	51
9550	0	52	0	0	0	52
9551	0	58	0	0	0	58
9552	57	0	0	0	0	57
9553	0	0	61	0	0	61
9554	0	0	0	64	0	64
9555	0	0	0	61	0	61
9556	0	0	0	62	0	62
9557	61	0	0	0	0	61
9558	0	62	0	0	0	62
9559	0	0	0	64	0	64
9560	0	58	0	0	0	58
9561	57	0	0	0	0	57
9562	0	0	0	63	0	63
9563	0	0	0	64	0	64
9564	0	60	0	0	0	60
9565	0	0	0	65	0	65
9566	0	0	0	70	0	70
9567	66	0	0	0	0	66
9568	0	61	0	0	0	61
9569	0	64	0	0	0	64
9570	0	0	0	69	0	69
9571	0	0	63	0	0	63
9572	0	0	62	0	0	62
9573	0	0	0	65	0	65
9574	0	0	60	0	0	60
9575	0	0	0	63	0	63
9576	0	0	0	63	0	63
9577	0	0	0	64	0	64
9578	63	0	0	0	0	63
9579	0	0	0	63	0	63
9580	0	0	0	62	0	62
9581	0	61	0	0	0	61
9582	0	0	0	61	0	61
9583	0	0	51	0	0	51
9584	0	0	0	53	0	53
9585	0	0	0	53	0	53
9586	53	0	0	0	0	53
9587	0	0	0	54	0	54
9588	0	0	0	53	0	53
9589	0	0	0	53	0	53
9590	44	0	0	0	0	44
9591	0	55	0	0	0	55
9592	0	0	0	55	0	55
9593	0	0	0	53	0	53
9594	0	0	51	0	0	51
9595	0	0	0	54	0	54
9596	52	0	0	0	0	52
9597	0	49	0	0	0	49
9598	0	0	0	55	0	55
9599	0	0	0	56	0	56
9600	0	0	53	0	0	53
9601	53	0	0	0	0	53
9602	0	58	0	0	0	58
9603	54	0	0	2	0	56
9604	0	0	0	58	0	58
9605	0	0	0	57	0	57
9606	0	0	0	59	0	59
9607	0	0	0	59	0	59
9608	59	0	0	0	0	59
9609	0	0	0	61	0	61
9610	0	63	0	0	0	63
9611	0	0	0	65	0	65
9612	0	0	0	61	0	61
9613	59	0	0	0	0	59
9614	0	56	0	0	0	56
9615	0	0	0	59	0	59
9616	57	0	0	0	0	57
9617	58	0	0	0	0	58
9618	0	0	0	59	0	59
9619	0	0	59	0	0	59
9620	57	0	0	0	0	57
9621	0	0	0	61	0	61
9622	0	0	63	0	0	63
9623	0	0	0	57	0	57
9624	0	0	0	62	0	62
9625	0	0	0	63	0	63
9626	0	62	0	0	0	62
9627	0	0	0	65	0	65
9628	0	0	0	66	0	66
9629	0	0	0	63	0	63
9630	0	0	0	62	0	62
9631	0	0	0	61	0	61
9632	0	0	0	67	0	67
9633	67	0	0	0	0	67
9634	0	0	63	0	0	63
9635	0	62	0	0	0	62
9636	65	0	0	0	0	65
9637	0	65	0	0	0	65
9638	65	0	0	0	0	65
9639	0	0	0	66	0	66
9640	62	0	0	0	0	62
9641	0	0	0	67	0	67
9642	0	0	0	69	0	69
9643	0	67	0	0	0	67
9644	64	0	0	0	0	64
9645	0	0	66	0	0	66
9646	0	0	0	58	0	58
9647	0	0	60	0	0	60
9648	0	1	55	0	0	56
9649	60	0	0	0	0	60
9650	0	0	0	58	0	58
9651	0	0	58	1	0	59
9652	0	0	57	1	0	58
9653	1	0	0	60	0	61
9654	0	0	0	60	0	60
9655	59	0	0	0	0	59
9656	0	0	0	58	0	58
9657	0	0	59	0	0	59
9658	0	0	0	55	0	55
9659	0	2	0	46	0	48
9660	0	56	0	0	0	56
9661	58	1	0	0	0	59
9662	0	57	0	0	0	57
9663	58	0	0	0	0	58
9664	0	58	0	0	0	58
9665	0	56	0	0	0	56
9666	0	0	0	60	0	60
9667	0	0	0	64	0	64
9668	0	0	0	65	0	65
9669	63	0	0	0	0	63
9670	0	0	64	0	0	64
9671	0	0	0	64	0	64
9672	60	1	0	1	0	62
9673	0	63	0	0	0	63
9674	0	57	0	0	0	57
9675	0	0	0	62	0	62
9676	0	0	0	62	0	62
9677	0	0	0	65	0	65
9678	0	61	0	0	0	61
9679	0	0	0	61	0	61
9680	0	0	60	0	0	60
9681	0	0	57	0	0	57
9682	64	0	0	0	0	64
9683	0	0	0	64	0	64
9684	62	0	0	0	0	62
9685	61	0	0	0	0	61
9686	1	57	0	0	0	58
9687	58	0	0	0	0	58
9688	57	0	0	0	0	57
9689	0	0	0	62	0	62
9690	0	0	0	66	0	66
9691	0	0	64	0	0	64
9692	0	65	0	0	0	65
9693	0	0	0	68	0	68
9694	0	0	0	67	0	67
9695	65	0	0	0	0	65
9696	0	0	0	62	0	62
9697	62	0	0	0	0	62
9698	0	0	0	63	0	63
9699	0	61	0	0	0	61
9700	63	0	0	0	0	63
9701	0	0	0	61	0	61
9702	0	0	0	63	0	63
9703	0	0	0	58	0	58
9704	0	0	61	0	0	61
9705	1	0	0	58	0	59
9706	63	0	0	0	0	63
9707	0	0	0	62	0	62
9708	0	0	0	63	0	63
9709	0	0	0	64	0	64
9710	0	61	0	0	0	61
9711	0	63	0	0	0	63
9712	64	0	0	0	0	64
9713	0	64	0	0	0	64
9714	63	0	0	0	0	63
9715	61	0	0	0	0	61
9716	60	0	0	0	0	60
9717	0	0	61	0	0	61
9718	0	62	0	0	0	62
9719	64	0	0	0	0	64
9720	0	0	0	61	0	61
9721	0	0	0	58	0	58
9722	0	0	0	62	0	62
9723	0	62	0	0	0	62
9724	0	0	0	63	0	63
9725	60	0	0	0	0	60
9726	0	0	0	58	0	58
9727	0	0	0	60	0	60
9728	0	0	61	0	0	61
9729	0	0	60	0	0	60
9730	1	0	0	71	0	72
9731	0	0	0	72	0	72
9732	0	69	0	0	0	69
9733	0	0	0	74	0	74
9734	0	0	0	72	0	72
9735	0	0	0	72	0	72
9736	69	0	0	0	0	69
9737	0	0	70	0	0	70
9738	0	0	0	75	0	75
9739	74	0	0	0	0	74
9740	73	0	0	0	0	73
9741	0	0	0	74	0	74
9742	0	0	0	74	0	74
9743	75	0	0	0	0	75
9744	0	75	0	0	0	75
9745	0	74	0	0	0	74
9746	0	0	0	72	0	72
9747	77	0	0	0	0	77
9748	78	0	0	0	0	78
9749	78	0	0	1	0	79
9750	0	0	80	0	0	80
9751	79	0	0	0	0	79
9752	0	0	77	0	0	77
9753	71	0	0	0	0	71
9754	0	70	0	0	0	70
9755	0	0	73	0	0	73
9756	0	0	0	78	0	78
9757	0	0	75	0	0	75
9758	0	0	0	78	0	78
9759	80	0	0	0	0	80
9760	0	0	76	0	0	76
9761	0	0	0	72	0	72
9762	0	73	0	0	0	73
9763	0	0	0	77	0	77
9764	1	0	0	76	0	77
9765	0	0	0	81	0	81
9766	79	0	0	1	0	80
9767	81	0	0	0	0	81
9768	0	0	0	81	0	81
9769	0	0	79	0	0	79
9770	0	0	79	0	0	79
9771	0	0	0	78	0	78
9772	0	0	84	0	0	84
9773	0	0	0	82	0	82
9774	0	0	0	81	0	81
9775	0	0	0	83	0	83
9776	0	78	0	0	0	78
9777	0	76	0	1	0	77
9778	0	0	0	89	0	89
9779	0	0	0	88	0	88
9780	0	0	0	90	0	90
9781	87	0	0	0	0	87
9782	0	0	88	0	0	88
9783	0	0	0	91	0	91
9784	87	0	0	0	0	87
9785	0	90	0	0	0	90
9786	0	0	0	90	0	90
9787	0	0	0	93	0	93
9788	0	0	0	95	0	95
9789	0	0	0	96	0	96
9790	0	0	103	0	0	103
9791	100	0	0	0	0	100
9792	104	0	0	0	0	104
9793	0	0	102	0	0	102
9794	102	1	0	0	0	103
9795	105	0	0	0	0	105
9796	0	0	99	0	0	99
9797	0	109	0	0	0	109
9798	0	0	0	111	0	111
9799	1	0	107	0	0	108
9800	0	106	0	0	0	106
9801	0	0	104	3	0	107
9802	0	108	0	0	0	108
9803	0	0	0	116	0	116
9804	0	0	107	0	0	107
9805	0	0	0	113	0	113
9806	0	0	116	0	0	116
9807	0	117	0	0	0	117
9808	118	2	0	0	0	120
9809	0	111	2	1	0	114
9810	0	109	0	0	0	109
9811	0	0	0	116	0	116
9812	0	0	0	116	0	116
9813	0	0	0	111	0	111
9814	1	0	0	108	0	109
9815	0	0	0	119	0	119
9816	0	0	119	0	0	119
9817	1	0	0	114	0	115
9818	1	0	0	115	0	116
9819	118	0	0	1	0	119
9820	119	0	0	0	0	119
9821	116	0	0	0	0	116
9822	0	0	0	115	0	115
9823	118	0	0	0	0	118
9824	118	0	0	0	0	118
9825	121	0	0	0	0	121
9826	0	0	116	0	0	116
9827	124	0	0	0	0	124
9828	120	0	0	0	0	120
9829	120	0	0	0	0	120
9830	0	0	0	123	0	123
9831	0	0	122	0	0	122
9832	0	0	0	117	0	117
9833	127	0	0	0	0	127
9834	0	0	0	128	0	128
9835	0	134	0	0	0	134
9836	0	0	0	142	0	142
9837	146	0	0	0	0	146
9838	147	0	0	0	0	147
9839	139	0	0	0	0	139
9840	0	0	137	0	0	137
9841	0	0	0	136	0	136
9842	0	0	0	146	0	146
9843	0	0	137	0	0	137
9844	0	136	0	0	0	136
9845	0	0	150	0	0	150
9846	0	0	0	150	0	150
9847	155	0	0	0	0	155
9848	0	0	152	0	0	152
9849	0	0	0	139	0	139
9850	0	0	148	0	0	148
9851	146	0	0	0	0	146
9852	0	0	0	145	0	145
9853	0	0	145	0	0	145
9854	0	0	0	149	0	149
9855	0	0	148	0	0	148
9856	0	143	0	0	0	143
9857	0	0	0	146	0	146
9858	144	0	0	0	0	144
9859	0	0	0	147	0	147
9860	0	0	0	146	0	146
9861	142	0	0	0	0	142
9862	0	140	0	0	0	140
9863	0	139	0	0	0	139
9864	0	0	0	142	0	142
9865	0	139	0	0	0	139
9866	0	0	0	139	0	139
9867	0	0	0	139	0	139
9868	138	0	0	0	0	138
9869	0	134	0	0	0	134
9870	0	0	128	1	0	129
9871	0	130	1	0	0	131
9872	136	0	0	0	0	136
9873	135	0	0	0	0	135
9874	0	0	0	135	0	135
9875	130	0	0	0	0	130
9876	0	0	0	129	0	129
9877	126	0	0	0	0	126
9878	123	0	0	0	0	123
9879	0	1	1	121	0	123
9880	124	0	0	0	0	124
9881	4	0	119	0	0	123
9882	130	0	0	0	0	130
9883	0	0	0	122	0	122
9884	122	0	0	0	0	122
9885	0	119	0	0	0	119
9886	0	0	0	118	0	118
9887	0	0	0	118	0	118
9888	114	0	0	0	0	114
9889	0	0	114	0	0	114
9890	0	111	0	0	0	111
9891	0	0	0	116	0	116
9892	0	110	0	1	0	111
9893	0	0	0	113	0	113
9894	0	0	0	110	0	110
9895	0	0	0	112	0	112
9896	106	0	0	0	0	106
9897	0	0	0	107	0	107
9898	108	0	0	0	0	108
9899	105	0	0	0	0	105
9900	0	0	0	102	0	102
9901	106	0	0	0	0	106
9902	106	0	0	0	0	106
9903	0	0	104	0	0	104
9904	0	0	0	105	0	105
9905	102	0	0	0	0	102
9906	0	104	0	0	0	104
9907	109	0	0	0	0	109
9908	106	0	0	0	0	106
9909	0	0	116	0	0	116
9910	0	0	0	106	0	106
9911	121	0	0	0	0	121
9912	0	0	0	120	0	120
9913	0	0	0	133	0	133
9914	0	0	0	135	0	135
9915	0	0	0	134	0	134
9916	129	0	0	0	0	129
9917	0	0	137	0	0	137
9918	0	0	0	154	0	154
9919	0	1	153	0	0	154
9920	0	0	160	0	0	160
9921	164	0	0	0	0	164
9922	0	0	154	0	0	154
9923	0	162	0	0	0	162
9924	169	0	0	0	0	169
9925	168	0	0	0	0	168
9926	0	0	0	169	0	169
9927	0	0	168	0	0	168
9928	0	0	153	0	0	153
9929	154	2	0	0	0	156
9930	0	0	0	152	0	152
9931	150	0	0	1	0	151
9932	0	154	0	0	0	154
9933	150	0	0	0	0	150
9934	146	0	0	0	0	146
9935	0	149	0	0	0	149
9936	0	0	0	151	0	151
9937	148	0	0	0	0	148
9938	0	0	144	0	0	144
9939	0	142	0	0	0	142
9940	0	0	0	142	0	142
9941	142	0	0	0	0	142
9942	0	144	0	0	0	144
9943	139	0	0	0	0	139
9944	0	0	135	0	0	135
9945	136	0	0	0	0	136
9946	0	0	135	0	0	135
9947	136	0	0	0	0	136
9948	133	1	0	0	0	134
9949	0	0	128	0	0	128
9950	0	131	0	0	0	131
9951	0	0	0	136	0	136
9952	0	0	132	0	0	132
9953	0	131	0	0	0	131
9954	0	0	0	134	0	134
9955	0	0	0	135	0	135
9956	0	0	135	0	0	135
9957	0	0	1	132	0	133
9958	0	0	0	137	0	137
9959	0	0	136	0	0	136
9960	0	0	0	136	0	136
9961	0	132	0	0	0	132
9962	135	0	0	0	0	135
9963	0	0	0	132	0	132
9964	0	135	0	0	0	135
9965	0	0	0	139	0	139
9966	0	143	0	0	0	143
9967	0	0	147	0	0	147
9968	0	149	0	0	0	149
9969	152	0	0	0	0	152
9970	159	0	0	0	0	159
9971	157	0	0	0	0	157
9972	0	0	153	0	0	153
9973	0	0	146	1	0	147
9974	0	152	0	0	0	152
9975	0	0	0	157	0	157
9976	0	159	0	0	0	159
9977	0	0	0	160	0	160
9978	0	163	0	0	0	163
9979	164	0	0	0	0	164
9980	162	0	0	0	0	162
9981	0	0	0	168	0	168
9982	0	0	159	0	0	159
9983	158	0	0	1	0	159
9984	0	160	0	0	0	160
9985	2	0	0	158	0	160
9986	0	0	0	163	0	163
9987	0	169	0	0	0	169
9988	172	0	0	0	0	172
9989	1	0	167	0	0	168
9990	0	0	0	169	0	169
9991	167	0	0	0	0	167
9992	167	0	0	0	0	167
9993	0	158	1	0	0	159
9994	0	0	0	162	0	162
9995	0	160	0	0	0	160
9996	163	0	0	0	0	163
9997	0	0	164	0	0	164
9998	1	0	155	1	0	157
9999	1	0	0	157	0	158
10000	0	0	1	167	0	168
10001	0	158	1	0	0	159
10002	0	0	0	166	0	166
10003	0	0	159	0	0	159
10004	153	0	0	0	0	153
10005	0	0	0	153	0	153
10006	0	0	142	0	0	142
10007	0	0	0	135	0	135
10008	0	0	0	140	0	140
10009	0	134	0	0	0	134
10010	0	0	0	129	0	129
10011	0	0	0	103	0	103
10012	0	0	0	103	0	103
10013	84	0	0	0	0	84
10014	0	89	0	0	0	89
10015	0	93	0	0	0	93
10016	84	0	0	0	0	84
10017	75	0	1	1	0	77
10018	0	77	0	1	0	78
10019	0	79	1	0	0	80
10020	73	0	0	0	0	73
10021	0	78	0	0	0	78
10022	0	78	0	0	0	78
10023	80	0	0	0	0	80
10024	0	78	0	0	0	78
10025	76	0	0	0	0	76
10026	76	0	0	0	0	76
10027	74	0	0	0	0	74
10028	0	73	0	0	0	73
10029	0	73	0	0	0	73
10030	0	0	0	77	0	77
10031	0	78	0	0	0	78
10032	0	0	0	80	0	80
10033	73	0	0	0	0	73
10034	0	0	0	80	0	80
10035	0	69	0	0	0	69
10036	74	0	0	0	0	74
10037	0	71	0	0	0	71
10038	0	72	0	0	0	72
10039	0	0	0	75	0	75
10040	0	76	0	0	0	76
10041	80	0	0	0	0	80
10042	0	0	77	0	0	77
10043	0	76	0	0	0	76
10044	0	0	0	78	0	78
10045	0	0	77	0	0	77
10046	0	0	0	78	0	78
10047	0	0	0	73	0	73
10048	0	0	0	77	0	77
10049	0	0	0	84	0	84
10050	0	0	80	0	0	80
10051	0	81	0	0	0	81
10052	81	0	0	0	0	81
10053	0	0	78	0	0	78
10054	85	0	0	0	0	85
10055	0	0	83	0	0	83
10056	0	0	0	85	0	85
10057	0	0	82	0	0	82
10058	0	0	87	0	0	87
10059	0	0	0	79	0	79
10060	0	0	0	77	0	77
10061	0	0	0	78	0	78
10062	0	0	0	78	0	78
10063	71	0	0	0	0	71
10064	0	0	68	0	0	68
10065	66	0	0	0	0	66
10066	64	0	0	0	0	64
10067	65	0	0	0	0	65
10068	61	0	0	0	0	61
10069	63	0	0	0	0	63
10070	0	0	0	65	0	65
10071	0	0	57	0	0	57
10072	0	0	55	0	0	55
10073	0	59	0	0	0	59
10074	56	0	0	0	0	56
10075	0	0	0	52	0	52
10076	0	0	0	56	0	56
10077	0	50	0	0	0	50
10078	0	52	0	0	0	52
10079	0	48	0	0	0	48
10080	46	0	0	0	0	46
10081	0	0	0	45	0	45
10082	0	44	0	0	0	44
10083	0	0	0	41	0	41
10084	0	0	45	0	0	45
10085	0	0	46	0	0	46
10086	0	0	0	43	0	43
10087	43	0	0	0	0	43
10088	43	0	0	0	0	43
10089	43	0	0	0	0	43
10090	0	0	43	0	0	43
10091	0	0	0	43	0	43
10092	0	0	0	44	0	44
10093	0	0	42	0	0	42
10094	42	0	0	0	0	42
10095	0	0	42	0	0	42
10096	0	0	40	0	0	40
10097	0	0	38	0	0	38
10098	0	0	0	39	0	39
10099	0	0	0	40	0	40
10100	0	0	42	0	0	42
10101	0	0	0	40	0	40
10102	42	0	0	0	0	42
10103	0	0	0	46	0	46
10104	0	0	46	0	0	46
10105	0	0	43	0	0	43
10106	0	0	0	44	0	44
10107	45	0	0	0	0	45
10108	0	47	0	0	0	47
10109	47	0	0	0	0	47
10110	47	0	0	0	0	47
10111	0	0	47	0	0	47
10112	0	0	0	47	0	47
10113	49	0	0	0	0	49
10114	47	0	0	0	0	47
10115	0	48	0	0	0	48
10116	0	0	0	47	0	47
10117	0	0	0	50	0	50
10118	0	0	50	0	0	50
10119	1	0	0	48	0	49
10120	0	0	46	0	0	46
10121	0	0	45	0	0	45
10122	0	0	0	47	0	47
10123	45	0	0	0	0	45
10124	0	45	0	0	0	45
10125	45	0	0	0	0	45
10126	45	0	0	0	0	45
10127	0	44	0	0	0	44
10128	0	0	0	43	0	43
10129	43	0	0	0	0	43
10130	0	45	0	0	0	45
10131	44	0	0	0	0	44
10132	0	46	0	0	0	46
10133	0	0	0	49	0	49
10134	0	0	0	47	0	47
10135	52	0	0	0	0	52
10136	49	0	0	0	0	49
10137	0	52	0	0	0	52
10138	0	0	51	1	0	52
10139	0	0	52	0	0	52
10140	0	0	0	56	0	56
10141	0	55	0	0	0	55
10142	0	0	0	58	0	58
10143	0	0	1	56	0	57
10144	0	0	0	58	0	58
10145	0	0	57	0	0	57
10146	0	0	53	0	0	53
10147	0	59	0	0	0	59
10148	0	0	0	63	0	63
10149	0	0	0	63	0	63
10150	0	0	58	0	0	58
10151	56	0	0	0	0	56
10152	0	0	0	58	0	58
10153	0	0	59	0	0	59
10154	57	0	0	0	0	57
10155	0	57	0	0	0	57
10156	0	0	59	0	0	59
10157	0	0	0	55	0	55
10158	55	0	0	0	0	55
10159	0	0	55	0	0	55
10160	0	0	0	52	0	52
10161	0	0	0	53	0	53
10162	0	0	0	54	0	54
10163	55	0	0	0	0	55
10164	0	54	0	0	0	54
10165	0	0	0	55	0	55
10166	0	0	59	0	0	59
10167	0	0	0	55	0	55
10168	0	53	0	0	0	53
10169	0	58	0	0	0	58
10170	61	0	0	0	0	61
10171	60	0	0	0	0	60
10172	0	0	59	0	0	59
10173	59	0	0	0	0	59
10174	0	61	0	0	0	61
10175	65	0	0	0	0	65
10176	0	0	0	64	0	64
10177	0	0	60	0	0	60
10178	0	0	0	62	0	62
10179	0	0	61	0	0	61
10180	66	0	0	0	0	66
10181	0	0	0	64	0	64
10182	0	65	0	0	0	65
10183	0	0	0	65	0	65
10184	0	0	67	0	0	67
10185	0	67	0	0	0	67
10186	67	0	0	0	0	67
10187	0	63	0	0	0	63
10188	0	67	0	0	0	67
10189	0	0	0	68	0	68
10190	0	64	0	0	0	64
10191	0	0	0	69	0	69
10192	0	0	67	0	0	67
10193	66	0	0	0	0	66
10194	70	0	0	0	0	70
10195	0	0	67	0	0	67
10196	69	0	0	0	0	69
10197	0	69	0	0	0	69
10198	65	0	0	0	0	65
10199	0	0	0	68	0	68
10200	0	0	66	0	0	66
10201	0	67	0	0	0	67
10202	0	0	0	68	0	68
10203	0	0	0	68	0	68
10204	65	0	0	0	0	65
10205	67	0	0	0	0	67
10206	0	60	0	0	0	60
10207	0	55	0	1	0	56
10208	0	63	0	0	0	63
10209	0	0	0	63	0	63
10210	61	0	0	0	0	61
10211	63	0	0	0	0	63
10212	0	0	0	59	0	59
10213	0	0	0	62	0	62
10214	60	0	0	0	0	60
10215	0	0	0	63	0	63
10216	0	0	62	0	0	62
10217	65	0	0	0	0	65
10218	65	0	0	0	0	65
10219	0	0	62	0	0	62
10220	64	0	0	0	0	64
10221	0	0	0	65	0	65
10222	0	0	0	62	0	62
10223	0	0	0	63	0	63
10224	64	0	0	0	0	64
10225	0	62	0	0	0	62
10226	0	0	0	60	0	60
10227	0	59	0	0	0	59
10228	55	0	0	0	0	55
10229	0	0	0	52	0	52
10230	0	0	0	53	0	53
10231	0	54	0	0	0	54
10232	0	0	49	0	0	49
10233	0	0	0	50	0	50
10234	50	0	0	0	0	50
10235	47	0	0	0	0	47
10236	0	0	49	0	0	49
10237	0	0	0	45	0	45
10238	0	46	0	0	0	46
10239	0	0	0	52	0	52
10240	50	0	0	0	0	50
10241	49	0	0	0	0	49
10242	0	0	0	47	0	47
10243	0	49	0	0	0	49
10244	50	0	0	1	0	51
10245	0	0	0	50	0	50
10246	49	0	0	0	0	49
10247	47	0	0	0	0	47
10248	0	0	0	50	0	50
10249	0	0	0	50	0	50
10250	0	0	0	48	0	48
10251	0	51	0	0	0	51
10252	0	0	0	51	0	51
10253	0	0	0	51	0	51
10254	0	0	49	0	0	49
10255	0	0	55	0	0	55
10256	0	0	0	56	0	56
10257	56	0	0	0	0	56
10258	0	55	0	0	0	55
10259	53	0	0	0	0	53
10260	0	0	58	0	0	58
10261	0	0	52	0	0	52
10262	0	51	0	0	0	51
10263	0	0	0	52	0	52
10264	0	0	53	0	0	53
10265	0	0	50	0	0	50
10266	0	0	0	52	0	52
10267	50	0	0	0	0	50
10268	47	0	0	0	0	47
10269	0	0	0	44	0	44
10270	0	0	51	0	0	51
10271	0	0	0	50	0	50
10272	0	0	0	53	0	53
10273	0	48	0	0	0	48
10274	48	0	0	0	0	48
10275	48	0	0	0	0	48
10276	0	47	1	0	0	48
10277	0	0	0	43	0	43
10278	0	45	0	0	0	45
10279	46	0	0	0	0	46
10280	0	0	45	1	0	46
10281	0	0	43	0	0	43
10282	0	0	45	0	0	45
10283	0	0	0	47	0	47
10284	0	0	0	41	0	41
10285	45	0	0	0	0	45
10286	0	0	0	46	0	46
10287	0	0	0	44	0	44
10288	0	0	36	0	0	36
10289	0	0	42	0	0	42
10290	42	0	0	0	0	42
10291	0	37	0	0	0	37
10292	41	0	0	0	0	41
10293	0	0	0	40	0	40
10294	0	0	0	43	0	43
10295	0	43	0	0	0	43
10296	0	0	0	44	0	44
10297	44	0	0	0	0	44
10298	0	0	0	44	0	44
10299	0	0	37	0	0	37
10300	0	44	0	0	0	44
10301	43	0	0	0	0	43
10302	40	0	0	0	0	40
10303	45	0	0	0	0	45
10304	41	0	0	0	0	41
10305	0	0	0	45	0	45
10306	0	0	0	46	0	46
10307	0	0	46	0	0	46
10308	0	0	0	44	0	44
10309	0	0	44	0	0	44
10310	0	0	0	44	0	44
10311	43	0	0	0	0	43
10312	0	42	0	0	0	42
10313	0	0	0	42	0	42
10314	0	0	0	39	0	39
10315	41	0	0	0	0	41
10316	39	0	0	0	0	39
10317	0	0	39	0	0	39
10318	0	40	0	0	0	40
10319	0	0	0	38	0	38
10320	0	0	0	37	0	37
10321	39	0	0	0	0	39
10322	38	0	0	0	0	38
10323	0	0	38	0	0	38
10324	0	0	38	0	0	38
10325	0	0	0	37	0	37
10326	0	0	0	37	0	37
10327	0	0	41	0	0	41
10328	40	0	0	0	0	40
10329	0	0	0	39	0	39
10330	39	0	0	0	0	39
10331	0	38	0	0	0	38
10332	34	0	0	0	0	34
10333	0	0	37	0	0	37
10334	0	33	0	2	0	35
10335	0	32	0	0	0	32
10336	32	0	0	0	0	32
10337	29	0	0	0	0	29
10338	0	0	0	31	0	31
10339	0	30	0	0	0	30
10340	0	30	0	0	0	30
10341	0	0	0	30	0	30
10342	29	0	0	0	0	29
10343	30	0	0	0	0	30
10344	0	0	29	0	0	29
10345	32	0	0	0	0	32
10346	0	32	0	0	0	32
10347	33	0	0	0	0	33
10348	0	26	0	0	0	26
10349	0	27	0	0	0	27
10350	0	0	0	34	0	34
10351	34	0	0	0	0	34
10352	33	0	0	0	0	33
10353	0	0	35	0	0	35
10354	0	0	0	33	0	33
10355	40	0	0	0	0	40
10356	0	0	0	42	0	42
10357	41	0	0	0	0	41
10358	41	0	0	0	0	41
10359	0	0	43	0	0	43
10360	0	0	0	43	0	43
10361	0	0	0	44	0	44
10362	0	0	0	44	0	44
10363	0	0	40	0	0	40
10364	0	0	0	39	0	39
10365	0	0	0	38	0	38
10366	0	39	0	0	0	39
10367	0	0	37	0	0	37
10368	0	36	0	0	0	36
10369	40	0	0	0	0	40
10370	0	0	0	40	0	40
10371	0	0	0	41	0	41
10372	0	39	0	0	0	39
10373	39	0	0	0	0	39
10374	35	0	0	0	0	35
10375	0	37	0	0	0	37
10376	0	42	0	0	0	42
10377	45	0	0	0	0	45
10378	0	0	41	0	0	41
10379	0	1	40	0	0	41
10380	45	0	0	0	0	45
10381	0	46	0	0	0	46
10382	46	0	0	0	0	46
10383	0	0	40	1	0	41
10384	46	0	0	0	0	46
10385	0	48	0	0	0	48
10386	0	0	0	52	0	52
10387	0	0	0	50	0	50
10388	0	0	0	49	0	49
10389	0	0	0	49	0	49
10390	0	0	0	52	0	52
10391	0	56	0	0	0	56
10392	57	0	0	0	0	57
10393	0	0	56	0	0	56
10394	0	0	0	56	0	56
10395	0	0	54	0	0	54
10396	0	0	0	53	0	53
10397	0	0	0	54	0	54
10398	53	0	0	0	0	53
10399	0	0	53	0	0	53
10400	0	51	0	0	0	51
10401	0	0	0	54	0	54
10402	0	0	0	54	0	54
10403	0	0	54	0	0	54
10404	0	0	0	52	0	52
10405	0	0	0	50	0	50
10406	52	0	0	1	0	53
10407	0	55	0	0	0	55
10408	54	0	0	0	0	54
10409	55	0	0	0	0	55
10410	0	0	0	56	0	56
10411	0	0	54	0	0	54
10412	0	0	52	0	0	52
10413	0	0	0	55	0	55
10414	0	0	0	56	0	56
10415	0	55	0	0	0	55
10416	57	0	0	0	0	57
10417	0	55	0	0	0	55
10418	0	57	0	0	0	57
10419	57	0	0	0	0	57
10420	0	0	0	58	0	58
10421	0	63	0	0	0	63
10422	0	0	0	62	0	62
10423	0	0	58	0	0	58
10424	0	0	55	0	0	55
10425	0	0	0	64	0	64
10426	0	0	61	0	0	61
10427	0	0	0	64	0	64
10428	0	0	0	66	0	66
10429	0	0	0	65	0	65
10430	66	0	0	0	0	66
10431	0	55	0	0	0	55
10432	0	63	0	0	0	63
10433	66	0	0	0	0	66
10434	65	0	0	0	0	65
10435	0	0	0	64	0	64
10436	0	0	68	0	0	68
10437	0	0	0	64	0	64
10438	0	0	61	0	0	61
10439	0	60	0	0	0	60
10440	0	2	0	58	0	60
10441	58	0	2	0	0	60
10442	0	0	0	61	0	61
10443	0	0	52	0	0	52
10444	52	6	0	0	0	58
10445	0	0	57	0	0	57
10446	0	0	50	0	0	50
10447	0	52	0	0	0	52
10448	6	36	0	0	0	42
10449	0	49	0	0	0	49
10450	39	0	0	0	0	39
10451	41	0	0	0	0	41
10452	0	0	0	38	0	38
10453	0	0	0	42	0	42
10454	0	0	0	42	0	42
10455	0	43	0	0	0	43
10456	41	0	0	0	0	41
10457	0	42	0	0	0	42
10458	0	0	0	42	0	42
10459	43	0	0	0	0	43
10460	0	0	0	43	0	43
10461	0	0	0	43	0	43
10462	43	0	0	0	0	43
10463	42	0	0	0	0	42
10464	0	0	39	0	0	39
10465	0	0	38	0	0	38
10466	0	0	42	0	0	42
10467	0	0	0	41	0	41
10468	0	0	0	38	0	38
10469	0	34	0	0	0	34
10470	35	0	0	0	0	35
10471	0	0	0	35	0	35
10472	0	0	0	34	0	34
10473	0	34	0	0	0	34
10474	0	37	0	0	0	37
10475	0	0	0	39	0	39
10476	0	0	0	39	0	39
10477	38	0	0	0	0	38
10478	34	0	0	0	0	34
10479	0	0	0	34	0	34
10480	0	0	33	0	0	33
10481	0	0	30	0	0	30
10482	0	0	0	32	0	32
10483	0	0	0	33	0	33
10484	0	29	0	0	0	29
10485	30	0	0	0	0	30
10486	0	0	0	31	0	31
10487	0	1	29	0	0	30
10488	0	0	0	31	0	31
10489	0	0	31	0	0	31
10490	0	0	31	0	0	31
10491	0	0	0	32	0	32
10492	32	0	0	0	0	32
10493	0	0	32	0	0	32
10494	0	0	0	34	0	34
10495	0	0	36	0	0	36
10496	0	0	0	35	0	35
10497	0	0	0	35	0	35
10498	0	0	34	0	0	34
10499	0	0	34	0	0	34
10500	0	0	0	31	0	31
10501	0	0	0	33	0	33
10502	0	0	1	30	0	31
10503	0	0	0	32	0	32
10504	33	0	0	0	0	33
10505	30	0	0	0	0	30
10506	0	31	0	0	0	31
10507	32	0	0	0	0	32
10508	0	0	0	31	0	31
10509	32	0	0	0	0	32
10510	0	0	31	0	0	31
10511	30	0	0	0	0	30
10512	0	0	0	35	0	35
10513	0	0	0	30	0	30
10514	29	0	0	0	0	29
10515	0	0	0	27	0	27
10516	0	0	27	0	0	27
10517	27	0	0	0	0	27
10518	0	27	0	0	0	27
10519	0	0	0	27	0	27
10520	0	0	22	0	0	22
10521	0	0	0	24	0	24
10522	0	0	23	0	0	23
10523	0	0	0	23	0	23
10524	0	25	0	0	0	25
10525	0	0	0	27	0	27
10526	0	25	0	0	0	25
10527	0	0	0	27	0	27
10528	0	0	0	27	0	27
10529	0	0	0	25	0	25
10530	0	0	0	26	0	26
10531	0	0	0	24	0	24
10532	0	0	25	0	0	25
10533	0	0	0	25	0	25
10534	0	0	0	23	0	23
10535	21	0	0	0	0	21
10536	0	25	0	0	0	25
10537	25	0	0	0	0	25
10538	0	0	0	25	0	25
10539	0	0	24	0	0	24
10540	0	24	0	0	0	24
10541	24	0	0	0	0	24
10542	0	23	0	0	0	23
10543	0	25	0	0	0	25
10544	26	0	0	0	0	26
10545	1	0	0	25	0	26
10546	24	0	0	0	0	24
10547	0	0	0	26	0	26
10548	0	0	28	0	0	28
10549	0	0	28	0	0	28
10550	27	0	0	0	0	27
10551	27	0	0	0	0	27
10552	0	0	0	24	0	24
10553	0	0	0	26	0	26
10554	26	0	0	0	0	26
10555	0	27	0	0	0	27
10556	0	26	0	0	0	26
10557	28	0	0	0	0	28
10558	31	0	0	0	0	31
10559	0	29	0	0	0	29
10560	0	0	0	31	0	31
10561	0	0	31	0	0	31
10562	0	0	31	0	0	31
10563	29	0	0	0	0	29
10564	0	0	31	0	0	31
10565	0	0	0	30	0	30
10566	0	0	0	31	0	31
10567	0	26	0	0	0	26
10568	26	0	0	0	0	26
10569	0	0	0	26	0	26
10570	0	0	24	0	0	24
10571	0	26	0	0	0	26
10572	0	0	0	28	0	28
10573	0	0	27	0	0	27
10574	0	0	24	0	0	24
10575	0	25	0	0	0	25
10576	26	0	0	0	0	26
10577	0	26	0	0	0	26
10578	23	0	0	0	0	23
10579	0	0	23	0	0	23
10580	24	0	0	0	0	24
10581	0	24	0	0	0	24
10582	0	0	0	25	0	25
10583	0	0	0	26	0	26
10584	26	0	0	0	0	26
10585	0	0	25	0	0	25
10586	26	0	0	0	0	26
10587	26	0	0	0	0	26
10588	0	0	23	0	0	23
10589	0	0	30	0	0	30
10590	0	0	0	24	0	24
10591	30	0	0	0	0	30
10592	28	0	0	0	0	28
10593	0	30	0	0	0	30
10594	0	0	0	29	0	29
10595	0	0	0	30	0	30
10596	0	0	0	28	0	28
10597	0	0	0	28	0	28
10598	28	0	0	0	0	28
10599	0	0	0	28	0	28
10600	0	0	27	0	0	27
10601	0	0	26	0	0	26
10602	28	0	0	0	0	28
10603	0	23	0	1	0	24
10604	0	29	0	0	0	29
10605	0	0	0	24	0	24
10606	0	0	0	26	0	26
10607	0	0	0	25	0	25
10608	0	0	0	25	0	25
10609	0	0	20	0	0	20
10610	0	0	0	21	0	21
10611	0	0	0	21	0	21
10612	0	0	21	0	0	21
10613	21	0	0	0	0	21
10614	0	21	0	0	0	21
10615	17	0	0	0	0	17
10616	0	0	19	0	0	19
10617	0	0	16	0	0	16
10618	0	18	0	0	0	18
10619	18	0	0	0	0	18
10620	17	0	0	0	0	17
10621	18	0	0	0	0	18
10622	0	16	0	0	0	16
10623	17	0	0	0	0	17
10624	0	0	18	0	0	18
10625	0	22	0	0	0	22
10626	20	0	0	0	0	20
10627	0	21	0	0	0	21
10628	22	0	0	0	0	22
10629	20	0	0	0	0	20
10630	0	0	22	0	0	22
10631	0	22	0	0	0	22
10632	23	0	0	0	0	23
10633	0	0	22	0	0	22
10634	0	22	0	0	0	22
10635	0	0	0	23	0	23
10636	0	0	21	0	0	21
10637	0	0	20	0	0	20
10638	0	0	0	20	0	20
10639	20	0	0	0	0	20
10640	0	21	0	0	0	21
10641	0	0	22	0	0	22
10642	0	0	22	0	0	22
10643	20	0	0	0	0	20
10644	0	19	0	0	0	19
10645	22	0	0	0	0	22
10646	0	21	0	0	0	21
10647	22	0	0	0	0	22
10648	21	0	0	0	0	21
10649	0	22	0	0	0	22
10650	0	0	0	22	0	22
10651	20	0	0	0	0	20
10652	0	0	0	19	0	19
10653	0	0	0	20	0	20
10654	20	0	0	0	0	20
10655	0	20	0	0	0	20
10656	23	0	0	0	0	23
10657	0	0	24	0	0	24
10658	0	0	0	25	0	25
10659	0	0	0	24	0	24
10660	24	0	0	0	0	24
10661	24	0	0	0	0	24
10662	0	0	0	23	0	23
10663	0	0	22	0	0	22
10664	0	0	0	24	0	24
10665	0	0	0	27	0	27
10666	0	0	0	27	0	27
10667	0	0	0	25	0	25
10668	26	0	0	0	0	26
10669	0	0	26	0	0	26
10670	0	22	0	0	0	22
10671	0	0	0	26	0	26
10672	0	0	0	26	0	26
10673	0	0	23	0	0	23
10674	0	0	23	0	0	23
10675	0	0	0	24	0	24
10676	0	0	0	24	0	24
10677	0	0	24	0	0	24
10678	0	0	0	24	0	24
10679	24	0	0	0	0	24
10680	0	23	0	0	0	23
10681	0	0	23	0	0	23
10682	0	23	0	0	0	23
10683	0	0	0	23	0	23
10684	0	0	20	0	0	20
10685	0	20	0	0	0	20
10686	0	0	0	21	0	21
10687	0	0	21	0	0	21
10688	0	0	0	20	0	20
10689	0	0	0	21	0	21
10690	21	0	0	0	0	21
10691	0	0	0	21	0	21
10692	21	0	0	0	0	21
10693	22	0	0	0	0	22
10694	22	0	0	0	0	22
10695	0	0	0	24	0	24
10696	0	0	24	0	0	24
10697	0	0	22	0	0	22
10698	23	0	0	0	0	23
10699	0	0	22	0	0	22
10700	23	0	0	0	0	23
10701	0	23	0	0	0	23
10702	24	0	0	0	0	24
10703	0	0	21	0	0	21
10704	0	0	24	0	0	24
10705	0	0	0	24	0	24
10706	0	0	24	0	0	24
10707	0	0	24	0	0	24
10708	0	0	0	21	0	21
10709	0	0	0	22	0	22
10710	0	0	0	22	0	22
10711	0	21	0	0	0	21
10712	0	0	0	21	0	21
10713	0	22	0	0	0	22
10714	23	0	0	0	0	23
10715	23	0	0	0	0	23
10716	0	0	0	23	0	23
10717	0	23	0	0	0	23
10718	0	0	18	0	0	18
10719	19	0	0	0	0	19
10720	0	0	0	15	0	15
10721	0	0	0	19	0	19
10722	0	0	0	18	0	18
10723	18	0	0	0	0	18
10724	0	15	0	0	0	15
10725	0	18	0	0	0	18
10726	17	0	0	0	0	17
10727	0	18	0	0	0	18
10728	18	0	0	0	0	18
10729	17	0	0	0	0	17
10730	0	17	0	0	0	17
10731	0	0	0	19	0	19
10732	0	19	0	0	0	19
10733	0	0	0	17	0	17
10734	0	0	0	17	0	17
10735	17	0	0	0	0	17
10736	17	0	0	0	0	17
10737	0	0	0	17	0	17
10738	0	0	18	0	0	18
10739	18	0	0	0	0	18
10740	0	17	0	0	0	17
10741	0	0	0	17	0	17
10742	0	0	0	18	0	18
10743	0	0	0	17	0	17
10744	18	0	0	0	0	18
10745	18	0	0	0	0	18
10746	0	14	0	0	0	14
10747	0	17	0	0	0	17
10748	0	0	0	16	0	16
10749	0	0	0	15	0	15
10750	0	0	13	0	0	13
10751	0	0	0	13	0	13
10752	0	0	15	0	0	15
10753	0	0	13	0	0	13
10754	0	14	0	0	0	14
10755	0	0	0	13	0	13
10756	13	0	0	0	0	13
10757	0	0	0	12	0	12
10758	0	0	9	0	0	9
10759	8	0	0	0	0	8
10760	9	0	0	0	0	9
10761	0	0	9	0	0	9
10762	0	0	0	9	0	9
10763	9	0	0	0	0	9
10764	0	11	0	0	0	11
10765	12	0	0	0	0	12
10766	11	0	0	0	0	11
10767	0	0	0	12	0	12
10768	0	0	0	11	0	11
10769	12	0	0	0	0	12
10770	0	0	0	12	0	12
10771	0	0	12	0	0	12
10772	15	0	0	0	0	15
10773	13	0	0	0	0	13
10774	0	15	0	0	0	15
10775	0	14	0	0	0	14
10776	0	0	0	15	0	15
10777	0	14	0	0	0	14
10778	0	0	0	14	0	14
10779	14	0	0	0	0	14
10780	16	0	0	0	0	16
10781	0	16	0	0	0	16
10782	13	0	0	0	0	13
10783	0	15	0	0	0	15
10784	16	0	0	0	0	16
10785	14	0	0	0	0	14
10786	1	0	13	0	0	14
10787	15	0	0	0	0	15
10788	0	14	0	0	0	14
10789	0	13	0	0	0	13
10790	16	0	0	0	0	16
10791	0	0	0	16	0	16
10792	0	0	17	0	0	17
10793	0	0	0	17	0	17
10794	0	0	0	18	0	18
10795	0	0	17	0	0	17
10796	15	0	0	0	0	15
10797	0	18	0	0	0	18
10798	17	0	0	0	0	17
10799	0	0	0	17	0	17
10800	16	0	0	0	0	16
10801	0	17	0	0	0	17
10802	0	0	0	19	0	19
10803	17	0	0	0	0	17
10804	0	0	14	0	0	14
10805	0	0	14	1	0	15
10806	16	0	0	0	0	16
10807	0	14	0	0	0	14
10808	0	16	0	0	0	16
10809	0	0	0	16	0	16
10810	0	15	0	0	0	15
10811	0	0	0	15	0	15
10812	0	0	0	16	0	16
10813	0	0	0	16	0	16
10814	0	15	0	0	0	15
10815	0	0	0	15	0	15
10816	0	0	13	0	0	13
10817	0	16	0	0	0	16
10818	0	0	0	13	0	13
10819	0	13	0	0	0	13
10820	14	0	0	0	0	14
10821	14	0	0	0	0	14
10822	15	0	0	0	0	15
10823	0	14	0	0	0	14
10824	0	0	0	16	0	16
10825	0	0	16	0	0	16
10826	0	0	15	0	0	15
10827	16	0	0	0	0	16
10828	16	0	0	0	0	16
10829	0	0	0	15	0	15
10830	0	0	0	16	0	16
10831	0	0	13	2	0	15
10832	0	16	0	0	0	16
10833	0	15	0	0	0	15
10834	0	0	15	0	0	15
10835	0	0	0	13	0	13
10836	0	0	1	12	0	13
10837	0	0	0	15	0	15
10838	0	0	0	15	0	15
10839	19	0	0	0	0	19
10840	0	0	18	0	0	18
10841	19	0	0	0	0	19
10842	0	0	0	19	0	19
10843	20	0	0	0	0	20
10844	0	0	0	22	0	22
10845	0	0	21	0	0	21
10846	1	0	0	20	0	21
10847	0	0	23	0	0	23
10848	0	0	0	24	0	24
10849	0	0	21	0	0	21
10850	0	20	0	0	0	20
10851	0	0	0	23	0	23
10852	0	0	0	24	0	24
10853	0	22	0	0	0	22
10854	24	0	0	0	0	24
10855	0	0	0	24	0	24
10856	0	0	0	23	0	23
10857	22	0	0	0	0	22
10858	21	0	0	0	0	21
10859	21	0	0	0	0	21
10860	20	0	0	0	0	20
10861	0	0	21	0	0	21
10862	21	0	0	0	0	21
10863	21	0	0	0	0	21
10864	0	0	0	20	0	20
10865	0	0	0	18	0	18
10866	18	0	0	0	0	18
10867	0	19	0	0	0	19
10868	0	0	0	19	0	19
10869	0	0	19	0	0	19
10870	0	19	0	0	0	19
10871	20	0	0	0	0	20
10872	21	0	0	0	0	21
10873	16	0	0	3	0	19
10874	19	0	0	0	0	19
10875	0	0	0	18	0	18
10876	0	0	16	0	0	16
10877	0	0	14	0	0	14
10878	0	0	0	19	0	19
10879	16	0	0	0	0	16
10880	0	0	0	16	0	16
10881	0	0	16	0	0	16
10882	14	0	0	0	0	14
10883	13	0	0	0	0	13
10884	0	0	0	17	0	17
10885	0	0	17	0	0	17
10886	0	0	15	0	0	15
10887	16	0	0	0	0	16
10888	0	16	0	0	0	16
10889	0	0	17	0	0	17
10890	0	0	0	17	0	17
10891	17	0	0	0	0	17
10892	0	15	0	0	0	15
10893	0	17	0	0	0	17
10894	15	0	0	0	0	15
10895	0	0	0	16	0	16
10896	16	0	0	0	0	16
10897	0	0	0	15	0	15
10898	0	0	0	16	0	16
10899	0	0	15	0	0	15
10900	0	0	16	0	0	16
10901	0	0	16	0	0	16
10902	0	0	0	16	0	16
10903	15	0	0	0	0	15
10904	0	0	16	0	0	16
10905	0	0	0	18	0	18
10906	0	0	18	0	0	18
10907	0	17	0	0	0	17
10908	0	0	0	17	0	17
10909	0	0	0	18	0	18
10910	0	0	0	17	0	17
10911	15	0	0	0	0	15
10912	0	0	0	16	0	16
10913	0	0	0	20	0	20
10914	20	0	0	0	0	20
10915	0	0	16	0	0	16
10916	18	0	0	0	0	18
10917	18	0	0	0	0	18
10918	1	0	17	0	0	18
10919	18	0	0	0	0	18
10920	0	0	0	17	0	17
10921	0	0	21	0	0	21
10922	18	0	0	0	0	18
10923	21	0	0	0	0	21
10924	0	0	0	22	0	22
10925	0	0	0	21	0	21
10926	0	0	0	22	0	22
10927	23	0	0	0	0	23
10928	0	21	0	0	0	21
10929	21	0	0	0	0	21
10930	0	21	0	0	0	21
10931	0	21	0	0	0	21
10932	0	0	0	18	0	18
10933	0	0	0	18	0	18
10934	0	0	0	17	0	17
10935	0	0	0	18	0	18
10936	0	0	15	0	0	15
10937	15	0	0	0	0	15
10938	0	0	0	15	0	15
10939	0	0	14	0	0	14
10940	0	0	0	13	0	13
10941	0	0	0	14	0	14
10942	0	0	14	0	0	14
10943	0	0	0	14	0	14
10944	0	0	0	14	0	14
10945	14	0	0	0	0	14
10946	0	0	13	0	0	13
10947	17	0	0	0	0	17
10948	0	18	0	0	0	18
10949	18	0	0	0	0	18
10950	24	0	0	0	0	24
10951	0	0	0	25	0	25
10952	0	0	25	0	0	25
10953	0	28	0	1	0	29
10954	0	0	0	29	0	29
10955	0	25	0	0	0	25
10956	30	0	0	0	0	30
10957	0	0	29	0	0	29
10958	0	0	28	0	0	28
10959	0	0	0	32	0	32
10960	0	0	31	0	0	31
10961	0	0	0	32	0	32
10962	0	0	0	32	0	32
10963	33	0	0	0	0	33
10964	0	31	0	0	0	31
10965	1	0	0	29	0	30
10966	0	0	0	33	0	33
10967	0	0	0	29	0	29
10968	0	28	0	0	0	28
10969	0	35	0	0	0	35
10970	34	0	0	0	0	34
10971	35	0	0	0	0	35
10972	35	0	0	0	0	35
10973	0	0	34	0	0	34
10974	0	0	0	34	0	34
10975	0	0	32	0	0	32
10976	0	34	0	0	0	34
10977	30	0	0	0	0	30
10978	0	0	34	0	0	34
10979	0	0	0	30	0	30
10980	0	0	33	0	0	33
10981	33	0	0	0	0	33
10982	34	0	0	0	0	34
10983	30	1	0	0	0	31
10984	33	0	0	0	0	33
10985	0	0	35	0	0	35
10986	33	0	0	0	0	33
10987	33	0	0	0	0	33
10988	0	35	0	0	0	35
10989	35	0	0	0	0	35
10990	33	0	0	0	0	33
10991	0	0	0	36	0	36
10992	0	39	0	0	0	39
10993	39	0	0	0	0	39
10994	39	0	0	0	0	39
10995	0	0	37	0	0	37
10996	0	0	32	0	0	32
10997	1	0	35	0	0	36
10998	0	0	0	34	0	34
10999	38	0	0	0	0	38
11000	0	38	0	0	0	38
11001	38	0	0	0	0	38
11002	0	38	0	0	0	38
11003	38	0	0	0	0	38
11004	0	35	0	0	0	35
11005	0	37	0	0	0	37
11006	36	0	0	0	0	36
11007	0	39	0	0	0	39
11008	0	0	0	38	0	38
11009	0	0	38	0	0	38
11010	0	0	30	0	0	30
11011	0	0	0	37	0	37
11012	0	0	0	39	0	39
11013	0	0	39	0	0	39
11014	0	0	0	37	0	37
11015	0	0	0	40	0	40
11016	35	0	0	0	0	35
11017	0	36	0	0	0	36
11018	0	0	0	37	0	37
11019	0	38	0	0	0	38
11020	35	0	0	0	0	35
11021	0	37	0	0	0	37
11022	35	0	0	0	0	35
11023	36	0	0	0	0	36
11024	0	0	0	35	0	35
11025	0	0	0	36	0	36
11026	0	0	0	38	0	38
11027	0	0	0	38	0	38
11028	0	0	36	0	0	36
11029	38	0	0	0	0	38
11030	0	38	0	0	0	38
11031	0	0	0	39	0	39
11032	0	0	0	39	0	39
11033	0	38	0	0	0	38
11034	37	0	0	0	0	37
11035	0	36	0	0	0	36
11036	0	0	0	38	0	38
11037	0	0	0	36	0	36
11038	0	0	0	38	0	38
11039	0	0	0	38	0	38
11040	34	0	0	0	0	34
11041	0	0	33	0	0	33
11042	0	0	0	32	0	32
11043	0	0	0	27	0	27
11044	0	0	0	27	0	27
11045	0	0	0	28	0	28
11046	23	0	0	0	0	23
11047	0	0	22	0	0	22
11048	0	0	0	22	0	22
11049	0	22	0	0	0	22
11050	0	24	0	0	0	24
11051	24	0	0	0	0	24
11052	0	0	23	0	0	23
11053	19	0	0	0	0	19
11054	0	0	23	0	0	23
11055	0	0	0	23	0	23
11056	22	0	0	0	0	22
11057	0	22	0	0	0	22
11058	0	0	0	25	0	25
11059	0	25	0	0	0	25
11060	25	0	0	0	0	25
11061	27	0	0	0	0	27
11062	0	0	0	25	0	25
11063	0	0	25	0	0	25
11064	0	1	24	0	0	25
11065	0	0	0	26	0	26
11066	0	22	0	1	0	23
11067	0	0	0	25	0	25
11068	0	0	0	24	0	24
11069	0	0	0	25	0	25
11070	0	0	23	0	0	23
11071	0	0	0	24	0	24
11072	0	0	0	24	0	24
11073	0	21	0	0	0	21
11074	0	0	0	23	0	23
11075	0	0	0	24	0	24
11076	0	0	0	24	0	24
11077	0	0	0	24	0	24
11078	0	0	0	21	0	21
11079	0	0	0	22	0	22
11080	0	1	0	21	0	22
11081	0	0	0	22	0	22
11082	0	0	22	0	0	22
11083	0	0	0	20	0	20
11084	22	0	0	0	0	22
11085	0	0	0	18	0	18
11086	0	0	17	0	0	17
11087	19	0	0	0	0	19
11088	18	0	0	0	0	18
11089	17	0	0	0	0	17
11090	19	0	0	0	0	19
11091	0	0	0	21	0	21
11092	0	0	20	0	0	20
11093	0	18	0	0	0	18
11094	0	20	0	0	0	20
11095	0	0	0	23	0	23
11096	0	0	0	22	0	22
11097	0	0	0	23	0	23
11098	0	0	0	21	0	21
11099	0	0	0	23	0	23
11100	17	0	0	0	0	17
11101	0	20	0	0	0	20
11102	0	20	0	0	0	20
11103	0	0	0	22	0	22
11104	0	0	0	20	0	20
11105	0	0	0	21	0	21
11106	0	0	0	19	0	19
11107	0	0	20	0	0	20
11108	0	19	0	0	0	19
11109	0	0	0	20	0	20
11110	17	0	0	0	0	17
11111	0	0	0	19	0	19
11112	0	0	18	1	0	19
11113	0	0	18	0	0	18
11114	0	0	20	0	0	20
11115	0	0	0	20	0	20
11116	19	0	0	0	0	19
11117	0	0	0	16	0	16
11118	0	0	0	19	0	19
11119	21	0	0	0	0	21
11120	0	0	0	21	0	21
11121	0	0	0	23	0	23
11122	0	0	25	0	0	25
11123	0	27	0	0	0	27
11124	0	0	0	27	0	27
11125	25	0	0	0	0	25
11126	0	0	0	27	0	27
11127	0	0	26	0	0	26
11128	0	0	0	26	0	26
11129	0	27	0	0	0	27
11130	0	0	0	26	0	26
11131	0	0	26	0	0	26
11132	0	27	0	0	0	27
11133	0	0	0	27	0	27
11134	0	0	0	27	0	27
11135	0	0	0	26	0	26
11136	0	0	0	28	0	28
11137	0	0	25	0	0	25
11138	0	28	0	0	0	28
11139	26	0	0	0	0	26
11140	26	0	0	0	0	26
11141	0	0	0	26	0	26
11142	0	0	27	0	0	27
11143	26	0	0	0	0	26
11144	0	0	0	26	0	26
11145	0	0	26	0	0	26
11146	0	0	0	25	0	25
11147	0	0	0	24	0	24
11148	0	0	0	24	0	24
11149	0	0	27	0	0	27
11150	0	0	0	27	0	27
11151	0	24	0	0	0	24
11152	25	0	0	0	0	25
11153	26	0	0	0	0	26
11154	24	0	0	0	0	24
11155	0	27	0	0	0	27
11156	26	0	0	0	0	26
11157	0	0	0	26	0	26
11158	25	0	0	0	0	25
11159	26	0	0	0	0	26
11160	0	0	26	0	0	26
11161	0	25	0	0	0	25
11162	26	0	0	0	0	26
11163	0	0	0	29	0	29
11164	0	0	26	0	0	26
11165	0	27	0	0	0	27
11166	30	0	0	0	0	30
11167	0	0	0	30	0	30
11168	0	0	0	28	0	28
11169	0	0	0	30	0	30
11170	0	27	0	0	0	27
11171	0	0	0	30	0	30
11172	0	28	0	0	0	28
11173	0	0	0	32	0	32
11174	0	0	30	0	0	30
11175	0	0	0	29	0	29
11176	0	0	0	30	0	30
11177	0	0	0	32	0	32
11178	0	0	31	0	0	31
11179	0	0	0	33	0	33
11180	0	0	0	31	0	31
11181	0	0	0	31	0	31
11182	0	0	0	32	0	32
11183	0	0	0	30	0	30
11184	0	0	31	0	0	31
11185	0	0	0	28	0	28
11186	0	0	0	28	0	28
11187	28	0	0	0	0	28
11188	0	27	0	0	0	27
11189	0	30	0	0	0	30
11190	0	0	0	29	0	29
11191	0	0	0	30	0	30
11192	0	28	0	0	0	28
11193	0	0	0	30	0	30
11194	0	30	0	0	0	30
11195	0	0	0	30	0	30
11196	0	0	0	27	0	27
11197	0	0	27	0	0	27
11198	0	28	0	0	0	28
11199	0	28	0	0	0	28
11200	28	0	0	0	0	28
11201	0	28	0	0	0	28
11202	0	0	0	30	0	30
11203	0	0	29	0	0	29
11204	0	0	0	29	0	29
11205	31	0	0	0	0	31
11206	0	0	30	0	0	30
11207	0	28	0	0	0	28
11208	0	0	0	31	0	31
11209	0	0	0	37	0	37
11210	36	0	0	0	0	36
11211	0	0	0	37	0	37
11212	0	0	0	29	0	29
11213	0	0	0	33	0	33
11214	0	0	0	29	0	29
11215	28	0	0	0	0	28
11216	27	0	0	0	0	27
11217	0	0	0	28	0	28
11218	28	0	0	0	0	28
11219	0	0	0	28	0	28
11220	0	0	26	0	0	26
11221	0	0	23	0	0	23
11222	0	0	0	26	0	26
11223	0	26	0	0	0	26
11224	0	0	0	28	0	28
11225	27	0	0	0	0	27
11226	0	0	0	26	0	26
11227	25	0	0	0	0	25
11228	0	0	0	26	0	26
11229	0	0	29	0	0	29
11230	0	26	0	0	0	26
11231	0	27	0	0	0	27
11232	0	0	0	27	0	27
11233	0	0	29	0	0	29
11234	0	27	0	0	0	27
11235	0	0	0	29	0	29
11236	29	0	0	0	0	29
11237	0	0	27	0	0	27
11238	0	0	0	28	0	28
11239	0	0	0	32	0	32
11240	0	0	31	0	0	31
11241	0	0	30	0	0	30
11242	0	0	26	0	0	26
11243	0	0	0	30	0	30
11244	0	0	31	0	0	31
11245	30	0	0	0	0	30
11246	0	0	0	31	0	31
11247	0	0	34	0	0	34
11248	0	27	0	1	0	28
11249	0	0	32	0	0	32
11250	0	0	0	32	0	32
11251	33	0	0	0	0	33
11252	0	0	0	32	0	32
11253	0	0	0	34	0	34
11254	34	0	0	0	0	34
11255	0	0	0	34	0	34
11256	0	0	31	0	0	31
11257	30	0	0	0	0	30
11258	0	31	0	0	0	31
11259	30	0	0	0	0	30
11260	0	0	0	33	0	33
11261	0	0	34	0	0	34
11262	0	0	31	0	0	31
11263	0	0	0	35	0	35
11264	0	0	0	37	0	37
11265	0	0	36	0	0	36
11266	0	0	33	0	0	33
11267	34	0	0	0	0	34
11268	0	0	0	35	0	35
11269	35	0	0	0	0	35
11270	0	0	0	34	0	34
11271	0	0	34	0	0	34
11272	0	0	30	0	0	30
11273	0	0	0	35	0	35
11274	0	0	0	35	0	35
11275	0	0	33	0	0	33
11276	33	0	0	0	0	33
11277	0	0	0	32	0	32
11278	33	0	0	0	0	33
11279	0	33	0	0	0	33
11280	0	0	0	32	0	32
11281	32	0	0	0	0	32
11282	0	0	30	1	0	31
11283	0	0	0	33	0	33
11284	0	0	0	33	0	33
11285	0	0	0	33	0	33
11286	0	0	33	0	0	33
11287	0	0	0	32	0	32
11288	0	34	0	0	0	34
11289	0	0	0	35	0	35
11290	0	0	32	0	0	32
11291	0	0	34	0	0	34
11292	0	0	0	34	0	34
11293	0	0	0	35	0	35
11294	0	0	0	36	0	36
11295	0	0	0	36	0	36
11296	35	0	0	0	0	35
11297	33	0	0	0	0	33
11298	0	0	33	0	0	33
11299	0	33	0	0	0	33
11300	0	0	0	34	0	34
11301	35	0	0	0	0	35
11302	24	0	0	0	0	24
11303	29	0	0	0	0	29
11304	28	0	0	0	0	28
11305	0	0	29	0	0	29
11306	29	0	0	0	0	29
11307	0	29	0	0	0	29
11308	1	0	0	29	0	30
11309	0	0	30	0	0	30
11310	0	0	0	30	0	30
11311	0	0	30	0	0	30
11312	0	0	0	30	0	30
11313	0	0	0	29	0	29
11314	32	0	0	0	0	32
11315	0	0	0	33	0	33
11316	0	0	34	0	0	34
11317	0	0	0	31	0	31
11318	35	0	0	0	0	35
11319	0	0	0	35	0	35
11320	0	0	34	0	0	34
11321	0	32	0	0	0	32
11322	33	0	0	0	0	33
11323	0	0	0	33	0	33
11324	0	31	0	0	0	31
11325	32	0	0	0	0	32
11326	0	0	30	0	0	30
11327	0	35	0	0	0	35
11328	0	0	0	34	0	34
11329	0	0	33	0	0	33
11330	0	0	0	33	0	33
11331	36	0	0	0	0	36
11332	0	0	32	0	0	32
11333	0	0	0	33	0	33
11334	0	0	29	0	0	29
11335	0	0	0	30	0	30
11336	0	0	0	28	0	28
11337	25	0	0	0	0	25
11338	0	27	0	0	0	27
11339	0	0	0	28	0	28
11340	26	0	0	0	0	26
11341	27	0	0	0	0	27
11342	0	0	0	27	0	27
11343	0	24	0	0	0	24
11344	0	27	0	0	0	27
11345	0	0	0	27	0	27
11346	0	0	0	26	0	26
11347	28	0	0	0	0	28
11348	0	0	0	28	0	28
11349	0	0	26	0	0	26
11350	26	0	0	1	0	27
11351	0	27	0	0	0	27
11352	28	0	0	0	0	28
11353	0	0	23	0	0	23
11354	0	30	0	0	0	30
11355	29	0	0	0	0	29
11356	26	0	0	0	0	26
11357	0	0	25	0	0	25
11358	25	0	0	0	0	25
11359	25	0	0	0	0	25
11360	0	27	0	0	0	27
11361	0	0	0	26	0	26
11362	0	0	25	0	0	25
11363	0	0	0	26	0	26
11364	0	0	26	0	0	26
11365	0	0	0	26	0	26
11366	25	0	0	0	0	25
11367	0	0	0	24	0	24
11368	0	0	26	0	0	26
11369	27	0	0	0	0	27
11370	0	0	0	26	0	26
11371	0	0	26	0	0	26
11372	27	0	0	0	0	27
11373	0	0	0	26	0	26
11374	0	0	26	0	0	26
11375	0	0	24	0	0	24
11376	0	0	0	26	0	26
11377	0	0	26	0	0	26
11378	0	25	0	0	0	25
11379	0	0	0	26	0	26
11380	26	0	0	0	0	26
11381	0	0	24	0	0	24
11382	0	0	25	0	0	25
11383	24	0	0	0	0	24
11384	0	0	23	0	0	23
11385	22	0	0	0	0	22
11386	0	0	22	0	0	22
11387	0	0	0	22	0	22
11388	0	0	20	0	0	20
11389	0	0	0	21	0	21
11390	0	0	20	0	0	20
11391	0	0	20	0	0	20
11392	21	0	0	0	0	21
11393	0	20	0	0	0	20
11394	21	0	0	0	0	21
11395	0	21	0	0	0	21
11396	0	0	0	21	0	21
11397	0	0	0	21	0	21
11398	25	0	0	0	0	25
11399	0	0	0	26	0	26
11400	0	0	26	0	0	26
11401	24	0	0	0	0	24
11402	27	0	0	0	0	27
11403	0	0	0	27	0	27
11404	0	0	27	0	0	27
11405	0	0	0	24	0	24
11406	0	27	0	0	0	27
11407	0	0	0	24	0	24
11408	0	0	0	24	0	24
11409	0	0	25	0	0	25
11410	22	0	0	0	0	22
11411	0	24	0	0	0	24
11412	20	0	0	0	0	20
11413	0	26	0	0	0	26
11414	0	0	0	26	0	26
11415	0	26	0	0	0	26
11416	0	0	25	0	0	25
11417	0	0	0	25	0	25
11418	0	0	0	24	0	24
11419	0	0	0	24	0	24
11420	24	0	0	0	0	24
11421	0	0	0	23	0	23
11422	23	0	0	0	0	23
11423	23	0	0	0	0	23
11424	23	0	0	0	0	23
11425	0	0	23	0	0	23
11426	0	0	0	19	0	19
11427	0	0	0	22	0	22
11428	0	0	0	21	0	21
11429	22	0	0	0	0	22
11430	0	0	0	22	0	22
11431	0	0	0	22	0	22
11432	25	0	0	0	0	25
11433	0	0	0	26	0	26
11434	0	0	26	0	0	26
11435	0	0	24	0	0	24
11436	0	0	0	26	0	26
11437	26	0	0	0	0	26
11438	24	0	0	0	0	24
11439	0	0	0	23	0	23
11440	0	0	25	0	0	25
11441	0	24	0	0	0	24
11442	0	0	0	24	0	24
11443	0	0	0	24	0	24
11444	0	0	0	25	0	25
11445	25	0	0	0	0	25
11446	0	0	22	0	0	22
11447	22	0	0	0	0	22
11448	0	0	0	22	0	22
11449	0	22	0	0	0	22
11450	21	0	0	0	0	21
11451	22	0	0	0	0	22
11452	0	0	22	0	0	22
11453	0	17	0	0	0	17
11454	0	22	0	0	0	22
11455	22	0	0	0	0	22
11456	0	0	0	25	0	25
11457	0	0	0	24	0	24
11458	0	0	0	26	0	26
11459	0	26	0	0	0	26
11460	0	25	0	0	0	25
11461	25	0	0	0	0	25
11462	0	0	0	26	0	26
11463	0	0	26	0	0	26
11464	0	0	0	25	0	25
11465	0	0	24	0	0	24
11466	0	0	23	0	0	23
11467	0	0	25	0	0	25
11468	0	23	0	0	0	23
11469	0	0	0	25	0	25
11470	0	27	0	0	0	27
11471	0	0	0	26	0	26
11472	0	0	0	26	0	26
11473	27	0	0	0	0	27
11474	0	0	0	30	0	30
11475	32	0	0	0	0	32
11476	29	0	0	0	0	29
11477	0	0	0	29	0	29
11478	0	30	0	0	0	30
11479	0	0	0	33	0	33
11480	0	34	0	0	0	34
11481	1	0	0	32	0	33
11482	0	0	35	0	0	35
11483	0	0	0	35	0	35
11484	0	0	0	37	0	37
11485	34	0	0	0	0	34
11486	0	36	0	0	0	36
11487	0	0	0	37	0	37
11488	0	0	0	37	0	37
11489	0	32	0	1	0	33
11490	0	0	0	37	0	37
11491	30	0	0	0	0	30
11492	31	0	0	0	0	31
11493	0	31	0	0	0	31
11494	0	0	0	33	0	33
11495	30	0	0	0	0	30
11496	0	31	0	0	0	31
11497	0	0	0	30	0	30
11498	0	28	0	0	0	28
11499	31	0	0	0	0	31
11500	0	0	29	0	0	29
11501	0	0	32	0	0	32
11502	0	0	0	32	0	32
11503	0	0	33	0	0	33
11504	0	0	0	28	0	28
11505	33	0	0	0	0	33
11506	0	0	29	0	0	29
11507	0	0	0	36	0	36
11508	0	0	0	36	0	36
11509	34	0	0	0	0	34
11510	0	37	0	0	0	37
11511	40	0	0	0	0	40
11512	40	0	0	0	0	40
11513	0	32	0	1	0	33
11514	1	0	0	38	0	39
11515	1	0	37	0	0	38
11516	0	0	0	41	0	41
11517	0	42	0	0	0	42
11518	44	0	0	0	0	44
11519	0	0	0	46	0	46
11520	1	0	46	0	0	47
11521	0	0	0	46	0	46
11522	0	0	0	48	0	48
11523	0	0	0	47	0	47
11524	0	0	0	49	0	49
11525	0	0	0	41	0	41
11526	0	0	45	0	0	45
11527	1	0	41	0	0	42
11528	0	43	0	0	0	43
11529	0	43	0	1	0	44
11530	46	0	0	0	0	46
11531	0	0	46	0	0	46
11532	40	0	0	0	0	40
11533	0	0	37	0	0	37
11534	0	0	42	0	0	42
11535	0	0	0	37	0	37
11536	39	0	0	0	0	39
11537	0	0	0	41	0	41
11538	0	0	0	45	0	45
11539	0	0	45	1	0	46
11540	0	0	0	46	0	46
11541	0	0	0	47	0	47
11542	0	0	0	45	0	45
11543	0	0	0	46	0	46
11544	0	0	0	45	0	45
11545	46	0	0	0	0	46
11546	0	0	0	46	0	46
11547	0	0	43	0	0	43
11548	0	0	0	45	0	45
11549	0	0	46	0	0	46
11550	0	0	0	47	0	47
11551	0	0	47	0	0	47
11552	0	0	0	42	0	42
11553	0	0	0	47	0	47
11554	0	0	45	0	0	45
11555	43	0	0	0	0	43
11556	0	0	44	0	0	44
11557	0	0	0	46	0	46
11558	44	0	0	0	0	44
11559	0	0	0	45	0	45
11560	0	0	0	43	0	43
11561	0	0	45	0	0	45
11562	0	38	0	0	0	38
11563	0	43	0	0	0	43
11564	0	41	0	0	0	41
11565	0	0	0	42	0	42
11566	42	0	0	0	0	42
11567	0	0	0	36	0	36
11568	0	0	0	40	0	40
11569	0	0	0	40	0	40
11570	0	0	0	39	0	39
11571	0	36	0	0	0	36
11572	0	0	0	40	0	40
11573	0	0	0	40	0	40
11574	0	40	0	0	0	40
11575	36	0	0	0	0	36
11576	0	0	0	38	0	38
11577	37	0	0	0	0	37
11578	36	0	0	0	0	36
11579	0	34	0	1	0	35
11580	0	0	0	37	0	37
11581	0	0	36	0	0	36
11582	0	0	37	0	0	37
11583	0	0	0	39	0	39
11584	35	0	0	0	0	35
11585	34	0	0	0	0	34
11586	0	0	0	38	0	38
11587	38	0	0	0	0	38
11588	0	37	0	0	0	37
11589	37	0	0	0	0	37
11590	0	34	0	0	0	34
11591	0	0	0	36	0	36
11592	0	0	0	32	0	32
11593	0	36	0	0	0	36
11594	36	0	0	0	0	36
11595	0	0	34	0	0	34
11596	0	0	0	35	0	35
11597	0	0	35	0	0	35
11598	0	0	0	34	0	34
11599	33	0	0	0	0	33
11600	0	0	0	26	0	26
11601	26	0	0	0	0	26
11602	24	0	0	0	0	24
11603	0	0	0	22	0	22
11604	0	0	22	0	0	22
11605	0	23	0	0	0	23
11606	0	0	0	24	0	24
11607	23	0	0	0	0	23
11608	0	0	22	0	0	22
11609	0	0	0	24	0	24
11610	0	0	0	22	0	22
11611	0	0	0	13	0	13
11612	14	0	0	0	0	14
11613	0	0	0	15	0	15
11614	0	0	0	16	0	16
11615	0	0	18	0	0	18
11616	0	0	0	19	0	19
11617	0	0	0	17	0	17
11618	0	0	0	18	0	18
11619	0	18	0	0	0	18
11620	0	0	0	16	0	16
11621	0	0	0	18	0	18
11622	18	0	0	0	0	18
11623	0	0	17	0	0	17
11624	0	0	15	0	0	15
11625	0	16	0	0	0	16
11626	0	0	0	17	0	17
11627	17	0	0	0	0	17
11628	0	0	0	18	0	18
11629	0	0	0	18	0	18
11630	0	0	0	18	0	18
11631	0	0	0	17	0	17
11632	0	0	0	18	0	18
11633	0	0	16	0	0	16
11634	0	0	0	19	0	19
11635	18	0	0	0	0	18
11636	0	19	0	0	0	19
11637	0	0	0	19	0	19
11638	0	0	0	19	0	19
11639	0	0	18	0	0	18
11640	0	0	0	17	0	17
11641	0	0	0	18	0	18
11642	17	0	0	0	0	17
11643	0	16	0	0	0	16
11644	0	0	0	17	0	17
11645	0	0	0	18	0	18
11646	0	0	0	18	0	18
11647	0	0	17	0	0	17
11648	0	0	16	0	0	16
11649	0	17	0	0	0	17
11650	0	14	0	0	0	14
11651	0	0	0	16	0	16
11652	0	15	0	0	0	15
11653	0	0	0	17	0	17
11654	0	0	0	17	0	17
11655	0	0	0	20	0	20
11656	0	0	0	20	0	20
11657	0	0	21	0	0	21
11658	0	0	0	20	0	20
11659	0	0	0	19	0	19
11660	0	0	0	21	0	21
11661	24	0	0	0	0	24
11662	0	27	0	0	0	27
11663	0	0	0	25	0	25
11664	0	25	0	0	0	25
11665	24	0	0	0	0	24
11666	23	1	0	0	0	24
11667	0	23	0	0	0	23
11668	0	19	0	0	0	19
11669	0	0	27	0	0	27
11670	0	26	0	0	0	26
11671	0	0	0	28	0	28
11672	28	0	0	0	0	28
11673	0	27	0	0	0	27
11674	0	0	0	27	0	27
11675	0	0	0	27	0	27
11676	0	0	0	26	0	26
11677	25	0	0	0	0	25
11678	0	0	26	0	0	26
11679	24	0	0	0	0	24
11680	0	26	0	0	0	26
11681	0	0	0	26	0	26
11682	0	0	23	0	0	23
11683	26	0	0	0	0	26
11684	0	24	0	0	0	24
11685	0	0	0	25	0	25
11686	0	24	0	0	0	24
11687	0	0	0	26	0	26
11688	0	0	0	26	0	26
11689	0	0	24	0	0	24
11690	0	0	25	0	0	25
11691	0	0	0	25	0	25
11692	0	0	25	0	0	25
11693	0	0	0	26	0	26
11694	0	0	0	24	0	24
11695	0	0	0	30	0	30
11696	30	0	0	0	0	30
11697	0	0	0	25	0	25
11698	0	0	28	0	0	28
11699	26	0	0	0	0	26
11700	0	0	0	28	0	28
11701	0	0	0	28	0	28
11702	27	0	0	0	0	27
11703	0	29	0	0	0	29
11704	0	0	0	28	0	28
11705	0	0	0	29	0	29
11706	27	0	0	0	0	27
11707	0	0	28	0	0	28
11708	0	0	0	26	0	26
11709	0	0	0	27	0	27
11710	0	0	0	27	0	27
11711	0	30	0	0	0	30
11712	0	0	0	32	0	32
11713	31	0	0	0	0	31
11714	0	32	0	0	0	32
11715	32	0	0	0	0	32
11716	0	31	0	0	0	31
11717	34	0	0	0	0	34
11718	0	0	31	0	0	31
11719	0	0	32	0	0	32
11720	33	0	0	0	0	33
11721	0	0	32	0	0	32
11722	0	0	0	34	0	34
11723	0	0	0	30	0	30
11724	0	0	0	32	0	32
11725	30	0	0	0	0	30
11726	0	0	31	0	0	31
11727	31	0	0	0	0	31
11728	0	0	0	31	0	31
11729	33	0	0	0	0	33
11730	0	0	0	33	0	33
11731	29	0	0	0	0	29
11732	0	0	0	35	0	35
11733	0	0	33	0	0	33
11734	34	0	0	0	0	34
11735	32	0	0	0	0	32
11736	0	0	0	33	0	33
11737	0	0	0	35	0	35
11738	0	32	0	0	0	32
11739	30	0	0	0	0	30
11740	0	33	0	0	0	33
11741	37	0	0	0	0	37
11742	0	0	38	0	0	38
11743	0	0	32	0	0	32
11744	0	0	32	0	0	32
11745	37	0	0	0	0	37
11746	0	33	0	0	0	33
11747	0	0	0	37	0	37
11748	32	0	0	0	0	32
11749	0	35	0	0	0	35
11750	0	0	0	34	0	34
11751	0	31	0	0	0	31
11752	0	34	0	0	0	34
11753	0	32	0	0	0	32
11754	25	0	0	0	0	25
11755	0	22	0	0	0	22
11756	0	21	0	0	0	21
11757	0	24	0	0	0	24
11758	18	0	0	0	0	18
11759	23	0	0	0	0	23
11760	0	0	23	0	0	23
11761	22	0	0	0	0	22
11762	23	0	0	0	0	23
11763	0	0	0	23	0	23
11764	23	0	0	0	0	23
11765	0	0	21	0	0	21
11766	0	22	0	0	0	22
11767	22	0	0	0	0	22
11768	0	0	0	22	0	22
11769	23	0	0	0	0	23
11770	0	0	21	0	0	21
11771	23	0	0	0	0	23
11772	0	0	0	22	0	22
11773	0	0	18	0	0	18
11774	0	20	0	0	0	20
11775	0	17	1	0	0	18
11776	0	0	0	18	0	18
11777	0	0	0	21	0	21
11778	0	20	0	0	0	20
11779	21	0	0	0	0	21
11780	21	0	0	0	0	21
11781	21	0	0	0	0	21
11782	0	20	0	0	0	20
11783	0	0	0	21	0	21
11784	0	20	0	0	0	20
11785	21	0	0	0	0	21
11786	21	0	0	0	0	21
11787	0	25	0	0	0	25
11788	24	0	0	0	0	24
11789	0	0	0	25	0	25
11790	0	0	0	25	0	25
11791	23	0	0	0	0	23
11792	24	0	0	0	0	24
11793	26	0	0	0	0	26
11794	0	0	0	24	0	24
11795	0	0	0	26	0	26
11796	0	0	26	0	0	26
11797	0	0	0	23	0	23
11798	0	0	0	25	0	25
11799	0	0	25	0	0	25
11800	0	0	24	0	0	24
11801	0	0	24	0	0	24
11802	0	0	0	26	0	26
11803	0	0	26	0	0	26
11804	0	0	0	20	0	20
11805	0	0	0	23	0	23
11806	0	0	23	0	0	23
11807	0	0	22	0	0	22
11808	0	0	0	24	0	24
11809	0	0	27	0	0	27
11810	0	0	25	0	0	25
11811	0	26	0	0	0	26
11812	27	0	0	0	0	27
11813	29	0	0	0	0	29
11814	29	0	0	0	0	29
11815	0	26	0	0	0	26
11816	0	27	0	0	0	27
11817	0	0	0	29	0	29
11818	0	0	0	29	0	29
11819	0	0	28	0	0	28
11820	0	0	0	28	0	28
11821	30	0	0	0	0	30
11822	0	0	0	29	0	29
11823	0	27	0	0	0	27
11824	29	0	0	0	0	29
11825	27	0	0	0	0	27
11826	28	0	0	0	0	28
11827	0	0	30	1	0	31
11828	0	0	0	34	0	34
11829	34	0	0	0	0	34
11830	0	0	36	0	0	36
11831	0	35	0	0	0	35
11832	0	38	0	0	0	38
11833	39	0	0	0	0	39
11834	0	32	0	0	0	32
11835	0	0	0	35	0	35
11836	0	0	38	0	0	38
11837	0	0	0	36	0	36
11838	37	0	0	0	0	37
11839	0	37	0	0	0	37
11840	36	0	0	0	0	36
11841	0	0	38	0	0	38
11842	0	0	0	38	0	38
11843	0	40	0	0	0	40
11844	0	0	0	43	0	43
11845	42	0	0	0	0	42
11846	41	1	0	0	0	42
11847	43	0	0	0	0	43
11848	42	0	0	0	0	42
11849	0	0	0	42	0	42
11850	0	0	37	0	0	37
11851	0	0	0	42	0	42
11852	0	42	0	0	0	42
11853	42	0	0	0	0	42
11854	0	0	41	0	0	41
11855	42	0	0	0	0	42
11856	0	0	0	38	0	38
11857	0	0	40	0	0	40
11858	1	0	0	40	0	41
11859	42	0	0	0	0	42
11860	42	0	0	0	0	42
11861	39	0	0	0	0	39
11862	0	0	42	0	0	42
11863	0	0	0	43	0	43
11864	0	0	43	0	0	43
11865	0	42	0	0	0	42
11866	41	0	0	0	0	41
11867	0	41	0	0	0	41
11868	44	0	0	0	0	44
11869	0	0	0	41	0	41
11870	0	42	0	0	0	42
11871	39	0	0	0	0	39
11872	0	0	38	0	0	38
11873	0	0	0	42	0	42
11874	42	0	0	0	0	42
11875	0	0	41	0	0	41
11876	0	0	0	37	0	37
11877	0	38	0	0	0	38
11878	0	0	0	40	0	40
11879	0	0	0	40	0	40
11880	36	0	0	1	0	37
11881	0	42	0	0	0	42
11882	0	0	0	42	0	42
11883	0	41	0	0	0	41
11884	0	0	0	42	0	42
11885	0	41	0	0	0	41
11886	40	0	0	0	0	40
11887	0	0	40	0	0	40
11888	0	0	0	40	0	40
11889	0	0	0	39	0	39
11890	1	0	0	39	0	40
11891	0	0	0	38	0	38
11892	0	0	40	0	0	40
11893	0	38	0	0	0	38
11894	39	0	0	0	0	39
11895	38	0	0	0	0	38
11896	0	37	0	0	0	37
11897	39	0	0	0	0	39
11898	33	0	0	0	0	33
11899	0	36	0	0	0	36
11900	0	0	0	36	0	36
11901	0	36	0	0	0	36
11902	30	0	0	0	0	30
11903	0	0	31	0	0	31
11904	32	0	0	0	0	32
11905	0	0	29	0	0	29
11906	0	0	0	24	0	24
11907	30	0	0	0	0	30
11908	0	0	29	0	0	29
11909	29	0	0	0	0	29
11910	30	0	0	0	0	30
11911	0	0	0	32	0	32
11912	0	31	0	0	0	31
11913	32	0	0	0	0	32
11914	0	0	0	32	0	32
11915	0	32	0	0	0	32
11916	32	0	0	0	0	32
11917	0	0	0	31	0	31
11918	0	34	0	0	0	34
11919	0	0	0	40	0	40
11920	36	0	0	0	0	36
11921	36	0	0	0	0	36
11922	35	0	0	0	0	35
11923	0	0	0	36	0	36
11924	0	0	0	35	0	35
11925	0	0	31	0	0	31
11926	0	0	0	33	0	33
11927	0	0	33	0	0	33
11928	0	0	31	0	0	31
11929	0	0	34	0	0	34
11930	0	36	0	0	0	36
11931	0	0	0	37	0	37
11932	0	38	0	0	0	38
11933	33	0	0	0	0	33
11934	37	0	0	0	0	37
11935	0	0	0	38	0	38
11936	0	0	34	0	0	34
11937	0	0	0	33	0	33
11938	0	0	33	0	0	33
11939	0	0	0	33	0	33
11940	0	31	0	0	0	31
11941	0	32	0	0	0	32
11942	30	0	0	0	0	30
11943	0	0	30	0	0	30
11944	0	0	0	33	0	33
11945	0	0	0	34	0	34
11946	31	0	0	1	0	32
11947	0	33	0	0	0	33
11948	32	0	0	0	0	32
11949	0	32	0	0	0	32
11950	34	0	0	0	0	34
11951	32	0	0	0	0	32
11952	0	0	0	33	0	33
11953	0	0	31	0	0	31
11954	34	0	0	0	0	34
11955	0	32	0	0	0	32
11956	34	0	0	0	0	34
11957	0	0	0	33	0	33
11958	0	0	0	33	0	33
11959	0	33	0	0	0	33
11960	0	0	0	35	0	35
11961	0	36	0	0	0	36
11962	0	0	0	35	0	35
11963	0	0	0	35	0	35
11964	35	0	0	0	0	35
11965	0	0	32	0	0	32
11966	0	34	0	0	0	34
11967	0	0	0	40	0	40
11968	38	0	0	0	0	38
11969	44	0	0	0	0	44
11970	45	0	0	0	0	45
11971	0	0	45	0	0	45
11972	44	0	0	0	0	44
11973	0	0	0	44	0	44
11974	40	0	0	0	0	40
11975	0	41	0	0	0	41
11976	0	0	0	38	0	38
11977	40	0	0	0	0	40
11978	0	39	0	0	0	39
11979	0	0	0	37	0	37
11980	0	0	40	0	0	40
11981	40	0	0	0	0	40
11982	39	0	0	0	0	39
11983	0	0	41	0	0	41
11984	0	40	0	0	0	40
11985	0	45	0	0	0	45
11986	0	0	0	43	0	43
11987	0	0	0	45	0	45
11988	0	0	0	46	0	46
11989	0	0	44	0	0	44
11990	46	0	0	0	0	46
11991	46	0	0	0	0	46
11992	47	0	0	0	0	47
11993	47	0	0	0	0	47
11994	46	0	0	0	0	46
11995	46	0	0	0	0	46
11996	0	0	0	49	0	49
11997	0	0	48	0	0	48
11998	0	0	47	0	0	47
11999	0	0	0	49	0	49
12000	0	0	0	49	0	49
12001	0	0	0	54	0	54
12002	0	53	0	0	0	53
12003	54	0	0	0	0	54
12004	0	48	0	0	0	48
12005	0	0	0	51	0	51
12006	50	0	0	0	0	50
12007	0	51	0	0	0	51
12008	0	0	0	52	0	52
12009	0	0	0	51	0	51
12010	0	0	0	50	0	50
12011	0	50	0	0	0	50
12012	0	0	0	47	0	47
12013	0	0	49	0	0	49
12014	0	0	0	45	0	45
12015	0	0	0	46	0	46
12016	0	0	0	48	0	48
12017	0	0	0	47	0	47
12018	0	0	45	0	0	45
12019	0	46	0	0	0	46
12020	0	0	0	46	0	46
12021	0	0	0	47	0	47
12022	0	0	0	43	0	43
12023	0	39	0	0	0	39
12024	0	40	0	0	0	40
12025	39	0	0	0	0	39
12026	0	0	0	39	0	39
12027	0	0	38	0	0	38
12028	0	38	0	0	0	38
12029	38	0	0	0	0	38
12030	0	0	35	0	0	35
12031	0	0	33	0	0	33
12032	0	0	35	0	0	35
12033	0	0	0	37	0	37
12034	0	0	37	0	0	37
12035	0	37	0	0	0	37
12036	0	0	0	37	0	37
12037	0	0	37	0	0	37
12038	0	0	0	43	0	43
12039	43	0	0	0	0	43
12040	0	0	43	0	0	43
12041	42	0	0	1	0	43
12042	0	46	0	0	0	46
12043	45	0	0	0	0	45
12044	0	0	0	44	0	44
12045	43	0	0	0	0	43
12046	47	0	0	0	0	47
12047	43	1	0	1	0	45
12048	0	47	0	0	0	47
12049	48	0	0	0	0	48
12050	47	0	0	0	0	47
12051	0	0	46	0	0	46
12052	0	44	0	0	0	44
12053	0	0	0	44	0	44
12054	0	0	0	43	0	43
12055	0	0	0	44	0	44
12056	0	0	46	0	0	46
12057	0	0	0	45	0	45
12058	0	0	48	0	0	48
12059	45	0	0	0	0	45
12060	43	0	0	0	0	43
12061	0	0	45	0	0	45
12062	42	0	0	0	0	42
12063	41	0	0	0	0	41
12064	41	0	0	0	0	41
12065	0	0	0	37	0	37
12066	0	0	39	0	0	39
12067	0	40	0	0	0	40
12068	0	0	0	41	0	41
12069	0	0	41	0	0	41
12070	0	0	41	0	0	41
12071	40	0	0	0	0	40
12072	0	45	0	0	0	45
12073	45	0	0	0	0	45
12074	46	0	0	0	0	46
12075	0	46	0	0	0	46
12076	44	0	0	0	0	44
12077	0	0	42	0	0	42
12078	0	0	41	0	0	41
12079	0	0	41	0	0	41
12080	0	43	0	0	0	43
12081	42	0	0	0	0	42
12082	43	0	0	1	0	44
12083	0	45	0	0	0	45
12084	0	44	0	0	0	44
12085	0	0	0	43	0	43
12086	0	0	0	40	0	40
12087	44	0	0	0	0	44
12088	0	44	0	0	0	44
12089	45	0	0	0	0	45
12090	38	0	0	0	0	38
12091	0	0	39	0	0	39
12092	0	40	0	0	0	40
12093	0	0	0	42	0	42
12094	37	0	0	0	0	37
12095	0	0	0	37	0	37
12096	37	0	0	0	0	37
12097	0	0	37	0	0	37
12098	0	33	0	0	0	33
12099	0	39	0	0	0	39
12100	0	0	0	40	0	40
12101	0	37	0	0	0	37
12102	39	0	0	0	0	39
12103	0	0	37	0	0	37
12104	33	0	0	0	0	33
12105	0	0	35	0	0	35
12106	0	0	0	31	0	31
12107	0	0	0	33	0	33
12108	0	0	0	33	0	33
12109	32	0	0	0	0	32
12110	0	0	31	0	0	31
12111	0	0	0	32	0	32
12112	0	0	0	32	0	32
12113	0	33	0	0	0	33
12114	0	34	0	0	0	34
12115	0	36	0	0	0	36
12116	0	0	0	36	0	36
12117	0	1	0	37	0	38
12118	0	39	0	0	0	39
12119	0	39	0	0	0	39
12120	41	0	0	0	0	41
12121	1	0	0	41	0	42
12122	0	42	0	0	0	42
12123	45	0	0	0	0	45
12124	0	0	0	45	0	45
12125	39	0	0	0	0	39
12126	0	0	0	42	0	42
12127	0	0	41	0	0	41
12128	0	44	0	0	0	44
12129	44	0	0	0	0	44
12130	0	0	41	1	0	42
12131	0	39	0	0	0	39
12132	0	0	0	43	0	43
12133	0	0	0	43	0	43
12134	0	0	0	42	0	42
12135	0	0	0	39	0	39
12136	0	0	44	0	0	44
12137	0	43	0	0	0	43
12138	0	0	1	40	0	41
12139	40	0	0	0	0	40
12140	0	40	1	0	0	41
12141	0	0	0	40	0	40
12142	0	0	38	0	0	38
12143	0	40	0	0	0	40
12144	0	0	0	43	0	43
12145	0	44	0	0	0	44
12146	45	0	0	0	0	45
12147	44	0	0	0	0	44
12148	0	0	45	0	0	45
12149	45	0	0	0	0	45
12150	44	0	0	0	0	44
12151	0	0	42	0	0	42
12152	0	45	0	0	0	45
12153	0	0	0	41	0	41
12154	0	0	0	41	0	41
12155	42	0	0	0	0	42
12156	0	0	0	41	0	41
12157	0	0	40	0	0	40
12158	37	0	0	0	0	37
12159	0	0	44	0	0	44
12160	0	42	0	0	0	42
12161	44	0	0	0	0	44
12162	1	0	40	0	0	41
12163	0	0	41	0	0	41
12164	0	42	0	0	0	42
12165	0	0	0	39	0	39
12166	0	1	37	0	0	38
12167	0	0	0	39	0	39
12168	0	0	0	40	0	40
12169	0	0	40	0	0	40
12170	0	34	0	0	0	34
12171	0	0	0	35	0	35
12172	39	0	0	0	0	39
12173	37	0	0	0	0	37
12174	0	0	0	39	0	39
12175	0	0	39	0	0	39
12176	0	0	33	0	0	33
12177	0	0	0	38	0	38
12178	0	0	31	0	0	31
12179	35	0	0	0	0	35
12180	0	0	0	36	0	36
12181	0	0	0	38	0	38
12182	0	38	0	0	0	38
12183	0	0	0	39	0	39
12184	0	0	39	0	0	39
12185	38	0	0	1	0	39
12186	42	0	0	0	0	42
12187	0	0	40	0	0	40
12188	1	0	0	40	0	41
12189	0	0	0	39	0	39
12190	0	1	40	0	0	41
12191	0	0	0	41	0	41
12192	0	0	0	40	0	40
12193	0	37	0	0	0	37
12194	0	0	0	44	0	44
12195	0	0	0	55	0	55
12196	56	0	0	0	0	56
12197	61	0	0	0	0	61
12198	60	0	0	0	0	60
12199	59	0	0	0	0	59
12200	60	0	0	1	0	61
12201	0	1	59	0	0	60
12202	0	0	0	61	0	61
12203	0	0	0	61	0	61
12204	0	0	60	0	0	60
12205	61	0	0	0	0	61
12206	58	0	0	0	0	58
12207	0	1	51	0	0	52
12208	57	0	0	0	0	57
12209	56	0	0	0	0	56
12210	0	1	55	0	0	56
12211	1	0	0	53	0	54
12212	0	53	0	0	0	53
12213	0	0	0	56	0	56
12214	0	0	0	57	0	57
12215	0	0	0	55	0	55
12216	0	0	56	0	0	56
12217	57	0	0	0	0	57
12218	57	0	0	0	0	57
12219	0	0	0	56	0	56
12220	0	0	56	0	0	56
12221	0	0	0	56	0	56
12222	0	1	55	0	0	56
12223	0	0	52	0	0	52
12224	0	54	0	0	0	54
12225	0	0	0	54	0	54
12226	55	0	0	0	0	55
12227	51	0	1	0	0	52
12228	52	0	0	0	0	52
12229	0	0	0	56	0	56
12230	0	53	0	0	0	53
12231	0	0	0	57	0	57
12232	0	0	58	0	0	58
12233	59	0	0	0	0	59
12234	61	0	0	0	0	61
12235	0	0	0	61	0	61
12236	0	0	0	61	0	61
12237	0	0	0	57	0	57
12238	0	0	54	0	0	54
12239	53	0	0	0	0	53
12240	0	55	0	0	0	55
12241	0	55	0	0	0	55
12242	0	0	55	0	0	55
12243	0	0	0	57	0	57
12244	0	0	56	0	0	56
12245	61	0	0	0	0	61
12246	0	0	0	61	0	61
12247	0	1	58	0	0	59
12248	0	57	0	0	0	57
12249	59	0	0	0	0	59
12250	0	0	58	0	0	58
12251	0	54	0	0	0	54
12252	0	56	0	0	0	56
12253	59	0	0	0	0	59
12254	0	0	0	59	0	59
12255	0	1	56	0	0	57
12256	0	59	0	0	0	59
12257	57	0	0	0	0	57
12258	56	0	0	0	0	56
12259	0	57	0	0	0	57
12260	0	0	57	0	0	57
12261	0	0	0	56	0	56
12262	59	0	0	0	0	59
12263	57	0	0	0	0	57
12264	0	1	56	0	0	57
12265	0	0	0	56	0	56
12266	0	0	0	58	0	58
12267	0	0	57	0	0	57
12268	0	0	61	0	0	61
12269	60	0	0	0	0	60
12270	59	0	0	0	0	59
12271	60	0	0	0	0	60
12272	57	0	0	0	0	57
12273	0	0	54	0	0	54
12274	58	0	0	0	0	58
12275	0	0	0	53	0	53
12276	0	0	55	0	0	55
12277	0	0	55	0	0	55
12278	0	55	0	0	0	55
12279	0	0	0	51	0	51
12280	0	0	50	0	0	50
12281	54	0	0	0	0	54
12282	0	0	0	50	0	50
12283	0	53	0	0	0	53
12284	56	0	0	0	0	56
12285	55	0	0	0	0	55
12286	0	0	51	0	0	51
12287	0	42	0	0	0	42
12288	0	0	0	33	0	33
12289	32	0	0	0	0	32
12290	0	0	0	30	0	30
12291	0	0	31	0	0	31
12292	29	0	0	0	0	29
12293	0	29	0	0	0	29
12294	0	28	0	0	0	28
12295	0	30	0	0	0	30
12296	31	0	0	0	0	31
12297	31	0	0	0	0	31
12298	31	0	0	0	0	31
12299	0	0	0	33	0	33
12300	0	0	33	0	0	33
12301	0	0	0	32	0	32
12302	32	0	0	0	0	32
12303	0	0	0	34	0	34
12304	34	0	0	0	0	34
12305	33	0	0	0	0	33
12306	28	0	0	0	0	28
12307	0	27	0	0	0	27
12308	28	0	0	0	0	28
12309	0	0	24	0	0	24
12310	0	0	32	0	0	32
12311	0	31	0	0	0	31
12312	0	0	0	34	0	34
12313	35	0	0	0	0	35
12314	0	0	33	0	0	33
12315	36	0	0	0	0	36
12316	0	0	0	33	0	33
12317	0	34	0	0	0	34
12318	0	0	0	32	0	32
12319	0	0	32	0	0	32
12320	33	0	0	0	0	33
12321	0	0	35	0	0	35
12322	0	0	33	0	0	33
12323	31	0	0	0	0	31
12324	0	33	0	0	0	33
12325	34	0	0	0	0	34
12326	33	0	0	0	0	33
12327	0	0	29	0	0	29
12328	30	0	0	0	0	30
12329	0	0	27	0	0	27
12330	0	0	27	0	0	27
12331	0	0	30	0	0	30
12332	0	33	0	0	0	33
12333	33	0	0	0	0	33
12334	33	0	0	0	0	33
12335	32	0	0	0	0	32
12336	32	0	0	0	0	32
12337	0	0	31	0	0	31
12338	0	0	0	26	0	26
12339	0	0	0	27	0	27
12340	28	0	0	0	0	28
12341	0	28	0	0	0	28
12342	0	0	0	26	0	26
12343	27	0	0	0	0	27
12344	0	0	30	0	0	30
12345	0	0	0	28	0	28
12346	0	0	29	0	0	29
12347	0	28	0	0	0	28
12348	0	2	0	27	0	29
12349	26	0	2	0	0	28
12350	0	0	0	28	0	28
12351	0	0	28	0	0	28
12352	0	31	0	0	0	31
12353	31	0	0	0	0	31
12354	0	0	33	0	0	33
12355	33	0	0	0	0	33
12356	0	32	0	0	0	32
12357	32	0	0	0	0	32
12358	35	0	0	0	0	35
12359	0	0	0	36	0	36
12360	0	0	36	0	0	36
12361	0	35	0	0	0	35
12362	0	0	0	35	0	35
12363	0	0	0	36	0	36
12364	0	0	0	34	0	34
12365	0	0	0	35	0	35
12366	0	36	0	0	0	36
12367	33	0	0	0	0	33
12368	0	35	0	0	0	35
12369	0	0	0	37	0	37
12370	38	0	0	0	0	38
12371	0	0	0	38	0	38
12372	0	0	38	0	0	38
12373	0	38	0	0	0	38
12374	0	0	0	37	0	37
12375	0	0	0	38	0	38
12376	38	0	0	0	0	38
12377	0	0	39	0	0	39
12378	38	0	0	0	0	38
12379	39	0	0	0	0	39
12380	38	0	0	0	0	38
12381	0	0	41	0	0	41
12382	0	0	0	37	0	37
12383	0	0	0	40	0	40
12384	0	0	46	0	0	46
12385	0	0	44	0	0	44
12386	49	0	0	0	0	49
12387	0	0	0	47	0	47
12388	49	0	0	0	0	49
12389	48	0	0	0	0	48
12390	0	0	0	48	0	48
12391	0	0	48	0	0	48
12392	48	0	0	0	0	48
12393	0	0	0	49	0	49
12394	0	0	50	0	0	50
12395	0	51	0	0	0	51
12396	52	0	0	0	0	52
12397	0	52	0	0	0	52
12398	0	0	0	52	0	52
12399	0	58	0	0	0	58
12400	57	0	0	0	0	57
12401	58	0	0	0	0	58
12402	0	55	0	0	0	55
12403	52	0	0	0	0	52
12404	49	0	0	0	0	49
12405	0	52	0	0	0	52
12406	49	0	0	0	0	49
12407	0	0	0	52	0	52
12408	0	0	0	55	0	55
12409	55	0	0	0	0	55
12410	0	0	0	53	0	53
12411	0	49	0	0	0	49
12412	54	0	0	0	0	54
12413	49	0	0	0	0	49
12414	0	53	0	0	0	53
12415	53	0	0	0	0	53
12416	55	0	0	0	0	55
12417	0	0	0	49	0	49
12418	0	0	50	0	0	50
12419	0	46	0	0	0	46
12420	51	0	0	0	0	51
12421	52	0	0	0	0	52
12422	0	0	50	0	0	50
12423	49	0	0	0	0	49
12424	0	0	44	0	0	44
12425	44	0	0	0	0	44
12426	0	0	0	43	0	43
12427	0	0	42	0	0	42
12428	0	0	46	0	0	46
12429	0	0	0	45	0	45
12430	0	0	0	43	0	43
12431	0	0	47	0	0	47
12432	0	0	0	47	0	47
12433	0	0	44	0	0	44
12434	1	0	0	47	0	48
12435	0	0	0	48	0	48
12436	0	46	0	1	0	47
12437	0	42	0	0	0	42
12438	0	51	0	0	0	51
12439	0	0	0	52	0	52
12440	0	0	0	52	0	52
12441	0	0	50	0	0	50
12442	51	0	0	0	0	51
12443	51	0	0	0	0	51
12444	0	50	0	0	0	50
12445	47	0	0	0	0	47
12446	0	0	0	49	0	49
12447	48	0	0	0	0	48
12448	48	0	0	0	0	48
12449	0	0	0	49	0	49
12450	47	1	0	0	0	48
12451	0	45	0	0	0	45
12452	0	44	0	0	0	44
12453	0	0	0	46	0	46
12454	0	45	0	0	0	45
12455	0	0	0	46	0	46
12456	0	0	0	45	0	45
12457	46	0	0	0	0	46
12458	0	47	0	0	0	47
12459	47	0	0	0	0	47
12460	47	0	0	0	0	47
12461	0	46	0	0	0	46
12462	47	0	0	0	0	47
12463	0	0	44	0	0	44
12464	0	46	0	0	0	46
12465	45	0	0	0	0	45
12466	0	0	40	0	0	40
12467	0	42	0	0	0	42
12468	0	44	0	0	0	44
12469	43	0	0	0	0	43
12470	42	0	0	0	0	42
12471	43	0	0	0	0	43
12472	0	47	0	0	0	47
12473	0	0	0	45	0	45
12474	44	0	0	0	0	44
12475	45	0	0	0	0	45
12476	0	0	0	46	0	46
12477	0	0	37	0	0	37
12478	0	0	33	1	0	34
12479	0	0	0	39	0	39
12480	0	0	0	39	0	39
12481	0	0	36	0	0	36
12482	1	0	0	37	0	38
12483	0	39	0	0	0	39
12484	37	0	0	0	0	37
12485	0	0	0	38	0	38
12486	35	0	0	0	0	35
12487	0	34	0	0	0	34
12488	0	36	0	0	0	36
12489	38	0	0	0	0	38
12490	0	0	33	0	0	33
12491	37	0	0	0	0	37
12492	0	32	0	0	0	32
12493	0	0	0	31	0	31
12494	32	0	0	0	0	32
12495	0	0	0	32	0	32
12496	32	0	0	0	0	32
12497	27	0	0	0	0	27
12498	0	31	0	0	0	31
12499	30	0	0	0	0	30
12500	0	28	0	0	0	28
12501	30	0	0	0	0	30
12502	0	1	0	26	0	27
12503	28	0	0	0	0	28
12504	0	0	0	30	0	30
12505	31	0	0	0	0	31
12506	30	0	0	0	0	30
12507	32	0	0	0	0	32
12508	33	0	0	0	0	33
12509	33	0	0	0	0	33
12510	0	0	0	32	0	32
12511	32	0	0	0	0	32
12512	0	30	0	0	0	30
12513	0	0	31	0	0	31
12514	0	0	0	35	0	35
12515	0	0	35	0	0	35
12516	0	0	0	36	0	36
12517	0	0	38	0	0	38
12518	37	0	0	0	0	37
12519	0	0	0	39	0	39
12520	0	0	35	0	0	35
12521	0	1	31	0	0	32
12522	0	0	0	33	0	33
12523	41	0	0	0	0	41
12524	0	40	0	0	0	40
12525	39	0	0	0	0	39
12526	40	0	0	0	0	40
12527	0	37	0	0	0	37
12528	43	0	0	0	0	43
12529	0	0	0	43	0	43
12530	0	0	0	39	0	39
12531	0	0	0	43	0	43
12532	43	0	0	0	0	43
12533	0	41	0	0	0	41
12534	0	0	0	43	0	43
12535	0	0	0	41	0	41
12536	45	0	0	0	0	45
12537	0	0	0	46	0	46
12538	0	0	48	0	0	48
12539	0	46	0	0	0	46
12540	48	0	0	0	0	48
12541	0	0	0	46	0	46
12542	0	47	0	0	0	47
12543	51	0	0	0	0	51
12544	0	0	47	0	0	47
12545	0	47	0	0	0	47
12546	49	0	0	0	0	49
12547	0	0	0	51	0	51
12548	0	0	0	53	0	53
12549	0	0	51	0	0	51
12550	0	0	0	52	0	52
12551	0	0	51	0	0	51
12552	0	0	47	0	0	47
12553	0	1	53	0	0	54
12554	56	0	0	0	0	56
12555	55	0	0	0	0	55
12556	55	0	0	0	0	55
12557	0	0	0	54	0	54
12558	0	56	0	0	0	56
12559	0	56	0	0	0	56
12560	54	0	0	0	0	54
12561	55	0	0	0	0	55
12562	0	51	0	0	0	51
12563	51	0	0	0	0	51
12564	0	0	51	0	0	51
12565	0	0	47	0	0	47
12566	0	0	0	49	0	49
12567	0	0	0	50	0	50
12568	0	0	51	0	0	51
12569	0	0	0	50	0	50
12570	50	0	0	0	0	50
12571	0	0	47	0	0	47
12572	49	0	0	0	0	49
12573	0	0	0	47	0	47
12574	0	0	45	0	0	45
12575	0	45	0	0	0	45
12576	44	0	0	0	0	44
12577	0	0	45	0	0	45
12578	47	0	0	0	0	47
12579	0	0	0	47	0	47
12580	47	0	0	0	0	47
12581	0	0	45	0	0	45
12582	0	0	0	44	0	44
12583	47	0	0	0	0	47
12584	46	0	0	0	0	46
12585	46	1	0	0	0	47
12586	47	0	0	0	0	47
12587	0	0	0	42	0	42
12588	0	0	0	46	0	46
12589	0	0	47	0	0	47
12590	0	0	0	47	0	47
12591	0	0	0	47	0	47
12592	0	47	0	0	0	47
12593	47	0	0	0	0	47
12594	44	0	0	0	0	44
12595	0	46	0	0	0	46
12596	0	0	0	45	0	45
12597	0	0	0	46	0	46
12598	44	0	0	0	0	44
12599	0	0	45	0	0	45
12600	0	0	0	46	0	46
12601	0	0	47	0	0	47
12602	48	0	0	0	0	48
12603	47	0	0	0	0	47
12604	48	0	0	0	0	48
12605	0	0	0	45	0	45
12606	0	0	0	45	0	45
12607	43	0	0	0	0	43
12608	0	0	44	0	0	44
12609	0	0	0	42	0	42
12610	43	0	0	0	0	43
12611	0	0	0	44	0	44
12612	0	0	42	0	0	42
12613	0	0	41	0	0	41
12614	45	0	0	0	0	45
12615	0	41	0	0	0	41
12616	38	0	0	0	0	38
12617	40	0	0	0	0	40
12618	0	0	0	41	0	41
12619	0	0	0	40	0	40
12620	0	39	0	0	0	39
12621	35	0	0	0	0	35
12622	0	36	0	0	0	36
12623	0	38	0	0	0	38
12624	0	0	0	33	0	33
12625	32	0	0	0	0	32
12626	32	0	0	0	0	32
12627	0	0	0	31	0	31
12628	0	0	0	32	0	32
12629	0	0	0	29	0	29
12630	29	0	0	0	0	29
12631	0	0	33	0	0	33
12632	0	29	0	0	0	29
12633	35	0	0	0	0	35
12634	0	0	0	34	0	34
12635	0	0	34	0	0	34
12636	0	0	32	0	0	32
12637	0	29	0	1	0	30
12638	0	33	0	0	0	33
12639	0	0	0	33	0	33
12640	0	29	0	0	0	29
12641	0	0	0	28	0	28
12642	0	0	0	30	0	30
12643	30	0	0	0	0	30
12644	0	0	0	31	0	31
12645	0	0	0	28	0	28
12646	0	0	25	0	0	25
12647	0	0	0	25	0	25
12648	25	0	0	0	0	25
12649	26	0	0	0	0	26
12650	0	25	0	0	0	25
12651	25	0	0	0	0	25
12652	0	0	25	0	0	25
12653	0	27	0	0	0	27
12654	0	0	0	27	0	27
12655	0	0	0	28	0	28
12656	0	0	0	27	0	27
12657	28	0	0	0	0	28
12658	27	0	0	0	0	27
12659	0	0	27	0	0	27
12660	0	0	26	0	0	26
12661	0	0	26	0	0	26
12662	0	27	0	0	0	27
12663	0	24	0	0	0	24
12664	27	0	0	0	0	27
12665	24	0	0	0	0	24
12666	0	0	0	27	0	27
12667	0	0	0	28	0	28
12668	0	26	0	0	0	26
12669	0	0	0	26	0	26
12670	0	0	27	0	0	27
12671	0	29	0	0	0	29
12672	0	0	0	27	0	27
12673	0	0	26	0	0	26
12674	0	0	0	29	0	29
12675	0	28	0	0	0	28
12676	25	0	0	0	0	25
12677	25	0	0	0	0	25
12678	26	0	0	0	0	26
12679	0	0	0	27	0	27
12680	0	0	0	24	0	24
12681	27	0	0	0	0	27
12682	0	29	0	0	0	29
12683	29	0	0	0	0	29
12684	0	0	27	0	0	27
12685	28	0	0	0	0	28
12686	29	0	0	0	0	29
12687	0	0	0	27	0	27
12688	29	0	0	0	0	29
12689	33	0	0	0	0	33
12690	0	0	0	33	0	33
12691	0	0	29	0	0	29
12692	31	0	0	0	0	31
12693	0	0	33	0	0	33
12694	0	32	0	0	0	32
12695	0	0	0	31	0	31
12696	0	0	0	33	0	33
12697	36	0	0	0	0	36
12698	0	0	36	0	0	36
12699	0	0	0	38	0	38
12700	0	42	0	0	0	42
12701	0	43	0	0	0	43
12702	0	0	0	45	0	45
12703	0	0	46	0	0	46
12704	0	0	0	43	0	43
12705	0	0	0	43	0	43
12706	0	0	42	0	0	42
12707	0	44	0	0	0	44
12708	43	0	0	0	0	43
12709	0	44	0	0	0	44
12710	0	0	0	45	0	45
12711	43	0	0	0	0	43
12712	0	41	0	0	0	41
12713	0	0	49	0	0	49
12714	47	0	0	0	0	47
12715	0	49	0	0	0	49
12716	46	0	0	0	0	46
12717	0	0	46	0	0	46
12718	50	0	0	0	0	50
12719	0	0	0	50	0	50
12720	0	0	49	0	0	49
12721	0	0	0	50	0	50
12722	0	50	0	0	0	50
12723	0	0	0	52	0	52
12724	0	0	0	50	0	50
12725	0	0	50	0	0	50
12726	0	0	0	44	0	44
12727	0	0	34	1	0	35
12728	0	42	0	0	0	42
12729	0	0	0	45	0	45
12730	0	0	46	0	0	46
12731	0	43	0	0	0	43
12732	0	46	0	0	0	46
12733	0	0	47	0	0	47
12734	0	0	48	0	0	48
12735	0	0	0	49	0	49
12736	48	0	0	0	0	48
12737	0	49	0	0	0	49
12738	0	0	0	50	0	50
12739	49	0	0	0	0	49
12740	0	49	0	0	0	49
12741	47	0	0	0	0	47
12742	0	48	0	0	0	48
12743	53	0	0	0	0	53
12744	52	0	0	0	0	52
12745	55	0	0	0	0	55
12746	0	56	0	0	0	56
12747	0	0	0	57	0	57
12748	0	0	55	0	0	55
12749	0	56	0	0	0	56
12750	0	0	0	60	0	60
12751	0	0	0	60	0	60
12752	0	0	57	0	0	57
12753	0	56	0	0	0	56
12754	58	0	0	0	0	58
12755	0	58	0	0	0	58
12756	0	0	0	57	0	57
12757	0	0	58	0	0	58
12758	57	0	0	0	0	57
12759	0	0	0	57	0	57
12760	0	0	57	0	0	57
12761	57	0	0	0	0	57
12762	0	59	0	0	0	59
12763	59	0	0	0	0	59
12764	58	0	0	0	0	58
12765	0	0	0	58	0	58
12766	0	0	59	0	0	59
12767	0	57	0	0	0	57
12768	0	0	57	0	0	57
12769	0	0	0	56	0	56
12770	0	0	0	58	0	58
12771	56	0	0	0	0	56
12772	0	0	55	0	0	55
12773	0	55	0	0	0	55
12774	0	0	0	55	0	55
12775	0	0	0	55	0	55
12776	50	0	0	1	0	51
12777	0	52	0	0	0	52
12778	0	0	0	51	0	51
12779	51	0	0	0	0	51
12780	0	51	0	0	0	51
12781	51	0	0	0	0	51
12782	45	0	0	0	0	45
12783	0	46	0	0	0	46
12784	46	0	0	0	0	46
12785	0	45	0	0	0	45
12786	48	0	0	0	0	48
12787	47	0	0	0	0	47
12788	0	48	0	0	0	48
12789	45	0	0	0	0	45
12790	42	0	0	0	0	42
12791	39	0	0	0	0	39
12792	0	0	37	0	0	37
12793	0	0	31	0	0	31
12794	0	0	31	0	0	31
12795	35	0	0	0	0	35
12796	0	0	36	0	0	36
12797	1	0	36	0	0	37
12798	0	0	1	29	0	30
12799	35	0	0	0	0	35
12800	0	0	34	0	0	34
12801	0	0	33	0	0	33
12802	0	0	0	30	0	30
12803	0	0	0	34	0	34
12804	0	0	0	32	0	32
12805	0	0	30	0	0	30
12806	0	0	0	29	0	29
12807	28	0	0	0	0	28
12808	0	29	0	0	0	29
12809	0	0	0	28	0	28
12810	0	0	0	29	0	29
12811	0	0	28	0	0	28
12812	0	29	0	0	0	29
12813	28	0	0	0	0	28
12814	0	26	0	0	0	26
12815	0	0	0	27	0	27
12816	0	0	26	0	0	26
12817	1	0	0	27	0	28
12818	0	0	0	27	0	27
12819	28	0	0	0	0	28
12820	0	0	0	28	0	28
12821	0	26	0	0	0	26
12822	0	28	0	0	0	28
12823	0	0	28	0	0	28
12824	27	0	0	0	0	27
12825	0	0	0	27	0	27
12826	0	0	0	25	0	25
12827	0	0	1	26	0	27
12828	25	0	0	1	0	26
12829	1	24	0	0	0	25
12830	28	0	0	0	0	28
12831	0	0	27	0	0	27
12832	0	0	28	0	0	28
12833	28	0	0	0	0	28
12834	0	0	0	29	0	29
12835	0	0	0	29	0	29
12836	0	0	0	26	0	26
12837	0	0	28	0	0	28
12838	20	0	0	0	0	20
12839	21	0	0	0	0	21
12840	21	0	0	0	0	21
12841	0	0	0	20	0	20
12842	0	0	21	0	0	21
12843	0	0	19	0	0	19
12844	0	0	22	0	0	22
12845	0	21	0	0	0	21
12846	0	0	0	23	0	23
12847	22	0	0	0	0	22
12848	0	0	22	0	0	22
12849	23	0	0	0	0	23
12850	0	0	0	21	0	21
12851	0	0	0	23	0	23
12852	0	24	0	0	0	24
12853	0	21	0	0	0	21
12854	0	22	0	0	0	22
12855	0	0	0	23	0	23
12856	24	0	0	0	0	24
12857	24	0	0	0	0	24
12858	0	0	23	0	0	23
12859	26	0	0	0	0	26
12860	0	0	25	0	0	25
12861	0	0	0	26	0	26
12862	0	0	26	0	0	26
12863	26	0	0	0	0	26
12864	0	0	0	28	0	28
12865	0	0	29	0	0	29
12866	0	1	27	0	0	28
12867	29	0	0	0	0	29
12868	29	0	0	0	0	29
12869	0	30	0	0	0	30
12870	0	0	0	30	0	30
12871	0	0	28	0	0	28
12872	0	0	32	0	0	32
12873	0	0	0	34	0	34
12874	34	0	0	0	0	34
12875	0	32	0	0	0	32
12876	0	0	0	35	0	35
12877	35	0	0	0	0	35
12878	0	0	0	35	0	35
12879	0	36	0	1	0	37
12880	0	0	0	36	0	36
12881	32	0	0	0	0	32
12882	1	0	0	33	0	34
12883	35	0	0	0	0	35
12884	0	37	0	0	0	37
12885	35	0	0	0	0	35
12886	0	0	36	0	0	36
12887	39	0	0	0	0	39
12888	34	0	0	0	0	34
12889	0	39	0	0	0	39
12890	0	0	0	37	0	37
12891	0	0	37	0	0	37
12892	0	0	36	0	0	36
12893	38	0	0	0	0	38
12894	35	0	0	0	0	35
12895	0	35	0	0	0	35
12896	0	37	0	0	0	37
12897	36	0	0	0	0	36
12898	0	32	0	0	0	32
12899	0	35	0	0	0	35
12900	0	0	0	37	0	37
12901	0	0	0	38	0	38
12902	0	0	38	0	0	38
12903	0	0	0	36	0	36
12904	37	0	0	0	0	37
12905	0	0	37	0	0	37
12906	0	1	37	0	0	38
12907	0	0	0	39	0	39
12908	0	0	0	37	0	37
12909	0	0	0	39	0	39
12910	0	0	38	0	0	38
12911	1	0	0	35	0	36
12912	0	0	0	36	0	36
12913	34	0	0	0	0	34
12914	0	35	0	0	0	35
12915	35	0	0	0	0	35
12916	0	0	37	0	0	37
12917	36	0	0	0	0	36
12918	0	36	0	0	0	36
12919	35	0	0	0	0	35
12920	0	35	0	0	0	35
12921	36	0	0	0	0	36
12922	0	35	0	0	0	35
12923	0	37	0	0	0	37
12924	0	0	0	38	0	38
12925	38	0	0	0	0	38
12926	34	0	0	0	0	34
12927	38	0	0	0	0	38
12928	0	0	34	0	0	34
12929	0	0	33	0	0	33
12930	0	0	0	37	0	37
12931	0	34	0	0	0	34
12932	0	36	0	0	0	36
12933	0	0	0	37	0	37
12934	40	0	0	0	0	40
12935	41	0	0	0	0	41
12936	38	0	0	0	0	38
12937	0	0	36	0	0	36
12938	0	0	0	38	0	38
12939	0	0	39	0	0	39
12940	40	0	0	0	0	40
12941	39	0	0	0	0	39
12942	0	0	40	0	0	40
12943	0	0	0	39	0	39
12944	40	0	0	0	0	40
12945	1	0	0	39	0	40
12946	0	0	0	45	0	45
12947	0	0	0	45	0	45
12948	45	0	0	0	0	45
12949	0	0	0	42	0	42
12950	42	0	0	0	0	42
12951	0	44	0	0	0	44
12952	0	0	0	42	0	42
12953	0	0	0	41	0	41
12954	0	0	0	43	0	43
12955	44	0	0	0	0	44
12956	0	0	0	44	0	44
12957	0	0	0	44	0	44
12958	45	0	0	0	0	45
12959	45	0	0	0	0	45
12960	46	0	0	0	0	46
12961	0	0	43	0	0	43
12962	0	0	36	0	0	36
12963	47	0	0	0	0	47
12964	0	0	0	47	0	47
12965	0	0	0	42	0	42
12966	45	0	0	0	0	45
12967	41	1	0	0	0	42
12968	42	0	0	0	0	42
12969	0	40	0	0	0	40
12970	40	0	0	0	0	40
12971	39	0	0	0	0	39
12972	0	37	0	1	0	38
12973	0	35	0	0	0	35
12974	0	0	0	38	0	38
12975	39	0	0	0	0	39
12976	39	0	0	0	0	39
12977	38	0	0	0	0	38
12978	0	0	0	39	0	39
12979	38	0	0	0	0	38
12980	0	0	35	0	0	35
12981	37	0	0	0	0	37
12982	0	0	37	0	0	37
12983	0	0	29	0	0	29
12984	0	0	0	36	0	36
12985	36	0	0	0	0	36
12986	0	0	0	35	0	35
12987	0	0	35	0	0	35
12988	0	0	34	0	0	34
12989	0	0	0	35	0	35
12990	35	0	0	0	0	35
12991	0	34	0	0	0	34
12992	0	0	0	35	0	35
12993	0	0	0	33	0	33
12994	0	0	35	0	0	35
12995	0	0	34	0	0	34
12996	0	0	0	35	0	35
12997	35	0	0	0	0	35
12998	0	0	37	0	0	37
12999	0	0	0	37	0	37
13000	0	0	0	37	0	37
13001	0	0	0	36	0	36
13002	36	0	0	0	0	36
13003	0	0	31	0	0	31
13004	0	35	0	0	0	35
13005	0	0	0	35	0	35
13006	0	0	39	0	0	39
13007	0	37	0	0	0	37
13008	0	36	0	0	0	36
13009	36	0	0	0	0	36
13010	0	37	0	0	0	37
13011	36	0	0	0	0	36
13012	0	0	35	0	0	35
13013	0	0	0	37	0	37
13014	36	0	0	0	0	36
13015	0	35	0	0	0	35
13016	0	0	35	0	0	35
13017	0	0	0	35	0	35
13018	0	36	0	0	0	36
13019	0	0	0	36	0	36
13020	36	0	0	0	0	36
13021	0	37	0	0	0	37
13022	39	0	0	0	0	39
13023	49	0	0	0	0	49
13024	0	0	49	0	0	49
13025	0	43	0	0	0	43
13026	0	0	0	46	0	46
13027	0	0	44	0	0	44
13028	0	0	50	0	0	50
13029	0	0	0	51	0	51
13030	51	0	0	0	0	51
13031	50	0	0	0	0	50
13032	1	0	0	54	0	55
13033	0	0	56	0	0	56
13034	0	56	0	0	0	56
13035	56	0	0	0	0	56
13036	55	0	0	0	0	55
13037	0	55	0	0	0	55
13038	53	0	0	0	0	53
13039	0	0	54	0	0	54
13040	51	0	0	0	0	51
13041	51	0	0	0	0	51
13042	0	0	53	0	0	53
13043	0	0	0	52	0	52
13044	0	0	51	0	0	51
13045	0	52	0	0	0	52
13046	0	53	0	0	0	53
13047	0	0	0	46	0	46
13048	0	0	50	0	0	50
13049	0	42	0	0	0	42
13050	0	44	0	0	0	44
13051	39	1	0	0	0	40
13052	41	0	0	0	0	41
13053	0	0	0	40	0	40
13054	0	0	0	42	0	42
13055	0	44	0	0	0	44
13056	39	0	0	0	0	39
13057	43	0	0	0	0	43
13058	0	44	0	0	0	44
13059	0	0	0	41	0	41
13060	0	0	42	0	0	42
13061	0	0	0	43	0	43
13062	40	0	0	0	0	40
13063	0	0	0	43	0	43
13064	0	0	0	42	0	42
13065	42	0	0	0	0	42
13066	0	0	0	41	0	41
13067	0	41	0	0	0	41
13068	0	0	0	43	0	43
13069	0	0	0	43	0	43
13070	0	0	0	40	0	40
13071	0	41	0	0	0	41
13072	0	0	0	43	0	43
13073	0	0	43	0	0	43
13074	0	0	0	43	0	43
13075	0	0	42	0	0	42
13076	0	42	0	0	0	42
13077	0	0	0	42	0	42
13078	0	0	0	42	0	42
13079	0	0	1	42	0	43
13080	0	0	0	42	0	42
13081	0	0	40	0	0	40
13082	0	40	0	0	0	40
13083	0	0	0	39	0	39
13084	0	0	41	0	0	41
13085	0	0	0	43	0	43
13086	41	0	0	0	0	41
13087	0	0	40	0	0	40
13088	39	0	0	0	0	39
13089	0	0	0	43	0	43
13090	0	0	44	0	0	44
13091	0	42	0	0	0	42
13092	0	0	0	42	0	42
13093	0	0	47	0	0	47
13094	0	44	0	0	0	44
13095	0	0	0	49	0	49
13096	48	0	0	0	0	48
13097	48	0	0	0	0	48
13098	49	0	0	0	0	49
13099	0	0	44	0	0	44
13100	0	45	0	0	0	45
13101	0	0	0	44	0	44
13102	0	0	0	44	0	44
13103	45	0	0	0	0	45
13104	0	44	0	0	0	44
13105	46	0	0	0	0	46
13106	43	0	0	0	0	43
13107	46	0	0	0	0	46
13108	0	0	45	0	0	45
13109	47	0	0	0	0	47
13110	0	0	0	47	0	47
13111	0	0	0	50	0	50
13112	49	0	0	0	0	49
13113	0	0	0	50	0	50
13114	0	49	0	0	0	49
13115	0	0	0	50	0	50
13116	43	0	0	0	0	43
13117	0	0	43	0	0	43
13118	0	42	0	0	0	42
13119	0	0	0	42	0	42
13120	40	0	0	0	0	40
13121	0	0	37	0	0	37
13122	0	0	0	37	0	37
13123	0	0	35	0	0	35
13124	0	0	34	1	0	35
13125	0	0	31	0	0	31
13126	0	0	29	0	0	29
13127	0	0	29	0	0	29
13128	29	0	0	0	0	29
13129	0	32	0	0	0	32
13130	31	0	0	0	0	31
13131	32	0	0	0	0	32
13132	0	33	0	0	0	33
13133	0	32	0	0	0	32
13134	34	0	0	0	0	34
13135	35	0	0	0	0	35
13136	0	0	0	35	0	35
13137	0	38	0	0	0	38
13138	36	0	0	0	0	36
13139	0	38	0	0	0	38
13140	0	0	0	37	0	37
13141	38	0	0	0	0	38
13142	38	0	0	0	0	38
13143	0	0	0	38	0	38
13144	0	0	0	38	0	38
13145	0	0	38	0	0	38
13146	0	0	0	37	0	37
13147	0	0	37	0	0	37
13148	0	0	0	38	0	38
13149	0	0	0	40	0	40
13150	36	0	0	0	0	36
13151	36	0	0	0	0	36
13152	0	0	38	0	0	38
13153	39	0	0	0	0	39
13154	0	0	0	40	0	40
13155	0	0	41	0	0	41
13156	0	0	1	38	0	39
13157	0	0	0	40	0	40
13158	0	0	40	0	0	40
13159	0	0	0	38	0	38
13160	0	0	41	0	0	41
13161	0	0	0	39	0	39
13162	39	0	0	0	0	39
13163	0	42	0	0	0	42
13164	39	0	0	0	0	39
13165	0	46	0	0	0	46
13166	44	0	0	0	0	44
13167	0	45	0	0	0	45
13168	44	0	0	0	0	44
13169	0	49	0	0	0	49
13170	0	0	0	50	0	50
13171	0	0	49	0	0	49
13172	0	0	48	0	0	48
13173	0	0	0	50	0	50
13174	52	0	0	0	0	52
13175	0	50	0	0	0	50
13176	0	0	0	51	0	51
13177	0	0	51	0	0	51
13178	0	0	56	0	0	56
13179	0	0	0	53	0	53
13180	0	55	0	0	0	55
13181	57	0	0	0	0	57
13182	0	0	59	0	0	59
13183	0	0	59	0	0	59
13184	0	60	0	0	0	60
13185	62	0	0	0	0	62
13186	61	0	0	0	0	61
13187	0	0	0	68	0	68
13188	69	0	0	0	0	69
13189	64	0	0	0	0	64
13190	0	66	0	0	0	66
13191	72	0	0	0	0	72
13192	0	0	71	0	0	71
13193	0	0	0	67	0	67
13194	0	0	0	73	0	73
13195	74	0	0	0	0	74
13196	0	76	0	0	0	76
13197	72	0	0	0	0	72
13198	0	72	0	0	0	72
13199	0	69	0	0	0	69
13200	0	0	70	0	0	70
13201	0	0	64	0	0	64
13202	73	0	0	0	0	73
13203	72	0	0	0	0	72
13204	0	0	66	0	0	66
13205	0	61	1	0	0	62
13206	0	68	0	0	0	68
13207	72	0	0	0	0	72
13208	65	0	0	0	0	65
13209	0	0	0	66	0	66
13210	68	0	0	0	0	68
13211	0	0	0	69	0	69
13212	0	0	67	0	0	67
13213	0	0	66	0	0	66
13214	70	0	0	1	0	71
13215	0	0	0	72	0	72
13216	0	74	0	0	0	74
13217	77	0	0	0	0	77
13218	77	0	0	0	0	77
13219	0	0	73	0	0	73
13220	77	0	0	0	0	77
13221	78	0	0	0	0	78
13222	0	0	0	79	0	79
13223	0	73	0	0	0	73
13224	0	71	0	0	0	71
13225	0	0	0	81	0	81
13226	0	0	0	81	0	81
13227	0	0	0	80	0	80
13228	0	0	80	0	0	80
13229	0	0	70	0	0	70
13230	0	0	0	76	0	76
13231	0	0	74	0	0	74
13232	0	0	70	0	0	70
13233	0	0	0	74	0	74
13234	0	0	75	0	0	75
13235	0	75	0	0	0	75
13236	76	0	0	0	0	76
13237	0	0	0	77	0	77
13238	0	76	0	0	0	76
13239	0	0	75	0	0	75
13240	0	0	0	74	0	74
13241	0	0	76	0	0	76
13242	0	0	0	75	0	75
13243	0	0	0	76	0	76
13244	0	0	80	0	0	80
13245	0	0	0	76	0	76
13246	0	72	0	0	0	72
13247	0	0	0	79	0	79
13248	0	0	79	0	0	79
13249	0	0	0	79	0	79
13250	75	0	0	0	0	75
13251	0	77	0	0	0	77
13252	0	0	0	80	0	80
13253	0	0	73	0	0	73
13254	0	74	0	0	0	74
13255	0	77	0	0	0	77
13256	0	0	76	0	0	76
13257	0	0	0	72	0	72
13258	0	0	0	71	0	71
13259	0	0	74	0	0	74
13260	0	72	0	0	0	72
13261	0	70	0	0	0	70
13262	69	0	0	0	0	69
13263	0	68	0	0	0	68
13264	68	0	0	0	0	68
13265	0	0	0	64	0	64
13266	67	0	0	1	0	68
13267	1	0	63	0	0	64
13268	67	0	0	0	0	67
13269	0	0	0	67	0	67
13270	0	63	1	0	0	64
13271	60	0	0	0	0	60
13272	0	0	0	54	0	54
13273	0	56	0	0	0	56
13274	0	60	0	0	0	60
13275	60	0	0	0	0	60
13276	60	0	0	0	0	60
13277	61	0	0	1	0	62
13278	0	0	0	65	0	65
13279	0	57	0	1	0	58
13280	0	56	0	0	0	56
13281	0	0	0	59	0	59
13282	60	0	0	0	0	60
13283	60	0	0	0	0	60
13284	57	0	0	0	0	57
13285	0	1	49	0	0	50
13286	0	0	54	0	0	54
13287	55	0	0	0	0	55
13288	0	0	0	56	0	56
13289	0	0	0	53	0	53
13290	0	0	0	54	0	54
13291	0	0	0	52	0	52
13292	0	0	51	0	0	51
13293	0	0	0	50	0	50
13294	0	0	48	1	0	49
13295	47	0	0	0	0	47
13296	0	47	0	0	0	47
13297	0	0	0	51	0	51
13298	0	0	0	50	0	50
13299	48	0	0	0	0	48
13300	47	0	0	0	0	47
13301	45	0	0	0	0	45
13302	47	0	0	0	0	47
13303	0	0	50	0	0	50
13304	0	0	45	0	0	45
13305	0	0	0	46	0	46
13306	47	0	0	0	0	47
13307	52	0	0	0	0	52
13308	0	0	52	0	0	52
13309	0	0	0	47	0	47
13310	46	0	0	0	0	46
13311	0	0	0	48	0	48
13312	0	0	47	0	0	47
13313	0	0	0	43	0	43
13314	44	0	0	0	0	44
13315	0	44	0	0	0	44
13316	46	0	0	0	0	46
13317	41	0	0	0	0	41
13318	43	0	0	0	0	43
13319	0	0	0	43	0	43
13320	41	0	0	0	0	41
13321	0	42	0	0	0	42
13322	0	44	0	0	0	44
13323	0	0	0	43	0	43
13324	44	0	0	0	0	44
13325	0	43	0	0	0	43
13326	45	0	0	0	0	45
13327	44	0	0	0	0	44
13328	0	49	0	0	0	49
13329	0	0	0	51	0	51
13330	0	0	0	45	0	45
13331	0	0	48	0	0	48
13332	0	0	0	51	0	51
13333	0	0	67	0	0	67
13334	0	70	0	0	0	70
13335	0	0	0	71	0	71
13336	70	0	0	0	0	70
13337	59	0	0	0	0	59
13338	0	0	0	65	0	65
13339	0	0	67	0	0	67
13340	64	0	0	1	0	65
13341	0	64	0	0	0	64
13342	0	61	0	0	0	61
13343	0	64	0	0	0	64
13344	0	0	0	67	0	67
13345	0	0	66	0	0	66
13346	0	0	0	68	0	68
13347	0	0	68	0	0	68
13348	0	0	66	0	0	66
13349	0	0	68	0	0	68
13350	0	0	0	68	0	68
13351	0	0	0	67	0	67
13352	0	0	0	67	0	67
13353	0	0	0	68	0	68
13354	66	0	0	0	0	66
13355	0	64	0	0	0	64
13356	65	0	0	1	0	66
13357	0	67	0	0	0	67
13358	0	0	0	66	0	66
13359	0	0	0	68	0	68
13360	66	0	0	0	0	66
13361	62	0	0	0	0	62
13362	64	1	0	0	0	65
13363	66	0	0	0	0	66
13364	65	0	0	0	0	65
13365	0	69	0	0	0	69
13366	65	0	0	0	0	65
13367	0	68	0	0	0	68
13368	65	0	0	0	0	65
13369	0	0	64	0	0	64
13370	0	0	0	65	0	65
13371	0	68	0	0	0	68
13372	0	0	0	62	0	62
13373	0	0	65	0	0	65
13374	0	0	1	62	0	63
13375	63	0	0	0	0	63
13376	0	58	0	0	0	58
13377	0	59	0	0	0	59
13378	0	0	69	0	0	69
13379	0	0	0	58	0	58
13380	0	69	0	0	0	69
13381	0	0	0	71	0	71
13382	0	0	71	0	0	71
13383	0	68	0	0	0	68
13384	0	0	70	0	0	70
13385	0	0	68	0	0	68
13386	0	0	0	69	0	69
13387	68	0	0	0	0	68
13388	0	0	0	71	0	71
13389	0	0	72	0	0	72
13390	0	0	0	74	0	74
13391	0	1	72	0	0	73
13392	1	1	68	0	0	70
13393	71	0	0	0	0	71
13394	73	0	0	0	0	73
13395	73	0	0	0	0	73
13396	0	0	64	0	0	64
13397	0	0	70	0	0	70
13398	0	0	0	69	0	69
13399	0	0	0	73	0	73
13400	66	0	0	0	0	66
13401	0	0	0	68	0	68
13402	0	0	66	0	0	66
13403	0	0	64	1	0	65
13404	0	62	0	0	0	62
13405	0	0	0	68	0	68
13406	0	0	68	0	0	68
13407	0	0	0	63	0	63
13408	60	0	0	1	0	61
13409	0	0	62	0	0	62
13410	0	0	1	58	0	59
13411	0	0	0	55	0	55
13412	0	0	61	0	0	61
13413	0	0	0	62	0	62
13414	0	0	57	0	0	57
13415	55	0	0	0	0	55
13416	0	0	0	53	0	53
13417	0	52	0	0	0	52
13418	52	0	0	0	0	52
13419	50	0	0	1	0	51
13420	0	51	0	0	0	51
13421	0	0	0	49	0	49
13422	0	48	0	0	0	48
13423	0	49	0	0	0	49
13424	0	0	49	0	0	49
13425	0	43	0	0	0	43
13426	0	0	30	0	0	30
13427	28	0	0	0	0	28
13428	27	0	0	0	0	27
13429	0	27	0	0	0	27
13430	0	24	0	0	0	24
13431	0	27	0	0	0	27
13432	27	0	0	0	0	27
13433	0	0	0	27	0	27
13434	0	0	27	0	0	27
13435	0	27	0	0	0	27
13436	0	0	0	28	0	28
13437	0	0	0	28	0	28
13438	0	30	0	0	0	30
13439	28	0	0	0	0	28
13440	0	0	29	0	0	29
13441	0	0	0	30	0	30
13442	0	29	0	0	0	29
13443	30	0	0	0	0	30
13444	0	0	28	0	0	28
13445	0	32	0	0	0	32
13446	0	0	0	31	0	31
13447	0	0	30	0	0	30
13448	31	0	0	0	0	31
13449	0	0	0	32	0	32
13450	0	0	34	1	0	35
13451	0	34	0	0	0	34
13452	35	0	0	0	0	35
13453	0	36	0	0	0	36
13454	35	0	0	0	0	35
13455	34	0	0	0	0	34
13456	0	0	0	35	0	35
13457	0	34	0	0	0	34
13458	0	0	31	0	0	31
13459	0	0	0	34	0	34
13460	0	0	0	34	0	34
13461	0	0	0	34	0	34
13462	0	0	0	37	0	37
13463	0	0	0	39	0	39
13464	38	0	0	0	0	38
13465	37	0	1	0	0	38
13466	33	0	0	0	0	33
13467	0	37	0	0	0	37
13468	0	0	40	0	0	40
13469	0	0	40	0	0	40
13470	0	0	39	0	0	39
13471	0	0	0	39	0	39
13472	0	0	0	36	0	36
13473	0	0	0	34	0	34
13474	0	0	34	0	0	34
13475	0	31	0	0	0	31
13476	0	0	34	0	0	34
13477	0	0	29	0	0	29
13478	0	0	0	32	0	32
13479	0	0	31	0	0	31
13480	0	0	0	33	0	33
13481	33	0	0	0	0	33
13482	31	0	0	0	0	31
13483	0	0	32	0	0	32
13484	0	0	0	30	0	30
13485	0	0	30	0	0	30
13486	0	31	0	0	0	31
13487	32	0	0	0	0	32
13488	0	0	32	0	0	32
13489	0	31	0	0	0	31
13490	0	32	0	0	0	32
13491	0	34	0	0	0	34
13492	0	0	33	0	0	33
13493	0	0	0	32	0	32
13494	0	33	0	0	0	33
13495	0	0	0	31	0	31
13496	0	0	0	32	0	32
13497	32	0	0	0	0	32
13498	0	31	0	0	0	31
13499	32	0	0	0	0	32
13500	0	31	0	0	0	31
13501	0	31	0	0	0	31
13502	0	0	31	0	0	31
13503	0	0	0	32	0	32
13504	0	0	32	0	0	32
13505	0	31	0	0	0	31
13506	0	0	31	0	0	31
13507	0	0	29	0	0	29
13508	0	32	0	0	0	32
13509	33	0	0	0	0	33
13510	0	35	0	0	0	35
13511	33	0	0	0	0	33
13512	0	0	34	0	0	34
13513	0	0	32	0	0	32
13514	0	32	0	0	0	32
13515	33	0	0	0	0	33
13516	0	30	0	0	0	30
13517	0	0	0	31	0	31
13518	32	0	0	0	0	32
13519	0	0	33	0	0	33
13520	0	0	0	33	0	33
13521	29	0	0	0	0	29
13522	0	32	0	0	0	32
13523	0	0	0	31	0	31
13524	0	0	31	0	0	31
13525	33	0	0	0	0	33
13526	0	0	0	32	0	32
13527	0	0	31	0	0	31
13528	0	0	0	31	0	31
13529	0	30	0	0	0	30
13530	0	0	27	0	0	27
13531	0	0	0	28	0	28
13532	28	0	0	0	0	28
13533	0	0	0	27	0	27
13534	26	0	0	0	0	26
13535	0	25	0	0	0	25
13536	26	0	0	0	0	26
13537	0	0	24	0	0	24
13538	0	0	28	0	0	28
13539	0	0	27	0	0	27
13540	0	31	0	0	0	31
13541	0	0	0	34	0	34
13542	0	0	0	33	0	33
13543	0	0	0	30	0	30
13544	0	0	0	31	0	31
13545	0	0	27	0	0	27
13546	28	0	0	0	0	28
13547	0	30	0	0	0	30
13548	30	0	0	0	0	30
13549	0	0	0	30	0	30
13550	0	28	0	0	0	28
13551	0	0	0	30	0	30
13552	27	0	0	0	0	27
13553	0	33	0	0	0	33
13554	31	0	0	0	0	31
13555	28	0	0	0	0	28
13556	0	0	0	27	0	27
13557	0	0	29	0	0	29
13558	29	0	0	0	0	29
13559	0	0	0	29	0	29
13560	29	0	0	0	0	29
13561	29	0	0	0	0	29
13562	28	0	0	0	0	28
13563	0	0	28	0	0	28
13564	0	0	0	29	0	29
13565	29	0	0	0	0	29
13566	0	0	26	0	0	26
13567	0	24	0	0	0	24
13568	0	0	0	28	0	28
13569	0	0	27	0	0	27
13570	0	0	25	0	0	25
13571	0	0	1	24	0	25
13572	0	0	0	28	0	28
13573	0	0	0	27	0	27
13574	0	0	0	27	0	27
13575	0	0	27	0	0	27
13576	0	26	0	0	0	26
13577	0	0	0	26	0	26
13578	26	0	0	0	0	26
13579	23	0	0	0	0	23
13580	24	0	0	0	0	24
13581	0	0	0	24	0	24
13582	0	0	0	25	0	25
13583	0	24	0	0	0	24
13584	0	24	0	0	0	24
13585	0	0	0	23	0	23
13586	22	0	0	0	0	22
13587	23	0	0	0	0	23
13588	24	0	0	0	0	24
13589	25	0	0	0	0	25
13590	25	0	0	0	0	25
13591	0	24	0	0	0	24
13592	0	0	0	25	0	25
13593	25	0	0	0	0	25
13594	27	0	0	0	0	27
13595	0	0	0	32	0	32
13596	0	0	0	32	0	32
13597	0	0	32	0	0	32
13598	0	0	0	30	0	30
13599	0	0	0	30	0	30
13600	0	0	31	0	0	31
13601	0	0	0	32	0	32
13602	0	32	0	0	0	32
13603	0	0	31	0	0	31
13604	0	32	0	0	0	32
13605	0	0	0	30	0	30
13606	0	0	0	29	0	29
13607	0	33	0	0	0	33
13608	0	35	0	0	0	35
13609	35	0	0	0	0	35
13610	35	0	0	0	0	35
13611	0	0	35	0	0	35
13612	33	0	0	0	0	33
13613	33	0	0	0	0	33
13614	34	0	0	0	0	34
13615	34	0	0	0	0	34
13616	0	0	32	0	0	32
13617	0	0	30	0	0	30
13618	33	0	0	0	0	33
13619	0	34	0	0	0	34
13620	0	0	34	0	0	34
13621	34	0	0	0	0	34
13622	34	0	0	0	0	34
13623	0	0	33	0	0	33
13624	34	0	0	0	0	34
13625	0	0	0	33	0	33
13626	0	0	35	0	0	35
13627	35	0	0	0	0	35
13628	0	34	0	0	0	34
13629	35	0	0	0	0	35
13630	35	0	0	0	0	35
13631	0	0	0	28	0	28
13632	0	0	0	30	0	30
13633	0	0	0	33	0	33
13634	31	0	0	0	0	31
13635	33	0	0	0	0	33
13636	0	0	0	31	0	31
13637	0	0	0	31	0	31
13638	0	0	31	0	0	31
13639	31	0	0	0	0	31
13640	0	0	0	30	0	30
13641	0	0	0	30	0	30
13642	0	29	0	0	0	29
13643	0	0	0	33	0	33
13644	0	0	0	33	0	33
13645	32	0	0	0	0	32
13646	0	30	0	0	0	30
13647	0	0	0	29	0	29
13648	0	0	0	29	0	29
13649	0	0	0	28	0	28
13650	0	0	28	0	0	28
13651	0	0	0	26	0	26
13652	27	0	0	0	0	27
13653	0	0	28	0	0	28
13654	0	0	0	28	0	28
13655	0	0	0	27	0	27
13656	30	0	0	0	0	30
13657	30	0	0	0	0	30
13658	0	0	29	0	0	29
13659	30	0	0	0	0	30
13660	0	0	32	0	0	32
13661	31	0	0	0	0	31
13662	0	31	0	0	0	31
13663	32	0	0	0	0	32
13664	0	33	0	0	0	33
13665	33	0	0	1	0	34
13666	0	32	0	0	0	32
13667	0	0	0	33	0	33
13668	0	0	0	36	0	36
13669	0	0	0	34	0	34
13670	0	34	0	0	0	34
13671	0	0	0	35	0	35
13672	0	34	0	0	0	34
13673	0	0	0	32	0	32
13674	38	0	0	0	0	38
13675	38	0	0	0	0	38
13676	0	35	0	0	0	35
13677	0	0	0	35	0	35
13678	34	0	0	0	0	34
13679	0	32	0	0	0	32
13680	0	34	0	0	0	34
13681	34	0	0	0	0	34
13682	32	0	0	0	0	32
13683	0	34	0	0	0	34
13684	34	0	0	0	0	34
13685	1	0	0	34	0	35
13686	0	0	35	0	0	35
13687	31	0	0	0	0	31
13688	29	0	0	0	0	29
13689	0	0	25	0	0	25
13690	27	0	0	0	0	27
13691	26	0	0	0	0	26
13692	27	0	0	0	0	27
13693	0	28	0	0	0	28
13694	30	0	0	0	0	30
13695	29	0	0	0	0	29
13696	0	0	0	30	0	30
13697	0	0	0	30	0	30
13698	0	0	0	27	0	27
13699	29	0	0	0	0	29
13700	0	0	0	25	0	25
13701	26	0	0	0	0	26
13702	26	0	0	0	0	26
13703	0	0	0	25	0	25
13704	0	0	0	24	0	24
13705	0	0	0	26	0	26
13706	25	0	0	0	0	25
13707	0	26	0	0	0	26
13708	0	0	0	26	0	26
13709	0	0	0	26	0	26
13710	28	0	0	0	0	28
13711	26	0	0	0	0	26
13712	0	0	30	0	0	30
13713	0	0	31	0	0	31
13714	32	0	0	0	0	32
13715	0	0	0	32	0	32
13716	1	0	0	31	0	32
13717	0	0	33	0	0	33
13718	0	0	0	31	0	31
13719	0	26	0	0	0	26
13720	1	32	0	0	0	33
13721	29	0	1	0	0	30
13722	0	0	30	0	0	30
13723	0	33	0	0	0	33
13724	0	0	0	35	0	35
13725	0	0	34	0	0	34
13726	0	0	0	27	0	27
13727	0	0	0	29	0	29
13728	0	0	28	0	0	28
13729	0	25	0	0	0	25
13730	0	0	0	32	0	32
13731	32	0	0	0	0	32
13732	31	0	0	0	0	31
13733	30	0	0	0	0	30
13734	0	32	0	0	0	32
13735	32	0	0	0	0	32
13736	0	0	0	29	0	29
13737	0	0	28	0	0	28
13738	27	0	0	0	0	27
13739	0	32	0	1	0	33
13740	0	0	0	36	0	36
13741	0	0	0	34	0	34
13742	0	35	0	1	0	36
13743	0	0	0	37	0	37
13744	0	0	0	38	0	38
13745	0	0	0	36	0	36
13746	36	0	0	0	0	36
13747	38	0	0	0	0	38
13748	0	0	37	0	0	37
13749	0	0	0	37	0	37
13750	0	0	0	38	0	38
13751	0	0	0	38	0	38
13752	39	0	0	0	0	39
13753	0	0	36	0	0	36
13754	36	0	0	0	0	36
13755	38	0	0	0	0	38
13756	0	0	0	39	0	39
13757	39	0	0	0	0	39
13758	0	0	40	0	0	40
13759	38	0	0	0	0	38
13760	0	37	0	0	0	37
13761	0	0	36	0	0	36
13762	0	0	39	0	0	39
13763	0	0	0	39	0	39
13764	0	0	43	0	0	43
13765	46	0	0	0	0	46
13766	0	45	0	0	0	45
13767	43	0	0	0	0	43
13768	0	2	0	43	0	45
13769	0	0	45	0	0	45
13770	0	0	42	0	0	42
13771	0	2	0	44	0	46
13772	49	0	0	0	0	49
13773	0	45	0	0	0	45
13774	0	46	0	0	0	46
13775	50	0	0	0	0	50
13776	0	51	0	0	0	51
13777	50	0	0	0	0	50
13778	0	0	0	51	0	51
13779	50	0	0	0	0	50
13780	0	0	0	50	0	50
13781	51	0	0	0	0	51
13782	0	0	0	51	0	51
13783	0	53	0	0	0	53
13784	50	0	0	0	0	50
13785	0	52	0	0	0	52
13786	0	0	50	0	0	50
13787	0	0	0	55	0	55
13788	0	55	0	0	0	55
13789	55	0	0	0	0	55
13790	52	0	0	0	0	52
13791	0	54	0	0	0	54
13792	0	0	51	0	0	51
13793	0	0	0	53	0	53
13794	0	50	0	0	0	50
13795	0	0	0	51	0	51
13796	0	0	0	51	0	51
13797	53	0	0	0	0	53
13798	0	52	0	0	0	52
13799	0	0	0	54	0	54
13800	50	0	0	0	0	50
13801	50	0	0	0	0	50
13802	51	0	0	0	0	51
13803	0	0	0	50	0	50
13804	50	0	0	0	0	50
13805	0	48	0	0	0	48
13806	46	0	0	0	0	46
13807	0	47	0	0	0	47
13808	47	0	0	0	0	47
13809	47	0	0	0	0	47
13810	0	0	0	42	0	42
13811	0	0	49	0	0	49
13812	0	0	45	0	0	45
13813	0	49	0	0	0	49
13814	51	0	0	0	0	51
13815	0	0	47	0	0	47
13816	50	0	0	0	0	50
13817	0	47	0	0	0	47
13818	0	53	0	0	0	53
13819	0	0	0	50	0	50
13820	0	50	0	0	0	50
13821	0	0	51	0	0	51
13822	0	0	0	45	0	45
13823	0	47	0	0	0	47
13824	0	0	0	50	0	50
13825	49	0	0	0	0	49
13826	0	0	0	50	0	50
13827	0	0	48	0	0	48
13828	0	50	0	0	0	50
13829	0	0	0	51	0	51
13830	0	0	0	52	0	52
13831	0	0	0	52	0	52
13832	48	0	0	0	0	48
13833	48	0	0	0	0	48
13834	0	0	45	0	0	45
13835	0	0	42	0	0	42
13836	0	53	0	0	0	53
13837	59	0	0	0	0	59
13838	0	0	0	55	0	55
13839	1	0	0	54	0	55
13840	0	0	0	57	0	57
13841	0	0	0	57	0	57
13842	0	0	53	0	0	53
13843	59	0	0	0	0	59
13844	0	0	0	55	0	55
13845	0	0	54	0	0	54
13846	58	0	0	0	0	58
13847	58	0	0	0	0	58
13848	0	0	58	0	0	58
13849	0	0	57	0	0	57
13850	0	0	0	59	0	59
13851	61	0	0	0	0	61
13852	59	0	0	0	0	59
13853	0	0	0	54	0	54
13854	0	0	0	57	0	57
13855	0	0	56	0	0	56
13856	1	0	0	56	0	57
13857	0	0	54	0	0	54
13858	52	0	0	0	0	52
13859	0	49	0	0	0	49
13860	51	0	0	0	0	51
13861	0	47	0	0	0	47
13862	47	0	0	0	0	47
13863	0	0	0	51	0	51
13864	0	0	0	46	0	46
13865	50	0	0	0	0	50
13866	51	0	0	0	0	51
13867	49	0	0	0	0	49
13868	45	0	0	0	0	45
13869	0	0	49	0	0	49
13870	46	0	0	0	0	46
13871	45	0	0	0	0	45
13872	43	0	0	0	0	43
13873	0	0	0	46	0	46
13874	45	0	0	0	0	45
13875	0	46	0	0	0	46
13876	0	0	0	47	0	47
13877	0	0	0	47	0	47
13878	0	0	46	0	0	46
13879	0	0	0	40	0	40
13880	0	42	0	0	0	42
13881	41	0	0	0	0	41
13882	0	42	0	0	0	42
13883	41	0	0	0	0	41
13884	0	0	0	45	0	45
13885	45	0	0	0	0	45
13886	0	43	0	0	0	43
13887	50	0	0	0	0	50
13888	50	0	0	0	0	50
13889	0	0	0	50	0	50
13890	0	0	0	54	0	54
13891	0	0	47	0	0	47
13892	0	0	0	51	0	51
13893	0	0	0	54	0	54
13894	0	0	53	0	0	53
13895	0	0	0	53	0	53
13896	0	0	53	0	0	53
13897	53	0	0	0	0	53
13898	0	0	0	50	0	50
13899	0	0	52	0	0	52
13900	52	0	0	0	0	52
13901	0	0	0	52	0	52
13902	0	0	51	0	0	51
13903	53	0	0	0	0	53
13904	0	0	0	51	0	51
13905	0	0	0	54	0	54
13906	52	0	0	0	0	52
13907	0	0	0	52	0	52
13908	0	0	0	51	0	51
13909	0	0	0	52	0	52
13910	0	53	0	0	0	53
13911	48	0	0	0	0	48
13912	46	0	0	0	0	46
13913	0	0	0	48	0	48
13914	47	0	0	0	0	47
13915	46	0	0	0	0	46
13916	45	0	0	0	0	45
13917	49	0	0	0	0	49
13918	49	0	0	0	0	49
13919	0	0	48	0	0	48
13920	0	0	43	0	0	43
13921	46	0	0	0	0	46
13922	0	46	0	0	0	46
13923	0	0	0	50	0	50
13924	0	0	48	0	0	48
13925	0	0	51	0	0	51
13926	1	0	0	44	0	45
13927	48	0	0	0	0	48
13928	0	0	0	49	0	49
13929	0	0	49	0	0	49
13930	44	0	0	0	0	44
13931	0	0	0	44	0	44
13932	0	0	0	44	0	44
13933	0	0	0	43	0	43
13934	0	0	0	44	0	44
13935	0	0	43	0	0	43
13936	0	0	0	40	0	40
13937	42	0	0	0	0	42
13938	0	0	41	0	0	41
13939	38	0	0	0	0	38
13940	40	0	0	0	0	40
13941	40	0	0	0	0	40
13942	36	0	0	0	0	36
13943	0	37	0	0	0	37
13944	0	40	0	0	0	40
13945	0	42	0	0	0	42
13946	44	0	0	0	0	44
13947	0	0	42	0	0	42
13948	44	0	0	0	0	44
13949	0	0	0	46	0	46
13950	46	0	0	0	0	46
13951	0	0	0	44	0	44
13952	46	0	0	0	0	46
13953	0	0	0	45	0	45
13954	0	0	0	44	0	44
13955	45	0	0	0	0	45
13956	0	45	0	0	0	45
13957	0	0	43	0	0	43
13958	0	39	0	0	0	39
13959	0	0	42	0	0	42
13960	0	0	0	40	0	40
13961	41	0	0	0	0	41
13962	0	0	0	44	0	44
13963	39	0	0	0	0	39
13964	0	48	0	0	0	48
13965	0	0	46	0	0	46
13966	0	48	0	0	0	48
13967	0	48	0	0	0	48
13968	48	0	0	0	0	48
13969	46	0	0	0	0	46
13970	0	48	0	0	0	48
13971	0	0	0	50	0	50
13972	0	0	0	50	0	50
13973	51	0	0	0	0	51
13974	0	0	50	0	0	50
13975	0	0	50	0	0	50
13976	0	0	0	55	0	55
13977	0	0	52	0	0	52
13978	52	0	0	0	0	52
13979	54	0	0	0	0	54
13980	0	46	0	0	0	46
13981	0	0	46	0	0	46
13982	0	0	0	42	0	42
13983	0	0	42	0	0	42
13984	0	0	0	45	0	45
13985	44	1	0	0	0	45
13986	0	43	0	0	0	43
13987	0	0	49	0	0	49
13988	0	53	0	0	0	53
13989	0	51	0	0	0	51
13990	52	0	0	0	0	52
13991	56	0	0	0	0	56
13992	0	0	56	0	0	56
13993	0	56	0	0	0	56
13994	0	0	0	53	0	53
13995	0	0	0	56	0	56
13996	0	0	0	54	0	54
13997	0	0	56	0	0	56
13998	0	0	0	51	0	51
13999	0	0	0	54	0	54
14000	56	0	0	0	0	56
14001	55	0	0	0	0	55
14002	58	0	0	0	0	58
14003	60	0	0	0	0	60
14004	60	0	0	0	0	60
14005	0	60	0	0	0	60
14006	60	0	0	0	0	60
14007	0	0	57	0	0	57
14008	0	0	0	57	0	57
14009	59	0	0	0	0	59
14010	0	59	0	0	0	59
14011	63	0	0	0	0	63
14012	63	0	0	0	0	63
14013	0	0	0	63	0	63
14014	0	0	0	62	0	62
14015	0	60	0	0	0	60
14016	0	0	0	61	0	61
14017	0	0	60	0	0	60
14018	0	0	0	60	0	60
14019	0	0	59	0	0	59
14020	60	0	0	0	0	60
14021	0	0	0	60	0	60
14022	0	0	58	0	0	58
14023	0	59	0	0	0	59
14024	0	62	0	0	0	62
14025	62	0	0	0	0	62
14026	0	0	0	58	0	58
14027	0	0	58	0	0	58
14028	0	61	0	0	0	61
14029	0	0	58	0	0	58
14030	61	0	0	0	0	61
14031	59	0	0	0	0	59
14032	57	0	0	0	0	57
14033	0	0	0	59	0	59
14034	0	0	59	0	0	59
14035	0	60	0	0	0	60
14036	0	0	0	61	0	61
14037	0	0	53	0	0	53
14038	0	0	54	0	0	54
14039	0	0	0	52	0	52
14040	55	0	0	0	0	55
14041	0	0	0	56	0	56
14042	0	0	0	62	0	62
14043	0	0	62	0	0	62
14044	0	0	0	61	0	61
14045	0	0	0	60	0	60
14046	0	0	62	0	0	62
14047	1	0	59	0	0	60
14048	0	0	0	62	0	62
14049	0	0	58	0	0	58
14050	0	0	0	57	0	57
14051	60	0	0	0	0	60
14052	0	60	0	0	0	60
14053	0	0	0	60	0	60
14054	0	0	61	0	0	61
14055	60	0	0	0	0	60
14056	0	61	0	0	0	61
14057	62	0	0	0	0	62
14058	0	0	0	61	0	61
14059	0	0	0	63	0	63
14060	64	0	0	0	0	64
14061	0	0	65	0	0	65
14062	69	0	0	0	0	69
14063	0	0	0	67	0	67
14064	67	0	0	0	0	67
14065	68	0	0	0	0	68
14066	0	0	0	68	0	68
14067	0	66	0	0	0	66
14068	66	0	0	0	0	66
14069	62	0	0	0	0	62
14070	0	0	63	0	0	63
14071	63	0	0	0	0	63
14072	0	0	0	63	0	63
14073	0	68	0	0	0	68
14074	0	0	0	67	0	67
14075	0	65	0	0	0	65
14076	65	0	0	0	0	65
14077	64	0	0	0	0	64
14078	0	0	0	65	0	65
14079	2	0	60	0	0	62
14080	0	0	52	0	0	52
14081	0	0	0	54	0	54
14082	53	0	0	0	0	53
14083	53	0	0	0	0	53
14084	0	55	0	0	0	55
14085	0	0	0	55	0	55
14086	0	0	55	0	0	55
14087	0	0	55	0	0	55
14088	0	0	0	55	0	55
14089	56	0	0	0	0	56
14090	0	0	0	56	0	56
14091	0	0	57	0	0	57
14092	54	0	0	0	0	54
14093	0	0	0	53	0	53
14094	0	0	0	66	0	66
14095	0	0	0	68	0	68
14096	0	67	0	0	0	67
14097	0	0	67	0	0	67
14098	0	0	72	0	0	72
14099	0	0	0	72	0	72
14100	0	0	72	0	0	72
14101	73	0	0	0	0	73
14102	0	0	1	72	0	73
14103	0	0	0	73	0	73
14104	0	0	0	71	0	71
14105	0	73	0	0	0	73
14106	71	0	0	0	0	71
14107	0	0	0	71	0	71
14108	70	0	0	0	0	70
14109	0	70	0	0	0	70
14110	68	0	0	0	0	68
14111	67	0	0	0	0	67
14112	67	0	0	0	0	67
14113	0	67	0	1	0	68
14114	0	65	0	0	0	65
14115	66	0	0	0	0	66
14116	0	65	0	1	0	66
14117	0	0	66	0	0	66
14118	0	62	0	0	0	62
14119	0	65	0	0	0	65
14120	67	0	0	0	0	67
14121	0	0	66	0	0	66
14122	0	0	69	0	0	69
14123	0	0	0	66	0	66
14124	68	0	0	0	0	68
14125	0	0	67	0	0	67
14126	1	0	0	66	0	67
14127	0	0	63	0	0	63
14128	0	0	64	0	0	64
14129	64	0	0	0	0	64
14130	0	0	63	0	0	63
14131	0	0	0	58	0	58
14132	0	0	0	59	0	59
14133	0	55	0	0	0	55
14134	0	55	0	0	0	55
14135	0	0	0	51	0	51
14136	0	0	49	0	0	49
14137	0	0	0	47	0	47
14138	0	0	0	48	0	48
14139	0	0	51	0	0	51
14140	0	0	0	51	0	51
14141	51	0	0	0	0	51
14142	0	0	52	0	0	52
14143	54	0	0	0	0	54
14144	0	0	0	50	0	50
14145	0	0	0	52	0	52
14146	0	51	0	0	0	51
14147	0	0	0	55	0	55
14148	0	0	0	53	0	53
14149	54	0	0	0	0	54
14150	0	0	0	52	0	52
14151	0	0	0	53	0	53
14152	51	0	0	0	0	51
14153	0	0	0	51	0	51
14154	0	0	0	51	0	51
14155	0	50	0	0	0	50
14156	50	0	0	0	0	50
14157	0	0	0	50	0	50
14158	0	0	0	48	0	48
14159	0	0	52	0	0	52
14160	0	0	0	51	0	51
14161	0	0	0	50	0	50
14162	48	0	0	0	0	48
14163	49	0	0	0	0	49
14164	0	0	0	49	0	49
14165	0	0	45	0	0	45
14166	0	37	0	0	0	37
14167	0	43	0	0	0	43
14168	0	0	0	45	0	45
14169	45	0	0	0	0	45
14170	0	0	0	45	0	45
14171	46	0	0	0	0	46
14172	0	0	0	44	0	44
14173	0	0	0	44	0	44
14174	44	0	0	0	0	44
14175	44	0	0	0	0	44
14176	0	42	0	0	0	42
14177	0	43	0	0	0	43
14178	0	0	0	44	0	44
14179	0	0	0	42	0	42
14180	0	0	40	0	0	40
14181	41	0	0	0	0	41
14182	0	40	0	0	0	40
14183	0	41	0	0	0	41
14184	41	0	0	0	0	41
14185	0	0	42	0	0	42
14186	0	0	38	0	0	38
14187	0	0	25	0	0	25
14188	0	33	0	0	0	33
14189	0	0	0	24	0	24
14190	0	0	0	24	0	24
14191	0	0	0	19	0	19
14192	19	0	0	0	0	19
14193	18	0	0	0	0	18
14194	0	18	0	0	0	18
14195	0	0	0	18	0	18
14196	0	0	17	0	0	17
14197	0	16	0	0	0	16
14198	16	0	0	0	0	16
14199	0	0	13	0	0	13
14200	14	0	0	0	0	14
14201	0	0	15	0	0	15
14202	0	0	0	14	0	14
14203	0	16	0	0	0	16
14204	15	0	0	0	0	15
14205	0	15	0	0	0	15
14206	15	0	0	0	0	15
14207	0	0	0	14	0	14
14208	0	0	15	0	0	15
14209	0	0	0	15	0	15
14210	0	0	0	14	0	14
14211	0	0	15	0	0	15
14212	18	0	0	0	0	18
14213	0	19	0	0	0	19
14214	20	0	0	0	0	20
14215	0	20	0	0	0	20
14216	0	0	0	23	0	23
14217	0	0	24	0	0	24
14218	22	0	0	0	0	22
14219	0	24	0	0	0	24
14220	0	0	0	26	0	26
14221	0	0	0	26	0	26
14222	31	0	0	0	0	31
14223	30	0	0	0	0	30
14224	0	32	0	0	0	32
14225	30	0	0	0	0	30
14226	33	0	0	0	0	33
14227	34	0	0	0	0	34
14228	0	0	30	0	0	30
14229	0	29	0	0	0	29
14230	0	29	0	0	0	29
14231	0	0	0	35	0	35
14232	0	0	0	34	0	34
14233	34	0	0	0	0	34
14234	0	30	0	0	0	30
14235	31	0	0	0	0	31
14236	0	0	0	30	0	30
14237	0	0	0	32	0	32
14238	34	0	0	0	0	34
14239	31	0	0	0	0	31
14240	0	0	30	0	0	30
14241	0	0	0	29	0	29
14242	0	0	29	0	0	29
14243	0	0	27	0	0	27
14244	0	0	30	0	0	30
14245	30	0	0	0	0	30
14246	0	0	0	29	0	29
14247	0	0	0	31	0	31
14248	0	0	0	30	0	30
14249	0	0	29	0	0	29
14250	0	0	0	27	0	27
14251	0	0	0	34	0	34
14252	34	0	0	0	0	34
14253	34	0	0	0	0	34
14254	31	0	0	0	0	31
14255	34	0	0	0	0	34
14256	0	0	0	32	0	32
14257	33	0	0	0	0	33
14258	0	0	0	32	0	32
14259	0	0	30	0	0	30
14260	34	0	0	0	0	34
14261	0	34	0	0	0	34
14262	0	0	0	33	0	33
14263	0	0	0	34	0	34
14264	0	36	0	0	0	36
14265	33	0	0	0	0	33
14266	0	35	0	0	0	35
14267	0	0	36	0	0	36
14268	0	0	35	0	0	35
14269	37	0	0	0	0	37
14270	37	0	0	0	0	37
14271	0	0	37	0	0	37
14272	37	0	0	0	0	37
14273	0	0	37	0	0	37
14274	36	0	0	0	0	36
14275	0	0	36	0	0	36
14276	0	0	38	0	0	38
14277	0	0	0	36	0	36
14278	0	0	0	34	0	34
14279	36	0	0	0	0	36
14280	37	0	0	0	0	37
14281	36	0	0	0	0	36
14282	35	0	0	0	0	35
14283	0	35	0	0	0	35
14284	0	0	0	38	0	38
14285	0	37	0	0	0	37
14286	0	0	0	38	0	38
14287	0	0	0	37	0	37
14288	0	0	0	38	0	38
14289	0	0	37	0	0	37
14290	37	0	0	0	0	37
14291	0	36	0	0	0	36
14292	0	34	0	0	0	34
14293	0	0	38	0	0	38
14294	0	0	0	44	0	44
14295	0	0	0	47	0	47
14296	47	0	0	0	0	47
14297	0	0	0	47	0	47
14298	0	0	0	47	0	47
14299	0	0	0	47	0	47
14300	0	0	0	49	0	49
14301	48	0	0	0	0	48
14302	48	0	0	0	0	48
14303	47	0	0	0	0	47
14304	0	0	0	45	0	45
14305	44	0	0	0	0	44
14306	0	0	0	38	0	38
14307	0	0	0	39	0	39
14308	0	0	37	0	0	37
14309	0	0	29	0	0	29
14310	1	0	35	0	0	36
14311	40	0	0	0	0	40
14312	0	0	0	37	0	37
14313	0	34	0	0	0	34
14314	35	0	0	0	0	35
14315	0	0	32	0	0	32
14316	32	0	0	0	0	32
14317	0	32	0	0	0	32
14318	32	0	0	0	0	32
14319	0	0	0	32	0	32
14320	31	0	0	0	0	31
14321	0	28	0	0	0	28
14322	0	31	0	0	0	31
14323	30	0	0	0	0	30
14324	0	31	0	0	0	31
14325	0	32	0	0	0	32
14326	0	30	0	1	0	31
14327	33	0	0	0	0	33
14328	32	0	0	0	0	32
14329	33	0	0	0	0	33
14330	0	0	0	33	0	33
14331	0	0	0	33	0	33
14332	0	0	32	0	0	32
14333	0	0	0	32	0	32
14334	0	0	32	0	0	32
14335	0	0	0	33	0	33
14336	0	0	0	32	0	32
14337	33	0	0	0	0	33
14338	30	0	0	0	0	30
14339	0	33	0	0	0	33
14340	0	0	0	33	0	33
14341	0	1	33	0	0	34
14342	0	0	0	34	0	34
14343	0	0	0	33	0	33
14344	0	0	0	30	0	30
14345	0	0	31	0	0	31
14346	0	0	29	0	0	29
14347	30	0	0	0	0	30
14348	0	0	0	32	0	32
14349	0	0	32	0	0	32
14350	31	0	0	0	0	31
14351	0	32	0	0	0	32
14352	32	0	0	0	0	32
14353	0	0	32	0	0	32
14354	31	0	0	0	0	31
14355	0	0	0	30	0	30
14356	0	0	29	0	0	29
14357	0	31	0	0	0	31
14358	31	0	0	0	0	31
14359	0	0	0	27	0	27
14360	0	0	0	26	0	26
14361	0	27	1	0	0	28
14362	0	0	0	28	0	28
14363	0	0	27	0	0	27
14364	0	30	0	0	0	30
14365	31	0	0	0	0	31
14366	0	0	0	30	0	30
14367	0	0	0	28	0	28
14368	0	0	32	0	0	32
14369	0	0	0	31	0	31
14370	0	0	28	0	0	28
14371	0	29	0	0	0	29
14372	31	0	0	0	0	31
14373	29	0	0	1	0	30
14374	30	0	0	3	0	33
14375	0	32	0	0	0	32
14376	0	0	0	31	0	31
14377	0	0	0	32	0	32
14378	0	0	0	32	0	32
14379	33	0	0	0	0	33
14380	33	0	0	0	0	33
14381	0	0	0	35	0	35
14382	0	0	36	0	0	36
14383	0	0	0	36	0	36
14384	0	0	0	36	0	36
14385	0	0	0	36	0	36
14386	0	0	0	35	0	35
14387	29	0	0	0	0	29
14388	0	0	1	23	0	24
14389	0	0	0	28	0	28
14390	1	26	0	0	0	27
14391	0	0	0	27	0	27
14392	0	27	0	0	0	27
14393	0	0	0	26	0	26
14394	26	0	0	0	0	26
14395	0	24	0	0	0	24
14396	27	0	0	0	0	27
14397	0	0	26	0	0	26
14398	0	0	0	26	0	26
14399	0	0	26	0	0	26
14400	0	0	0	29	0	29
14401	0	0	0	27	0	27
14402	0	26	0	0	0	26
14403	0	19	0	0	0	19
14404	0	18	0	0	0	18
14405	17	0	3	0	0	20
14406	0	14	3	0	0	17
14407	0	18	0	0	0	18
14408	0	0	0	19	0	19
14409	19	0	0	0	0	19
14410	0	20	0	0	0	20
14411	18	0	0	0	0	18
14412	17	0	0	0	0	17
14413	0	0	18	0	0	18
14414	0	0	0	17	0	17
14415	0	0	0	18	0	18
14416	0	0	0	16	0	16
14417	0	0	0	16	0	16
14418	0	0	16	0	0	16
14419	0	0	17	0	0	17
14420	15	0	0	0	0	15
14421	0	18	0	0	0	18
14422	0	19	0	0	0	19
14423	18	0	0	0	0	18
14424	0	18	0	0	0	18
14425	0	0	0	18	0	18
14426	20	0	0	0	0	20
14427	0	0	18	0	0	18
14428	0	0	0	18	0	18
14429	0	0	22	0	0	22
14430	22	0	0	0	0	22
14431	0	0	24	0	0	24
14432	24	0	0	0	0	24
14433	25	0	0	0	0	25
14434	25	0	0	0	0	25
14435	26	0	0	0	0	26
14436	24	0	0	0	0	24
14437	0	0	0	24	0	24
14438	22	0	0	0	0	22
14439	0	0	0	23	0	23
14440	0	0	0	24	0	24
14441	0	0	0	25	0	25
14442	0	0	27	0	0	27
14443	0	0	0	21	0	21
14444	0	0	0	27	0	27
14445	0	0	26	0	0	26
14446	26	0	0	0	0	26
14447	0	0	0	27	0	27
14448	0	0	24	0	0	24
14449	0	0	19	0	0	19
14450	0	0	0	26	0	26
14451	0	0	26	0	0	26
14452	0	0	0	24	0	24
14453	0	0	0	27	0	27
14454	0	25	0	0	0	25
14455	0	25	0	0	0	25
14456	27	0	0	0	0	27
14457	0	0	0	27	0	27
14458	0	0	0	27	0	27
14459	0	0	0	27	0	27
14460	0	0	26	0	0	26
14461	0	0	0	26	0	26
14462	27	0	0	0	0	27
14463	0	0	27	0	0	27
14464	0	0	1	24	0	25
14465	0	0	0	24	0	24
14466	0	0	0	26	0	26
14467	0	26	0	0	0	26
14468	27	0	0	0	0	27
14469	24	0	0	0	0	24
14470	0	26	0	0	0	26
14471	0	0	0	26	0	26
14472	0	0	27	0	0	27
14473	0	0	24	0	0	24
14474	25	0	0	0	0	25
14475	0	0	0	26	0	26
14476	26	0	0	0	0	26
14477	0	25	0	0	0	25
14478	0	26	0	0	0	26
14479	24	0	0	0	0	24
14480	0	21	0	0	0	21
14481	0	0	0	26	0	26
14482	0	0	0	26	0	26
14483	0	27	0	0	0	27
14484	27	0	0	0	0	27
14485	0	0	26	0	0	26
14486	26	0	0	0	0	26
14487	0	0	26	0	0	26
14488	25	0	0	0	0	25
14489	0	0	26	0	0	26
14490	0	25	0	0	0	25
14491	0	0	0	28	0	28
14492	30	0	0	0	0	30
14493	0	0	27	0	0	27
14494	0	0	26	0	0	26
14495	0	0	0	24	0	24
14496	0	0	26	0	0	26
14497	0	0	0	28	0	28
14498	0	0	0	28	0	28
14499	0	0	28	0	0	28
14500	0	0	0	24	0	24
14501	27	0	0	0	0	27
14502	0	27	0	0	0	27
14503	27	0	0	0	0	27
14504	0	0	0	26	0	26
14505	27	0	0	0	0	27
14506	27	0	0	0	0	27
14507	0	0	0	27	0	27
14508	0	25	0	0	0	25
14509	27	0	0	0	0	27
14510	0	0	24	0	0	24
14511	0	0	27	0	0	27
14512	27	0	0	0	0	27
14513	0	0	0	26	0	26
14514	0	0	24	0	0	24
14515	0	0	0	22	0	22
14516	24	0	0	0	0	24
14517	24	0	0	0	0	24
14518	24	0	0	0	0	24
14519	0	25	0	0	0	25
14520	0	0	0	24	0	24
14521	0	0	0	24	0	24
14522	24	0	0	0	0	24
14523	0	21	0	0	0	21
14524	20	0	0	0	0	20
14525	0	0	0	17	0	17
14526	18	0	0	0	0	18
14527	0	0	18	0	0	18
14528	0	18	0	0	0	18
14529	0	0	0	19	0	19
14530	0	18	0	0	0	18
14531	0	0	0	18	0	18
14532	18	0	0	0	0	18
14533	0	0	19	0	0	19
14534	20	0	0	0	0	20
14535	0	20	0	0	0	20
14536	0	0	0	21	0	21
14537	0	0	0	19	0	19
14538	18	0	0	0	0	18
14539	0	0	18	0	0	18
14540	0	0	0	17	0	17
14541	0	0	0	16	0	16
14542	0	0	0	16	0	16
14543	0	0	0	16	0	16
14544	15	0	0	0	0	15
14545	16	0	0	0	0	16
14546	0	0	15	0	0	15
14547	0	0	16	0	0	16
14548	17	0	0	0	0	17
14549	17	0	0	0	0	17
14550	0	0	0	16	0	16
14551	0	0	0	20	0	20
14552	18	0	0	0	0	18
14553	0	18	0	0	0	18
14554	0	0	0	20	0	20
14555	0	0	0	19	0	19
14556	0	0	22	0	0	22
14557	0	0	0	23	0	23
14558	0	0	21	0	0	21
14559	0	0	0	23	0	23
14560	23	0	0	0	0	23
14561	0	0	0	23	0	23
14562	0	0	21	0	0	21
14563	0	21	0	0	0	21
14564	0	0	0	23	0	23
14565	0	0	23	0	0	23
14566	0	23	0	0	0	23
14567	0	0	0	23	0	23
14568	0	0	22	0	0	22
14569	21	0	0	0	0	21
14570	0	22	0	0	0	22
14571	0	25	0	0	0	25
14572	0	26	0	0	0	26
14573	0	0	0	32	0	32
14574	0	0	37	0	0	37
14575	0	35	0	0	0	35
14576	0	0	0	39	0	39
14577	36	0	0	0	0	36
14578	0	0	0	40	0	40
14579	0	0	38	0	0	38
14580	0	40	0	0	0	40
14581	38	0	0	0	0	38
14582	0	40	0	0	0	40
14583	0	0	39	0	0	39
14584	0	42	0	0	0	42
14585	0	0	0	51	0	51
14586	0	0	51	0	0	51
14587	0	50	0	0	0	50
14588	0	0	0	53	0	53
14589	0	0	0	50	0	50
14590	0	51	0	0	0	51
14591	0	0	0	52	0	52
14592	0	0	51	0	0	51
14593	0	0	54	0	0	54
14594	0	0	0	53	0	53
14595	53	0	0	0	0	53
14596	54	0	0	0	0	54
14597	0	0	0	53	0	53
14598	0	51	0	0	0	51
14599	0	0	0	53	0	53
14600	53	0	0	0	0	53
14601	0	0	0	50	0	50
14602	0	0	0	53	0	53
14603	50	0	0	0	0	50
14604	0	52	0	0	0	52
14605	0	0	0	54	0	54
14606	54	0	0	0	0	54
14607	0	0	52	0	0	52
14608	53	0	0	0	0	53
14609	0	0	0	53	0	53
14610	51	0	0	0	0	51
14611	50	0	0	0	0	50
14612	49	0	0	0	0	49
14613	0	54	0	0	0	54
14614	0	0	54	0	0	54
14615	0	54	0	0	0	54
14616	55	0	0	0	0	55
14617	0	57	0	0	0	57
14618	0	0	0	53	0	53
14619	54	0	0	0	0	54
14620	0	56	0	0	0	56
14621	0	0	54	0	0	54
14622	0	0	0	52	0	52
14623	0	0	55	0	0	55
14624	0	54	0	0	0	54
14625	0	0	0	54	0	54
14626	0	0	0	52	0	52
14627	0	0	0	52	0	52
14628	1	0	0	50	0	51
14629	0	51	0	0	0	51
14630	52	0	0	0	0	52
14631	0	0	53	0	0	53
14632	0	0	0	51	0	51
14633	53	0	0	0	0	53
14634	0	0	49	0	0	49
14635	0	51	0	0	0	51
14636	0	0	0	51	0	51
14637	0	0	52	0	0	52
14638	0	50	0	0	0	50
14639	53	0	0	0	0	53
14640	0	50	0	0	0	50
14641	0	0	0	50	0	50
14642	0	0	0	52	0	52
14643	50	0	0	1	0	51
14644	0	45	0	0	0	45
14645	0	0	0	50	0	50
14646	46	0	0	0	0	46
14647	47	0	0	1	0	48
14648	0	45	0	0	0	45
14649	44	0	0	0	0	44
14650	44	0	0	0	0	44
14651	0	0	0	41	0	41
14652	0	0	44	0	0	44
14653	0	0	0	41	0	41
14654	0	0	0	44	0	44
14655	0	0	43	0	0	43
14656	0	42	0	0	0	42
14657	0	0	0	46	0	46
14658	0	0	0	42	0	42
14659	0	0	0	44	0	44
14660	0	0	0	46	0	46
14661	0	44	0	0	0	44
14662	45	1	0	0	0	46
14663	43	0	0	0	0	43
14664	40	0	0	0	0	40
14665	0	38	0	0	0	38
14666	0	0	0	35	0	35
14667	0	0	33	0	0	33
14668	0	0	0	33	0	33
14669	0	26	0	0	0	26
14670	25	0	0	0	0	25
14671	23	1	0	0	0	24
14672	26	0	0	0	0	26
14673	0	26	0	0	0	26
14674	0	20	0	0	0	20
14675	0	20	0	0	0	20
14676	0	0	22	0	0	22
14677	0	0	20	0	0	20
14678	0	0	0	11	0	11
14679	13	0	0	0	0	13
14680	11	0	0	0	0	11
14681	0	0	0	10	0	10
14682	0	0	0	11	0	11
14683	0	0	0	11	0	11
14684	0	0	0	10	0	10
14685	11	0	0	0	0	11
14686	10	0	0	0	0	10
14687	0	10	0	0	0	10
14688	10	0	0	0	0	10
14689	10	0	0	0	0	10
14690	10	0	0	0	0	10
14691	0	0	9	0	0	9
14692	8	0	0	0	0	8
14693	0	10	0	0	0	10
14694	0	0	0	9	0	9
14695	0	0	0	10	0	10
14696	0	10	0	0	0	10
14697	0	0	0	9	0	9
14698	8	0	0	0	0	8
14699	0	0	0	9	0	9
14700	0	0	9	0	0	9
14701	8	0	0	0	0	8
14702	0	9	0	0	0	9
14703	0	0	0	9	0	9
14704	0	0	0	8	0	8
14705	0	0	0	8	0	8
14706	0	0	8	0	0	8
14707	0	10	0	0	0	10
14708	0	0	0	9	0	9
14709	0	0	8	0	0	8
14710	0	0	0	9	0	9
14711	0	0	9	0	0	9
14712	0	0	0	9	0	9
14713	0	9	0	0	0	9
14714	0	0	0	12	0	12
14715	11	0	0	0	0	11
14716	12	0	0	0	0	12
14717	0	0	11	0	0	11
14718	0	0	11	0	0	11
14719	0	0	10	0	0	10
14720	0	0	0	11	0	11
14721	0	0	0	13	0	13
14722	0	0	0	13	0	13
14723	0	14	0	0	0	14
14724	0	0	0	14	0	14
14725	0	0	0	16	0	16
14726	0	0	0	15	0	15
14727	16	0	0	0	0	16
14728	16	0	0	0	0	16
14729	0	0	16	0	0	16
14730	0	0	15	0	0	15
14731	15	0	0	0	0	15
14732	16	0	0	0	0	16
14733	0	0	16	0	0	16
14734	0	0	15	0	0	15
14735	16	0	0	0	0	16
14736	15	0	0	0	0	15
14737	0	0	16	0	0	16
14738	0	0	0	16	0	16
14739	0	0	0	16	0	16
14740	0	15	0	0	0	15
14741	0	0	0	16	0	16
14742	0	0	15	0	0	15
14743	0	0	0	16	0	16
14744	0	0	0	16	0	16
14745	0	0	14	0	0	14
14746	17	0	0	0	0	17
14747	15	0	0	0	0	15
14748	0	0	0	15	0	15
14749	0	0	0	17	0	17
14750	17	0	0	0	0	17
14751	16	0	0	0	0	16
14752	15	0	0	0	0	15
14753	15	0	0	0	0	15
14754	0	17	0	0	0	17
14755	17	0	0	0	0	17
14756	0	16	0	0	0	16
14757	0	0	0	16	0	16
14758	0	0	0	16	0	16
14759	0	21	0	0	0	21
14760	0	0	0	18	0	18
14761	0	0	0	18	0	18
14762	0	17	0	0	0	17
14763	0	0	0	18	0	18
14764	0	0	0	17	0	17
14765	0	0	0	18	0	18
14766	0	0	17	0	0	17
14767	0	16	0	0	0	16
14768	0	0	0	18	0	18
14769	0	18	0	0	0	18
14770	17	0	0	0	0	17
14771	0	0	19	0	0	19
14772	0	0	21	0	0	21
14773	24	0	0	0	0	24
14774	0	0	0	24	0	24
14775	0	0	23	0	0	23
14776	0	0	22	0	0	22
14777	0	0	0	22	0	22
14778	24	0	0	0	0	24
14779	23	0	0	0	0	23
14780	0	0	0	23	0	23
14781	0	0	23	0	0	23
14782	0	24	0	0	0	24
14783	0	0	0	24	0	24
14784	0	0	24	0	0	24
14785	0	24	0	0	0	24
14786	0	0	0	23	0	23
14787	25	0	0	0	0	25
14788	0	0	0	23	0	23
14789	0	25	0	0	0	25
14790	24	0	0	0	0	24
14791	0	0	26	0	0	26
14792	0	22	0	0	0	22
14793	0	0	25	0	0	25
14794	25	0	0	0	0	25
14795	0	0	0	22	0	22
14796	0	0	0	24	0	24
14797	23	0	0	0	0	23
14798	0	0	0	24	0	24
14799	0	0	21	0	0	21
14800	22	0	0	0	0	22
14801	0	21	0	0	0	21
14802	0	0	0	22	0	22
14803	20	0	0	0	0	20
14804	0	22	0	0	0	22
14805	0	0	0	22	0	22
14806	21	0	0	0	0	21
14807	0	0	0	22	0	22
14808	0	24	0	0	0	24
14809	0	0	22	0	0	22
14810	0	0	0	25	0	25
14811	0	0	0	24	0	24
14812	24	0	0	0	0	24
14813	0	0	0	25	0	25
14814	24	0	0	0	0	24
14815	24	0	0	0	0	24
14816	0	0	0	22	0	22
14817	0	24	0	0	0	24
14818	0	0	0	21	0	21
14819	21	0	0	0	0	21
14820	0	19	0	0	0	19
14821	0	22	0	0	0	22
14822	25	0	0	0	0	25
14823	25	0	0	0	0	25
14824	0	25	0	0	0	25
14825	26	0	0	0	0	26
14826	26	0	0	0	0	26
14827	0	0	0	26	0	26
14828	0	0	21	0	0	21
14829	0	0	0	25	0	25
14830	0	0	27	0	0	27
14831	0	0	0	27	0	27
14832	0	0	27	0	0	27
14833	26	0	0	0	0	26
14834	0	0	0	25	0	25
14835	25	0	0	0	0	25
14836	0	0	0	25	0	25
14837	0	28	0	0	0	28
14838	28	0	0	0	0	28
14839	0	1	27	0	0	28
14840	29	0	0	0	0	29
14841	0	27	0	0	0	27
14842	28	0	0	0	0	28
14843	27	0	0	0	0	27
14844	0	29	0	0	0	29
14845	0	0	0	27	0	27
14846	28	0	0	0	0	28
14847	0	29	0	0	0	29
14848	0	0	0	28	0	28
14849	26	0	0	0	0	26
14850	0	0	0	30	0	30
14851	0	0	0	29	0	29
14852	0	0	0	26	0	26
14853	0	0	26	0	0	26
14854	0	0	0	26	0	26
14855	27	0	0	0	0	27
14856	0	0	23	0	0	23
14857	0	0	0	23	0	23
14858	0	0	0	24	0	24
14859	0	0	26	0	0	26
14860	28	0	0	0	0	28
14861	28	0	0	0	0	28
14862	0	0	27	0	0	27
14863	0	0	0	27	0	27
14864	0	0	0	23	0	23
14865	1	0	25	0	0	26
14866	0	0	0	25	0	25
14867	0	0	0	26	0	26
14868	0	0	27	0	0	27
14869	28	0	0	0	0	28
14870	0	0	0	27	0	27
14871	27	0	0	0	0	27
14872	28	0	0	0	0	28
14873	0	0	26	0	0	26
14874	0	0	0	29	0	29
14875	27	0	0	0	0	27
14876	0	29	0	0	0	29
14877	0	0	0	32	0	32
14878	0	0	0	31	0	31
14879	0	0	0	31	0	31
14880	0	0	30	0	0	30
14881	29	0	0	0	0	29
14882	0	0	0	31	0	31
14883	0	0	0	32	0	32
14884	0	0	42	0	0	42
14885	0	0	0	37	0	37
14886	0	0	0	38	0	38
14887	41	0	0	0	0	41
14888	0	40	0	0	0	40
14889	0	0	39	0	0	39
14890	40	0	0	0	0	40
14891	0	0	0	44	0	44
14892	0	0	44	0	0	44
14893	0	0	40	0	0	40
14894	0	0	0	44	0	44
14895	0	0	44	0	0	44
14896	0	0	39	0	0	39
14897	0	39	0	0	0	39
14898	0	0	0	41	0	41
14899	0	0	44	0	0	44
14900	0	0	0	47	0	47
14901	51	0	0	0	0	51
14902	0	0	0	47	0	47
14903	0	0	0	54	0	54
14904	55	0	0	0	0	55
14905	54	0	0	0	0	54
14906	0	0	0	56	0	56
14907	0	0	55	0	0	55
14908	0	54	0	0	0	54
14909	0	0	0	56	0	56
14910	54	0	0	0	0	54
14911	56	0	0	0	0	56
14912	0	50	0	0	0	50
14913	0	54	0	0	0	54
14914	53	0	0	0	0	53
14915	55	0	0	0	0	55
14916	0	0	54	0	0	54
14917	0	0	0	55	0	55
14918	0	54	0	0	0	54
14919	56	0	0	0	0	56
14920	0	0	0	52	0	52
14921	0	55	0	0	0	55
14922	0	0	55	0	0	55
14923	0	0	0	51	0	51
14924	0	52	0	0	0	52
14925	54	0	0	0	0	54
14926	55	0	0	0	0	55
14927	0	58	0	0	0	58
14928	59	0	0	0	0	59
14929	56	0	0	0	0	56
14930	0	55	0	0	0	55
14931	0	59	0	0	0	59
14932	0	0	0	58	0	58
14933	57	0	0	0	0	57
14934	0	0	57	0	0	57
14935	56	0	0	0	0	56
14936	0	57	0	0	0	57
14937	56	0	0	0	0	56
14938	58	0	0	0	0	58
14939	58	0	0	0	0	58
14940	0	0	0	54	0	54
14941	0	56	0	0	0	56
14942	56	0	0	0	0	56
14943	0	0	48	0	0	48
14944	0	50	0	1	0	51
14945	0	0	0	52	0	52
14946	0	0	50	0	0	50
14947	0	0	50	0	0	50
14948	0	0	0	52	0	52
14949	0	0	0	52	0	52
14950	0	0	0	43	0	43
14951	0	0	0	48	0	48
14952	0	42	0	0	0	42
14953	0	47	0	0	0	47
14954	46	0	0	0	0	46
14955	0	0	0	46	0	46
14956	0	0	0	48	0	48
14957	0	0	0	50	0	50
14958	46	0	0	0	0	46
14959	46	0	0	0	0	46
14960	0	0	0	46	0	46
14961	46	0	0	0	0	46
14962	45	0	0	0	0	45
14963	46	0	0	0	0	46
14964	0	0	0	45	0	45
14965	0	0	44	0	0	44
14966	0	0	40	0	0	40
14967	0	0	46	0	0	46
14968	0	0	45	0	0	45
14969	0	0	0	41	0	41
14970	44	0	0	0	0	44
14971	43	0	0	0	0	43
14972	0	0	44	0	0	44
14973	0	0	38	0	0	38
14974	0	39	0	0	0	39
14975	0	0	0	39	0	39
14976	36	0	0	0	0	36
14977	0	0	35	0	0	35
14978	38	0	0	0	0	38
14979	0	31	0	0	0	31
14980	0	0	0	37	0	37
14981	0	0	0	33	0	33
14982	0	0	0	37	0	37
14983	37	0	0	0	0	37
14984	0	0	0	34	0	34
14985	0	0	0	34	0	34
14986	33	0	0	0	0	33
14987	0	0	0	33	0	33
14988	0	0	31	0	0	31
14989	30	0	0	0	0	30
14990	0	0	0	33	0	33
14991	0	0	0	33	0	33
14992	0	32	0	0	0	32
14993	30	0	0	0	0	30
14994	28	0	0	0	0	28
14995	0	0	0	28	0	28
14996	0	0	23	0	0	23
14997	20	0	0	0	0	20
14998	0	0	22	0	0	22
14999	0	0	0	23	0	23
15000	0	0	0	23	0	23
15001	23	0	0	0	0	23
15002	0	0	0	22	0	22
15003	0	0	24	0	0	24
15004	23	0	0	0	0	23
15005	0	0	25	0	0	25
15006	0	0	25	0	0	25
15007	26	0	0	0	0	26
15008	0	0	0	27	0	27
15009	0	28	0	0	0	28
15010	30	0	0	0	0	30
15011	30	0	0	0	0	30
15012	0	0	29	0	0	29
15013	27	0	0	0	0	27
15014	0	0	0	30	0	30
15015	1	0	29	0	0	30
15016	0	30	0	0	0	30
15017	29	0	0	0	0	29
15018	0	30	0	0	0	30
15019	0	0	0	28	0	28
15020	0	0	0	25	0	25
15021	0	0	0	25	0	25
15022	0	0	0	28	0	28
15023	0	27	0	0	0	27
15024	0	0	26	1	0	27
15025	0	30	0	0	0	30
15026	30	0	0	0	0	30
15027	0	0	0	30	0	30
15028	30	0	0	0	0	30
15029	0	0	0	29	0	29
15030	28	0	0	0	0	28
15031	0	28	0	0	0	28
15032	28	0	0	0	0	28
15033	29	0	0	0	0	29
15034	28	0	0	0	0	28
15035	25	0	0	0	0	25
15036	0	31	0	0	0	31
15037	0	0	32	0	0	32
15038	0	0	0	29	0	29
15039	27	0	0	0	0	27
15040	29	0	0	0	0	29
15041	0	0	0	32	0	32
15042	0	0	32	0	0	32
15043	0	0	0	32	0	32
15044	0	33	0	0	0	33
15045	32	0	0	0	0	32
15046	0	0	0	30	0	30
15047	0	30	0	0	0	30
15048	0	31	0	0	0	31
15049	0	34	0	0	0	34
15050	0	0	0	33	0	33
15051	33	0	0	0	0	33
15052	0	30	0	0	0	30
15053	0	0	0	30	0	30
15054	29	0	0	0	0	29
15055	0	0	0	28	0	28
15056	31	0	0	0	0	31
15057	29	0	0	0	0	29
15058	0	31	0	0	0	31
15059	0	0	0	31	0	31
15060	0	32	0	0	0	32
15061	32	0	0	0	0	32
15062	27	0	0	0	0	27
15063	28	0	0	0	0	28
15064	0	0	0	30	0	30
15065	0	0	30	0	0	30
15066	30	0	0	0	0	30
15067	29	0	0	0	0	29
15068	0	0	0	28	0	28
15069	0	31	0	0	0	31
15070	0	0	0	31	0	31
15071	0	0	0	31	0	31
15072	33	0	0	0	0	33
15073	34	0	0	0	0	34
15074	0	0	33	0	0	33
15075	0	0	0	32	0	32
15076	30	0	0	0	0	30
15077	0	0	0	31	0	31
15078	0	0	30	0	0	30
15079	0	28	0	0	0	28
15080	0	32	0	0	0	32
15081	29	0	0	0	0	29
15082	0	0	0	30	0	30
15083	0	0	0	32	0	32
15084	34	0	0	0	0	34
15085	0	0	37	0	0	37
15086	0	0	0	35	0	35
15087	1	0	35	0	0	36
15088	0	36	0	0	0	36
15089	38	0	0	0	0	38
15090	35	0	0	0	0	35
15091	40	0	0	0	0	40
15092	0	0	37	0	0	37
15093	37	0	0	0	0	37
15094	38	0	0	0	0	38
15095	0	0	0	39	0	39
15096	39	0	0	0	0	39
15097	0	0	39	0	0	39
15098	39	0	0	0	0	39
15099	0	0	35	0	0	35
15100	0	34	0	0	0	34
15101	0	0	0	34	0	34
15102	0	37	0	0	0	37
15103	0	0	36	0	0	36
15104	0	36	0	0	0	36
15105	31	0	0	1	0	32
15106	0	36	0	0	0	36
15107	0	35	0	0	0	35
15108	0	0	33	0	0	33
15109	0	0	0	32	0	32
15110	34	0	0	0	0	34
15111	0	0	30	0	0	30
15112	0	34	0	0	0	34
15113	0	0	0	34	0	34
15114	0	0	33	0	0	33
15115	0	0	34	0	0	34
15116	0	0	0	33	0	33
15117	1	0	34	0	0	35
15118	0	0	0	35	0	35
15119	0	30	0	0	0	30
15120	0	0	0	34	0	34
15121	0	36	0	0	0	36
15122	0	0	0	36	0	36
15123	36	0	0	0	0	36
15124	0	0	0	35	0	35
15125	0	35	0	0	0	35
15126	0	0	0	34	0	34
15127	0	0	32	0	0	32
15128	0	0	0	34	0	34
15129	34	0	0	0	0	34
15130	0	0	34	0	0	34
15131	0	0	0	34	0	34
15132	34	0	0	0	0	34
15133	0	34	0	0	0	34
15134	0	0	0	33	0	33
15135	31	0	0	0	0	31
15136	0	0	0	32	0	32
15137	0	0	32	0	0	32
15138	29	0	0	0	0	29
15139	0	30	0	0	0	30
15140	0	30	0	0	0	30
15141	32	0	0	0	0	32
15142	31	0	0	0	0	31
15143	0	0	0	30	0	30
15144	32	0	0	0	0	32
15145	0	0	32	0	0	32
15146	29	0	0	0	0	29
15147	0	32	0	0	0	32
15148	32	0	0	0	0	32
15149	0	0	29	0	0	29
15150	0	0	0	24	0	24
15151	0	0	0	23	0	23
15152	0	0	0	28	0	28
15153	0	28	0	0	0	28
15154	27	0	0	0	0	27
15155	0	0	0	25	0	25
15156	0	26	0	0	0	26
15157	27	0	0	0	0	27
15158	28	0	0	0	0	28
15159	27	0	0	0	0	27
15160	28	0	0	0	0	28
15161	26	0	0	0	0	26
15162	0	0	0	23	0	23
15163	0	0	0	23	0	23
15164	25	0	0	0	0	25
15165	0	0	0	22	0	22
15166	0	0	0	23	0	23
15167	0	0	26	0	0	26
15168	29	0	0	0	0	29
15169	26	0	0	0	0	26
15170	27	0	0	0	0	27
15171	0	0	0	29	0	29
15172	0	28	0	0	0	28
15173	29	0	0	0	0	29
15174	28	0	0	0	0	28
15175	0	0	0	30	0	30
15176	30	0	0	0	0	30
15177	0	0	18	0	0	18
15178	0	26	0	0	0	26
15179	0	26	0	0	0	26
15180	0	0	24	0	0	24
15181	0	22	0	0	0	22
15182	0	25	0	0	0	25
15183	25	0	0	0	0	25
15184	0	21	0	0	0	21
15185	0	0	0	22	0	22
15186	22	0	0	0	0	22
15187	0	0	23	0	0	23
15188	23	0	0	0	0	23
15189	0	0	23	0	0	23
15190	0	0	22	0	0	22
15191	22	0	0	0	0	22
15192	0	0	20	0	0	20
15193	0	21	0	0	0	21
15194	0	0	0	21	0	21
15195	20	0	0	0	0	20
15196	0	20	0	0	0	20
15197	0	0	0	21	0	21
15198	0	0	22	0	0	22
15199	0	0	0	20	0	20
15200	22	0	0	0	0	22
15201	0	0	20	0	0	20
15202	0	0	0	22	0	22
15203	24	0	0	0	0	24
15204	30	0	0	0	0	30
15205	0	0	0	29	0	29
15206	0	0	0	32	0	32
15207	0	0	28	0	0	28
15208	0	0	29	0	0	29
15209	27	0	0	0	0	27
15210	28	0	0	0	0	28
15211	0	31	0	0	0	31
15212	30	0	0	0	0	30
15213	33	0	0	0	0	33
15214	0	0	31	0	0	31
15215	0	34	0	0	0	34
15216	34	0	0	0	0	34
15217	35	0	0	0	0	35
15218	34	0	0	0	0	34
15219	0	0	0	32	0	32
15220	0	0	0	35	0	35
15221	0	33	0	0	0	33
15222	0	0	0	35	0	35
15223	36	0	0	0	0	36
15224	0	0	0	35	0	35
15225	0	0	31	0	0	31
15226	0	0	32	0	0	32
15227	0	0	0	34	0	34
15228	0	0	33	0	0	33
15229	0	0	30	0	0	30
15230	0	0	0	29	0	29
15231	0	0	0	30	0	30
15232	0	0	31	0	0	31
15233	0	0	31	0	0	31
15234	0	34	0	0	0	34
15235	36	0	0	0	0	36
15236	0	42	0	0	0	42
15237	42	0	0	0	0	42
15238	42	0	0	0	0	42
15239	0	42	0	0	0	42
15240	41	0	0	0	0	41
15241	0	0	0	45	0	45
15242	0	0	44	0	0	44
15243	0	0	0	46	0	46
15244	0	0	0	50	0	50
15245	51	0	0	0	0	51
15246	51	0	0	0	0	51
15247	50	0	0	0	0	50
15248	51	0	0	0	0	51
15249	51	0	0	0	0	51
15250	0	49	0	0	0	49
15251	0	0	0	50	0	50
15252	0	0	47	0	0	47
15253	0	0	0	50	0	50
15254	0	0	0	50	0	50
15255	0	0	0	51	0	51
15256	50	0	0	0	0	50
15257	0	0	0	50	0	50
15258	51	0	0	0	0	51
15259	0	0	51	0	0	51
15260	0	0	0	47	0	47
15261	0	0	50	0	0	50
15262	45	0	0	0	0	45
15263	0	0	0	45	0	45
15264	0	0	45	0	0	45
15265	0	0	0	47	0	47
15266	49	0	0	0	0	49
15267	0	0	49	0	0	49
15268	50	0	0	0	0	50
15269	51	0	0	0	0	51
15270	49	0	0	0	0	49
15271	48	0	0	0	0	48
15272	0	45	0	0	0	45
15273	0	49	0	0	0	49
15274	0	41	0	0	0	41
15275	0	0	0	52	0	52
15276	0	52	0	0	0	52
15277	51	0	0	0	0	51
15278	0	54	0	0	0	54
15279	0	52	0	0	0	52
15280	0	0	0	53	0	53
15281	0	0	0	51	0	51
15282	52	0	0	0	0	52
15283	0	0	0	54	0	54
15284	0	0	49	0	0	49
15285	0	0	44	2	0	46
15286	0	0	49	0	0	49
15287	0	0	0	51	0	51
15288	0	0	0	53	0	53
15289	0	0	47	0	0	47
15290	0	0	51	0	0	51
15291	0	0	55	0	0	55
15292	56	0	0	0	0	56
15293	0	0	0	54	0	54
15294	0	0	0	59	0	59
15295	60	0	0	0	0	60
15296	0	0	0	56	0	56
15297	0	51	0	0	0	51
15298	0	51	0	0	0	51
15299	0	0	0	53	0	53
15300	53	0	0	0	0	53
15301	53	0	0	0	0	53
15302	51	0	0	0	0	51
15303	0	0	0	52	0	52
15304	0	0	49	0	0	49
15305	0	0	0	47	0	47
15306	0	0	46	0	0	46
15307	44	0	0	0	0	44
15308	0	0	0	44	0	44
15309	43	0	0	0	0	43
15310	0	0	47	0	0	47
15311	40	0	0	0	0	40
15312	0	0	43	0	0	43
15313	0	43	0	0	0	43
15314	1	45	0	0	0	46
15315	46	0	0	0	0	46
15316	0	0	0	50	0	50
15317	0	0	51	0	0	51
15318	0	53	0	0	0	53
15319	0	51	0	0	0	51
15320	0	0	0	53	0	53
15321	53	0	0	0	0	53
15322	52	0	0	0	0	52
15323	0	53	0	0	0	53
15324	55	0	0	0	0	55
15325	0	0	0	56	0	56
15326	0	0	49	0	0	49
15327	0	52	1	0	0	53
15328	0	0	0	49	0	49
15329	0	0	0	51	0	51
15330	52	0	0	0	0	52
15331	0	0	51	0	0	51
15332	52	0	0	0	0	52
15333	47	0	0	0	0	47
15334	0	0	0	49	0	49
15335	0	0	0	47	0	47
15336	49	0	0	0	0	49
15337	0	0	0	46	0	46
15338	0	0	42	0	0	42
15339	0	0	42	0	0	42
15340	0	40	0	0	0	40
15341	0	42	0	0	0	42
15342	0	0	0	44	0	44
15343	0	38	0	0	0	38
15344	43	0	0	0	0	43
15345	0	39	1	0	0	40
15346	0	0	0	46	0	46
15347	0	0	0	47	0	47
15348	0	0	46	0	0	46
15349	0	0	0	46	0	46
15350	0	0	0	47	0	47
15351	0	46	0	0	0	46
15352	0	0	0	48	0	48
15353	0	0	0	46	0	46
15354	0	0	44	0	0	44
15355	0	46	0	0	0	46
15356	0	0	0	45	0	45
15357	0	47	0	0	0	47
15358	0	0	42	0	0	42
15359	0	42	0	0	0	42
15360	43	0	0	0	0	43
15361	38	0	0	0	0	38
15362	44	0	0	0	0	44
15363	0	45	0	0	0	45
15364	43	0	0	0	0	43
15365	0	0	0	44	0	44
15366	42	0	0	0	0	42
15367	0	44	0	0	0	44
15368	43	0	0	0	0	43
15369	43	0	0	0	0	43
15370	0	43	0	0	0	43
15371	0	0	42	0	0	42
15372	1	0	0	41	0	42
15373	0	0	40	0	0	40
15374	0	0	0	42	0	42
15375	0	0	0	43	0	43
15376	0	0	41	0	0	41
15377	0	0	0	42	0	42
15378	42	0	0	0	0	42
15379	0	0	44	0	0	44
15380	0	44	0	0	0	44
15381	0	0	0	45	0	45
15382	0	0	0	43	0	43
15383	0	0	45	0	0	45
15384	0	0	0	40	0	40
15385	0	40	0	0	0	40
15386	37	0	0	0	0	37
15387	0	39	0	0	0	39
15388	35	0	0	0	0	35
15389	0	42	0	0	0	42
15390	0	31	0	1	0	32
15391	0	0	37	0	0	37
15392	0	0	0	37	0	37
15393	0	0	0	36	0	36
15394	0	0	0	40	0	40
15395	0	40	0	0	0	40
15396	0	0	0	38	0	38
15397	37	0	0	0	0	37
15398	0	0	0	39	0	39
15399	39	0	0	0	0	39
15400	0	0	40	0	0	40
15401	41	0	0	0	0	41
15402	0	0	1	41	0	42
15403	0	0	0	41	0	41
15404	43	0	0	0	0	43
15405	0	0	41	0	0	41
15406	0	41	0	0	0	41
15407	0	1	0	42	0	43
15408	42	0	0	0	0	42
15409	35	0	0	0	0	35
15410	0	0	0	37	0	37
15411	0	0	40	0	0	40
15412	40	0	0	0	0	40
15413	0	0	38	0	0	38
15414	0	0	0	39	0	39
15415	0	0	40	0	0	40
15416	0	0	0	38	0	38
15417	0	0	39	0	0	39
15418	0	34	0	0	0	34
15419	0	0	0	39	0	39
15420	0	38	0	0	0	38
15421	40	0	0	0	0	40
15422	39	0	0	0	0	39
15423	0	0	41	0	0	41
15424	0	0	0	41	0	41
15425	38	0	0	0	0	38
15426	0	0	0	42	0	42
15427	0	0	0	44	0	44
15428	0	0	44	0	0	44
15429	44	0	0	0	0	44
15430	0	0	44	0	0	44
15431	0	0	0	41	0	41
15432	0	0	39	0	0	39
15433	51	0	0	0	0	51
15434	48	0	0	0	0	48
15435	49	0	0	0	0	49
15436	0	0	0	50	0	50
15437	0	0	50	0	0	50
15438	0	0	48	0	0	48
15439	0	0	0	50	0	50
15440	0	47	0	0	0	47
15441	49	0	0	0	0	49
15442	0	0	0	49	0	49
15443	0	0	48	0	0	48
15444	0	0	0	49	0	49
15445	0	0	47	0	0	47
15446	0	0	0	47	0	47
15447	0	0	44	0	0	44
15448	0	0	44	0	0	44
15449	0	45	0	0	0	45
15450	0	0	48	0	0	48
15451	0	0	44	0	0	44
15452	0	0	0	41	0	41
15453	0	0	0	44	0	44
15454	0	47	0	0	0	47
15455	49	0	0	0	0	49
15456	0	46	0	0	0	46
15457	0	0	0	50	0	50
15458	51	0	0	0	0	51
15459	0	0	0	50	0	50
15460	48	0	0	0	0	48
15461	0	0	0	50	0	50
15462	0	0	50	0	0	50
15463	1	0	0	51	0	52
15464	0	0	0	51	0	51
15465	53	0	0	0	0	53
15466	53	0	0	0	0	53
15467	54	0	0	0	0	54
15468	0	51	0	0	0	51
15469	0	48	0	0	0	48
15470	52	0	0	0	0	52
15471	0	0	52	0	0	52
15472	0	0	49	0	0	49
15473	0	0	0	54	0	54
15474	0	0	53	0	0	53
15475	0	0	54	0	0	54
15476	57	0	0	0	0	57
15477	52	0	0	0	0	52
15478	0	54	0	0	0	54
15479	1	54	0	0	0	55
15480	0	0	0	55	0	55
15481	0	55	0	0	0	55
15482	60	0	0	0	0	60
15483	0	0	0	59	0	59
15484	0	52	0	0	0	52
15485	62	0	0	0	0	62
15486	0	0	59	0	0	59
15487	0	0	56	0	0	56
15488	62	0	0	0	0	62
15489	0	0	52	0	0	52
15490	61	0	0	0	0	61
15491	1	0	0	61	0	62
15492	0	0	54	0	0	54
15493	0	52	0	0	0	52
15494	0	56	0	0	0	56
15495	55	0	0	0	0	55
15496	0	57	0	0	0	57
15497	59	0	0	0	0	59
15498	56	0	0	1	0	57
15499	0	54	0	0	0	54
15500	0	0	0	56	0	56
15501	0	0	48	0	0	48
15502	0	51	0	0	0	51
15503	0	0	0	56	0	56
15504	0	0	0	55	0	55
15505	55	0	0	0	0	55
15506	0	0	0	58	0	58
15507	0	0	56	0	0	56
15508	0	58	1	0	0	59
15509	0	0	0	60	0	60
15510	59	0	0	0	0	59
15511	57	0	0	0	0	57
15512	0	0	0	56	0	56
15513	60	0	0	0	0	60
15514	0	0	58	0	0	58
15515	0	0	0	60	0	60
15516	0	0	58	0	0	58
15517	0	0	0	57	0	57
15518	0	0	0	60	0	60
15519	0	0	0	62	0	62
15520	0	0	0	58	0	58
15521	0	0	0	57	0	57
15522	58	0	0	0	0	58
15523	58	0	0	0	0	58
15524	0	57	0	0	0	57
15525	58	0	0	0	0	58
15526	0	0	0	51	0	51
15527	0	0	0	50	0	50
15528	0	0	0	51	0	51
15529	0	0	55	0	0	55
15530	0	0	0	53	0	53
15531	0	56	0	0	0	56
15532	52	0	0	0	0	52
15533	52	0	0	0	0	52
15534	0	0	49	0	0	49
15535	0	51	0	0	0	51
15536	0	0	0	52	0	52
15537	0	0	52	0	0	52
15538	0	0	0	51	0	51
15539	0	54	0	0	0	54
15540	50	0	0	0	0	50
15541	0	49	0	0	0	49
15542	0	0	50	0	0	50
15543	0	0	48	0	0	48
15544	0	52	1	0	0	53
15545	0	54	0	0	0	54
15546	56	0	0	0	0	56
15547	55	0	0	0	0	55
15548	0	0	0	57	0	57
15549	0	0	58	0	0	58
15550	0	0	0	55	0	55
15551	0	0	0	57	0	57
15552	58	0	0	0	0	58
15553	57	0	0	0	0	57
15554	0	0	0	61	0	61
15555	0	0	57	0	0	57
15556	0	60	0	0	0	60
15557	59	0	0	0	0	59
15558	0	61	0	0	0	61
15559	0	0	0	59	0	59
15560	0	0	0	54	0	54
15561	0	0	0	55	0	55
15562	0	0	0	55	0	55
15563	57	0	0	0	0	57
15564	0	0	0	57	0	57
15565	0	53	0	0	0	53
15566	0	0	0	53	0	53
15567	51	0	0	0	0	51
15568	0	49	0	0	0	49
15569	0	0	0	49	0	49
15570	0	0	48	0	0	48
15571	48	0	0	0	0	48
15572	0	0	0	49	0	49
15573	0	0	49	0	0	49
15574	0	0	40	0	0	40
15575	0	0	0	42	0	42
15576	40	0	0	0	0	40
15577	41	0	0	0	0	41
15578	0	43	0	0	0	43
15579	42	0	0	0	0	42
15580	45	0	0	0	0	45
15581	42	0	0	0	0	42
15582	44	0	0	0	0	44
15583	0	0	0	43	0	43
15584	0	0	0	45	0	45
15585	0	0	42	0	0	42
15586	0	43	0	0	0	43
15587	0	44	0	0	0	44
15588	0	0	47	0	0	47
15589	48	0	0	0	0	48
15590	0	0	0	46	0	46
15591	49	0	0	0	0	49
15592	50	0	0	0	0	50
15593	0	0	49	0	0	49
15594	0	0	0	50	0	50
15595	49	0	0	0	0	49
15596	0	0	0	49	0	49
15597	0	0	48	0	0	48
15598	0	0	0	47	0	47
15599	0	40	0	0	0	40
15600	1	46	0	0	0	47
15601	0	0	48	0	0	48
15602	0	48	0	0	0	48
15603	49	0	0	0	0	49
15604	48	0	0	0	0	48
15605	0	0	0	50	0	50
15606	0	0	0	44	0	44
15607	0	0	0	44	0	44
15608	44	0	0	0	0	44
15609	0	45	0	0	0	45
15610	42	0	0	0	0	42
15611	39	1	0	0	0	40
15612	0	46	0	0	0	46
15613	44	0	0	0	0	44
15614	0	44	0	0	0	44
15615	44	0	0	0	0	44
15616	0	0	45	0	0	45
15617	47	0	0	0	0	47
15618	0	46	0	0	0	46
15619	0	0	0	49	0	49
15620	0	0	0	51	0	51
15621	1	0	0	48	0	49
15622	47	0	0	0	0	47
15623	0	0	0	48	0	48
15624	0	0	47	0	0	47
15625	48	0	0	0	0	48
15626	0	0	48	0	0	48
15627	0	0	0	48	0	48
15628	0	0	46	0	0	46
15629	0	0	0	47	0	47
15630	0	47	0	0	0	47
15631	0	0	0	47	0	47
15632	0	48	0	0	0	48
15633	0	0	0	49	0	49
15634	49	0	0	0	0	49
15635	1	0	0	49	0	50
15636	52	0	0	0	0	52
15637	0	0	50	0	0	50
15638	49	0	0	0	0	49
15639	49	0	0	0	0	49
15640	48	0	0	0	0	48
15641	0	0	0	48	0	48
15642	47	1	0	0	0	48
15643	0	0	45	0	0	45
15644	48	0	0	0	0	48
15645	0	0	45	0	0	45
15646	48	0	0	1	0	49
15647	0	0	0	44	0	44
15648	0	0	46	0	0	46
15649	0	0	1	41	0	42
15650	0	0	0	43	0	43
15651	0	0	46	0	0	46
15652	42	0	0	0	0	42
15653	0	49	0	0	0	49
15654	46	0	0	0	0	46
15655	0	46	0	0	0	46
15656	45	0	1	0	0	46
15657	0	0	49	0	0	49
15658	51	0	0	0	0	51
15659	0	49	0	0	0	49
15660	0	0	0	50	0	50
15661	0	0	0	51	0	51
15662	0	0	0	49	0	49
15663	0	0	50	0	0	50
15664	0	0	0	49	0	49
15665	0	0	50	0	0	50
15666	50	0	0	0	0	50
15667	50	0	0	0	0	50
15668	0	0	0	53	0	53
15669	0	0	51	0	0	51
15670	55	0	0	0	0	55
15671	0	0	58	0	0	58
15672	0	0	0	59	0	59
15673	0	0	0	61	0	61
15674	0	0	0	60	0	60
15675	0	0	0	60	0	60
15676	57	0	0	0	0	57
15677	0	57	0	0	0	57
15678	0	0	54	0	0	54
15679	0	58	0	0	0	58
15680	56	0	0	0	0	56
15681	1	0	0	55	0	56
15682	54	0	0	0	0	54
15683	0	0	0	56	0	56
15684	1	0	0	52	0	53
15685	0	0	0	51	0	51
15686	0	0	50	0	0	50
15687	0	51	0	0	0	51
15688	0	0	48	0	0	48
15689	0	0	0	53	0	53
15690	49	0	0	0	0	49
15691	53	0	0	0	0	53
15692	54	0	0	0	0	54
15693	0	52	0	0	0	52
15694	50	0	0	0	0	50
15695	0	0	0	50	0	50
15696	0	0	0	51	0	51
15697	0	0	0	47	0	47
15698	0	46	0	0	0	46
15699	0	0	0	52	0	52
15700	0	52	0	0	0	52
15701	52	0	0	0	0	52
15702	52	0	0	0	0	52
15703	0	0	0	52	0	52
15704	0	0	52	0	0	52
15705	51	0	0	0	0	51
15706	0	0	0	51	0	51
15707	1	0	51	0	0	52
15708	50	0	0	0	0	50
15709	0	0	0	53	0	53
15710	51	0	0	0	0	51
15711	0	53	0	0	0	53
15712	0	0	0	48	0	48
15713	0	53	0	0	0	53
15714	0	0	0	50	0	50
15715	0	50	0	0	0	50
15716	0	0	0	54	0	54
15717	0	0	58	0	0	58
15718	56	0	0	0	0	56
15719	0	58	0	0	0	58
15720	0	0	57	0	0	57
15721	59	0	0	0	0	59
15722	0	0	0	56	0	56
15723	0	0	57	0	0	57
15724	0	58	0	0	0	58
15725	0	0	0	57	0	57
15726	0	0	57	0	0	57
15727	0	0	0	58	0	58
15728	0	0	0	59	0	59
15729	0	0	57	0	0	57
15730	0	0	0	57	0	57
15731	0	0	57	0	0	57
15732	0	0	0	59	0	59
15733	0	0	58	0	0	58
15734	0	0	0	57	0	57
15735	0	0	0	58	0	58
15736	0	0	0	53	0	53
15737	0	57	0	0	0	57
15738	56	0	0	0	0	56
15739	54	0	0	0	0	54
15740	0	0	0	56	0	56
15741	57	0	0	0	0	57
15742	0	0	55	0	0	55
15743	0	55	0	0	0	55
15744	53	0	0	0	0	53
15745	0	53	0	0	0	53
15746	0	0	0	52	0	52
15747	0	0	0	52	0	52
15748	51	0	0	0	0	51
15749	0	0	0	51	0	51
15750	0	0	50	0	0	50
15751	0	50	0	0	0	50
15752	50	0	0	0	0	50
15753	0	0	0	52	0	52
15754	0	48	0	0	0	48
15755	0	0	0	50	0	50
15756	0	51	0	0	0	51
15757	52	0	0	0	0	52
15758	49	0	0	0	0	49
15759	0	0	49	0	0	49
15760	0	0	49	0	0	49
15761	0	0	0	49	0	49
15762	0	49	0	0	0	49
15763	0	0	0	44	0	44
15764	42	0	0	0	0	42
15765	0	0	39	0	0	39
15766	0	0	0	38	0	38
15767	0	0	39	0	0	39
15768	0	0	38	0	0	38
15769	0	38	0	0	0	38
15770	0	0	0	38	0	38
15771	39	0	0	0	0	39
15772	0	0	39	0	0	39
15773	0	36	0	0	0	36
15774	39	0	0	0	0	39
15775	0	0	0	40	0	40
15776	40	0	0	0	0	40
15777	41	0	0	0	0	41
15778	42	0	0	0	0	42
15779	0	0	41	1	0	42
15780	40	0	0	0	0	40
15781	40	0	0	0	0	40
15782	0	41	0	0	0	41
15783	0	0	0	41	0	41
15784	0	0	0	43	0	43
15785	0	0	0	40	0	40
15786	39	0	0	0	0	39
15787	39	0	0	0	0	39
15788	0	0	39	0	0	39
15789	0	0	0	38	0	38
15790	0	39	0	0	0	39
15791	41	0	0	0	0	41
15792	0	0	43	0	0	43
15793	0	0	0	40	0	40
15794	0	0	0	43	0	43
15795	0	41	0	0	0	41
15796	0	0	0	43	0	43
15797	0	0	0	40	0	40
15798	0	0	0	43	0	43
15799	40	0	0	0	0	40
15800	0	0	0	40	0	40
15801	0	0	0	43	0	43
15802	39	0	6	0	0	45
15803	0	0	0	45	0	45
15804	0	49	0	0	0	49
15805	52	0	0	0	0	52
15806	51	0	0	0	0	51
15807	52	0	0	0	0	52
15808	51	0	0	0	0	51
15809	0	47	0	0	0	47
15810	47	0	0	0	0	47
15811	56	0	0	0	0	56
15812	0	0	0	58	0	58
15813	0	0	56	0	0	56
15814	0	0	0	57	0	57
15815	0	0	0	60	0	60
15816	0	0	0	63	0	63
15817	0	0	0	63	0	63
15818	0	0	0	58	0	58
15819	63	0	0	0	0	63
15820	0	0	0	63	0	63
15821	0	0	62	0	0	62
15822	0	0	0	59	0	59
15823	0	68	0	0	0	68
15824	0	0	0	67	0	67
15825	0	0	71	0	0	71
15826	70	0	0	0	0	70
15827	73	0	0	0	0	73
15828	0	0	72	0	0	72
15829	0	71	0	0	0	71
15830	79	0	0	0	0	79
15831	79	0	0	0	0	79
15832	77	0	0	1	0	78
15833	79	0	0	0	0	79
15834	0	0	0	77	0	77
15835	0	0	75	0	0	75
15836	0	0	0	77	0	77
15837	0	0	0	75	0	75
15838	0	0	74	0	0	74
15839	0	0	74	0	0	74
15840	76	0	0	0	0	76
15841	0	76	0	0	0	76
15842	0	0	0	78	0	78
15843	0	0	78	0	0	78
15844	76	0	0	0	0	76
15845	0	0	78	0	0	78
15846	80	0	0	0	0	80
15847	0	81	0	0	0	81
15848	0	0	0	80	0	80
15849	0	0	80	0	0	80
15850	82	0	0	0	0	82
15851	0	83	0	0	0	83
15852	0	79	0	0	0	79
15853	0	0	0	82	0	82
15854	0	0	0	82	0	82
15855	83	0	0	0	0	83
15856	0	83	0	0	0	83
15857	0	0	0	86	0	86
15858	85	0	0	0	0	85
15859	87	0	0	0	0	87
15860	86	0	0	0	0	86
15861	0	0	83	0	0	83
15862	0	0	77	0	0	77
15863	85	0	0	0	0	85
15864	0	80	0	0	0	80
15865	0	83	0	0	0	83
15866	0	0	0	88	0	88
15867	0	90	0	0	0	90
15868	92	0	0	0	0	92
15869	0	0	0	95	0	95
15870	0	0	95	0	0	95
15871	97	0	0	0	0	97
15872	98	0	0	0	0	98
15873	1	0	0	98	0	99
15874	0	0	0	101	0	101
15875	0	0	0	97	0	97
15876	0	0	0	99	0	99
15877	0	0	97	0	0	97
15878	0	96	0	0	0	96
15879	0	0	0	100	0	100
15880	0	101	0	0	0	101
15881	0	0	0	96	0	96
15882	1	100	0	0	0	101
15883	97	0	0	0	0	97
15884	100	0	0	0	0	100
15885	0	99	0	0	0	99
15886	99	0	0	0	0	99
15887	0	0	0	95	0	95
15888	94	0	0	0	0	94
15889	0	91	0	0	0	91
15890	98	0	0	0	0	98
15891	90	0	0	0	0	90
15892	0	0	2	94	0	96
15893	0	0	98	0	0	98
15894	0	94	0	0	0	94
15895	0	0	0	89	0	89
15896	87	0	0	0	0	87
15897	0	2	84	0	0	86
15898	0	0	0	85	0	85
15899	0	0	0	85	0	85
15900	80	0	6	0	0	86
15901	81	0	0	0	0	81
15902	80	0	0	0	0	80
15903	0	82	0	0	0	82
15904	71	0	0	0	0	71
15905	0	0	74	0	0	74
15906	0	0	66	1	0	67
15907	0	0	61	0	0	61
15908	0	0	0	63	0	63
15909	0	0	61	0	0	61
15910	65	0	0	0	0	65
15911	0	0	0	56	0	56
15912	0	0	56	0	0	56
15913	58	0	0	0	0	58
15914	0	0	0	59	0	59
15915	0	0	0	57	0	57
15916	56	0	0	0	0	56
15917	0	0	0	58	0	58
15918	0	0	58	0	0	58
15919	0	0	0	55	0	55
15920	0	0	58	0	0	58
15921	0	0	0	53	0	53
15922	56	0	0	0	0	56
15923	0	52	0	0	0	52
15924	0	52	0	0	0	52
15925	0	0	0	52	0	52
15926	0	0	0	53	0	53
15927	0	49	0	0	0	49
15928	0	50	0	0	0	50
15929	0	0	0	52	0	52
15930	0	0	0	53	0	53
15931	52	0	0	0	0	52
15932	0	53	0	0	0	53
15933	0	50	0	0	0	50
15934	0	52	0	0	0	52
15935	55	0	0	0	0	55
15936	0	0	51	0	0	51
15937	51	0	0	0	0	51
15938	0	0	0	52	0	52
15939	0	49	0	0	0	49
15940	0	49	0	0	0	49
15941	51	0	0	0	0	51
15942	0	0	0	49	0	49
15943	0	51	0	0	0	51
15944	50	0	0	0	0	50
15945	53	0	0	0	0	53
15946	1	0	52	0	0	53
15947	51	0	0	0	0	51
15948	53	0	0	0	0	53
15949	0	0	0	50	0	50
15950	0	48	0	0	0	48
15951	0	47	0	0	0	47
15952	0	0	0	49	0	49
15953	49	0	0	0	0	49
15954	0	0	47	0	0	47
15955	0	0	50	1	0	51
15956	0	0	47	0	0	47
15957	0	0	49	0	0	49
15958	0	52	0	0	0	52
15959	0	48	0	0	0	48
15960	0	0	47	0	0	47
15961	0	0	49	0	0	49
15962	0	50	0	0	0	50
15963	0	0	0	51	0	51
15964	0	0	48	0	0	48
15965	0	0	0	42	0	42
15966	0	0	0	42	0	42
15967	0	0	0	40	0	40
15968	0	0	0	42	0	42
15969	0	0	42	0	0	42
15970	0	0	0	41	0	41
15971	45	0	0	0	0	45
15972	0	0	43	0	0	43
15973	47	0	0	0	0	47
15974	0	0	0	47	0	47
15975	0	0	45	0	0	45
15976	46	0	0	0	0	46
15977	0	0	0	46	0	46
15978	46	0	0	0	0	46
15979	0	0	0	45	0	45
15980	0	47	0	0	0	47
15981	0	0	45	0	0	45
15982	0	0	0	50	0	50
15983	50	0	0	0	0	50
15984	48	0	0	0	0	48
15985	50	0	0	0	0	50
15986	48	0	0	0	0	48
15987	48	0	0	0	0	48
15988	0	45	0	0	0	45
15989	48	0	0	0	0	48
15990	0	0	47	0	0	47
15991	47	0	0	0	0	47
15992	0	1	0	44	0	45
15993	0	0	48	0	0	48
15994	0	0	45	0	0	45
15995	0	1	0	47	0	48
15996	49	0	0	0	0	49
15997	0	50	0	0	0	50
15998	47	0	0	0	0	47
15999	0	47	0	0	0	47
16000	0	0	0	49	0	49
16001	0	0	0	49	0	49
16002	47	0	0	0	0	47
16003	0	0	0	49	0	49
16004	0	0	51	0	0	51
16005	48	0	0	0	0	48
16006	0	0	0	48	0	48
16007	0	0	0	48	0	48
16008	0	0	47	0	0	47
16009	45	0	0	0	0	45
16010	45	0	0	0	0	45
16011	0	46	0	0	0	46
16012	0	0	50	0	0	50
16013	0	0	47	0	0	47
16014	0	1	0	45	0	46
16015	0	0	0	47	0	47
16016	0	47	0	0	0	47
16017	0	0	47	0	0	47
16018	0	0	0	44	0	44
16019	0	0	47	0	0	47
16020	0	0	0	44	0	44
16021	0	44	0	0	0	44
16022	0	0	0	44	0	44
16023	0	0	0	45	0	45
16024	0	0	0	44	0	44
16025	42	0	0	0	0	42
16026	0	0	43	0	0	43
16027	0	45	0	0	0	45
16028	0	0	0	47	0	47
16029	46	0	0	0	0	46
16030	0	0	0	48	0	48
16031	46	0	0	0	0	46
16032	0	0	45	0	0	45
16033	46	0	0	0	0	46
16034	0	0	0	47	0	47
16035	0	0	45	0	0	45
16036	0	44	0	0	0	44
16037	0	0	0	50	0	50
16038	0	0	0	48	0	48
16039	46	0	0	0	0	46
16040	0	44	0	0	0	44
16041	0	43	0	0	0	43
16042	0	49	0	0	0	49
16043	49	0	0	0	0	49
16044	0	47	0	0	0	47
16045	1	0	0	46	0	47
16046	0	0	0	52	0	52
16047	53	0	0	0	0	53
16048	0	57	0	0	0	57
16049	0	0	0	57	0	57
16050	62	0	0	0	0	62
16051	62	0	0	0	0	62
16052	61	0	0	0	0	61
16053	0	62	0	0	0	62
16054	59	0	0	0	0	59
16055	0	0	0	62	0	62
16056	0	58	0	0	0	58
16057	0	59	0	0	0	59
16058	0	0	0	63	0	63
16059	65	0	0	0	0	65
16060	63	0	0	0	0	63
16061	0	0	0	63	0	63
16062	0	67	0	0	0	67
16063	66	0	0	0	0	66
16064	0	0	64	0	0	64
16065	0	0	58	0	0	58
16066	59	0	0	0	0	59
16067	0	1	59	0	0	60
16068	0	0	0	59	0	59
16069	60	0	0	0	0	60
16070	0	0	0	60	0	60
16071	0	0	61	0	0	61
16072	0	61	0	0	0	61
16073	0	0	0	61	0	61
16074	0	0	58	0	0	58
16075	59	0	0	0	0	59
16076	0	0	0	62	0	62
16077	0	0	60	0	0	60
16078	0	0	0	61	0	61
16079	0	61	0	0	0	61
16080	0	0	0	62	0	62
16081	0	0	0	61	0	61
16082	0	0	0	64	0	64
16083	0	60	0	0	0	60
16084	62	0	0	0	0	62
16085	0	0	0	61	0	61
16086	0	0	0	62	0	62
16087	0	0	0	60	0	60
16088	0	0	67	0	0	67
16089	0	0	0	63	0	63
16090	63	0	0	0	0	63
16091	0	66	0	0	0	66
16092	0	0	0	67	0	67
16093	0	0	0	65	0	65
16094	66	0	0	0	0	66
16095	0	65	0	0	0	65
16096	67	0	0	0	0	67
16097	67	0	0	0	0	67
16098	0	0	0	66	0	66
16099	66	0	0	0	0	66
16100	0	62	0	0	0	62
16101	63	0	0	0	0	63
16102	0	0	0	61	0	61
16103	66	0	0	0	0	66
16104	68	0	0	0	0	68
16105	0	0	67	0	0	67
16106	66	0	1	0	0	67
16107	68	0	0	0	0	68
16108	71	0	0	0	0	71
16109	0	0	65	0	0	65
16110	0	72	0	0	0	72
16111	0	0	0	70	0	70
16112	75	0	0	0	0	75
16113	0	78	0	0	0	78
16114	77	0	0	0	0	77
16115	0	0	0	76	0	76
16116	0	0	78	0	0	78
16117	72	0	0	0	0	72
16118	0	0	0	76	0	76
16119	0	0	73	0	0	73
16120	74	0	0	0	0	74
16121	0	0	73	0	0	73
16122	0	0	0	68	0	68
16123	0	0	0	70	0	70
16124	69	0	0	0	0	69
16125	72	0	0	0	0	72
16126	0	71	0	0	0	71
16127	75	0	0	0	0	75
16128	0	0	68	0	0	68
16129	0	0	71	0	0	71
16130	67	0	0	0	0	67
16131	0	62	0	0	0	62
16132	66	0	0	0	0	66
16133	0	64	0	0	0	64
16134	65	0	0	0	0	65
16135	0	0	0	69	0	69
16136	0	0	69	0	0	69
16137	0	0	0	71	0	71
16138	0	0	0	72	0	72
16139	67	0	0	0	0	67
16140	0	0	66	0	0	66
16141	62	0	0	0	0	62
16142	0	69	0	0	0	69
16143	68	0	0	0	0	68
16144	0	0	0	67	0	67
16145	0	0	77	0	0	77
16146	0	0	0	76	0	76
16147	78	0	0	0	0	78
16148	0	0	0	83	0	83
16149	0	0	0	83	0	83
16150	0	82	0	0	0	82
16151	0	0	0	81	0	81
16152	0	0	79	0	0	79
16153	1	0	0	76	0	77
16154	0	0	0	80	0	80
16155	78	0	0	0	0	78
16156	0	0	0	78	0	78
16157	0	0	78	0	0	78
16158	0	77	0	0	0	77
16159	0	0	0	76	0	76
16160	0	0	0	74	0	74
16161	80	0	0	0	0	80
16162	0	80	0	0	0	80
16163	0	0	0	79	0	79
16164	83	0	0	0	0	83
16165	87	0	0	0	0	87
16166	0	0	0	87	0	87
16167	0	0	90	0	0	90
16168	90	0	0	0	0	90
16169	0	0	0	86	0	86
16170	88	0	0	0	0	88
16171	82	0	0	0	0	82
16172	0	88	0	0	0	88
16173	84	0	0	0	0	84
16174	0	87	0	0	0	87
16175	0	0	0	88	0	88
16176	0	0	0	89	0	89
16177	0	87	0	0	0	87
16178	87	0	0	0	0	87
16179	87	0	0	0	0	87
16180	0	0	88	0	0	88
16181	0	0	78	0	0	78
16182	2	0	0	79	0	81
16183	82	0	0	0	0	82
16184	0	0	0	81	0	81
16185	1	0	0	80	0	81
16186	0	0	90	0	0	90
16187	0	0	83	0	0	83
16188	0	0	93	0	0	93
16189	98	0	0	0	0	98
16190	93	0	1	0	0	94
16191	0	93	0	0	0	93
16192	0	96	0	0	0	96
16193	0	0	0	99	0	99
16194	0	0	109	0	0	109
16195	102	0	0	0	0	102
16196	0	0	111	0	0	111
16197	0	0	0	103	0	103
16198	0	0	0	107	0	107
16199	0	0	0	109	0	109
16200	0	0	0	115	0	115
16201	113	0	0	0	0	113
16202	0	0	0	111	0	111
16203	0	0	111	0	0	111
16204	115	0	0	0	0	115
16205	0	0	113	0	0	113
16206	1	0	104	0	0	105
16207	0	118	0	0	0	118
16208	0	0	0	119	0	119
16209	120	0	2	0	0	122
16210	0	0	0	119	0	119
16211	0	0	124	0	0	124
16212	0	0	0	125	0	125
16213	121	0	0	0	0	121
16214	0	127	0	0	0	127
16215	130	0	0	0	0	130
16216	0	132	0	0	0	132
16217	130	0	0	0	0	130
16218	0	129	0	0	0	129
16219	0	137	0	0	0	137
16220	1	0	126	0	0	127
16221	0	135	0	0	0	135
16222	131	0	0	0	0	131
16223	0	0	0	132	0	132
16224	129	0	0	0	0	129
16225	0	127	0	0	0	127
16226	130	0	0	0	0	130
16227	0	0	129	0	0	129
16228	0	0	0	129	0	129
16229	0	128	0	0	0	128
16230	0	0	0	128	0	128
16231	0	0	0	127	0	127
16232	125	0	0	0	0	125
16233	0	130	0	0	0	130
16234	125	0	0	0	0	125
16235	0	0	123	0	0	123
16236	0	0	121	0	0	121
16237	0	122	0	0	0	122
16238	0	0	0	119	0	119
16239	0	0	116	0	0	116
16240	0	0	0	115	0	115
16241	0	0	0	114	0	114
16242	0	0	105	0	0	105
16243	0	0	104	0	0	104
16244	0	0	110	0	0	110
16245	1	0	106	0	0	107
16246	0	116	0	0	0	116
16247	0	0	0	119	0	119
16248	0	0	0	120	0	120
16249	0	0	120	0	0	120
16250	0	0	0	113	0	113
16251	0	0	117	0	0	117
16252	0	0	1	116	0	117
16253	0	0	0	120	0	120
16254	0	123	0	0	0	123
16255	0	0	0	126	0	126
16256	0	0	0	126	0	126
16257	0	0	0	121	0	121
16258	0	0	114	0	0	114
16259	0	111	0	0	0	111
16260	111	0	0	0	0	111
16261	108	0	0	0	0	108
16262	0	0	0	114	0	114
16263	1	0	0	111	0	112
16264	0	115	0	0	0	115
16265	115	0	0	0	0	115
16266	0	116	0	0	0	116
16267	120	0	0	0	0	120
16268	0	0	113	0	0	113
16269	121	0	0	0	0	121
16270	0	118	0	0	0	118
16271	0	0	0	123	0	123
16272	0	0	0	119	0	119
16273	0	124	0	0	0	124
16274	128	0	0	0	0	128
16275	0	0	0	124	0	124
16276	0	0	0	125	0	125
16277	128	0	0	0	0	128
16278	125	0	0	0	0	125
16279	0	0	117	0	0	117
16280	114	0	0	0	0	114
16281	0	0	0	104	0	104
16282	0	0	105	0	0	105
16283	0	0	0	104	0	104
16284	0	0	106	0	0	106
16285	0	0	111	0	0	111
16286	0	0	0	111	0	111
16287	0	0	109	0	0	109
16288	0	103	0	0	0	103
16289	0	0	0	95	0	95
16290	0	0	0	105	0	105
16291	0	0	107	0	0	107
16292	0	102	0	0	0	102
16293	96	0	0	0	0	96
16294	0	0	0	92	0	92
16295	97	0	0	0	0	97
16296	0	90	0	0	0	90
16297	0	0	92	0	0	92
16298	0	0	0	93	0	93
16299	94	0	0	0	0	94
16300	0	0	90	0	0	90
16301	87	0	0	0	0	87
16302	0	88	0	0	0	88
16303	0	94	0	0	0	94
16304	86	0	0	0	0	86
16305	0	0	0	88	0	88
16306	0	0	0	90	0	90
16307	0	83	0	0	0	83
16308	0	0	0	89	0	89
16309	0	0	0	87	0	87
16310	87	0	0	0	0	87
16311	0	0	0	85	0	85
16312	0	0	85	0	0	85
16313	1	0	0	85	0	86
16314	0	0	0	88	0	88
16315	0	0	92	0	0	92
16316	0	0	0	89	0	89
16317	95	0	0	0	0	95
16318	92	0	0	1	0	93
16319	91	0	0	0	0	91
16320	0	0	0	92	0	92
16321	0	0	90	0	0	90
16322	0	92	0	0	0	92
16323	0	0	0	99	0	99
16324	0	0	98	0	0	98
16325	0	0	0	98	0	98
16326	0	0	0	97	0	97
16327	100	0	0	0	0	100
16328	0	101	0	0	0	101
16329	0	0	94	0	0	94
16330	103	0	0	0	0	103
16331	0	97	0	0	0	97
16332	0	104	0	0	0	104
16333	106	0	0	0	0	106
16334	0	0	0	104	0	104
16335	0	0	107	0	0	107
16336	0	0	0	105	0	105
16337	0	108	0	0	0	108
16338	106	0	0	0	0	106
16339	0	0	0	107	0	107
16340	107	0	0	0	0	107
16341	0	0	0	104	0	104
16342	0	110	0	0	0	110
16343	111	0	0	0	0	111
16344	108	0	0	0	0	108
16345	0	107	0	0	0	107
16346	110	0	0	0	0	110
16347	0	0	0	103	0	103
16348	0	104	0	0	0	104
16349	101	0	0	0	0	101
16350	0	98	0	0	0	98
16351	101	0	0	0	0	101
16352	0	0	0	100	0	100
16353	103	0	0	0	0	103
16354	103	0	0	1	0	104
16355	97	0	0	0	0	97
16356	0	2	0	107	0	109
16357	0	0	0	105	0	105
16358	110	0	0	0	0	110
16359	0	1	110	0	0	111
16360	0	0	0	111	0	111
16361	0	111	0	0	0	111
16362	0	0	0	117	0	117
16363	0	0	0	123	0	123
16364	0	0	117	0	0	117
16365	0	0	0	120	0	120
16366	0	114	0	0	0	114
16367	0	0	0	123	0	123
16368	0	0	121	0	0	121
16369	1	0	0	123	0	124
16370	0	0	0	124	0	124
16371	125	0	0	0	0	125
16372	124	0	0	0	0	124
16373	0	0	0	128	0	128
16374	0	119	0	0	0	119
16375	0	123	0	0	0	123
16376	0	0	132	0	0	132
16377	0	0	0	123	0	123
16378	129	0	0	0	0	129
16379	0	0	0	129	0	129
16380	1	0	130	0	0	131
16381	0	0	1	126	0	127
16382	0	0	0	130	0	130
16383	0	0	0	131	0	131
16384	0	0	121	0	0	121
16385	0	128	0	0	0	128
16386	129	0	0	0	0	129
16387	130	0	0	0	0	130
16388	0	0	0	133	0	133
16389	0	0	127	0	0	127
16390	0	132	0	0	0	132
16391	0	0	0	143	0	143
16392	0	132	0	0	0	132
16393	0	139	0	0	0	139
16394	139	0	0	0	0	139
16395	1	0	136	0	0	137
16396	0	0	134	0	0	134
16397	0	0	0	136	0	136
16398	0	0	0	137	0	137
16399	0	0	141	0	0	141
16400	0	0	0	138	0	138
16401	0	0	139	0	0	139
16402	140	0	0	0	0	140
16403	0	0	0	145	0	145
16404	0	0	143	0	0	143
16405	1	0	0	136	0	137
16406	0	136	0	0	0	136
16407	136	0	0	0	0	136
16408	0	136	0	0	0	136
16409	134	0	0	0	0	134
16410	0	0	135	0	0	135
16411	135	0	0	0	0	135
16412	0	0	0	135	0	135
16413	0	0	131	0	0	131
16414	0	0	0	135	0	135
16415	0	0	132	0	0	132
16416	126	0	0	0	0	126
16417	0	129	0	0	0	129
16418	0	0	0	129	0	129
16419	0	134	0	0	0	134
16420	131	0	0	0	0	131
16421	118	0	0	0	0	118
16422	0	126	0	0	0	126
16423	0	0	0	133	0	133
16424	0	0	0	131	0	131
16425	0	0	0	127	0	127
16426	129	0	0	0	0	129
16427	0	132	0	0	0	132
16428	0	0	0	134	0	134
16429	0	0	0	133	0	133
16430	132	0	0	0	0	132
16431	0	0	125	0	0	125
16432	0	0	125	0	0	125
16433	128	0	0	0	0	128
16434	0	0	127	0	0	127
16435	0	0	120	0	0	120
16436	0	0	0	117	0	117
16437	120	0	0	0	0	120
16438	0	0	0	123	0	123
16439	0	0	126	0	0	126
16440	125	0	0	0	0	125
16441	1	0	115	0	0	116
16442	0	120	0	1	0	121
16443	0	0	0	125	0	125
16444	121	0	0	0	0	121
16445	0	0	0	123	0	123
16446	0	0	0	121	0	121
16447	122	0	0	0	0	122
16448	0	0	0	120	0	120
16449	0	0	0	119	0	119
16450	0	1	110	0	0	111
16451	2	0	0	110	0	112
16452	112	0	0	0	0	112
16453	110	0	0	0	0	110
16454	106	0	0	0	0	106
16455	1	0	0	102	0	103
16456	0	101	0	0	0	101
16457	102	0	0	0	0	102
16458	0	103	0	0	0	103
16459	95	0	0	0	0	95
16460	0	2	0	93	0	95
16461	90	1	0	0	0	91
16462	89	0	0	0	0	89
16463	86	0	0	0	0	86
16464	0	86	0	0	0	86
16465	0	87	0	0	0	87
16466	88	0	0	0	0	88
16467	0	83	0	0	0	83
16468	1	81	0	0	0	82
16469	0	81	0	0	0	81
16470	87	0	0	0	0	87
16471	0	0	0	76	0	76
16472	0	0	0	77	0	77
16473	79	0	0	0	0	79
16474	0	0	81	0	0	81
16475	1	0	0	81	0	82
16476	0	0	0	87	0	87
16477	1	0	0	84	0	85
16478	0	0	0	83	0	83
16479	0	80	0	1	0	81
16480	0	87	0	0	0	87
16481	84	0	0	0	0	84
16482	0	0	0	93	0	93
16483	0	0	0	89	0	89
16484	0	0	81	0	0	81
16485	0	0	0	83	0	83
16486	0	0	81	0	0	81
16487	0	0	0	85	0	85
16488	0	0	86	0	0	86
16489	0	86	0	0	0	86
16490	0	0	0	91	0	91
16491	86	0	0	0	0	86
16492	86	0	0	0	0	86
16493	0	0	0	95	0	95
16494	0	0	88	0	0	88
16495	0	0	87	0	0	87
16496	87	0	0	2	0	89
16497	0	87	0	0	0	87
16498	96	0	0	0	0	96
16499	95	0	0	0	0	95
16500	0	0	93	1	0	94
16501	0	0	0	90	0	90
16502	0	0	0	90	0	90
16503	0	0	0	93	0	93
16504	0	0	0	92	0	92
16505	0	0	0	95	0	95
16506	0	0	92	0	0	92
16507	0	0	92	0	0	92
16508	0	0	0	94	0	94
16509	0	0	0	92	0	92
16510	0	0	0	92	0	92
16511	92	0	0	0	0	92
16512	0	0	0	91	0	91
16513	95	1	0	0	0	96
16514	0	0	0	98	0	98
16515	97	0	0	0	0	97
16516	91	0	0	0	0	91
16517	91	0	0	0	0	91
16518	93	0	0	0	0	93
16519	98	0	0	0	0	98
16520	0	0	0	91	0	91
16521	84	0	0	1	0	85
16522	0	92	0	0	0	92
16523	88	0	0	0	0	88
16524	0	0	0	92	0	92
16525	0	0	91	0	0	91
16526	0	0	0	90	0	90
16527	0	0	89	0	0	89
16528	0	0	0	87	0	87
16529	0	0	0	92	0	92
16530	0	0	91	0	0	91
16531	0	0	88	0	0	88
16532	1	0	0	90	0	91
16533	92	0	0	0	0	92
16534	0	0	93	0	0	93
16535	0	86	0	1	0	87
16536	0	0	94	0	0	94
16537	98	0	0	0	0	98
16538	0	0	0	93	0	93
16539	93	0	0	0	0	93
16540	94	0	0	0	0	94
16541	0	0	0	92	0	92
16542	0	0	89	0	0	89
16543	0	0	0	89	0	89
16544	0	0	0	93	0	93
16545	94	0	0	0	0	94
16546	0	106	0	0	0	106
16547	1	0	0	105	0	106
16548	0	0	108	0	0	108
16549	105	0	0	2	0	107
16550	0	105	0	0	0	105
16551	0	0	0	106	0	106
16552	0	0	0	105	0	105
16553	0	0	0	103	0	103
16554	106	0	0	0	0	106
16555	104	0	0	0	0	104
16556	0	0	0	107	0	107
16557	0	0	103	0	0	103
16558	0	107	0	0	0	107
16559	108	0	0	0	0	108
16560	103	0	0	0	0	103
16561	0	0	0	103	0	103
16562	0	0	0	109	0	109
16563	0	0	108	0	0	108
16564	0	105	0	0	0	105
16565	110	0	0	1	0	111
16566	110	0	0	0	0	110
16567	0	107	0	0	0	107
16568	106	0	0	0	0	106
16569	0	0	0	101	0	101
16570	0	0	99	0	0	99
16571	0	0	0	98	0	98
16572	0	0	95	0	0	95
16573	94	4	0	1	0	99
16574	0	99	0	0	0	99
16575	0	0	4	89	0	93
16576	0	0	87	0	0	87
16577	0	0	79	0	0	79
16578	86	0	0	0	0	86
16579	0	90	0	0	0	90
16580	84	0	0	0	0	84
16581	84	0	0	0	0	84
16582	84	0	0	0	0	84
16583	0	0	0	78	0	78
16584	0	0	88	0	0	88
16585	0	89	0	0	0	89
16586	0	0	0	91	0	91
16587	0	0	90	0	0	90
16588	1	0	84	0	0	85
16589	0	0	0	95	0	95
16590	0	0	92	0	0	92
16591	84	0	0	0	0	84
16592	0	0	0	87	0	87
16593	0	0	0	92	0	92
16594	90	1	0	0	0	91
16595	0	87	1	0	0	88
16596	88	0	0	0	0	88
16597	0	0	0	92	0	92
16598	0	0	0	92	0	92
16599	0	0	1	89	0	90
16600	0	0	0	90	0	90
16601	88	0	0	0	0	88
16602	0	0	92	0	0	92
16603	1	93	0	0	0	94
16604	0	0	0	95	0	95
16605	100	0	0	0	0	100
16606	101	0	0	0	0	101
16607	0	103	0	0	0	103
16608	100	0	0	0	0	100
16609	0	100	0	0	0	100
16610	6	93	0	0	0	99
16611	0	0	0	99	0	99
16612	0	0	102	0	0	102
16613	0	0	1	96	0	97
16614	100	0	0	0	0	100
16615	0	109	0	1	0	110
16616	0	0	0	109	0	109
16617	0	0	124	1	0	125
16618	121	0	0	0	0	121
16619	124	0	0	0	0	124
16620	120	0	0	0	0	120
16621	0	0	124	0	0	124
16622	124	0	0	0	0	124
16623	0	128	0	0	0	128
16624	0	0	0	121	0	121
16625	0	125	0	0	0	125
16626	127	0	0	1	0	128
16627	128	0	0	0	0	128
16628	0	0	131	0	0	131
16629	0	121	0	1	0	122
16630	0	0	0	138	0	138
16631	0	0	0	131	0	131
16632	0	0	0	135	0	135
16633	0	0	0	131	0	131
16634	0	0	0	135	0	135
16635	0	0	129	1	0	130
16636	0	136	0	0	0	136
16637	135	0	0	0	0	135
16638	0	0	132	0	0	132
16639	0	118	0	0	0	118
16640	121	0	0	0	0	121
16641	0	0	120	0	0	120
16642	113	0	0	1	0	114
16643	109	0	0	0	0	109
16644	111	0	0	0	0	111
16645	0	114	0	0	0	114
16646	0	0	115	0	0	115
16647	0	112	0	0	0	112
16648	0	0	0	118	0	118
16649	0	117	0	0	0	117
16650	118	0	0	0	0	118
16651	113	0	0	0	0	113
16652	124	0	0	0	0	124
16653	0	0	124	0	0	124
16654	0	129	0	0	0	129
16655	0	0	0	133	0	133
16656	123	0	0	0	0	123
16657	0	123	0	0	0	123
16658	0	0	0	133	0	133
16659	0	0	129	0	0	129
16660	145	0	0	0	0	145
16661	0	0	144	0	0	144
16662	1	0	144	0	0	145
16663	150	0	0	0	0	150
16664	1	0	146	0	0	147
16665	151	0	0	0	0	151
16666	0	149	0	0	0	149
16667	153	0	0	0	0	153
16668	0	0	0	152	0	152
16669	1	0	0	150	0	151
16670	0	0	0	150	0	150
16671	151	1	0	0	0	152
16672	145	1	0	0	0	146
16673	151	0	0	0	0	151
16674	0	153	0	0	0	153
16675	0	0	0	155	0	155
16676	0	0	155	1	0	156
16677	0	0	0	148	0	148
16678	0	146	0	0	0	146
16679	0	0	0	153	0	153
16680	0	0	0	147	0	147
16681	144	0	0	0	0	144
16682	0	0	0	145	0	145
16683	0	0	144	0	0	144
16684	0	1	135	0	0	136
16685	0	0	0	145	0	145
16686	146	0	0	0	0	146
16687	0	0	0	144	0	144
16688	0	0	0	147	0	147
16689	0	0	141	0	0	141
16690	0	143	0	0	0	143
16691	0	0	0	147	0	147
16692	143	0	0	0	0	143
16693	0	142	0	0	0	142
16694	0	1	0	146	0	147
16695	0	0	151	0	0	151
16696	0	0	0	156	0	156
16697	150	0	0	0	0	150
16698	0	154	0	1	0	155
16699	0	0	151	0	0	151
16700	0	0	0	156	0	156
16701	0	0	148	4	0	152
16702	157	0	0	0	0	157
16703	159	0	0	0	0	159
16704	0	0	160	0	0	160
16705	0	0	0	160	0	160
16706	0	0	160	0	0	160
16707	0	150	0	0	0	150
16708	0	1	0	146	0	147
16709	0	0	145	0	0	145
16710	0	0	0	129	0	129
16711	0	127	0	0	0	127
16712	0	0	0	127	0	127
16713	0	0	126	0	0	126
16714	123	0	0	1	0	124
16715	0	127	0	0	0	127
16716	128	0	0	0	0	128
16717	0	0	126	0	0	126
16718	128	0	0	0	0	128
16719	0	0	129	0	0	129
16720	129	0	0	0	0	129
16721	127	0	0	0	0	127
16722	0	0	0	123	0	123
16723	0	0	0	117	0	117
16724	114	0	0	0	0	114
16725	0	119	0	0	0	119
16726	123	0	0	0	0	123
16727	1	0	0	126	0	127
16728	0	121	0	0	0	121
16729	0	0	1	122	0	123
16730	0	0	0	124	0	124
16731	0	0	0	126	0	126
16732	0	120	0	0	0	120
16733	127	0	0	0	0	127
16734	0	0	0	132	0	132
16735	0	0	123	0	0	123
16736	1	0	121	0	0	122
16737	0	1	129	0	0	130
16738	127	0	0	0	0	127
16739	132	0	0	0	0	132
16740	0	0	128	0	0	128
16741	0	0	0	125	0	125
16742	0	0	0	131	0	131
16743	0	0	129	0	0	129
16744	0	0	124	0	0	124
16745	0	0	0	129	0	129
16746	126	0	0	0	0	126
16747	122	0	0	0	0	122
16748	119	0	0	0	0	119
16749	0	119	0	0	0	119
16750	0	111	0	0	0	111
16751	0	0	0	114	0	114
16752	114	0	0	0	0	114
16753	0	0	99	0	0	99
16754	95	0	4	2	0	101
16755	0	98	0	0	0	98
16756	0	94	4	0	0	98
16757	100	0	0	0	0	100
16758	0	98	0	0	0	98
16759	0	96	0	0	0	96
16760	93	0	0	1	0	94
16761	0	93	0	0	0	93
16762	0	0	0	96	0	96
16763	0	0	0	96	0	96
16764	93	0	0	0	0	93
16765	93	0	0	0	0	93
16766	0	87	0	0	0	87
16767	1	90	0	0	0	91
16768	0	0	86	0	0	86
16769	95	0	0	0	0	95
16770	95	0	0	0	0	95
16771	94	0	0	0	0	94
16772	0	0	0	96	0	96
16773	0	0	0	99	0	99
16774	95	0	0	0	0	95
16775	0	0	0	103	0	103
16776	0	0	89	0	0	89
16777	0	0	0	92	0	92
16778	0	91	0	0	0	91
16779	0	0	0	95	0	95
16780	0	0	0	94	0	94
16781	0	0	0	93	0	93
16782	94	0	0	0	0	94
16783	0	92	0	0	0	92
16784	0	0	0	89	0	89
16785	0	0	87	0	0	87
16786	0	0	93	0	0	93
16787	0	0	0	82	0	82
16788	0	0	0	89	0	89
16789	84	0	0	0	0	84
16790	0	0	0	84	0	84
16791	0	80	0	0	0	80
16792	0	0	85	0	0	85
16793	0	0	0	83	0	83
16794	0	0	94	0	0	94
16795	0	0	1	86	0	87
16796	89	0	0	0	0	89
16797	87	0	0	0	0	87
16798	0	89	0	0	0	89
16799	0	0	0	91	0	91
16800	93	0	0	0	0	93
16801	92	0	0	0	0	92
16802	93	0	0	0	0	93
16803	92	0	0	0	0	92
16804	90	0	0	0	0	90
16805	0	94	0	0	0	94
16806	93	0	0	0	0	93
16807	0	0	89	0	0	89
16808	1	0	0	86	0	87
16809	89	0	0	0	0	89
16810	84	0	0	0	0	84
16811	86	0	0	0	0	86
16812	1	0	87	0	0	88
16813	0	0	0	85	0	85
16814	85	0	0	0	0	85
16815	0	84	0	0	0	84
16816	90	0	0	0	0	90
16817	90	0	0	0	0	90
16818	91	0	0	0	0	91
16819	0	0	0	88	0	88
16820	86	0	0	0	0	86
16821	1	0	87	0	0	88
16822	0	0	83	0	0	83
16823	95	0	0	0	0	95
16824	0	0	89	0	0	89
16825	93	0	0	0	0	93
16826	0	0	85	0	0	85
16827	0	0	0	86	0	86
16828	84	0	0	0	0	84
16829	0	86	0	0	0	86
16830	84	0	0	0	0	84
16831	0	80	0	1	0	81
16832	0	81	0	0	0	81
16833	0	0	0	83	0	83
16834	0	0	1	82	0	83
16835	0	0	0	81	0	81
16836	0	0	80	0	0	80
16837	84	0	0	0	0	84
16838	82	0	0	0	0	82
16839	75	0	0	0	0	75
16840	81	0	0	0	0	81
16841	76	0	0	0	0	76
16842	0	0	67	0	0	67
16843	0	0	63	0	0	63
16844	0	0	0	71	0	71
16845	0	0	74	0	0	74
16846	76	0	0	0	0	76
16847	0	75	0	0	0	75
16848	0	0	0	81	0	81
16849	79	0	0	0	0	79
16850	0	0	0	79	0	79
16851	0	0	76	0	0	76
16852	0	0	77	0	0	77
16853	0	0	0	87	0	87
16854	0	0	82	0	0	82
16855	82	0	1	0	0	83
16856	0	0	0	84	0	84
16857	0	0	80	0	0	80
16858	0	81	0	0	0	81
16859	0	0	0	82	0	82
16860	0	0	75	0	0	75
16861	0	0	0	79	0	79
16862	0	0	0	83	0	83
16863	0	0	85	0	0	85
16864	0	0	0	75	0	75
16865	0	0	0	79	0	79
16866	0	0	0	78	0	78
16867	74	0	0	0	0	74
16868	1	75	0	0	0	76
16869	0	76	0	0	0	76
16870	0	0	82	0	0	82
16871	77	0	0	0	0	77
16872	0	0	82	0	0	82
16873	0	0	77	0	0	77
16874	0	0	0	77	0	77
16875	76	0	0	0	0	76
16876	0	78	0	0	0	78
16877	80	0	0	0	0	80
16878	82	0	0	0	0	82
16879	0	82	0	0	0	82
16880	82	0	0	0	0	82
16881	80	0	0	0	0	80
16882	0	78	0	0	0	78
16883	0	0	0	80	0	80
16884	0	0	0	81	0	81
16885	81	0	0	0	0	81
16886	0	77	0	0	0	77
16887	74	0	0	0	0	74
16888	76	0	0	0	0	76
16889	76	0	0	0	0	76
16890	0	0	0	78	0	78
16891	0	0	0	81	0	81
16892	85	0	0	0	0	85
16893	96	0	0	0	0	96
16894	99	0	0	0	0	99
16895	0	0	0	100	0	100
16896	0	1	104	0	0	105
16897	0	0	0	107	0	107
16898	0	0	0	111	0	111
16899	0	0	112	0	0	112
16900	0	0	113	0	0	113
16901	0	0	0	120	0	120
16902	0	0	125	0	0	125
16903	123	0	0	0	0	123
16904	0	0	0	123	0	123
16905	0	0	0	124	0	124
16906	125	0	0	0	0	125
16907	0	0	0	128	0	128
16908	0	0	0	131	0	131
16909	0	0	0	135	0	135
16910	0	0	0	137	0	137
16911	0	0	137	0	0	137
16912	0	0	0	135	0	135
16913	0	0	145	0	0	145
16914	0	133	0	0	0	133
16915	0	0	0	145	0	145
16916	0	0	148	0	0	148
16917	146	0	0	0	0	146
16918	0	146	0	0	0	146
16919	148	0	0	0	0	148
16920	0	0	0	147	0	147
16921	0	152	0	0	0	152
16922	146	0	0	0	0	146
16923	0	150	1	0	0	151
16924	149	0	0	0	0	149
16925	0	0	0	150	0	150
16926	147	0	0	0	0	147
16927	0	151	0	0	0	151
16928	151	0	0	0	0	151
16929	0	0	153	0	0	153
16930	0	0	0	156	0	156
16931	157	0	0	0	0	157
16932	163	0	0	0	0	163
16933	0	0	0	165	0	165
16934	0	0	165	0	0	165
16935	0	153	0	0	0	153
16936	0	167	0	0	0	167
16937	169	0	0	0	0	169
16938	0	0	0	171	0	171
16939	1	0	0	170	0	171
16940	166	0	0	0	0	166
16941	163	0	0	0	0	163
16942	1	3	160	0	0	164
16943	0	0	3	163	0	166
16944	0	0	164	0	0	164
16945	0	166	0	0	0	166
16946	157	0	0	1	0	158
16947	0	156	0	0	0	156
16948	0	156	0	0	0	156
16949	1	0	0	161	0	162
16950	160	1	0	0	0	161
16951	0	164	0	0	0	164
16952	159	0	0	0	0	159
16953	0	157	0	0	0	157
16954	0	0	0	162	0	162
16955	154	0	0	0	0	154
16956	0	0	155	0	0	155
16957	0	2	0	158	0	160
16958	0	0	157	0	0	157
16959	0	152	2	0	0	154
16960	0	156	0	0	0	156
16961	153	0	0	1	0	154
16962	0	159	0	0	0	159
16963	153	0	0	0	0	153
16964	156	0	0	0	0	156
16965	0	0	158	0	0	158
16966	157	0	0	1	0	158
16967	0	0	152	0	0	152
16968	0	166	0	0	0	166
16969	164	0	0	0	0	164
16970	0	160	0	0	0	160
16971	0	0	0	168	0	168
16972	166	0	0	0	0	166
16973	0	0	0	168	0	168
16974	0	0	168	0	0	168
16975	0	0	0	167	0	167
16976	0	0	0	171	0	171
16977	167	0	0	0	0	167
16978	0	0	159	1	0	160
16979	169	0	0	0	0	169
16980	167	0	0	0	0	167
16981	0	0	0	161	0	161
16982	0	0	0	160	0	160
16983	162	0	0	0	0	162
16984	0	163	0	0	0	163
16985	0	0	0	151	0	151
16986	0	0	134	0	0	134
16987	0	0	135	0	0	135
16988	0	137	0	0	0	137
16989	0	0	0	131	0	131
16990	0	0	0	127	0	127
16991	128	0	0	0	0	128
16992	0	0	0	121	0	121
16993	122	0	0	0	0	122
16994	0	120	0	0	0	120
16995	0	99	0	0	0	99
16996	0	125	0	0	0	125
16997	127	0	0	0	0	127
16998	128	0	0	0	0	128
16999	0	126	0	0	0	126
17000	127	0	0	0	0	127
17001	0	131	0	0	0	131
17002	0	0	0	125	0	125
17003	0	128	0	0	0	128
17004	129	0	0	0	0	129
17005	130	0	0	0	0	130
17006	0	0	0	125	0	125
17007	123	0	0	0	0	123
17008	0	0	0	119	0	119
17009	0	117	0	0	0	117
17010	0	0	0	108	0	108
17011	0	113	0	0	0	113
17012	112	0	0	0	0	112
17013	0	0	111	0	0	111
17014	113	0	0	0	0	113
17015	0	0	0	110	0	110
17016	0	0	105	0	0	105
17017	107	0	0	0	0	107
17018	0	0	104	0	0	104
17019	0	0	0	104	0	104
17020	0	0	0	106	0	106
17021	0	0	0	95	0	95
17022	0	0	0	103	0	103
17023	1	98	0	0	0	99
17024	0	0	0	101	0	101
17025	102	0	0	0	0	102
17026	0	0	97	0	0	97
17027	0	99	0	0	0	99
17028	96	0	0	0	0	96
17029	102	0	0	0	0	102
17030	0	0	0	103	0	103
17031	0	0	101	0	0	101
17032	0	0	0	100	0	100
17033	1	0	0	103	0	104
17034	0	0	105	0	0	105
17035	0	97	0	0	0	97
17036	105	0	0	0	0	105
17037	109	0	0	0	0	109
17038	107	0	0	1	0	108
17039	0	0	0	110	0	110
17040	0	0	0	114	0	114
17041	110	0	0	0	0	110
17042	1	0	0	107	0	108
17043	0	110	0	0	0	110
17044	118	0	0	0	0	118
17045	112	0	0	0	0	112
17046	116	0	0	0	0	116
17047	121	0	0	0	0	121
17048	0	0	117	0	0	117
17049	0	1	111	0	0	112
17050	0	0	0	116	0	116
17051	0	0	0	115	0	115
17052	0	0	114	0	0	114
17053	0	0	107	0	0	107
17054	0	0	0	114	0	114
17055	115	0	0	0	0	115
17056	0	0	0	117	0	117
17057	0	0	116	0	0	116
17058	0	113	0	0	0	113
17059	113	0	0	0	0	113
17060	118	0	0	0	0	118
17061	112	0	0	1	0	113
17062	114	0	0	0	0	114
17063	0	0	114	0	0	114
17064	0	0	0	108	0	108
17065	116	0	0	0	0	116
17066	0	0	0	116	0	116
17067	0	0	0	108	0	108
17068	0	121	1	0	0	122
17069	0	2	0	119	0	121
17070	122	0	0	0	0	122
17071	0	118	0	0	0	118
17072	123	0	0	0	0	123
17073	0	125	0	0	0	125
17074	0	0	0	120	0	120
17075	0	120	1	0	0	121
17076	0	128	0	0	0	128
17077	132	0	0	0	0	132
17078	0	0	131	0	0	131
17079	0	0	127	0	0	127
17080	0	0	132	0	0	132
17081	129	0	0	0	0	129
17082	0	127	0	0	0	127
17083	0	138	0	0	0	138
17084	133	0	0	0	0	133
17085	0	128	0	0	0	128
17086	0	129	0	0	0	129
17087	0	1	1	135	0	137
17088	0	0	136	0	0	136
17089	0	1	127	0	0	128
17090	0	1	0	129	0	130
17091	131	0	0	0	0	131
17092	0	131	0	1	0	132
17093	0	0	0	127	0	127
17094	0	0	126	0	0	126
17095	0	0	134	0	0	134
17096	0	0	0	137	0	137
17097	142	0	0	0	0	142
17098	140	0	0	0	0	140
17099	0	0	141	0	0	141
17100	138	0	0	0	0	138
17101	0	0	138	0	0	138
17102	0	0	0	134	0	134
17103	0	138	0	0	0	138
17104	136	0	0	0	0	136
17105	0	0	0	137	0	137
17106	0	0	0	136	0	136
17107	0	0	0	142	0	142
17108	0	0	0	145	0	145
17109	0	0	150	0	0	150
17110	0	157	0	0	0	157
17111	0	0	0	157	0	157
17112	150	0	0	0	0	150
17113	0	0	0	153	0	153
17114	0	0	0	152	0	152
17115	0	0	153	0	0	153
17116	1	0	147	0	0	148
17117	0	153	0	0	0	153
17118	0	153	0	0	0	153
17119	0	0	0	162	0	162
17120	160	0	0	0	0	160
17121	0	0	157	0	0	157
17122	0	159	0	0	0	159
17123	0	0	0	152	0	152
17124	0	155	0	0	0	155
17125	0	0	0	164	0	164
17126	0	161	0	0	0	161
17127	0	0	0	165	0	165
17128	160	0	0	1	0	161
17129	0	156	0	0	0	156
17130	0	0	0	158	0	158
17131	146	0	0	1	0	147
17132	0	149	0	0	0	149
17133	0	145	0	0	0	145
17134	0	147	0	1	0	148
17135	0	0	0	153	0	153
17136	0	0	0	153	0	153
17137	0	148	0	0	0	148
17138	0	0	0	148	0	148
17139	0	0	136	0	0	136
17140	0	140	0	0	0	140
17141	0	0	0	141	0	141
17142	0	137	0	0	0	137
17143	2	0	129	0	0	131
17144	0	138	0	0	0	138
17145	141	0	0	0	0	141
17146	0	0	0	143	0	143
17147	142	0	0	0	0	142
17148	0	0	142	0	0	142
17149	0	0	0	137	0	137
17150	0	0	139	0	0	139
17151	0	0	0	138	0	138
17152	143	0	0	0	0	143
17153	0	0	0	139	0	139
17154	131	0	0	2	0	133
17155	0	139	0	0	0	139
17156	139	0	0	0	0	139
17157	0	0	144	0	0	144
17158	0	142	0	0	0	142
17159	0	0	0	146	0	146
17160	0	0	0	149	0	149
17161	0	0	137	0	0	137
17162	0	147	0	0	0	147
17163	0	0	0	144	0	144
17164	0	145	0	0	0	145
17165	0	0	0	147	0	147
17166	0	149	0	0	0	149
17167	151	0	0	0	0	151
17168	0	0	0	148	0	148
17169	0	0	141	0	0	141
17170	0	145	0	0	0	145
17171	1	139	0	1	0	141
17172	0	0	136	0	0	136
17173	0	141	0	0	0	141
17174	0	0	0	147	0	147
17175	0	0	147	0	0	147
17176	0	0	0	137	0	137
17177	0	0	0	141	0	141
17178	0	0	139	0	0	139
17179	140	0	0	0	0	140
17180	0	0	0	140	0	140
17181	2	0	140	0	0	142
17182	0	139	0	0	0	139
17183	148	0	0	0	0	148
17184	0	139	0	0	0	139
17185	0	0	0	138	0	138
17186	137	0	0	1	0	138
17187	0	0	0	139	0	139
17188	0	0	129	0	0	129
17189	0	0	0	122	0	122
17190	0	0	121	0	0	121
17191	121	0	0	0	0	121
17192	0	0	120	0	0	120
17193	119	0	0	0	0	119
17194	119	1	0	0	0	120
17195	0	0	122	0	0	122
17196	0	0	116	0	0	116
17197	0	119	0	0	0	119
17198	124	0	0	0	0	124
17199	0	1	0	121	0	122
17200	0	0	0	112	0	112
17201	112	0	0	0	0	112
17202	110	0	0	0	0	110
17203	99	0	0	0	0	99
17204	103	0	0	0	0	103
17205	0	0	1	103	0	104
17206	102	0	0	0	0	102
17207	0	0	0	100	0	100
17208	0	0	2	101	0	103
17209	0	0	0	107	0	107
17210	0	0	92	0	0	92
17211	0	99	0	0	0	99
17212	0	94	0	0	0	94
17213	0	0	2	93	0	95
17214	93	0	0	0	0	93
17215	1	0	0	91	0	92
17216	94	0	0	0	0	94
17217	0	0	92	0	0	92
17218	89	0	0	1	0	90
17219	0	0	0	93	0	93
17220	93	0	0	0	0	93
17221	91	0	0	1	0	92
17222	91	0	0	0	0	91
17223	0	0	0	92	0	92
17224	0	0	91	0	0	91
17225	0	0	0	93	0	93
17226	96	0	0	0	0	96
17227	0	1	94	0	0	95
17228	0	1	0	100	0	101
17229	98	1	0	1	0	100
17230	0	0	99	0	0	99
17231	103	1	0	0	0	104
17232	104	1	0	0	0	105
17233	0	0	0	103	0	103
17234	0	0	0	108	0	108
17235	109	0	0	0	0	109
17236	0	0	0	109	0	109
17237	99	0	0	0	0	99
17238	0	108	0	0	0	108
17239	0	109	0	0	0	109
17240	0	0	0	106	0	106
17241	0	0	116	0	0	116
17242	0	118	1	0	0	119
17243	118	0	0	0	0	118
17244	0	119	0	0	0	119
17245	0	0	119	0	0	119
17246	0	0	1	112	0	113
17247	0	0	113	0	0	113
17248	0	115	0	0	0	115
17249	0	0	0	126	0	126
17250	0	119	0	0	0	119
17251	0	0	119	0	0	119
17252	0	0	0	112	0	112
17253	0	0	116	0	0	116
17254	0	0	0	122	0	122
17255	116	0	0	0	0	116
17256	0	0	127	0	0	127
17257	117	0	0	0	0	117
17258	0	1	117	0	0	118
17259	0	0	0	117	0	117
17260	0	0	116	0	0	116
17261	1	0	0	111	0	112
17262	0	0	0	106	0	106
17263	0	0	0	112	0	112
17264	0	0	0	119	0	119
17265	0	0	121	0	0	121
17266	121	0	0	0	0	121
17267	0	0	0	124	0	124
17268	122	0	0	0	0	122
17269	129	0	0	0	0	129
17270	129	0	0	0	0	129
17271	0	0	0	130	0	130
17272	0	0	0	127	0	127
17273	0	127	0	0	0	127
17274	131	0	0	0	0	131
17275	135	0	0	0	0	135
17276	135	0	0	0	0	135
17277	0	0	141	0	0	141
17278	0	0	0	139	0	139
17279	0	0	137	0	0	137
17280	144	0	0	1	0	145
17281	144	0	0	0	0	144
17282	0	0	0	142	0	142
17283	0	0	0	139	0	139
17284	0	143	0	0	0	143
17285	151	0	0	0	0	151
17286	152	0	0	0	0	152
17287	0	149	0	0	0	149
17288	146	0	0	0	0	146
17289	1	0	0	147	0	148
17290	0	0	0	144	0	144
17291	144	0	0	1	0	145
17292	0	0	144	1	0	145
17293	146	0	0	0	0	146
17294	148	0	0	0	0	148
17295	0	149	0	0	0	149
17296	154	0	0	0	0	154
17297	0	0	147	0	0	147
17298	0	0	0	149	0	149
17299	148	0	0	0	0	148
17300	0	0	0	150	0	150
17301	0	0	148	0	0	148
17302	1	0	0	148	0	149
17303	0	145	0	0	0	145
17304	0	0	0	146	0	146
17305	1	0	0	145	0	146
17306	0	0	0	147	0	147
17307	0	0	0	151	0	151
17308	0	0	147	0	0	147
17309	1	0	0	147	0	148
17310	142	0	0	0	0	142
17311	0	144	0	0	0	144
17312	0	0	0	143	0	143
17313	0	0	138	0	0	138
17314	0	0	0	139	0	139
17315	141	0	0	0	0	141
17316	131	0	0	0	0	131
17317	139	0	0	0	0	139
17318	1	0	0	138	0	139
17319	0	0	136	0	0	136
17320	0	136	0	0	0	136
17321	138	0	0	0	0	138
17322	0	0	3	138	0	141
17323	0	0	0	144	0	144
17324	0	0	138	0	0	138
17325	0	125	0	1	0	126
17326	0	134	0	0	0	134
17327	0	0	4	132	0	136
17328	0	0	126	0	0	126
17329	132	0	0	0	0	132
17330	0	0	127	0	0	127
17331	123	0	0	0	0	123
17332	0	121	0	0	0	121
17333	0	0	123	0	0	123
17334	115	0	0	1	0	116
17335	0	110	0	0	0	110
17336	116	0	0	0	0	116
17337	0	0	109	0	0	109
17338	0	112	1	0	0	113
17339	110	0	0	0	0	110
17340	0	0	110	0	0	110
17341	111	0	0	0	0	111
17342	0	0	0	107	0	107
17343	108	0	0	0	0	108
17344	0	0	0	106	0	106
17345	111	0	0	0	0	111
17346	0	0	104	0	0	104
17347	0	0	0	99	0	99
17348	0	0	0	97	0	97
17349	0	0	96	0	0	96
17350	0	0	0	98	0	98
17351	0	82	0	1	0	83
17352	0	0	0	103	0	103
17353	0	0	0	105	0	105
17354	0	0	0	110	0	110
17355	0	0	109	0	0	109
17356	109	0	0	0	0	109
17357	0	0	0	131	0	131
17358	0	0	128	0	0	128
17359	131	0	0	0	0	131
17360	140	0	0	0	0	140
17361	149	0	0	0	0	149
17362	0	0	1	153	0	154
17363	0	0	0	146	0	146
17364	0	0	0	152	0	152
17365	0	150	0	0	0	150
17366	154	0	0	0	0	154
17367	150	0	0	0	0	150
17368	0	0	0	150	0	150
17369	0	5	145	0	0	150
17370	0	0	137	0	0	137
17371	0	133	3	1	0	137
17372	0	144	0	0	0	144
17373	151	0	0	1	0	152
17374	0	155	0	0	0	155
17375	160	0	0	0	0	160
17376	156	0	0	0	0	156
17377	151	0	0	1	0	152
17378	1	0	0	154	0	155
17379	0	0	0	157	0	157
17380	151	0	0	0	0	151
17381	0	0	0	159	0	159
17382	0	0	159	0	0	159
17383	159	0	0	0	0	159
17384	0	0	0	161	0	161
17385	0	0	0	157	0	157
17386	0	0	0	151	0	151
17387	0	0	151	0	0	151
17388	146	0	0	0	0	146
17389	0	0	143	0	0	143
17390	0	0	0	143	0	143
17391	0	0	146	0	0	146
17392	0	0	0	144	0	144
17393	0	0	0	147	0	147
17394	0	0	145	0	0	145
17395	0	1	0	140	0	141
17396	0	148	0	0	0	148
17397	146	0	0	0	0	146
17398	145	0	0	0	0	145
17399	0	0	0	147	0	147
17400	0	0	154	0	0	154
17401	0	148	0	0	0	148
17402	0	151	0	0	0	151
17403	157	0	0	0	0	157
17404	0	0	153	0	0	153
17405	153	1	0	0	0	154
17406	0	0	0	153	0	153
17407	0	0	0	157	0	157
17408	157	0	0	0	0	157
17409	0	160	0	0	0	160
17410	0	0	160	1	0	161
17411	0	0	0	161	0	161
17412	0	0	159	0	0	159
17413	0	153	0	0	0	153
17414	0	0	0	158	0	158
17415	157	0	0	0	0	157
17416	158	0	0	0	0	158
17417	0	0	155	0	0	155
17418	0	150	0	0	0	150
17419	155	0	0	0	0	155
17420	0	156	0	0	0	156
17421	0	0	0	156	0	156
17422	155	0	0	0	0	155
17423	0	0	0	157	0	157
17424	0	0	161	0	0	161
17425	0	0	0	156	0	156
17426	0	0	155	0	0	155
17427	0	0	0	157	0	157
17428	154	0	0	1	0	155
17429	0	158	0	0	0	158
17430	160	0	0	0	0	160
17431	0	0	0	158	0	158
17432	0	0	0	162	0	162
17433	1	0	139	0	0	140
17434	0	0	150	0	0	150
17435	0	146	0	0	0	146
17436	0	0	162	0	0	162
17437	159	0	0	0	0	159
17438	0	141	0	0	0	141
17439	0	148	1	1	0	150
17440	0	157	0	0	0	157
17441	0	0	0	167	0	167
17442	0	0	158	0	0	158
17443	1	145	0	0	0	146
17444	0	0	0	158	0	158
17445	0	146	0	0	0	146
17446	149	0	0	0	0	149
17447	139	0	0	0	0	139
17448	0	0	0	142	0	142
17449	0	0	0	141	0	141
17450	118	0	0	0	0	118
17451	2	134	0	0	0	136
17452	0	118	0	0	0	118
17453	0	0	4	109	0	113
17454	0	0	111	0	0	111
17455	0	121	0	0	0	121
17456	109	0	0	0	0	109
17457	0	97	0	1	0	98
17458	0	94	0	0	0	94
17459	89	1	0	0	0	90
17460	0	91	1	0	0	92
17461	0	0	87	0	0	87
17462	0	87	0	0	0	87
17463	85	0	0	0	0	85
17464	1	86	0	0	0	87
17465	82	0	0	0	0	82
17466	0	0	0	80	0	80
17467	0	0	0	75	0	75
17468	0	0	69	0	0	69
17469	0	71	0	0	0	71
17470	0	0	0	70	0	70
17471	68	0	0	0	0	68
17472	69	0	0	0	0	69
17473	0	69	0	0	0	69
17474	0	0	0	67	0	67
17475	68	0	0	0	0	68
17476	68	0	0	0	0	68
17477	0	0	65	0	0	65
17478	0	0	65	0	0	65
17479	0	0	61	0	0	61
17480	0	67	0	0	0	67
17481	68	0	0	0	0	68
17482	0	67	0	0	0	67
17483	69	0	0	0	0	69
17484	0	69	0	0	0	69
17485	0	0	0	70	0	70
17486	70	0	0	0	0	70
17487	0	0	73	0	0	73
17488	72	0	0	0	0	72
17489	72	0	0	0	0	72
17490	0	66	0	0	0	66
17491	0	69	0	0	0	69
17492	74	0	0	0	0	74
17493	0	0	69	0	0	69
17494	69	0	0	0	0	69
17495	71	0	0	0	0	71
17496	0	0	0	68	0	68
17497	76	0	0	0	0	76
17498	0	0	0	77	0	77
17499	0	0	0	77	0	77
17500	0	0	0	77	0	77
17501	0	69	0	0	0	69
17502	76	0	0	0	0	76
17503	76	0	0	0	0	76
17504	0	0	0	75	0	75
17505	0	0	0	74	0	74
17506	0	68	0	0	0	68
17507	74	0	0	0	0	74
17508	0	0	75	0	0	75
17509	0	0	0	76	0	76
17510	0	0	73	0	0	73
17511	0	0	0	73	0	73
17512	0	0	74	0	0	74
17513	0	0	0	73	0	73
17514	78	0	0	0	0	78
17515	0	0	78	0	0	78
17516	74	0	0	1	0	75
17517	0	72	0	0	0	72
17518	0	0	0	72	0	72
17519	0	0	0	72	0	72
17520	75	0	0	0	0	75
17521	0	0	0	76	0	76
17522	0	0	92	0	0	92
17523	90	0	0	0	0	90
17524	93	0	0	0	0	93
17525	89	0	0	0	0	89
17526	91	0	0	0	0	91
17527	0	90	0	0	0	90
17528	0	0	0	91	0	91
17529	86	0	0	0	0	86
17530	0	0	0	92	0	92
17531	89	0	0	0	0	89
17532	0	0	86	0	0	86
17533	0	0	85	0	0	85
17534	0	0	0	86	0	86
17535	0	83	0	0	0	83
17536	0	90	0	0	0	90
17537	98	0	0	0	0	98
17538	0	0	95	0	0	95
17539	96	0	0	0	0	96
17540	0	98	0	0	0	98
17541	99	0	0	0	0	99
17542	0	0	0	96	0	96
17543	0	0	96	0	0	96
17544	0	0	0	92	0	92
17545	0	0	0	92	0	92
17546	0	89	0	0	0	89
17547	0	92	0	0	0	92
17548	0	0	0	95	0	95
17549	0	96	0	0	0	96
17550	0	0	91	0	0	91
17551	0	0	84	0	0	84
17552	94	0	0	0	0	94
17553	94	0	0	0	0	94
17554	0	94	0	0	0	94
17555	0	0	0	94	0	94
17556	0	0	0	94	0	94
17557	0	0	97	0	0	97
17558	0	0	0	94	0	94
17559	0	103	0	0	0	103
17560	0	0	101	0	0	101
17561	0	0	92	0	0	92
17562	0	95	0	0	0	95
17563	0	0	102	0	0	102
17564	0	0	0	103	0	103
17565	1	0	0	104	0	105
17566	0	0	102	0	0	102
17567	0	0	0	101	0	101
17568	2	100	0	0	0	102
17569	0	104	0	0	0	104
17570	0	0	0	105	0	105
17571	0	0	105	0	0	105
17572	0	100	0	0	0	100
17573	0	0	0	103	0	103
17574	0	0	107	0	0	107
17575	101	0	0	0	0	101
17576	105	1	0	0	0	106
17577	104	0	0	0	0	104
17578	0	0	0	105	0	105
17579	0	0	0	107	0	107
17580	0	0	108	0	0	108
17581	1	0	0	106	0	107
17582	0	0	0	112	0	112
17583	0	0	109	0	0	109
17584	110	0	0	0	0	110
17585	0	110	0	0	0	110
17586	105	0	0	1	0	106
17587	0	106	0	0	0	106
17588	0	0	0	108	0	108
17589	0	0	109	0	0	109
17590	0	0	0	103	0	103
17591	0	0	105	0	0	105
17592	101	0	0	0	0	101
17593	0	0	100	0	0	100
17594	0	0	0	104	0	104
17595	0	0	96	0	0	96
17596	0	100	0	0	0	100
17597	0	0	0	101	0	101
17598	0	0	0	100	0	100
17599	1	0	0	101	0	102
17600	0	0	99	0	0	99
17601	1	0	104	0	0	105
17602	0	0	0	106	0	106
17603	0	0	0	108	0	108
17604	0	0	0	118	0	118
17605	115	0	0	0	0	115
17606	0	0	0	118	0	118
17607	0	0	113	0	0	113
17608	118	0	0	0	0	118
17609	0	0	0	118	0	118
17610	131	0	0	0	0	131
17611	130	0	0	0	0	130
17612	0	0	0	134	0	134
17613	126	0	0	0	0	126
17614	133	0	0	0	0	133
17615	0	0	118	0	0	118
17616	0	129	0	0	0	129
17617	0	0	0	118	0	118
17618	0	0	0	118	0	118
17619	118	0	0	0	0	118
17620	117	0	0	0	0	117
17621	120	0	0	0	0	120
17622	0	0	121	0	0	121
17623	0	122	0	0	0	122
17624	124	0	0	0	0	124
17625	0	127	0	0	0	127
17626	125	0	0	0	0	125
17627	0	0	0	122	0	122
17628	126	0	0	0	0	126
17629	114	1	0	0	0	115
17630	120	0	0	0	0	120
17631	0	0	113	0	0	113
17632	118	0	0	0	0	118
17633	0	116	0	0	0	116
17634	118	0	0	0	0	118
17635	110	0	0	0	0	110
17636	114	0	0	0	0	114
17637	0	0	0	116	0	116
17638	0	114	1	0	0	115
17639	116	0	0	0	0	116
17640	0	0	110	0	0	110
17641	0	111	0	0	0	111
17642	0	0	0	109	0	109
17643	0	114	0	0	0	114
17644	115	0	0	0	0	115
17645	112	0	0	0	0	112
17646	0	0	0	113	0	113
17647	0	0	111	0	0	111
17648	0	108	0	0	0	108
17649	0	0	0	116	0	116
17650	0	0	0	113	0	113
17651	0	0	0	112	0	112
17652	110	0	0	0	0	110
17653	107	0	0	0	0	107
17654	102	0	1	0	0	103
17655	106	0	0	0	0	106
17656	0	0	0	105	0	105
17657	0	0	111	0	0	111
17658	0	0	0	109	0	109
17659	0	0	0	110	0	110
17660	0	0	0	112	0	112
17661	0	0	0	108	0	108
17662	111	0	0	0	0	111
17663	0	0	0	113	0	113
17664	110	0	0	0	0	110
17665	113	0	0	0	0	113
17666	0	1	109	0	0	110
17667	0	0	103	0	0	103
17668	0	0	110	0	0	110
17669	0	0	0	113	0	113
17670	0	0	114	0	0	114
17671	0	0	0	111	0	111
17672	0	0	0	114	0	114
17673	108	0	0	0	0	108
17674	0	0	0	109	0	109
17675	0	103	0	0	0	103
17676	111	0	0	0	0	111
17677	0	111	0	0	0	111
17678	1	0	111	0	0	112
17679	0	113	0	0	0	113
17680	114	0	0	0	0	114
17681	0	0	0	113	0	113
17682	0	0	108	0	0	108
17683	111	0	0	0	0	111
17684	0	0	0	110	0	110
17685	0	0	111	0	0	111
17686	0	0	0	105	0	105
17687	0	0	0	111	0	111
17688	0	0	0	107	0	107
17689	0	105	0	0	0	105
17690	105	0	0	0	0	105
17691	0	0	0	107	0	107
17692	0	111	0	0	0	111
17693	0	0	0	112	0	112
17694	0	0	110	0	0	110
17695	0	104	0	0	0	104
17696	101	0	0	0	0	101
17697	99	0	0	0	0	99
17698	0	0	0	93	0	93
17699	0	0	0	96	0	96
17700	94	0	0	0	0	94
17701	89	0	0	0	0	89
17702	0	93	0	0	0	93
17703	83	0	0	0	0	83
17704	0	12	77	0	0	89
17705	0	0	93	0	0	93
17706	0	75	13	0	0	88
17707	0	89	0	0	0	89
17708	84	0	0	0	0	84
17709	0	80	0	0	0	80
17710	73	0	0	0	0	73
17711	70	0	0	0	0	70
17712	69	0	0	0	0	69
17713	0	0	0	70	0	70
17714	70	0	0	0	0	70
17715	0	0	71	0	0	71
17716	0	0	67	0	0	67
17717	0	70	0	0	0	70
17718	0	0	74	0	0	74
17719	0	0	0	69	0	69
17720	0	0	67	0	0	67
17721	0	0	70	0	0	70
17722	0	0	0	70	0	70
17723	70	0	0	0	0	70
17724	66	0	0	0	0	66
17725	1	0	64	0	0	65
17726	67	0	0	0	0	67
17727	0	0	70	0	0	70
17728	70	0	0	0	0	70
17729	72	0	0	0	0	72
17730	0	0	0	76	0	76
17731	0	0	0	71	0	71
17732	0	68	0	1	0	69
17733	0	72	0	0	0	72
17734	0	0	0	75	0	75
17735	0	0	0	78	0	78
17736	71	1	0	0	0	72
17737	0	73	1	0	0	74
17738	76	0	0	0	0	76
17739	0	79	0	0	0	79
17740	0	0	77	0	0	77
17741	1	0	0	77	0	78
17742	79	0	0	0	0	79
17743	79	1	0	0	0	80
17744	0	77	0	0	0	77
17745	0	74	0	0	0	74
17746	0	77	0	0	0	77
17747	0	0	0	77	0	77
17748	0	0	78	0	0	78
17749	0	78	0	0	0	78
17750	0	0	0	76	0	76
17751	0	0	0	77	0	77
17752	0	0	76	0	0	76
17753	0	0	74	0	0	74
17754	74	0	0	0	0	74
17755	0	0	72	0	0	72
17756	80	0	0	0	0	80
17757	77	0	1	0	0	78
17758	72	0	0	0	0	72
17759	77	0	0	0	0	77
17760	0	0	73	0	0	73
17761	0	75	0	0	0	75
17762	0	0	0	71	0	71
17763	0	0	72	0	0	72
17764	0	0	0	67	0	67
17765	1	64	0	0	0	65
17766	0	0	0	70	0	70
17767	0	0	0	70	0	70
17768	0	0	0	72	0	72
17769	69	0	0	0	0	69
17770	0	0	0	68	0	68
17771	0	0	0	72	0	72
17772	0	0	0	76	0	76
17773	0	76	0	0	0	76
17774	73	0	0	0	0	73
17775	0	67	0	0	0	67
17776	0	75	0	0	0	75
17777	0	0	0	78	0	78
17778	0	0	0	79	0	79
17779	84	0	0	0	0	84
17780	0	0	0	85	0	85
17781	83	0	0	0	0	83
17782	79	0	0	1	0	80
17783	1	0	0	87	0	88
17784	0	0	0	83	0	83
17785	0	81	0	0	0	81
17786	79	0	0	0	0	79
17787	0	75	0	0	0	75
17788	81	0	0	0	0	81
17789	0	0	75	0	0	75
17790	77	0	0	0	0	77
17791	80	0	0	0	0	80
17792	0	0	0	82	0	82
17793	0	0	86	0	0	86
17794	0	82	0	0	0	82
17795	0	0	0	84	0	84
17796	0	1	88	0	0	89
17797	0	0	0	79	0	79
17798	95	0	0	0	0	95
17799	0	0	93	0	0	93
17800	0	84	0	0	0	84
17801	0	92	0	0	0	92
17802	2	0	0	87	0	89
17803	0	93	0	0	0	93
17804	95	0	0	0	0	95
17805	86	0	1	1	0	88
17806	95	0	0	0	0	95
17807	0	0	97	0	0	97
17808	95	0	0	0	0	95
17809	0	0	0	92	0	92
17810	0	0	0	97	0	97
17811	0	0	0	92	0	92
17812	0	2	0	93	0	95
17813	0	1	91	0	0	92
17814	1	0	84	0	0	85
17815	0	2	90	0	0	92
17816	89	0	0	0	0	89
17817	0	94	0	0	0	94
17818	0	0	0	91	0	91
17819	89	0	0	0	0	89
17820	0	87	0	0	0	87
17821	0	88	0	1	0	89
17822	86	0	0	0	0	86
17823	80	0	0	0	0	80
17824	0	84	0	0	0	84
17825	0	0	0	86	0	86
17826	0	90	0	0	0	90
17827	90	0	0	0	0	90
17828	89	0	0	0	0	89
17829	90	0	0	1	0	91
17830	0	89	0	0	0	89
17831	0	0	0	86	0	86
17832	0	0	84	0	0	84
17833	1	0	0	86	0	87
17834	0	0	0	83	0	83
17835	0	0	84	0	0	84
17836	82	0	0	0	0	82
17837	0	0	0	83	0	83
17838	0	0	0	84	0	84
17839	0	84	0	0	0	84
17840	77	0	1	1	0	79
17841	0	0	0	83	0	83
17842	0	79	0	0	0	79
17843	81	0	0	0	0	81
17844	0	81	0	0	0	81
17845	84	0	0	0	0	84
17846	0	1	81	0	0	82
17847	0	0	80	0	0	80
17848	0	0	81	0	0	81
17849	0	76	0	0	0	76
17850	0	0	0	74	0	74
17851	0	73	0	0	0	73
17852	81	0	0	0	0	81
17853	0	0	79	0	0	79
17854	79	0	0	0	0	79
17855	79	0	0	0	0	79
17856	0	0	0	80	0	80
17857	79	0	0	0	0	79
17858	0	0	0	80	0	80
17859	0	0	81	0	0	81
17860	81	0	0	0	0	81
17861	0	79	0	0	0	79
17862	0	0	0	76	0	76
17863	78	0	0	0	0	78
17864	0	0	0	76	0	76
17865	0	0	69	0	0	69
17866	0	0	0	72	0	72
17867	0	72	0	0	0	72
17868	71	0	0	0	0	71
17869	0	0	0	72	0	72
17870	67	0	0	0	0	67
17871	0	0	0	67	0	67
17872	0	0	0	63	0	63
17873	0	66	0	0	0	66
17874	65	0	0	0	0	65
17875	0	72	0	0	0	72
17876	0	0	0	67	0	67
17877	0	71	0	0	0	71
17878	72	0	0	0	0	72
17879	66	2	0	0	0	68
17880	70	0	0	0	0	70
17881	0	70	0	0	0	70
17882	0	71	0	0	0	71
17883	72	0	0	0	0	72
17884	0	72	0	0	0	72
17885	0	0	0	69	0	69
17886	0	0	73	0	0	73
17887	72	0	0	0	0	72
17888	68	0	0	0	0	68
17889	68	0	0	0	0	68
17890	0	71	0	0	0	71
17891	58	0	0	0	0	58
17892	0	0	53	0	0	53
17893	0	54	0	0	0	54
17894	0	0	0	58	0	58
17895	0	58	1	0	0	59
17896	56	0	0	0	0	56
17897	0	57	0	0	0	57
17898	0	0	0	60	0	60
17899	0	51	0	0	0	51
17900	0	0	0	53	0	53
17901	0	0	0	51	0	51
17902	0	0	54	0	0	54
17903	1	0	0	52	0	53
17904	55	0	0	0	0	55
17905	56	0	0	0	0	56
17906	0	0	0	54	0	54
17907	0	0	55	0	0	55
17908	0	0	0	55	0	55
17909	57	0	0	0	0	57
17910	51	0	0	0	0	51
17911	54	0	0	0	0	54
17912	0	55	0	0	0	55
17913	58	0	0	0	0	58
17914	0	0	59	0	0	59
17915	57	0	0	0	0	57
17916	0	0	0	55	0	55
17917	0	0	0	59	0	59
17918	0	0	0	52	0	52
17919	52	0	0	0	0	52
17920	51	0	0	0	0	51
17921	0	0	0	52	0	52
17922	0	0	53	0	0	53
17923	0	0	0	50	0	50
17924	0	0	0	51	0	51
17925	0	0	55	0	0	55
17926	0	56	0	0	0	56
17927	0	0	0	59	0	59
17928	60	0	0	0	0	60
17929	0	0	0	58	0	58
17930	0	0	0	61	0	61
17931	62	0	0	0	0	62
17932	0	61	0	0	0	61
17933	0	61	0	0	0	61
17934	64	0	0	0	0	64
17935	0	0	63	0	0	63
17936	64	0	0	0	0	64
17937	0	0	64	0	0	64
17938	0	69	0	0	0	69
17939	71	0	0	0	0	71
17940	73	0	0	0	0	73
17941	73	0	0	0	0	73
17942	73	0	0	0	0	73
17943	0	0	71	0	0	71
17944	0	0	0	69	0	69
17945	69	0	0	0	0	69
17946	0	0	69	0	0	69
17947	0	0	67	0	0	67
17948	0	67	0	0	0	67
17949	71	0	0	0	0	71
17950	0	0	0	72	0	72
17951	70	0	0	0	0	70
17952	0	68	0	0	0	68
17953	0	0	0	68	0	68
17954	0	0	0	69	0	69
17955	0	0	0	79	0	79
17956	0	0	75	0	0	75
17957	0	80	0	0	0	80
17958	79	0	0	0	0	79
17959	0	0	0	77	0	77
17960	80	0	0	0	0	80
17961	76	0	0	0	0	76
17962	0	0	0	79	0	79
17963	0	0	82	0	0	82
17964	0	0	0	79	0	79
17965	0	78	0	0	0	78
17966	0	0	0	83	0	83
17967	0	0	81	0	0	81
17968	76	0	0	0	0	76
17969	0	0	0	76	0	76
17970	77	0	0	0	0	77
17971	0	0	73	0	0	73
17972	74	0	0	0	0	74
17973	0	0	77	0	0	77
17974	70	0	0	0	0	70
17975	0	73	0	0	0	73
17976	0	74	0	0	0	74
17977	0	0	0	79	0	79
17978	0	0	0	75	0	75
17979	0	0	0	71	0	71
17980	72	0	0	0	0	72
17981	0	0	0	73	0	73
17982	0	0	73	0	0	73
17983	78	0	0	0	0	78
17984	0	79	0	0	0	79
17985	77	0	0	0	0	77
17986	77	0	0	0	0	77
17987	0	0	75	0	0	75
17988	0	0	0	76	0	76
17989	0	0	0	74	0	74
17990	0	0	76	0	0	76
17991	0	76	0	0	0	76
17992	79	0	0	0	0	79
17993	77	0	0	0	0	77
17994	0	1	0	72	0	73
17995	0	0	0	76	0	76
17996	0	0	0	78	0	78
17997	77	0	0	0	0	77
17998	0	82	0	0	0	82
17999	82	0	0	0	0	82
18000	83	0	0	0	0	83
18001	0	0	83	0	0	83
18002	0	0	0	77	0	77
18003	0	83	0	0	0	83
18004	0	0	0	82	0	82
18005	0	0	0	85	0	85
18006	0	0	84	0	0	84
18007	88	0	0	0	0	88
18008	92	0	0	0	0	92
18009	90	0	0	0	0	90
18010	0	0	0	86	0	86
18011	1	0	0	90	0	91
18012	0	90	0	0	0	90
18013	0	89	0	0	0	89
18014	96	0	0	0	0	96
18015	0	92	0	0	0	92
18016	0	0	101	0	0	101
18017	0	0	0	98	0	98
18018	98	0	0	0	0	98
18019	1	0	96	0	0	97
18020	0	1	93	0	0	94
18021	97	0	0	0	0	97
18022	91	0	0	0	0	91
18023	0	0	0	99	0	99
18024	0	0	92	0	0	92
18025	0	0	0	95	0	95
18026	0	0	81	0	0	81
18027	0	0	85	0	0	85
18028	0	88	0	0	0	88
18029	92	0	0	0	0	92
18030	86	0	0	0	0	86
18031	0	84	0	0	0	84
18032	0	0	0	85	0	85
18033	1	0	0	84	0	85
18034	0	0	0	86	0	86
18035	81	0	0	0	0	81
18036	0	83	1	0	0	84
18037	85	0	0	1	0	86
18038	86	0	0	0	0	86
18039	0	0	84	0	0	84
18040	0	81	0	0	0	81
18041	0	0	0	82	0	82
18042	0	0	83	0	0	83
18043	81	0	0	0	0	81
18044	80	0	0	0	0	80
18045	79	0	0	0	0	79
18046	82	0	0	0	0	82
18047	1	0	0	82	0	83
18048	0	0	77	0	0	77
18049	0	0	0	73	0	73
18050	73	0	0	0	0	73
18051	75	0	0	0	0	75
18052	0	74	0	0	0	74
18053	73	0	0	0	0	73
18054	0	0	72	0	0	72
18055	0	0	67	0	0	67
18056	73	0	0	0	0	73
18057	0	74	0	0	0	74
18058	0	0	0	65	0	65
18059	0	63	0	0	0	63
18060	0	0	0	67	0	67
18061	0	0	0	63	0	63
18062	0	0	0	63	0	63
18063	65	0	0	0	0	65
18064	64	0	0	0	0	64
18065	64	0	0	0	0	64
18066	0	0	62	0	0	62
18067	64	0	0	0	0	64
18068	0	0	0	63	0	63
18069	0	0	0	67	0	67
18070	0	0	66	0	0	66
18071	0	0	0	59	0	59
18072	64	0	0	0	0	64
18073	0	0	62	0	0	62
18074	0	0	0	62	0	62
18075	64	0	0	0	0	64
18076	57	0	0	0	0	57
18077	0	0	56	0	0	56
18078	0	0	61	0	0	61
18079	0	0	0	57	0	57
18080	61	0	0	0	0	61
18081	57	0	0	0	0	57
18082	0	0	0	58	0	58
18083	0	58	0	0	0	58
18084	59	0	0	0	0	59
18085	0	58	0	0	0	58
18086	0	0	0	62	0	62
18087	0	0	62	0	0	62
18088	0	0	53	0	0	53
18089	0	0	52	0	0	52
18090	0	0	0	58	0	58
18091	0	0	0	57	0	57
18092	55	1	0	0	0	56
18093	0	55	0	0	0	55
18094	55	0	1	0	0	56
18095	0	0	0	57	0	57
18096	0	57	0	0	0	57
18097	0	51	0	0	0	51
18098	0	0	0	52	0	52
18099	46	0	0	1	0	47
18100	0	45	0	0	0	45
18101	41	0	0	0	0	41
18102	0	45	0	0	0	45
18103	43	0	0	0	0	43
18104	0	0	45	0	0	45
18105	0	0	45	0	0	45
18106	0	45	0	0	0	45
18107	38	0	0	0	0	38
18108	0	38	0	0	0	38
18109	0	33	0	0	0	33
18110	0	0	0	30	0	30
18111	26	0	0	0	0	26
18112	0	28	0	0	0	28
18113	29	0	0	0	0	29
18114	0	29	0	0	0	29
18115	29	0	0	0	0	29
18116	0	24	0	0	0	24
18117	0	27	0	0	0	27
18118	0	0	0	29	0	29
18119	0	28	0	0	0	28
18120	30	0	0	0	0	30
18121	0	0	30	0	0	30
18122	0	0	0	30	0	30
18123	0	0	27	0	0	27
18124	0	0	0	31	0	31
18125	0	0	0	30	0	30
18126	0	0	29	0	0	29
18127	30	0	0	0	0	30
18128	0	29	0	0	0	29
18129	30	0	0	0	0	30
18130	0	28	0	0	0	28
18131	0	0	0	34	0	34
18132	33	0	0	0	0	33
18133	31	0	0	0	0	31
18134	32	0	0	0	0	32
18135	0	0	0	31	0	31
18136	0	0	0	32	0	32
18137	0	33	0	0	0	33
18138	34	0	0	0	0	34
18139	31	0	0	0	0	31
18140	32	0	0	0	0	32
18141	31	0	0	0	0	31
18142	0	28	0	0	0	28
18143	0	0	0	31	0	31
18144	0	0	30	0	0	30
18145	31	0	1	0	0	32
18146	31	0	0	0	0	31
18147	0	0	27	0	0	27
18148	0	0	27	0	0	27
18149	0	0	0	31	0	31
18150	0	0	0	28	0	28
18151	0	0	0	28	0	28
18152	29	0	0	0	0	29
18153	0	0	0	28	0	28
18154	0	0	31	0	0	31
18155	0	0	0	31	0	31
18156	0	0	28	0	0	28
18157	0	0	1	29	0	30
18158	0	0	0	29	0	29
18159	0	0	32	0	0	32
18160	31	0	0	0	0	31
18161	0	34	0	0	0	34
18162	28	0	0	0	0	28
18163	0	0	0	28	0	28
18164	26	0	0	0	0	26
18165	0	32	0	0	0	32
18166	0	32	0	0	0	32
18167	0	0	0	35	0	35
18168	1	0	31	0	0	32
18169	0	0	28	0	0	28
18170	0	30	0	0	0	30
18171	29	0	0	0	0	29
18172	0	0	0	30	0	30
18173	29	0	0	0	0	29
18174	0	26	0	0	0	26
18175	0	25	0	0	0	25
18176	0	0	0	26	0	26
18177	27	0	0	0	0	27
18178	26	0	0	0	0	26
18179	0	0	26	0	0	26
18180	0	0	23	0	0	23
18181	25	0	0	0	0	25
18182	0	24	0	0	0	24
18183	26	0	0	0	0	26
18184	0	0	0	25	0	25
18185	0	0	26	0	0	26
18186	26	0	0	0	0	26
18187	0	25	0	0	0	25
18188	0	24	0	0	0	24
18189	0	0	0	25	0	25
18190	25	0	0	0	0	25
18191	0	0	0	25	0	25
18192	26	0	0	0	0	26
18193	0	0	25	0	0	25
18194	27	0	0	0	0	27
18195	28	0	0	0	0	28
18196	0	0	28	0	0	28
18197	28	0	0	0	0	28
18198	0	29	0	0	0	29
18199	0	0	0	26	0	26
18200	0	28	0	0	0	28
18201	29	0	0	0	0	29
18202	0	0	0	30	0	30
18203	0	27	0	0	0	27
18204	0	0	0	29	0	29
18205	0	32	0	0	0	32
18206	0	0	0	28	0	28
18207	31	0	0	0	0	31
18208	0	0	0	34	0	34
18209	0	0	33	0	0	33
18210	33	0	0	0	0	33
18211	0	0	0	34	0	34
18212	0	1	31	0	0	32
18213	1	0	33	0	0	34
18214	0	0	31	0	0	31
18215	0	0	0	31	0	31
18216	0	0	0	29	0	29
18217	0	0	1	29	0	30
18218	0	0	0	32	0	32
18219	32	0	0	0	0	32
18220	32	0	0	0	0	32
18221	28	0	0	0	0	28
18222	31	0	0	0	0	31
18223	0	0	0	27	0	27
18224	0	0	28	0	0	28
18225	29	0	0	0	0	29
18226	29	0	0	0	0	29
18227	0	0	0	28	0	28
18228	0	0	0	29	0	29
18229	31	0	0	0	0	31
18230	0	0	0	28	0	28
18231	0	30	0	0	0	30
18232	30	0	0	0	0	30
18233	31	0	0	0	0	31
18234	0	0	35	0	0	35
18235	0	0	0	35	0	35
18236	0	0	0	37	0	37
18237	37	0	0	0	0	37
18238	36	0	0	0	0	36
18239	0	0	0	41	0	41
18240	0	0	42	0	0	42
18241	0	0	41	0	0	41
18242	0	0	0	42	0	42
18243	0	0	0	43	0	43
18244	43	0	0	0	0	43
18245	0	38	0	0	0	38
18246	0	35	0	0	0	35
18247	0	40	0	0	0	40
18248	0	0	0	42	0	42
18249	40	0	0	0	0	40
18250	41	0	0	0	0	41
18251	0	39	0	0	0	39
18252	42	0	0	0	0	42
18253	0	0	0	41	0	41
18254	0	0	37	0	0	37
18255	0	0	0	41	0	41
18256	0	0	0	40	0	40
18257	0	0	0	43	0	43
18258	40	0	0	0	0	40
18259	0	0	0	39	0	39
18260	0	40	0	0	0	40
18261	40	0	0	0	0	40
18262	0	40	0	0	0	40
18263	0	43	0	0	0	43
18264	0	42	0	0	0	42
18265	0	0	45	0	0	45
18266	0	46	0	0	0	46
18267	0	0	50	0	0	50
18268	51	0	0	0	0	51
18269	56	0	0	0	0	56
18270	0	0	55	0	0	55
18271	56	0	0	0	0	56
18272	56	0	0	0	0	56
18273	0	0	54	0	0	54
18274	0	56	0	0	0	56
18275	0	0	0	56	0	56
18276	56	0	0	0	0	56
18277	0	0	0	55	0	55
18278	56	0	0	0	0	56
18279	54	0	0	0	0	54
18280	0	0	54	0	0	54
18281	55	0	0	0	0	55
18282	0	54	0	0	0	54
18283	56	0	0	0	0	56
18284	0	0	0	55	0	55
18285	0	0	54	0	0	54
18286	0	0	0	54	0	54
18287	48	0	0	1	0	49
18288	0	53	0	0	0	53
18289	0	0	51	0	0	51
18290	0	0	0	51	0	51
18291	0	0	52	0	0	52
18292	0	58	0	0	0	58
18293	61	0	0	0	0	61
18294	0	0	0	61	0	61
18295	0	0	60	0	0	60
18296	0	0	56	0	0	56
18297	62	0	0	0	0	62
18298	0	0	1	64	0	65
18299	0	0	0	66	0	66
18300	0	0	58	0	0	58
18301	0	0	60	0	0	60
18302	0	59	0	0	0	59
18303	0	0	0	57	0	57
18304	0	0	0	60	0	60
18305	0	61	0	0	0	61
18306	0	0	57	0	0	57
18307	59	0	0	0	0	59
18308	0	0	0	60	0	60
18309	0	0	61	0	0	61
18310	0	0	0	60	0	60
18311	0	59	0	0	0	59
18312	0	0	59	0	0	59
18313	60	0	0	0	0	60
18314	0	0	61	0	0	61
18315	0	0	57	0	0	57
18316	0	0	60	0	0	60
18317	0	0	55	0	0	55
18318	0	0	0	60	0	60
18319	0	0	61	0	0	61
18320	0	0	0	57	0	57
18321	0	63	0	0	0	63
18322	62	0	0	0	0	62
18323	0	0	0	62	0	62
18324	0	0	61	0	0	61
18325	0	61	0	0	0	61
18326	0	0	0	61	0	61
18327	52	0	0	0	0	52
18328	0	52	0	0	0	52
18329	0	0	0	56	0	56
18330	56	0	0	0	0	56
18331	0	0	54	0	0	54
18332	49	0	0	0	0	49
18333	0	0	50	0	0	50
18334	48	0	0	0	0	48
18335	48	0	0	0	0	48
18336	0	0	46	0	0	46
18337	0	50	0	0	0	50
18338	0	0	0	49	0	49
18339	0	0	51	0	0	51
18340	0	0	0	51	0	51
18341	0	0	0	51	0	51
18342	0	0	50	0	0	50
18343	0	0	51	0	0	51
18344	0	0	0	45	0	45
18345	48	0	0	0	0	48
18346	0	45	0	0	0	45
18347	0	49	0	0	0	49
18348	51	0	0	0	0	51
18349	49	0	0	0	0	49
18350	0	0	0	47	0	47
18351	0	0	0	47	0	47
18352	0	0	0	46	0	46
18353	43	0	0	0	0	43
18354	0	40	0	0	0	40
18355	0	40	0	0	0	40
18356	0	0	0	46	0	46
18357	0	0	0	45	0	45
18358	0	0	0	45	0	45
18359	39	0	0	1	0	40
18360	0	38	0	0	0	38
18361	40	0	5	0	0	45
18362	0	0	44	0	0	44
18363	0	45	0	0	0	45
18364	0	0	0	47	0	47
18365	46	0	0	0	0	46
18366	0	5	37	0	0	42
18367	1	0	38	0	0	39
18368	0	0	0	43	0	43
18369	0	0	0	43	0	43
18370	0	0	0	41	0	41
18371	0	0	0	42	0	42
18372	0	0	0	43	0	43
18373	0	43	0	0	0	43
18374	0	0	0	47	0	47
18375	47	0	0	0	0	47
18376	0	46	0	0	0	46
18377	45	0	0	0	0	45
18378	0	0	47	0	0	47
18379	0	0	46	0	0	46
18380	0	0	0	47	0	47
18381	0	0	46	0	0	46
18382	0	0	0	44	0	44
18383	0	0	0	47	0	47
18384	48	0	0	0	0	48
18385	40	0	0	0	0	40
18386	0	41	0	0	0	41
18387	0	44	0	0	0	44
18388	0	0	0	45	0	45
18389	45	0	0	0	0	45
18390	0	0	44	0	0	44
18391	0	0	0	40	0	40
18392	0	0	0	41	0	41
18393	0	0	39	0	0	39
18394	0	39	0	0	0	39
18395	0	0	0	41	0	41
18396	0	0	40	0	0	40
18397	0	0	0	42	0	42
18398	37	0	0	0	0	37
18399	0	37	0	0	0	37
18400	0	38	0	0	0	38
18401	0	0	0	40	0	40
18402	39	0	0	0	0	39
18403	0	41	0	0	0	41
18404	43	0	0	0	0	43
18405	0	0	42	0	0	42
18406	0	0	41	0	0	41
18407	0	0	0	42	0	42
18408	1	0	0	43	0	44
18409	44	0	0	0	0	44
18410	0	0	0	44	0	44
18411	0	0	40	0	0	40
18412	0	0	0	37	0	37
18413	0	0	0	38	0	38
18414	0	0	35	0	0	35
18415	36	0	0	0	0	36
18416	0	0	0	36	0	36
18417	33	0	0	0	0	33
18418	0	34	0	0	0	34
18419	33	0	2	0	0	35
18420	0	34	0	0	0	34
18421	0	32	0	0	0	32
18422	0	0	0	34	0	34
18423	34	0	0	0	0	34
18424	39	0	0	0	0	39
18425	0	0	0	38	0	38
18426	37	0	0	0	0	37
18427	39	0	0	0	0	39
18428	0	0	0	40	0	40
18429	41	0	0	0	0	41
18430	0	42	0	0	0	42
18431	41	0	0	0	0	41
18432	0	0	35	0	0	35
18433	41	0	0	0	0	41
18434	0	0	0	39	0	39
18435	0	0	0	40	0	40
18436	0	0	0	41	0	41
18437	0	0	0	42	0	42
18438	0	0	0	43	0	43
18439	0	41	0	0	0	41
18440	0	43	0	0	0	43
18441	37	0	0	0	0	37
18442	0	0	38	0	0	38
18443	38	0	0	0	0	38
18444	0	0	40	0	0	40
18445	0	0	0	40	0	40
18446	0	0	0	40	0	40
18447	41	0	0	0	0	41
18448	0	0	37	0	0	37
18449	0	0	0	38	0	38
18450	0	0	36	0	0	36
18451	0	41	0	0	0	41
18452	0	0	0	43	0	43
18453	44	0	0	0	0	44
18454	38	0	0	0	0	38
18455	38	0	0	0	0	38
18456	0	37	0	0	0	37
18457	0	36	0	0	0	36
18458	35	0	0	0	0	35
18459	0	35	0	0	0	35
18460	0	32	0	0	0	32
18461	0	0	33	0	0	33
18462	0	32	0	0	0	32
18463	0	39	0	0	0	39
18464	0	0	0	38	0	38
18465	0	0	33	0	0	33
18466	0	0	32	0	0	32
18467	35	0	0	1	0	36
18468	0	0	34	0	0	34
18469	33	0	0	0	0	33
18470	0	0	0	30	0	30
18471	0	33	0	0	0	33
18472	33	0	0	0	0	33
18473	32	0	0	0	0	32
18474	0	0	0	41	0	41
18475	0	0	0	42	0	42
18476	0	0	0	41	0	41
18477	43	0	0	0	0	43
18478	44	0	0	0	0	44
18479	43	0	0	0	0	43
18480	0	43	0	0	0	43
18481	48	0	0	0	0	48
18482	0	50	0	0	0	50
18483	0	45	0	0	0	45
18484	0	0	0	48	0	48
18485	0	48	0	0	0	48
18486	48	0	0	0	0	48
18487	0	0	0	44	0	44
18488	49	0	0	0	0	49
18489	0	51	0	0	0	51
18490	0	50	0	0	0	50
18491	51	0	0	0	0	51
18492	0	51	0	0	0	51
18493	0	0	0	51	0	51
18494	0	0	0	49	0	49
18495	50	0	0	0	0	50
18496	0	0	0	49	0	49
18497	0	1	50	0	0	51
18498	1	0	0	48	0	49
18499	48	0	0	0	0	48
18500	0	51	0	0	0	51
18501	51	0	0	0	0	51
18502	50	0	0	0	0	50
18503	53	0	0	0	0	53
18504	0	0	57	0	0	57
18505	0	0	52	0	0	52
18506	55	0	0	1	0	56
18507	0	57	0	0	0	57
18508	0	0	0	57	0	57
18509	0	0	0	56	0	56
18510	0	58	0	0	0	58
18511	0	58	0	0	0	58
18512	0	0	0	59	0	59
18513	0	0	0	57	0	57
18514	0	0	52	0	0	52
18515	0	0	47	0	0	47
18516	55	0	0	0	0	55
18517	50	0	0	0	0	50
18518	0	0	0	50	0	50
18519	0	0	53	0	0	53
18520	0	0	0	54	0	54
18521	53	0	0	0	0	53
18522	0	0	52	0	0	52
18523	0	0	0	55	0	55
18524	0	0	53	0	0	53
18525	0	53	0	0	0	53
18526	0	2	51	0	0	53
18527	0	0	2	52	0	54
18528	52	0	0	0	0	52
18529	0	0	0	53	0	53
18530	55	0	0	0	0	55
18531	56	0	0	0	0	56
18532	53	0	0	0	0	53
18533	0	0	52	0	0	52
18534	54	0	0	0	0	54
18535	0	0	0	54	0	54
18536	0	0	0	54	0	54
18537	0	0	52	0	0	52
18538	0	0	0	51	0	51
18539	52	0	0	0	0	52
18540	0	55	0	0	0	55
18541	53	0	0	0	0	53
18542	54	0	0	0	0	54
18543	54	0	0	1	0	55
18544	0	0	0	47	0	47
18545	0	0	52	0	0	52
18546	0	0	0	48	0	48
18547	1	0	0	52	0	53
18548	53	0	0	0	0	53
18549	53	0	0	0	0	53
18550	0	0	46	0	0	46
18551	0	0	0	50	0	50
18552	0	0	50	0	0	50
18553	51	0	0	0	0	51
18554	0	50	0	0	0	50
18555	50	0	0	0	0	50
18556	0	50	0	0	0	50
18557	52	0	0	0	0	52
18558	0	57	0	0	0	57
18559	0	0	0	56	0	56
18560	0	0	0	57	0	57
18561	57	0	0	1	0	58
18562	60	0	0	0	0	60
18563	59	0	0	0	0	59
18564	56	0	0	0	0	56
18565	59	0	0	1	0	60
18566	0	0	0	62	0	62
18567	1	58	0	0	0	59
18568	0	0	0	56	0	56
18569	0	64	0	0	0	64
18570	0	0	0	65	0	65
18571	0	65	0	0	0	65
18572	0	0	0	65	0	65
18573	0	0	64	0	0	64
18574	53	0	0	0	0	53
18575	0	53	0	0	0	53
18576	53	0	0	0	0	53
18577	0	0	54	0	0	54
18578	51	0	0	0	0	51
18579	0	0	52	0	0	52
18580	0	0	0	55	0	55
18581	0	49	0	0	0	49
18582	0	0	51	0	0	51
18583	0	0	0	48	0	48
18584	48	0	0	1	0	49
18585	0	0	0	49	0	49
18586	0	0	0	51	0	51
18587	0	0	0	51	0	51
18588	0	0	51	0	0	51
18589	0	0	0	50	0	50
18590	0	45	0	0	0	45
18591	1	0	0	51	0	52
18592	0	0	0	58	0	58
18593	60	1	0	0	0	61
18594	0	0	0	64	0	64
18595	0	0	61	0	0	61
18596	0	0	60	0	0	60
18597	0	0	61	0	0	61
18598	0	59	0	0	0	59
18599	62	0	0	0	0	62
18600	0	59	0	0	0	59
18601	60	0	1	0	0	61
18602	0	0	0	62	0	62
18603	0	0	59	0	0	59
18604	0	0	61	0	0	61
18605	0	57	0	0	0	57
18606	0	0	0	58	0	58
18607	0	0	0	58	0	58
18608	0	0	0	61	0	61
18609	0	0	60	0	0	60
18610	59	0	0	0	0	59
18611	0	0	58	0	0	58
18612	0	0	0	58	0	58
18613	0	0	0	57	0	57
18614	0	0	57	0	0	57
18615	51	0	0	1	0	52
18616	0	55	0	0	0	55
18617	56	0	0	0	0	56
18618	0	0	0	57	0	57
18619	0	57	0	0	0	57
18620	0	0	0	55	0	55
18621	56	0	0	0	0	56
18622	0	0	0	54	0	54
18623	0	0	54	0	0	54
18624	55	0	0	0	0	55
18625	51	0	0	0	0	51
18626	0	0	55	0	0	55
18627	0	0	0	52	0	52
18628	52	0	0	0	0	52
18629	0	0	0	53	0	53
18630	0	0	0	51	0	51
18631	0	0	0	51	0	51
18632	0	0	0	56	0	56
18633	0	0	52	0	0	52
18634	0	0	0	56	0	56
18635	0	0	55	0	0	55
18636	53	0	0	0	0	53
18637	56	0	0	0	0	56
18638	54	0	0	0	0	54
18639	53	0	0	0	0	53
18640	0	0	0	51	0	51
18641	56	0	0	0	0	56
18642	0	0	57	0	0	57
18643	0	0	54	0	0	54
18644	55	0	0	0	0	55
18645	0	52	0	1	0	53
18646	0	55	0	0	0	55
18647	0	0	0	58	0	58
18648	0	0	55	0	0	55
18649	50	0	0	0	0	50
18650	0	0	50	0	0	50
18651	0	48	0	0	0	48
18652	0	0	48	0	0	48
18653	0	48	0	0	0	48
18654	49	0	0	0	0	49
18655	0	42	0	0	0	42
18656	0	45	0	0	0	45
18657	0	0	0	45	0	45
18658	0	0	45	0	0	45
18659	0	0	0	39	0	39
18660	0	0	0	44	0	44
18661	0	0	42	0	0	42
18662	0	0	0	33	0	33
18663	0	32	0	0	0	32
18664	0	0	0	36	0	36
18665	37	0	0	0	0	37
18666	0	0	0	35	0	35
18667	0	0	38	0	0	38
18668	0	0	0	34	0	34
18669	0	0	36	0	0	36
18670	37	0	0	0	0	37
18671	0	0	0	36	0	36
18672	40	0	0	0	0	40
18673	0	0	39	0	0	39
18674	40	0	0	0	0	40
18675	0	39	0	1	0	40
18676	0	0	28	0	0	28
18677	0	0	0	32	0	32
18678	0	0	30	0	0	30
18679	0	30	0	0	0	30
18680	0	31	0	0	0	31
18681	33	0	0	0	0	33
18682	0	33	0	0	0	33
18683	37	0	0	0	0	37
18684	0	0	0	37	0	37
18685	0	0	37	0	0	37
18686	0	41	0	0	0	41
18687	0	0	0	40	0	40
18688	0	0	0	38	0	38
18689	0	0	0	38	0	38
18690	0	0	0	36	0	36
18691	0	37	0	0	0	37
18692	0	36	0	0	0	36
18693	35	0	0	0	0	35
18694	0	39	0	0	0	39
18695	0	0	0	39	0	39
18696	0	0	38	0	0	38
18697	0	38	0	0	0	38
18698	0	0	0	39	0	39
18699	0	0	0	41	0	41
18700	0	41	0	0	0	41
18701	43	0	0	0	0	43
18702	0	0	39	0	0	39
18703	43	0	0	0	0	43
18704	0	44	0	0	0	44
18705	47	0	0	0	0	47
18706	0	47	0	0	0	47
18707	0	0	0	48	0	48
18708	0	0	0	46	0	46
18709	46	0	0	0	0	46
18710	0	0	0	49	0	49
18711	0	0	50	0	0	50
18712	0	49	0	0	0	49
18713	0	49	0	0	0	49
18714	0	0	0	50	0	50
18715	0	0	50	0	0	50
18716	0	0	0	45	0	45
18717	1	0	0	47	0	48
18718	0	0	48	0	0	48
18719	0	0	41	0	0	41
18720	0	51	0	0	0	51
18721	54	0	0	0	0	54
18722	0	0	0	54	0	54
18723	0	52	0	0	0	52
18724	54	0	0	0	0	54
18725	0	0	0	52	0	52
18726	0	0	0	50	0	50
18727	0	47	0	0	0	47
18728	0	0	0	48	0	48
18729	45	0	0	1	0	46
18730	0	0	0	46	0	46
18731	0	0	0	47	0	47
18732	0	0	45	0	0	45
18733	1	0	41	0	0	42
18734	44	0	0	0	0	44
18735	0	0	0	43	0	43
18736	0	0	0	44	0	44
18737	0	0	0	43	0	43
18738	0	0	35	0	0	35
18739	41	0	0	0	0	41
18740	0	0	0	43	0	43
18741	0	0	0	44	0	44
18742	42	0	0	0	0	42
18743	0	43	0	0	0	43
18744	0	0	42	0	0	42
18745	0	0	0	43	0	43
18746	0	42	0	0	0	42
18747	0	0	0	43	0	43
18748	44	0	0	0	0	44
18749	0	0	0	43	0	43
18750	44	0	0	0	0	44
18751	41	0	0	0	0	41
18752	1	0	0	46	0	47
18753	0	44	0	0	0	44
18754	0	44	0	0	0	44
18755	0	0	44	0	0	44
18756	0	0	0	45	0	45
18757	0	0	0	43	0	43
18758	0	0	0	45	0	45
18759	44	0	0	0	0	44
18760	0	0	0	42	0	42
18761	0	0	42	0	0	42
18762	42	0	0	0	0	42
18763	0	0	0	41	0	41
18764	0	0	0	42	0	42
18765	0	0	41	0	0	41
18766	43	0	0	0	0	43
18767	0	0	0	42	0	42
18768	0	0	44	0	0	44
18769	1	0	0	43	0	44
18770	0	0	0	47	0	47
18771	0	46	0	1	0	47
18772	46	0	0	0	0	46
18773	43	0	0	0	0	43
18774	0	44	0	0	0	44
18775	42	0	0	0	0	42
18776	42	0	0	0	0	42
18777	0	0	0	41	0	41
18778	0	0	40	0	0	40
18779	0	0	30	0	0	30
18780	0	0	29	0	0	29
18781	0	0	33	0	0	33
18782	0	0	0	33	0	33
18783	0	0	0	34	0	34
18784	0	0	0	36	0	36
18785	0	0	0	35	0	35
18786	36	0	0	0	0	36
18787	0	39	0	0	0	39
18788	39	0	0	0	0	39
18789	0	0	39	0	0	39
18790	0	0	45	0	0	45
18791	0	0	0	43	0	43
18792	45	0	0	0	0	45
18793	43	0	2	0	0	45
18794	1	45	0	0	0	46
18795	0	46	0	0	0	46
18796	0	0	0	50	0	50
18797	52	0	0	0	0	52
18798	0	49	0	0	0	49
18799	50	0	0	0	0	50
18800	55	0	0	0	0	55
18801	55	0	0	0	0	55
18802	0	0	59	0	0	59
18803	1	57	0	0	0	58
18804	55	0	0	0	0	55
18805	53	0	0	0	0	53
18806	0	55	0	0	0	55
18807	0	57	0	0	0	57
18808	59	0	0	0	0	59
18809	0	0	0	57	0	57
18810	0	0	59	0	0	59
18811	59	0	0	0	0	59
18812	0	0	0	60	0	60
18813	0	60	0	0	0	60
18814	0	0	0	59	0	59
18815	0	0	61	0	0	61
18816	0	0	0	57	0	57
18817	57	0	0	0	0	57
18818	0	0	0	60	0	60
18819	0	0	0	59	0	59
18820	0	0	60	0	0	60
18821	0	0	0	60	0	60
18822	0	62	0	0	0	62
18823	58	0	0	0	0	58
18824	59	0	0	0	0	59
18825	0	0	61	0	0	61
18826	0	0	0	57	0	57
18827	0	53	0	0	0	53
18828	0	60	0	0	0	60
18829	62	0	0	0	0	62
18830	0	0	0	63	0	63
18831	0	0	63	0	0	63
18832	0	0	59	0	0	59
18833	0	0	0	64	0	64
18834	65	0	0	0	0	65
18835	65	0	0	0	0	65
18836	0	0	0	69	0	69
18837	0	0	71	0	0	71
18838	0	73	0	0	0	73
18839	71	0	0	1	0	72
18840	0	73	0	0	0	73
18841	76	0	0	0	0	76
18842	0	0	0	73	0	73
18843	0	0	77	0	0	77
18844	0	1	0	77	0	78
18845	77	0	0	0	0	77
18846	0	0	78	0	0	78
18847	0	77	0	0	0	77
18848	0	0	0	81	0	81
18849	81	0	0	0	0	81
18850	0	0	83	0	0	83
18851	0	0	0	83	0	83
18852	0	0	0	85	0	85
18853	0	0	92	0	0	92
18854	0	0	1	91	0	92
18855	0	0	91	0	0	91
18856	93	0	0	0	0	93
18857	0	0	0	93	0	93
18858	0	0	98	0	0	98
18859	0	98	0	0	0	98
18860	100	0	0	0	0	100
18861	100	0	0	0	0	100
18862	0	0	0	99	0	99
18863	0	97	0	0	0	97
18864	95	0	0	0	0	95
18865	0	0	0	99	0	99
18866	0	0	100	0	0	100
18867	99	0	0	0	0	99
18868	0	103	0	0	0	103
18869	0	0	0	105	0	105
18870	104	0	0	0	0	104
18871	0	1	104	0	0	105
18872	0	0	105	0	0	105
18873	0	0	0	106	0	106
18874	0	0	111	0	0	111
18875	0	0	0	108	0	108
18876	0	115	0	0	0	115
18877	0	0	0	114	0	114
18878	123	0	0	0	0	123
18879	0	1	113	0	0	114
18880	0	110	0	0	0	110
18881	0	1	0	115	0	116
18882	0	0	112	0	0	112
18883	0	0	0	113	0	113
18884	0	108	0	1	0	109
18885	0	103	0	0	0	103
18886	104	0	0	0	0	104
18887	0	113	0	0	0	113
18888	0	0	103	0	0	103
18889	109	0	0	0	0	109
18890	0	0	106	0	0	106
18891	0	0	0	103	0	103
18892	0	0	96	0	0	96
18893	0	91	0	0	0	91
18894	0	0	0	100	0	100
18895	0	0	0	97	0	97
18896	0	0	0	94	0	94
18897	0	0	95	0	0	95
18898	0	0	0	95	0	95
18899	0	0	0	94	0	94
18900	95	0	0	0	0	95
18901	96	0	0	0	0	96
18902	0	0	95	0	0	95
18903	0	89	0	0	0	89
18904	0	0	92	0	0	92
18905	0	0	0	96	0	96
18906	0	0	94	0	0	94
18907	0	0	0	93	0	93
18908	0	0	0	96	0	96
18909	0	0	94	0	0	94
18910	92	0	0	0	0	92
18911	0	94	1	0	0	95
18912	0	0	0	96	0	96
18913	0	0	92	0	0	92
18914	0	0	92	0	0	92
18915	92	0	0	1	0	93
18916	0	91	0	0	0	91
18917	0	0	0	94	0	94
18918	96	0	0	1	0	97
18919	0	0	0	98	0	98
18920	0	0	0	98	0	98
18921	0	0	98	0	0	98
18922	97	0	0	0	0	97
18923	95	0	0	0	0	95
18924	0	0	0	94	0	94
18925	94	0	0	0	0	94
18926	0	0	0	94	0	94
18927	0	85	0	0	0	85
18928	0	94	0	0	0	94
18929	0	0	0	97	0	97
18930	96	0	0	0	0	96
18931	0	0	0	94	0	94
18932	94	0	0	0	0	94
18933	90	0	0	0	0	90
18934	0	0	0	92	0	92
18935	1	0	0	91	0	92
18936	0	0	89	0	0	89
18937	0	0	85	1	0	86
18938	0	0	0	94	0	94
18939	0	0	90	0	0	90
18940	93	0	0	0	0	93
18941	0	0	0	93	0	93
18942	0	0	90	0	0	90
18943	102	0	0	0	0	102
18944	97	0	0	0	0	97
18945	0	104	0	0	0	104
18946	0	0	0	98	0	98
18947	0	0	105	0	0	105
18948	108	0	0	0	0	108
18949	108	0	0	0	0	108
18950	0	0	108	0	0	108
18951	106	0	0	0	0	106
18952	0	0	0	106	0	106
18953	0	0	0	108	0	108
18954	111	0	0	0	0	111
18955	113	0	0	0	0	113
18956	0	0	0	110	0	110
18957	0	0	119	0	0	119
18958	0	105	0	0	0	105
18959	0	0	113	0	0	113
18960	1	0	103	0	0	104
18961	0	110	0	0	0	110
18962	1	0	0	115	0	116
18963	0	0	0	119	0	119
18964	0	0	112	0	0	112
18965	0	1	0	108	0	109
18966	114	0	0	0	0	114
18967	0	0	107	0	0	107
18968	113	0	0	0	0	113
18969	108	0	0	0	0	108
18970	109	0	0	0	0	109
18971	0	0	102	0	0	102
18972	0	0	104	0	0	104
18973	0	0	0	105	0	105
18974	0	0	0	105	0	105
18975	0	107	0	0	0	107
18976	110	0	0	0	0	110
18977	105	0	0	0	0	105
18978	0	105	0	0	0	105
18979	106	0	0	0	0	106
18980	0	103	0	2	0	105
18981	105	0	0	0	0	105
18982	0	0	0	105	0	105
18983	0	0	103	0	0	103
18984	0	1	101	0	0	102
18985	0	0	0	106	0	106
18986	0	0	0	105	0	105
18987	0	0	102	0	0	102
18988	0	0	0	104	0	104
18989	1	0	0	101	0	102
18990	105	0	0	0	0	105
18991	103	0	0	0	0	103
18992	102	0	0	0	0	102
18993	0	0	98	0	0	98
18994	0	101	0	0	0	101
18995	0	0	0	103	0	103
18996	0	0	100	0	0	100
18997	0	102	0	0	0	102
18998	102	0	0	0	0	102
18999	0	0	0	101	0	101
19000	0	0	0	101	0	101
19001	111	0	0	0	0	111
19002	0	0	0	111	0	111
19003	0	0	0	111	0	111
19004	113	0	0	0	0	113
19005	0	0	106	2	0	108
19006	0	110	0	0	0	110
19007	110	0	0	0	0	110
19008	0	0	110	0	0	110
19009	107	0	0	1	0	108
19010	0	113	0	0	0	113
19011	113	0	0	0	0	113
19012	109	0	0	0	0	109
19013	108	0	0	0	0	108
19014	0	0	0	108	0	108
19015	1	0	0	109	0	110
19016	0	106	0	0	0	106
19017	0	103	0	1	0	104
19018	0	106	0	0	0	106
19019	112	0	0	0	0	112
19020	0	0	109	0	0	109
19021	0	0	0	102	0	102
19022	0	0	0	104	0	104
19023	0	106	1	0	0	107
19024	0	0	0	105	0	105
19025	0	0	0	101	0	101
19026	0	107	0	0	0	107
19027	106	0	0	0	0	106
19028	0	103	0	0	0	103
19029	0	0	102	0	0	102
19030	103	0	0	0	0	103
19031	0	103	0	0	0	103
19032	100	0	0	0	0	100
19033	0	0	0	101	0	101
19034	0	0	0	108	0	108
19035	0	0	110	0	0	110
19036	0	0	110	0	0	110
19037	0	0	0	116	0	116
19038	117	0	0	0	0	117
19039	127	0	0	0	0	127
19040	0	117	0	0	0	117
19041	1	115	0	0	0	116
19042	1	118	0	0	0	119
19043	0	0	0	120	0	120
19044	129	0	0	0	0	129
19045	137	0	0	0	0	137
19046	137	0	0	0	0	137
19047	0	0	142	0	0	142
19048	0	142	0	0	0	142
19049	0	0	0	142	0	142
19050	140	0	0	0	0	140
19051	0	0	0	139	0	139
19052	0	0	0	137	0	137
19053	137	0	0	0	0	137
19054	141	0	0	0	0	141
19055	0	0	142	0	0	142
19056	0	0	0	139	0	139
19057	0	0	142	0	0	142
19058	0	0	0	142	0	142
19059	0	0	143	0	0	143
19060	0	0	0	145	0	145
19061	139	0	0	1	0	140
19062	0	145	0	0	0	145
19063	0	145	0	0	0	145
19064	0	0	0	141	0	141
19065	0	141	0	0	0	141
19066	142	0	0	0	0	142
19067	143	0	0	0	0	143
19068	0	0	140	0	0	140
19069	1	141	0	0	0	142
19070	0	0	0	149	0	149
19071	0	0	146	0	0	146
19072	147	0	0	0	0	147
19073	0	0	0	146	0	146
19074	0	0	149	0	0	149
19075	0	0	0	148	0	148
19076	150	0	0	0	0	150
19077	0	0	145	0	0	145
19078	146	0	0	0	0	146
19079	145	0	0	0	0	145
19080	0	0	0	146	0	146
19081	0	0	144	0	0	144
19082	0	0	145	0	0	145
19083	138	0	0	0	0	138
19084	144	0	0	1	0	145
19085	0	0	149	0	0	149
19086	0	0	0	144	0	144
19087	0	0	0	146	0	146
19088	0	140	0	0	0	140
19089	0	0	0	150	0	150
19090	152	0	0	0	0	152
19091	0	0	0	152	0	152
19092	0	0	151	0	0	151
19093	150	1	0	0	0	151
19094	0	0	1	137	0	138
19095	0	0	151	0	0	151
19096	0	148	0	0	0	148
19097	147	0	0	1	0	148
19098	0	149	0	0	0	149
19099	134	0	0	0	0	134
19100	0	0	134	0	0	134
19101	0	126	0	1	0	127
19102	0	133	0	0	0	133
19103	0	0	0	139	0	139
19104	0	0	0	141	0	141
19105	0	0	143	0	0	143
19106	0	0	0	144	0	144
19107	148	0	0	0	0	148
19108	0	0	143	0	0	143
19109	0	0	0	134	0	134
19110	0	0	139	0	0	139
19111	139	0	0	0	0	139
19112	0	132	0	0	0	132
19113	142	0	0	0	0	142
19114	132	0	0	0	0	132
19115	143	0	0	0	0	143
19116	0	0	136	0	0	136
19117	0	134	0	0	0	134
19118	0	0	0	140	0	140
19119	0	0	0	135	0	135
19120	141	0	0	0	0	141
19121	0	0	0	136	0	136
19122	138	0	0	0	0	138
19123	132	0	0	1	0	133
19124	132	0	0	0	0	132
19125	132	1	0	0	0	133
19126	1	0	0	140	0	141
19127	131	0	0	0	0	131
19128	0	0	119	0	0	119
19129	115	0	0	0	0	115
19130	111	0	0	0	0	111
19131	0	0	105	1	0	106
19132	96	0	0	0	0	96
19133	102	0	0	0	0	102
19134	0	0	0	103	0	103
19135	0	0	0	100	0	100
19136	95	1	0	0	0	96
19137	0	0	0	75	0	75
19138	0	0	0	75	0	75
19139	0	69	0	0	0	69
19140	0	0	0	61	0	61
19141	65	0	0	0	0	65
19142	0	0	0	64	0	64
19143	0	0	0	68	0	68
19144	0	58	0	0	0	58
19145	0	0	0	60	0	60
19146	0	0	0	63	0	63
19147	59	0	0	0	0	59
19148	0	2	6	52	0	60
19149	0	0	59	0	0	59
19150	0	48	2	0	0	50
19151	0	47	0	6	0	53
19152	59	0	0	0	0	59
19153	0	60	0	0	0	60
19154	52	1	0	0	0	53
19155	0	55	0	0	0	55
19156	56	0	0	0	0	56
19157	0	0	0	53	0	53
19158	1	0	0	51	0	52
19159	0	54	0	0	0	54
19160	0	0	0	54	0	54
19161	0	0	54	0	0	54
19162	54	0	0	0	0	54
19163	0	53	0	0	0	53
19164	54	0	0	0	0	54
19165	55	0	0	0	0	55
19166	55	0	0	0	0	55
19167	0	0	0	54	0	54
19168	0	0	0	49	0	49
19169	0	54	0	0	0	54
19170	54	0	0	0	0	54
19171	0	54	0	0	0	54
19172	55	0	0	0	0	55
19173	0	0	56	0	0	56
19174	55	0	0	0	0	55
19175	0	0	0	52	0	52
19176	0	0	54	0	0	54
19177	0	0	52	0	0	52
19178	0	0	0	51	0	51
19179	0	0	50	0	0	50
19180	0	0	0	52	0	52
19181	52	0	0	0	0	52
19182	0	0	0	53	0	53
19183	0	0	48	0	0	48
19184	0	41	0	0	0	41
19185	0	48	0	0	0	48
19186	0	0	0	47	0	47
19187	44	0	0	0	0	44
19188	0	0	0	42	0	42
19189	0	0	0	41	0	41
19190	0	0	0	41	0	41
19191	0	0	0	40	0	40
19192	0	0	44	0	0	44
19193	0	0	43	0	0	43
19194	43	0	0	0	0	43
19195	43	0	0	0	0	43
19196	0	0	0	41	0	41
19197	0	0	0	43	0	43
19198	0	0	44	0	0	44
19199	0	38	0	0	0	38
19200	41	0	0	0	0	41
19201	41	0	0	0	0	41
19202	0	0	0	41	0	41
19203	0	5	32	0	0	37
19204	0	0	0	37	0	37
19205	0	35	0	0	0	35
19206	0	0	37	0	0	37
19207	38	0	0	0	0	38
19208	0	0	0	41	0	41
19209	41	0	0	0	0	41
19210	0	0	40	0	0	40
19211	40	0	0	0	0	40
19212	0	0	0	40	0	40
19213	38	0	0	0	0	38
19214	0	0	0	40	0	40
19215	0	38	0	0	0	38
19216	0	40	0	0	0	40
19217	0	0	0	39	0	39
19218	0	0	38	0	0	38
19219	0	35	0	0	0	35
19220	0	0	0	39	0	39
19221	33	0	0	0	0	33
19222	36	0	0	0	0	36
19223	0	0	0	39	0	39
19224	0	0	0	39	0	39
19225	0	31	0	1	0	32
19226	0	40	0	0	0	40
19227	40	0	0	0	0	40
19228	0	0	0	38	0	38
19229	0	0	0	37	0	37
19230	0	0	39	0	0	39
19231	0	0	0	39	0	39
19232	0	0	0	38	0	38
19233	0	0	0	37	0	37
19234	0	0	35	0	0	35
19235	0	0	0	36	0	36
19236	33	0	0	0	0	33
19237	0	0	33	0	0	33
19238	36	0	0	0	0	36
19239	0	0	0	34	0	34
19240	0	0	0	35	0	35
19241	0	0	0	35	0	35
19242	0	0	36	0	0	36
19243	34	0	0	0	0	34
19244	0	32	0	0	0	32
19245	31	0	0	0	0	31
19246	0	32	0	0	0	32
19247	0	0	0	32	0	32
19248	31	0	0	0	0	31
19249	0	0	30	0	0	30
19250	29	0	0	0	0	29
19251	0	0	30	0	0	30
19252	0	0	0	30	0	30
19253	0	0	30	0	0	30
19254	0	27	0	0	0	27
19255	0	0	0	28	0	28
19256	26	0	0	0	0	26
19257	0	0	0	29	0	29
19258	0	27	0	0	0	27
19259	0	0	0	29	0	29
19260	28	0	0	0	0	28
19261	27	0	0	0	0	27
19262	0	27	0	0	0	27
19263	0	26	0	0	0	26
19264	0	0	0	27	0	27
19265	0	0	0	28	0	28
19266	27	0	0	1	0	28
19267	24	1	0	0	0	25
19268	0	28	0	0	0	28
19269	0	0	0	27	0	27
19270	0	0	0	28	0	28
19271	0	0	28	0	0	28
19272	0	23	0	0	0	23
19273	0	27	0	0	0	27
19274	0	0	0	28	0	28
19275	0	0	27	0	0	27
19276	0	0	28	0	0	28
19277	0	0	0	30	0	30
19278	0	0	0	31	0	31
19279	0	0	32	0	0	32
19280	0	0	0	33	0	33
19281	0	0	34	0	0	34
19282	32	0	0	0	0	32
19283	0	0	0	33	0	33
19284	1	0	29	0	0	30
19285	0	0	29	0	0	29
19286	0	0	0	29	0	29
19287	0	0	32	0	0	32
19288	1	0	30	0	0	31
19289	0	29	0	0	0	29
19290	34	0	0	0	0	34
19291	0	0	31	0	0	31
19292	0	0	0	32	0	32
19293	0	0	0	30	0	30
19294	0	0	0	32	0	32
19295	0	0	33	0	0	33
19296	0	0	0	28	0	28
19297	31	0	0	0	0	31
19298	0	0	0	29	0	29
19299	0	0	30	0	0	30
19300	0	0	0	30	0	30
19301	25	0	0	0	0	25
19302	26	0	0	0	0	26
19303	24	0	0	0	0	24
19304	0	0	0	26	0	26
19305	27	0	0	0	0	27
19306	25	0	0	0	0	25
19307	25	0	0	0	0	25
19308	0	24	0	0	0	24
19309	25	0	0	0	0	25
19310	0	0	0	26	0	26
19311	0	0	22	0	0	22
19312	0	22	0	0	0	22
19313	22	0	0	0	0	22
19314	0	0	0	23	0	23
19315	0	0	0	23	0	23
19316	1	21	0	0	0	22
19317	0	25	0	0	0	25
19318	23	0	0	0	0	23
19319	0	24	0	0	0	24
19320	24	0	0	0	0	24
19321	0	24	0	0	0	24
19322	24	0	0	0	0	24
19323	0	21	0	0	0	21
19324	0	20	0	0	0	20
19325	22	0	0	0	0	22
19326	0	0	21	0	0	21
19327	0	21	0	0	0	21
19328	0	0	0	22	0	22
19329	0	0	0	23	0	23
19330	0	0	0	23	0	23
19331	0	0	0	20	0	20
19332	0	0	21	0	0	21
19333	21	0	0	0	0	21
19334	0	0	0	20	0	20
19335	20	0	0	0	0	20
19336	19	0	0	0	0	19
19337	20	0	0	0	0	20
19338	21	0	0	0	0	21
19339	0	0	21	0	0	21
19340	0	0	0	17	0	17
19341	0	0	16	0	0	16
19342	0	19	0	0	0	19
19343	0	0	0	19	0	19
19344	0	0	0	20	0	20
19345	0	0	0	19	0	19
19346	0	0	0	17	0	17
19347	0	0	20	0	0	20
19348	0	0	0	19	0	19
19349	0	0	0	19	0	19
19350	19	0	0	0	0	19
19351	19	0	0	0	0	19
19352	0	0	0	19	0	19
19353	0	0	0	19	0	19
19354	0	0	0	18	0	18
19355	19	0	0	0	0	19
19356	21	0	0	0	0	21
19357	19	0	0	0	0	19
19358	20	0	0	0	0	20
19359	0	20	0	0	0	20
19360	21	0	0	0	0	21
19361	21	0	0	0	0	21
19362	0	0	0	22	0	22
19363	0	0	0	19	0	19
19364	22	0	0	0	0	22
19365	0	20	0	0	0	20
19366	0	20	0	0	0	20
19367	21	0	0	0	0	21
19368	0	0	0	20	0	20
19369	0	0	0	21	0	21
19370	0	0	0	21	0	21
19371	0	0	0	20	0	20
19372	0	0	0	21	0	21
19373	0	21	0	0	0	21
19374	0	0	0	20	0	20
19375	20	0	0	0	0	20
19376	0	0	0	19	0	19
19377	0	0	0	22	0	22
19378	22	0	0	0	0	22
19379	0	21	0	0	0	21
19380	0	0	0	22	0	22
19381	0	20	0	0	0	20
19382	0	0	0	21	0	21
19383	0	0	20	0	0	20
19384	19	0	0	0	0	19
19385	0	20	0	0	0	20
19386	19	0	0	0	0	19
19387	0	0	21	0	0	21
19388	0	0	0	22	0	22
19389	0	23	0	0	0	23
19390	0	18	0	0	0	18
19391	22	0	0	0	0	22
19392	0	0	0	23	0	23
19393	0	0	24	0	0	24
19394	0	0	0	25	0	25
19395	0	0	25	0	0	25
19396	22	0	0	0	0	22
19397	0	0	23	0	0	23
19398	0	0	0	23	0	23
19399	0	21	0	0	0	21
19400	0	0	0	23	0	23
19401	0	24	0	0	0	24
19402	23	0	0	1	0	24
19403	0	0	0	26	0	26
19404	0	0	27	0	0	27
19405	0	0	31	0	0	31
19406	26	0	0	0	0	26
19407	32	0	0	0	0	32
19408	32	0	0	0	0	32
19409	31	0	0	0	0	31
19410	0	30	0	0	0	30
19411	31	0	0	0	0	31
19412	32	0	0	0	0	32
19413	0	0	30	0	0	30
19414	0	0	0	29	0	29
19415	31	0	0	0	0	31
19416	0	0	30	0	0	30
19417	0	0	0	34	0	34
19418	0	0	34	0	0	34
19419	0	0	0	35	0	35
19420	0	31	0	0	0	31
19421	28	0	0	0	0	28
19422	0	0	29	0	0	29
19423	32	0	0	0	0	32
19424	0	0	0	32	0	32
19425	29	0	0	0	0	29
19426	0	0	0	32	0	32
19427	32	0	0	0	0	32
19428	0	0	32	0	0	32
19429	32	0	0	0	0	32
19430	0	0	0	34	0	34
19431	0	0	0	32	0	32
19432	34	0	0	0	0	34
19433	0	0	0	34	0	34
19434	0	0	34	0	0	34
19435	0	0	0	34	0	34
19436	34	0	1	0	0	35
19437	0	34	0	0	0	34
19438	0	34	0	0	0	34
19439	34	0	1	0	0	35
19440	0	33	0	0	0	33
19441	0	0	0	37	0	37
19442	38	0	0	0	0	38
19443	37	0	0	0	0	37
19444	38	0	0	0	0	38
19445	0	0	37	0	0	37
19446	0	0	0	33	0	33
19447	0	40	0	0	0	40
19448	0	0	0	42	0	42
19449	0	0	39	0	0	39
19450	0	39	0	0	0	39
19451	0	0	0	40	0	40
19452	40	0	0	0	0	40
19453	0	41	0	0	0	41
19454	0	0	38	0	0	38
19455	0	0	0	39	0	39
19456	0	0	40	0	0	40
19457	0	0	0	39	0	39
19458	41	0	0	0	0	41
19459	0	0	0	38	0	38
19460	43	0	0	0	0	43
19461	36	0	0	0	0	36
19462	0	43	0	0	0	43
19463	39	0	0	0	0	39
19464	0	44	0	0	0	44
19465	0	0	39	0	0	39
19466	0	0	0	40	0	40
19467	0	0	0	43	0	43
19468	0	0	44	0	0	44
19469	0	48	0	0	0	48
19470	48	0	0	0	0	48
19471	51	0	0	0	0	51
19472	0	0	0	50	0	50
19473	0	0	0	51	0	51
19474	0	0	0	53	0	53
19475	54	0	0	0	0	54
19476	0	0	53	0	0	53
19477	0	0	44	0	0	44
19478	0	0	1	52	0	53
19479	0	0	55	0	0	55
19480	0	0	51	0	0	51
19481	0	0	0	52	0	52
19482	0	0	50	0	0	50
19483	0	52	0	0	0	52
19484	0	0	0	51	0	51
19485	0	0	51	0	0	51
19486	0	0	0	45	0	45
19487	0	47	0	0	0	47
19488	0	0	0	49	0	49
19489	0	0	50	0	0	50
19490	0	0	0	50	0	50
19491	50	0	0	0	0	50
19492	0	0	48	0	0	48
19493	49	0	0	0	0	49
19494	0	50	0	0	0	50
19495	49	0	0	0	0	49
19496	0	0	1	46	0	47
19497	0	47	0	0	0	47
19498	47	0	0	0	0	47
19499	0	0	0	46	0	46
19500	0	0	44	0	0	44
19501	0	44	0	0	0	44
19502	0	0	0	45	0	45
19503	45	0	0	0	0	45
19504	45	0	0	0	0	45
19505	0	0	0	46	0	46
19506	0	0	43	0	0	43
19507	46	0	0	0	0	46
19508	0	0	46	0	0	46
19509	0	0	0	45	0	45
19510	47	0	0	0	0	47
19511	0	49	0	0	0	49
19512	52	0	0	0	0	52
19513	0	0	50	1	0	51
19514	52	0	0	0	0	52
19515	0	0	0	51	0	51
19516	0	0	0	50	0	50
19517	0	0	51	0	0	51
19518	0	0	0	53	0	53
19519	54	0	0	0	0	54
19520	0	1	0	57	0	58
19521	0	57	0	0	0	57
19522	0	0	1	57	0	58
19523	0	53	0	0	0	53
19524	0	0	54	0	0	54
19525	55	0	0	1	0	56
19526	0	0	0	56	0	56
19527	0	0	54	0	0	54
19528	0	57	0	0	0	57
19529	0	0	0	58	0	58
19530	0	0	0	56	0	56
19531	58	0	0	0	0	58
19532	1	0	0	57	0	58
19533	56	0	0	0	0	56
19534	53	0	0	0	0	53
19535	0	55	0	0	0	55
19536	58	0	0	0	0	58
19537	0	0	0	61	0	61
19538	0	0	58	0	0	58
19539	61	0	0	0	0	61
19540	0	0	0	57	0	57
19541	0	0	56	0	0	56
19542	59	0	0	0	0	59
19543	0	0	0	58	0	58
19544	0	58	0	0	0	58
19545	0	0	0	60	0	60
19546	0	55	0	0	0	55
19547	57	0	0	0	0	57
19548	0	0	53	0	0	53
19549	0	57	0	0	0	57
19550	0	0	0	57	0	57
19551	0	0	54	0	0	54
19552	0	0	52	0	0	52
19553	0	58	0	1	0	59
19554	0	0	0	62	0	62
19555	0	0	0	62	0	62
19556	0	0	0	59	0	59
19557	61	0	0	0	0	61
19558	0	0	59	0	0	59
19559	0	56	0	0	0	56
19560	0	0	0	57	0	57
19561	0	0	0	59	0	59
19562	0	0	56	0	0	56
19563	0	0	0	56	0	56
19564	0	0	50	0	0	50
19565	0	0	49	0	0	49
19566	0	0	50	0	0	50
19567	0	0	0	50	0	50
19568	0	0	0	51	0	51
19569	0	0	0	51	0	51
19570	51	0	0	0	0	51
19571	0	50	0	0	0	50
19572	53	0	0	0	0	53
19573	48	0	0	0	0	48
19574	49	0	0	0	0	49
19575	0	51	0	0	0	51
19576	52	0	0	0	0	52
19577	49	0	0	0	0	49
19578	0	0	0	52	0	52
19579	0	0	0	51	0	51
19580	0	0	0	53	0	53
19581	0	0	52	0	0	52
19582	53	0	0	0	0	53
19583	0	0	0	51	0	51
19584	53	0	0	0	0	53
19585	0	52	0	0	0	52
19586	0	0	0	53	0	53
19587	0	0	0	51	0	51
19588	54	0	0	0	0	54
19589	0	0	0	52	0	52
19590	51	0	0	0	0	51
19591	53	0	0	0	0	53
19592	0	48	0	0	0	48
19593	0	52	0	0	0	52
19594	0	0	0	53	0	53
19595	0	54	0	0	0	54
19596	0	0	0	56	0	56
19597	0	0	55	0	0	55
19598	0	0	49	0	0	49
19599	53	0	0	0	0	53
19600	51	0	0	0	0	51
19601	0	53	0	0	0	53
19602	51	0	0	0	0	51
19603	0	55	0	0	0	55
19604	0	0	0	55	0	55
19605	1	0	0	49	0	50
19606	0	0	0	54	0	54
19607	0	0	0	54	0	54
19608	54	0	0	0	0	54
19609	0	50	0	0	0	50
19610	54	0	0	0	0	54
19611	50	1	0	0	0	51
19612	0	0	49	0	0	49
19613	45	0	0	0	0	45
19614	0	50	0	0	0	50
19615	0	0	0	49	0	49
19616	0	0	0	46	0	46
19617	0	48	0	0	0	48
19618	45	0	0	0	0	45
19619	0	0	45	0	0	45
19620	45	0	0	0	0	45
19621	0	0	43	0	0	43
19622	0	0	0	40	0	40
19623	0	0	0	42	0	42
19624	0	0	0	46	0	46
19625	45	0	0	0	0	45
19626	0	0	45	0	0	45
19627	43	0	0	0	0	43
19628	41	0	0	0	0	41
19629	41	0	0	0	0	41
19630	38	0	0	0	0	38
19631	0	0	0	38	0	38
19632	0	0	41	0	0	41
19633	0	0	0	39	0	39
19634	0	0	40	0	0	40
19635	0	0	35	0	0	35
19636	0	38	0	0	0	38
19637	0	0	0	39	0	39
19638	0	0	0	38	0	38
19639	0	0	0	36	0	36
19640	0	0	0	39	0	39
19641	38	0	0	0	0	38
19642	37	0	0	0	0	37
19643	0	0	0	37	0	37
19644	0	0	35	0	0	35
19645	0	0	0	34	0	34
19646	0	0	0	30	0	30
19647	0	0	33	0	0	33
19648	0	0	0	31	0	31
19649	34	0	0	0	0	34
19650	34	0	0	0	0	34
19651	33	0	0	0	0	33
19652	0	0	0	33	0	33
19653	33	0	0	0	0	33
19654	32	1	0	0	0	33
19655	0	0	33	0	0	33
19656	0	0	28	0	0	28
19657	0	1	27	0	0	28
19658	32	0	0	0	0	32
19659	0	30	0	0	0	30
19660	26	0	0	1	0	27
19661	0	27	0	0	0	27
19662	0	0	0	28	0	28
19663	0	0	0	27	0	27
19664	0	0	0	29	0	29
19665	0	0	27	0	0	27
19666	25	0	0	0	0	25
19667	0	0	0	26	0	26
19668	0	0	24	0	0	24
19669	0	0	19	0	0	19
19670	25	0	0	0	0	25
19671	0	25	0	0	0	25
19672	27	0	0	0	0	27
19673	27	0	0	0	0	27
19674	0	26	0	0	0	26
19675	26	0	0	0	0	26
19676	0	0	25	0	0	25
19677	0	0	23	0	0	23
19678	0	0	26	0	0	26
19679	0	0	0	26	0	26
19680	0	0	29	0	0	29
19681	28	0	0	0	0	28
19682	28	0	0	0	0	28
19683	0	0	29	0	0	29
19684	0	0	0	27	0	27
19685	30	0	0	0	0	30
19686	0	31	0	0	0	31
19687	0	32	0	0	0	32
19688	27	0	0	0	0	27
19689	0	0	24	0	0	24
19690	0	0	0	28	0	28
19691	0	0	0	28	0	28
19692	0	0	0	31	0	31
19693	0	29	0	0	0	29
19694	0	0	0	29	0	29
19695	31	0	0	0	0	31
19696	0	0	0	27	0	27
19697	0	29	0	0	0	29
19698	29	0	0	0	0	29
19699	0	0	0	28	0	28
19700	0	0	0	26	0	26
19701	28	0	0	0	0	28
19702	29	0	0	0	0	29
19703	0	0	0	29	0	29
19704	28	0	0	0	0	28
19705	28	0	0	0	0	28
19706	0	27	0	0	0	27
19707	29	0	0	0	0	29
19708	0	30	0	0	0	30
19709	0	0	0	29	0	29
19710	0	0	28	0	0	28
19711	0	0	0	29	0	29
19712	0	0	0	29	0	29
19713	0	0	0	29	0	29
19714	28	0	0	0	0	28
19715	0	30	0	0	0	30
19716	30	0	0	0	0	30
19717	1	30	0	0	0	31
19718	33	0	0	0	0	33
19719	33	0	0	0	0	33
19720	35	0	0	0	0	35
19721	36	0	0	0	0	36
19722	0	0	36	0	0	36
19723	0	0	0	36	0	36
19724	0	0	0	41	0	41
19725	0	0	36	0	0	36
19726	41	0	0	1	0	42
19727	0	0	0	43	0	43
19728	0	0	40	0	0	40
19729	1	0	40	0	0	41
19730	0	0	0	41	0	41
19731	0	0	39	0	0	39
19732	0	0	0	41	0	41
19733	0	0	0	42	0	42
19734	0	0	41	2	0	43
19735	45	0	0	0	0	45
19736	0	0	0	44	0	44
19737	0	0	46	0	0	46
19738	0	0	0	46	0	46
19739	47	0	0	0	0	47
19740	0	0	45	0	0	45
19741	46	0	0	0	0	46
19742	45	0	0	0	0	45
19743	0	0	0	46	0	46
19744	0	0	0	44	0	44
19745	0	0	45	0	0	45
19746	0	0	1	46	0	47
19747	0	0	0	46	0	46
19748	0	0	0	48	0	48
19749	0	0	47	0	0	47
19750	47	0	0	0	0	47
19751	48	0	0	0	0	48
19752	48	0	0	0	0	48
19753	47	0	1	0	0	48
19754	0	0	0	47	0	47
19755	50	0	0	0	0	50
19756	49	0	0	0	0	49
19757	45	0	0	0	0	45
19758	51	0	0	0	0	51
19759	0	48	0	0	0	48
19760	50	0	0	0	0	50
19761	52	0	0	0	0	52
19762	0	49	0	0	0	49
19763	52	0	0	0	0	52
19764	0	0	0	50	0	50
19765	1	0	0	50	0	51
19766	53	0	0	0	0	53
19767	0	56	0	0	0	56
19768	0	51	0	0	0	51
19769	0	0	0	58	0	58
19770	0	0	56	0	0	56
19771	0	0	0	55	0	55
19772	0	0	0	56	0	56
19773	54	0	0	0	0	54
19774	58	0	0	0	0	58
19775	0	0	0	54	0	54
19776	0	0	56	0	0	56
19777	0	0	0	55	0	55
19778	55	0	0	0	0	55
19779	0	0	60	0	0	60
19780	0	56	0	0	0	56
19781	58	1	0	1	0	60
19782	0	0	0	59	0	59
19783	1	0	0	56	0	57
19784	0	0	0	58	0	58
19785	0	0	58	0	0	58
19786	56	0	0	0	0	56
19787	0	0	56	0	0	56
19788	0	55	0	0	0	55
19789	0	0	0	55	0	55
19790	1	0	0	56	0	57
19791	0	0	0	57	0	57
19792	0	0	56	0	0	56
19793	0	0	52	0	0	52
19794	0	0	54	0	0	54
19795	0	54	0	0	0	54
19796	0	0	0	59	0	59
19797	59	0	0	0	0	59
19798	60	0	0	0	0	60
19799	0	0	58	0	0	58
19800	0	57	0	0	0	57
19801	0	0	55	0	0	55
19802	0	56	0	0	0	56
19803	58	0	0	0	0	58
19804	56	0	0	0	0	56
19805	0	57	0	0	0	57
19806	57	0	0	0	0	57
19807	0	0	0	56	0	56
19808	0	0	0	57	0	57
19809	55	0	0	0	0	55
19810	56	0	0	0	0	56
19811	54	0	0	0	0	54
19812	0	52	0	0	0	52
19813	0	54	0	0	0	54
19814	55	0	0	0	0	55
19815	0	0	54	0	0	54
19816	0	0	0	54	0	54
19817	51	0	0	0	0	51
19818	0	53	0	0	0	53
19819	0	45	0	0	0	45
19820	45	0	0	0	0	45
19821	0	0	45	0	0	45
19822	44	0	0	0	0	44
19823	0	0	41	0	0	41
19824	0	0	43	0	0	43
19825	0	0	0	40	0	40
19826	0	0	41	0	0	41
19827	37	0	0	0	0	37
19828	36	0	0	0	0	36
19829	37	0	0	0	0	37
19830	34	0	0	0	0	34
19831	1	0	0	35	0	36
19832	36	0	0	0	0	36
19833	0	38	0	0	0	38
19834	0	0	0	38	0	38
19835	0	36	0	0	0	36
19836	41	0	0	0	0	41
19837	40	0	0	0	0	40
19838	0	0	0	39	0	39
19839	40	0	0	0	0	40
19840	40	0	0	0	0	40
19841	0	0	0	40	0	40
19842	0	0	0	37	0	37
19843	0	0	0	40	0	40
19844	0	0	38	0	0	38
19845	0	0	39	0	0	39
19846	0	0	38	0	0	38
19847	0	0	0	41	0	41
19848	0	0	38	0	0	38
19849	0	0	0	40	0	40
19850	0	0	39	0	0	39
19851	0	0	37	0	0	37
19852	39	0	0	0	0	39
19853	0	37	0	0	0	37
19854	38	0	1	0	0	39
19855	0	0	1	39	0	40
19856	0	0	0	40	0	40
19857	0	0	39	0	0	39
19858	0	40	0	0	0	40
19859	0	0	0	36	0	36
19860	0	0	36	0	0	36
19861	0	36	0	0	0	36
19862	0	0	0	34	0	34
19863	35	0	0	0	0	35
19864	32	0	0	0	0	32
19865	0	0	0	37	0	37
19866	36	0	0	0	0	36
19867	0	33	0	0	0	33
19868	0	0	0	32	0	32
19869	0	0	36	0	0	36
19870	0	0	0	35	0	35
19871	0	0	32	0	0	32
19872	34	0	0	0	0	34
19873	0	0	0	32	0	32
19874	0	29	0	0	0	29
19875	0	0	0	30	0	30
19876	0	0	33	0	0	33
19877	0	0	37	0	0	37
19878	0	0	32	0	0	32
19879	37	0	0	0	0	37
19880	0	39	0	0	0	39
19881	0	0	3	34	0	37
19882	34	0	4	0	0	38
19883	0	34	0	0	0	34
19884	40	0	0	0	0	40
19885	39	0	0	0	0	39
19886	39	0	0	0	0	39
19887	40	0	0	0	0	40
19888	0	0	39	0	0	39
19889	39	0	0	0	0	39
19890	0	0	30	0	0	30
19891	35	0	0	0	0	35
19892	0	0	0	34	0	34
19893	0	0	33	0	0	33
19894	0	31	0	0	0	31
19895	0	0	0	34	0	34
19896	0	32	0	0	0	32
19897	0	31	0	0	0	31
19898	33	0	0	0	0	33
19899	0	0	32	0	0	32
19900	0	32	0	0	0	32
19901	32	0	0	0	0	32
19902	0	33	0	0	0	33
19903	32	0	0	0	0	32
19904	0	0	0	39	0	39
19905	40	0	0	0	0	40
19906	0	0	0	40	0	40
19907	43	0	1	0	0	44
19908	0	0	1	43	0	44
19909	0	39	0	0	0	39
19910	0	0	0	57	0	57
19911	55	0	0	0	0	55
19912	0	60	0	0	0	60
19913	0	0	0	60	0	60
19914	57	0	0	0	0	57
19915	0	0	0	59	0	59
19916	0	0	0	61	0	61
19917	0	0	59	0	0	59
19918	0	0	51	0	0	51
19919	0	0	0	60	0	60
19920	0	0	61	0	0	61
19921	0	0	0	59	0	59
19922	0	0	0	65	0	65
19923	0	0	0	64	0	64
19924	0	0	62	0	0	62
19925	0	0	0	61	0	61
19926	0	0	0	60	0	60
19927	0	63	0	0	0	63
19928	0	0	0	63	0	63
19929	59	0	0	0	0	59
19930	0	0	0	58	0	58
19931	0	0	62	0	0	62
19932	58	0	0	0	0	58
19933	0	58	0	0	0	58
19934	0	0	0	60	0	60
19935	0	0	60	0	0	60
19936	61	0	0	0	0	61
19937	0	58	0	0	0	58
19938	58	0	0	0	0	58
19939	0	0	0	62	0	62
19940	61	0	0	0	0	61
19941	0	0	62	0	0	62
19942	0	57	0	0	0	57
19943	0	66	0	0	0	66
19944	68	0	0	0	0	68
19945	68	1	0	0	0	69
19946	0	0	68	0	0	68
19947	61	0	0	0	0	61
19948	66	0	0	0	0	66
19949	70	0	0	0	0	70
19950	0	70	0	0	0	70
19951	0	67	0	0	0	67
19952	73	0	0	0	0	73
19953	71	0	0	0	0	71
19954	0	68	0	0	0	68
19955	0	0	0	70	0	70
19956	0	0	70	0	0	70
19957	72	0	0	0	0	72
19958	70	0	0	0	0	70
19959	72	0	0	0	0	72
19960	0	70	0	0	0	70
19961	0	0	77	0	0	77
19962	79	0	0	0	0	79
19963	0	2	0	70	0	72
19964	0	0	0	75	0	75
19965	0	0	0	77	0	77
19966	0	0	77	0	0	77
19967	2	0	1	69	0	72
19968	0	0	73	0	0	73
19969	0	74	0	0	0	74
19970	74	0	0	1	0	75
19971	0	76	0	0	0	76
19972	0	73	0	0	0	73
19973	76	0	0	0	0	76
19974	0	70	0	1	0	71
19975	0	0	0	68	0	68
19976	0	70	0	0	0	70
19977	73	0	0	1	0	74
19978	0	68	0	0	0	68
19979	0	0	0	72	0	72
19980	0	0	72	0	0	72
19981	0	0	0	72	0	72
19982	0	65	0	0	0	65
19983	0	0	0	70	0	70
19984	0	0	0	71	0	71
19985	0	0	0	68	0	68
19986	0	0	0	70	0	70
19987	0	0	0	71	0	71
19988	0	0	0	71	0	71
19989	0	0	71	0	0	71
19990	71	0	0	0	0	71
19991	0	0	0	71	0	71
19992	0	0	72	0	0	72
19993	0	0	70	0	0	70
19994	0	0	0	76	0	76
19995	76	0	0	0	0	76
19996	0	0	72	0	0	72
19997	70	0	0	0	0	70
19998	0	0	73	0	0	73
19999	0	0	0	70	0	70
20000	0	0	0	67	0	67
20001	0	0	68	0	0	68
20002	68	1	0	0	0	69
20003	0	0	0	52	0	52
20004	0	0	69	0	0	69
20005	0	0	66	0	0	66
20006	0	0	0	50	0	50
20007	0	51	0	0	0	51
20008	52	0	0	0	0	52
20009	50	0	0	0	0	50
20010	0	0	57	0	0	57
20011	0	0	0	53	0	53
20012	53	0	0	0	0	53
20013	0	0	55	0	0	55
20014	53	0	0	0	0	53
20015	0	46	0	1	0	47
20016	0	0	0	53	0	53
20017	0	0	0	54	0	54
20018	55	0	0	0	0	55
20019	0	0	1	54	0	55
20020	0	0	0	52	0	52
20021	0	0	0	58	0	58
20022	58	0	0	0	0	58
20023	0	0	56	0	0	56
20024	57	0	0	0	0	57
20025	59	0	0	0	0	59
20026	56	0	0	0	0	56
20027	0	0	0	61	0	61
20028	0	0	64	0	0	64
20029	0	63	0	0	0	63
20030	0	56	0	0	0	56
20031	0	71	0	0	0	71
20032	0	0	66	0	0	66
20033	0	0	0	66	0	66
20034	70	0	0	0	0	70
20035	64	0	0	0	0	64
20036	0	0	0	58	0	58
20037	0	0	59	0	0	59
20038	0	0	61	0	0	61
20039	0	0	0	62	0	62
20040	0	0	65	0	0	65
20041	0	0	0	62	0	62
20042	0	0	0	60	0	60
20043	0	66	0	0	0	66
20044	0	0	0	69	0	69
20045	0	0	0	69	0	69
20046	67	0	0	0	0	67
20047	0	0	0	69	0	69
20048	0	0	0	66	0	66
20049	66	0	0	1	0	67
20050	0	64	0	0	0	64
20051	64	0	0	0	0	64
20052	0	0	65	0	0	65
20053	63	0	0	0	0	63
20054	61	0	0	0	0	61
20055	0	0	61	0	0	61
20056	0	0	62	0	0	62
20057	0	0	0	60	0	60
20058	63	0	0	0	0	63
20059	0	0	60	0	0	60
20060	0	0	0	62	0	62
20061	0	0	60	0	0	60
20062	0	0	0	61	0	61
20063	0	0	0	59	0	59
20064	60	0	0	0	0	60
20065	61	0	0	0	0	61
20066	62	0	0	0	0	62
20067	0	0	65	0	0	65
20068	0	0	63	0	0	63
20069	1	0	0	65	0	66
20070	0	0	0	66	0	66
20071	0	0	0	67	0	67
20072	67	0	0	0	0	67
20073	0	68	0	0	0	68
20074	67	0	0	0	0	67
20075	65	0	0	0	0	65
20076	0	64	0	0	0	64
20077	0	67	0	0	0	67
20078	68	0	0	0	0	68
20079	0	0	0	66	0	66
20080	0	64	0	0	0	64
20081	0	0	0	70	0	70
20082	0	0	70	0	0	70
20083	0	0	0	68	0	68
20084	71	0	0	0	0	71
20085	0	0	64	0	0	64
20086	0	0	61	0	0	61
20087	0	0	0	62	0	62
20088	1	63	0	0	0	64
20089	0	64	0	0	0	64
20090	0	67	0	0	0	67
20091	70	0	0	0	0	70
20092	68	0	0	0	0	68
20093	61	0	0	0	0	61
20094	0	61	0	0	0	61
20095	68	0	0	0	0	68
20096	66	0	0	1	0	67
20097	0	0	66	0	0	66
20098	0	69	0	0	0	69
20099	0	0	0	66	0	66
20100	69	0	0	0	0	69
20101	0	0	64	0	0	64
20102	0	0	0	68	0	68
20103	0	63	0	0	0	63
20104	0	0	0	71	0	71
20105	0	0	0	65	0	65
20106	68	0	0	0	0	68
20107	69	0	0	0	0	69
20108	0	0	0	67	0	67
20109	0	0	66	0	0	66
20110	0	0	66	0	0	66
20111	68	0	0	0	0	68
20112	0	0	71	0	0	71
20113	0	0	0	68	0	68
20114	0	68	0	0	0	68
20115	70	0	0	0	0	70
20116	0	65	0	0	0	65
20117	66	0	0	0	0	66
20118	0	0	0	65	0	65
20119	1	0	0	68	0	69
20120	67	0	0	0	0	67
20121	64	0	0	0	0	64
20122	0	0	0	67	0	67
20123	0	0	0	70	0	70
20124	0	0	65	0	0	65
20125	0	0	64	0	0	64
20126	62	0	0	0	0	62
20127	0	0	53	0	0	53
20128	66	0	0	0	0	66
20129	67	0	0	0	0	67
20130	0	0	67	0	0	67
20131	0	55	0	0	0	55
20132	1	56	0	0	0	57
20133	0	0	59	0	0	59
20134	1	0	0	54	0	55
20135	62	0	0	0	0	62
20136	58	0	0	1	0	59
20137	59	0	0	0	0	59
20138	56	0	0	0	0	56
20139	57	0	0	0	0	57
20140	0	59	0	0	0	59
20141	57	0	0	0	0	57
20142	0	60	0	0	0	60
20143	62	0	0	0	0	62
20144	0	0	60	0	0	60
20145	1	0	1	62	0	64
20146	0	0	0	68	0	68
20147	0	65	0	0	0	65
20148	67	0	0	0	0	67
20149	65	0	0	0	0	65
20150	0	0	0	67	0	67
20151	0	0	0	64	0	64
20152	62	0	0	0	0	62
20153	0	0	0	65	0	65
20154	0	0	0	63	0	63
20155	62	0	0	0	0	62
20156	0	0	0	66	0	66
20157	65	0	0	0	0	65
20158	66	0	0	0	0	66
20159	0	0	63	0	0	63
20160	62	0	0	0	0	62
20161	59	0	0	0	0	59
20162	60	0	0	0	0	60
20163	0	0	61	0	0	61
20164	0	0	0	56	0	56
20165	0	0	0	59	0	59
20166	0	0	56	0	0	56
20167	59	0	0	0	0	59
20168	0	0	0	61	0	61
20169	0	0	61	0	0	61
20170	0	0	57	0	0	57
20171	0	0	0	61	0	61
20172	0	0	58	0	0	58
20173	0	0	0	54	0	54
20174	1	0	0	56	0	57
20175	0	0	59	0	0	59
20176	0	0	0	56	0	56
20177	0	48	0	0	0	48
20178	0	57	0	0	0	57
20179	60	0	0	0	0	60
20180	57	0	0	0	0	57
20181	0	58	0	0	0	58
20182	59	0	0	1	0	60
20183	61	0	0	0	0	61
20184	0	0	0	55	0	55
20185	0	0	0	55	0	55
20186	57	0	0	0	0	57
20187	0	56	0	0	0	56
20188	0	57	0	0	0	57
20189	0	0	0	59	0	59
20190	0	0	58	0	0	58
20191	58	0	0	1	0	59
20192	58	0	0	0	0	58
20193	56	0	0	0	0	56
20194	0	57	0	0	0	57
20195	0	0	0	55	0	55
20196	0	0	0	57	0	57
20197	55	0	0	0	0	55
20198	0	54	0	0	0	54
20199	0	0	0	54	0	54
20200	0	0	0	55	0	55
20201	0	0	0	55	0	55
20202	51	0	0	0	0	51
20203	0	51	0	0	0	51
20204	1	0	0	54	0	55
20205	0	52	0	0	0	52
20206	50	0	0	0	0	50
20207	0	0	54	0	0	54
20208	56	0	0	0	0	56
20209	0	0	50	0	0	50
20210	0	0	0	55	0	55
20211	57	0	0	0	0	57
20212	0	0	52	0	0	52
20213	51	0	0	0	0	51
20214	53	0	0	0	0	53
20215	49	0	0	0	0	49
20216	0	0	0	46	0	46
20217	0	0	0	48	0	48
20218	0	0	0	47	0	47
20219	44	0	0	0	0	44
20220	0	45	0	0	0	45
20221	45	0	0	0	0	45
20222	42	0	0	0	0	42
20223	0	0	44	0	0	44
20224	40	0	0	0	0	40
20225	47	0	0	0	0	47
20226	0	0	0	49	0	49
20227	0	0	0	54	0	54
20228	0	0	0	51	0	51
20229	47	0	0	0	0	47
20230	47	0	1	0	0	48
20231	48	0	0	0	0	48
20232	0	47	0	0	0	47
20233	0	40	0	0	0	40
20234	0	45	0	0	0	45
20235	48	0	0	0	0	48
20236	0	0	45	0	0	45
20237	0	0	44	0	0	44
20238	47	0	0	0	0	47
20239	0	0	49	0	0	49
20240	0	0	0	47	0	47
20241	0	46	0	0	0	46
20242	46	0	0	0	0	46
20243	48	0	0	0	0	48
20244	48	0	0	0	0	48
20245	0	0	0	47	0	47
20246	0	0	50	0	0	50
20247	0	0	44	0	0	44
20248	50	0	0	0	0	50
20249	47	0	0	0	0	47
20250	49	0	0	0	0	49
20251	0	0	0	47	0	47
20252	0	0	0	45	0	45
20253	0	0	45	0	0	45
20254	45	0	0	0	0	45
20255	0	0	0	49	0	49
20256	0	0	0	52	0	52
20257	0	0	0	53	0	53
20258	0	50	0	0	0	50
20259	0	0	0	52	0	52
20260	0	0	0	52	0	52
20261	52	0	0	0	0	52
20262	0	0	49	0	0	49
20263	53	0	0	0	0	53
20264	51	0	0	0	0	51
20265	0	0	0	50	0	50
20266	0	0	0	51	0	51
20267	52	0	0	0	0	52
20268	0	0	50	0	0	50
20269	0	50	0	0	0	50
20270	0	0	0	54	0	54
20271	51	0	0	0	0	51
20272	1	0	0	48	0	49
20273	0	0	51	0	0	51
20274	0	0	53	0	0	53
20275	49	0	0	0	0	49
20276	0	0	0	54	0	54
20277	0	0	54	0	0	54
20278	59	0	0	0	0	59
20279	57	0	0	0	0	57
20280	0	0	0	55	0	55
20281	0	0	0	56	0	56
20282	0	51	0	0	0	51
20283	58	0	0	0	0	58
20284	0	0	0	58	0	58
20285	0	0	0	55	0	55
20286	0	0	56	0	0	56
20287	55	0	0	0	0	55
20288	60	0	0	0	0	60
20289	0	63	0	0	0	63
20290	0	0	60	0	0	60
20291	0	0	61	0	0	61
20292	0	0	0	64	0	64
20293	65	0	0	0	0	65
20294	0	0	0	64	0	64
20295	62	0	0	0	0	62
20296	67	0	0	1	0	68
20297	62	0	0	0	0	62
20298	0	0	0	59	0	59
20299	0	0	0	63	0	63
20300	64	0	0	0	0	64
20301	0	0	63	0	0	63
20302	83	0	0	0	0	83
20303	84	0	0	0	0	84
20304	0	0	86	0	0	86
20305	0	0	83	0	0	83
20306	0	86	0	0	0	86
20307	0	0	0	85	0	85
20308	89	0	0	0	0	89
20309	0	0	0	91	0	91
20310	0	0	88	0	0	88
20311	0	83	0	2	0	85
20312	0	83	0	0	0	83
20313	0	0	0	89	0	89
20314	0	0	0	88	0	88
20315	0	89	0	0	0	89
20316	0	0	92	0	0	92
20317	90	0	0	0	0	90
20318	91	0	0	0	0	91
20319	0	86	0	0	0	86
20320	82	0	0	0	0	82
20321	0	0	0	81	0	81
20322	83	0	0	0	0	83
20323	0	0	0	84	0	84
20324	0	82	0	0	0	82
20325	0	0	83	0	0	83
20326	0	0	0	84	0	84
20327	0	0	0	82	0	82
20328	0	0	0	84	0	84
20329	83	0	0	0	0	83
20330	0	0	0	86	0	86
20331	0	0	90	0	0	90
20332	0	0	90	0	0	90
20333	87	0	0	0	0	87
20334	0	0	86	0	0	86
20335	88	0	0	0	0	88
20336	0	0	0	83	0	83
20337	0	0	0	83	0	83
20338	0	0	0	84	0	84
20339	0	0	0	87	0	87
20340	86	0	0	0	0	86
20341	0	0	79	0	0	79
20342	0	0	0	82	0	82
20343	0	80	0	0	0	80
20344	78	0	0	1	0	79
20345	0	0	0	79	0	79
20346	81	0	0	0	0	81
20347	0	0	80	0	0	80
20348	0	0	0	81	0	81
20349	0	77	0	0	0	77
20350	82	0	0	0	0	82
20351	0	0	82	0	0	82
20352	0	0	0	81	0	81
20353	0	0	0	80	0	80
20354	83	0	0	0	0	83
20355	0	0	82	0	0	82
20356	0	0	80	0	0	80
20357	0	0	0	81	0	81
20358	0	0	83	0	0	83
20359	0	0	81	0	0	81
20360	0	0	0	79	0	79
20361	0	0	0	84	0	84
20362	0	0	0	84	0	84
20363	84	0	0	0	0	84
20364	0	86	0	0	0	86
20365	87	0	0	0	0	87
20366	1	0	0	82	0	83
20367	0	83	0	0	0	83
20368	0	0	0	88	0	88
20369	90	0	0	0	0	90
20370	0	92	0	0	0	92
20371	0	0	0	86	0	86
20372	0	0	87	0	0	87
20373	82	1	0	0	0	83
20374	0	0	0	88	0	88
20375	0	0	0	89	0	89
20376	0	0	91	0	0	91
20377	0	0	84	0	0	84
20378	85	0	0	0	0	85
20379	0	86	0	0	0	86
20380	0	0	0	91	0	91
20381	85	0	0	0	0	85
20382	0	0	85	0	0	85
20383	0	86	0	0	0	86
20384	0	0	0	84	0	84
20385	86	0	0	0	0	86
20386	85	0	0	1	0	86
20387	86	0	0	0	0	86
20388	0	80	0	0	0	80
20389	0	0	82	0	0	82
20390	0	0	0	86	0	86
20391	0	0	0	86	0	86
20392	0	0	0	91	0	91
20393	0	0	0	86	0	86
20394	82	0	0	0	0	82
20395	67	0	0	0	0	67
20396	0	0	67	0	0	67
20397	0	0	60	0	0	60
20398	70	0	0	0	0	70
20399	67	0	0	0	0	67
20400	1	0	0	71	0	72
20401	0	69	0	0	0	69
20402	70	0	1	0	0	71
20403	0	63	0	0	0	63
20404	0	63	0	0	0	63
20405	0	0	0	68	0	68
20406	0	0	0	70	0	70
20407	0	0	0	67	0	67
20408	0	0	0	67	0	67
20409	0	0	65	0	0	65
20410	64	0	0	0	0	64
20411	68	0	0	0	0	68
20412	0	0	0	66	0	66
20413	0	0	0	68	0	68
20414	71	0	0	0	0	71
20415	0	0	71	0	0	71
20416	79	0	0	0	0	79
20417	80	0	0	1	0	81
20418	0	0	79	0	0	79
20419	83	0	0	0	0	83
20420	1	0	0	81	0	82
20421	0	0	0	82	0	82
20422	0	0	0	83	0	83
20423	0	0	0	81	0	81
20424	82	0	0	0	0	82
20425	0	0	0	80	0	80
20426	0	0	0	80	0	80
20427	0	75	0	2	0	77
20428	0	77	0	0	0	77
20429	0	0	0	77	0	77
20430	82	0	0	0	0	82
20431	0	0	0	83	0	83
20432	0	0	74	0	0	74
20433	0	0	68	0	0	68
20434	75	1	0	0	0	76
20435	0	79	0	0	0	79
20436	81	0	0	0	0	81
20437	0	0	78	0	0	78
20438	0	0	0	80	0	80
20439	80	0	0	0	0	80
20440	0	79	0	0	0	79
20441	79	0	0	0	0	79
20442	0	0	77	0	0	77
20443	1	0	0	77	0	78
20444	0	0	0	75	0	75
20445	81	0	0	0	0	81
20446	78	0	0	0	0	78
20447	82	0	0	0	0	82
20448	81	0	0	0	0	81
20449	81	0	0	0	0	81
20450	0	81	0	0	0	81
20451	0	0	0	80	0	80
20452	80	0	0	0	0	80
20453	0	0	0	80	0	80
20454	0	0	0	79	0	79
20455	0	0	0	79	0	79
20456	0	79	0	0	0	79
20457	80	0	0	0	0	80
20458	0	0	0	78	0	78
20459	73	0	0	0	0	73
20460	75	1	0	0	0	76
20461	0	74	0	0	0	74
20462	75	0	0	0	0	75
20463	0	0	71	0	0	71
20464	75	0	0	0	0	75
20465	0	0	0	78	0	78
20466	0	0	71	0	0	71
20467	0	73	0	0	0	73
20468	0	0	73	0	0	73
20469	0	76	0	0	0	76
20470	78	0	0	0	0	78
20471	77	0	0	0	0	77
20472	75	0	0	0	0	75
20473	0	75	0	0	0	75
20474	75	0	0	0	0	75
20475	0	0	71	0	0	71
20476	1	0	71	0	0	72
20477	0	0	0	72	0	72
20478	0	0	0	64	0	64
20479	0	71	0	0	0	71
20480	73	0	0	0	0	73
20481	0	0	0	69	0	69
20482	0	66	0	0	0	66
20483	0	0	0	67	0	67
20484	63	0	0	0	0	63
20485	59	0	0	0	0	59
20486	0	0	65	0	0	65
20487	0	0	0	65	0	65
20488	0	0	61	0	0	61
20489	0	0	0	61	0	61
20490	0	0	60	0	0	60
20491	0	0	0	63	0	63
20492	0	0	62	0	0	62
20493	0	0	0	56	0	56
20494	0	0	64	0	0	64
20495	0	0	0	64	0	64
20496	0	0	0	65	0	65
20497	0	66	0	0	0	66
20498	0	0	0	68	0	68
20499	0	0	67	0	0	67
20500	0	0	0	64	0	64
20501	0	0	0	72	0	72
20502	71	0	0	0	0	71
20503	0	0	0	66	0	66
20504	0	0	0	66	0	66
20505	0	0	65	0	0	65
20506	67	0	0	0	0	67
20507	0	0	0	66	0	66
20508	0	0	0	53	0	53
20509	0	0	0	54	0	54
20510	52	0	0	0	0	52
20511	0	0	0	49	0	49
20512	0	0	0	51	0	51
20513	51	0	0	0	0	51
20514	0	50	0	0	0	50
20515	0	0	0	51	0	51
20516	0	0	0	51	0	51
20517	0	0	49	0	0	49
20518	49	0	0	0	0	49
20519	0	0	0	50	0	50
20520	0	0	46	0	0	46
20521	49	0	0	0	0	49
20522	0	0	0	51	0	51
20523	0	0	0	51	0	51
20524	0	0	0	49	0	49
20525	0	0	0	49	0	49
20526	0	0	45	0	0	45
20527	0	0	0	46	0	46
20528	0	0	0	47	0	47
20529	0	0	48	0	0	48
20530	47	0	0	0	0	47
20531	45	0	0	0	0	45
20532	45	0	0	0	0	45
20533	0	0	0	45	0	45
20534	49	0	0	0	0	49
20535	49	0	0	0	0	49
20536	0	0	0	48	0	48
20537	50	0	0	0	0	50
20538	50	0	0	0	0	50
20539	49	0	0	0	0	49
20540	46	0	0	0	0	46
20541	0	0	0	45	0	45
20542	0	43	0	0	0	43
20543	0	40	0	1	0	41
20544	0	49	0	0	0	49
20545	50	0	0	0	0	50
20546	49	0	0	0	0	49
20547	0	0	48	0	0	48
20548	49	0	0	1	0	50
20549	0	0	0	52	0	52
20550	0	0	0	50	0	50
20551	0	0	0	48	0	48
20552	52	0	0	0	0	52
20553	0	0	0	52	0	52
20554	0	49	0	1	0	50
20555	0	0	0	49	0	49
20556	0	0	51	0	0	51
20557	0	0	0	52	0	52
20558	52	0	0	0	0	52
20559	0	0	49	0	0	49
20560	0	0	0	51	0	51
20561	0	0	0	48	0	48
20562	0	0	0	50	0	50
20563	0	49	0	0	0	49
20564	0	0	0	49	0	49
20565	49	0	0	0	0	49
20566	52	0	0	0	0	52
20567	0	0	47	0	0	47
20568	0	0	49	0	0	49
20569	0	0	0	49	0	49
20570	0	0	0	51	0	51
20571	0	0	59	0	0	59
20572	0	0	0	59	0	59
20573	0	54	0	0	0	54
20574	57	0	0	0	0	57
20575	57	0	0	0	0	57
20576	57	0	0	0	0	57
20577	0	0	50	0	0	50
20578	0	0	0	57	0	57
20579	0	0	48	0	0	48
20580	51	0	0	0	0	51
20581	0	50	0	0	0	50
20582	0	0	0	53	0	53
20583	53	0	0	0	0	53
20584	0	0	0	55	0	55
20585	0	0	0	53	0	53
20586	0	0	53	0	0	53
20587	53	0	0	0	0	53
20588	0	47	0	0	0	47
20589	0	0	0	50	0	50
20590	50	0	0	0	0	50
20591	0	0	0	49	0	49
20592	49	0	0	0	0	49
20593	0	50	0	0	0	50
20594	47	0	0	0	0	47
20595	0	0	53	0	0	53
20596	49	0	0	0	0	49
20597	53	0	0	0	0	53
20598	49	0	0	0	0	49
20599	0	0	0	48	0	48
20600	0	0	0	48	0	48
20601	0	0	0	48	0	48
20602	0	48	0	0	0	48
20603	50	0	0	0	0	50
20604	0	0	0	51	0	51
20605	0	0	0	51	0	51
20606	0	0	0	52	0	52
20607	52	0	0	0	0	52
20608	0	0	0	51	0	51
20609	0	0	52	0	0	52
20610	0	52	0	0	0	52
20611	0	0	0	54	0	54
20612	0	0	0	54	0	54
20613	0	0	0	53	0	53
20614	0	0	53	0	0	53
20615	0	0	52	0	0	52
20616	0	0	0	59	0	59
20617	0	0	62	0	0	62
20618	0	0	0	59	0	59
20619	62	0	0	0	0	62
20620	61	0	0	0	0	61
20621	59	0	0	0	0	59
20622	0	0	58	0	0	58
20623	60	0	0	0	0	60
20624	0	0	0	62	0	62
20625	0	0	58	0	0	58
20626	0	0	57	0	0	57
20627	0	54	0	0	0	54
20628	0	53	0	0	0	53
20629	61	0	0	0	0	61
20630	0	0	0	62	0	62
20631	0	0	61	0	0	61
20632	0	0	0	59	0	59
20633	58	0	0	0	0	58
20634	0	0	59	0	0	59
20635	62	0	0	0	0	62
20636	65	0	0	0	0	65
20637	59	0	0	0	0	59
20638	0	61	0	0	0	61
20639	61	0	0	0	0	61
20640	0	0	0	59	0	59
20641	0	0	0	61	0	61
20642	0	0	0	59	0	59
20643	0	0	0	57	0	57
20644	56	0	0	0	0	56
20645	0	58	1	0	0	59
20646	0	53	0	0	0	53
20647	0	55	0	0	0	55
20648	60	0	0	0	0	60
20649	57	0	0	0	0	57
20650	55	0	0	0	0	55
20651	57	0	0	0	0	57
20652	0	0	0	58	0	58
20653	0	0	0	58	0	58
20654	55	0	0	0	0	55
20655	0	57	0	0	0	57
20656	54	0	0	0	0	54
20657	54	0	0	0	0	54
20658	0	0	0	53	0	53
20659	0	53	0	0	0	53
20660	0	0	0	53	0	53
20661	51	0	0	0	0	51
20662	0	0	52	0	0	52
20663	0	0	0	51	0	51
20664	0	47	0	0	0	47
20665	44	0	0	0	0	44
20666	46	0	0	0	0	46
20667	0	0	44	0	0	44
20668	0	46	0	0	0	46
20669	0	0	49	0	0	49
20670	0	0	0	46	0	46
20671	0	0	45	0	0	45
20672	0	1	43	0	0	44
20673	0	48	0	0	0	48
20674	46	0	1	0	0	47
20675	47	0	0	0	0	47
20676	0	43	0	0	0	43
20677	0	48	0	0	0	48
20678	0	0	47	0	0	47
20679	0	0	40	0	0	40
20680	0	0	38	0	0	38
20681	0	0	0	46	0	46
20682	0	0	46	0	0	46
20683	0	0	0	47	0	47
20684	0	0	0	53	0	53
20685	0	0	55	0	0	55
20686	0	55	0	0	0	55
20687	0	0	0	55	0	55
20688	55	0	0	0	0	55
20689	0	0	0	54	0	54
20690	0	0	49	0	0	49
20691	0	47	0	0	0	47
20692	0	51	0	0	0	51
20693	0	0	0	54	0	54
20694	54	0	0	0	0	54
20695	58	0	0	0	0	58
20696	0	0	0	53	0	53
20697	0	56	0	0	0	56
20698	0	0	0	55	0	55
20699	0	0	0	56	0	56
20700	0	0	0	56	0	56
20701	56	0	0	0	0	56
20702	0	57	0	0	0	57
20703	58	0	0	0	0	58
20704	60	0	0	0	0	60
20705	61	0	0	0	0	61
20706	58	0	0	0	0	58
20707	0	0	0	58	0	58
20708	0	0	57	0	0	57
20709	0	56	0	0	0	56
20710	62	0	0	0	0	62
20711	63	0	0	0	0	63
20712	61	0	0	0	0	61
20713	0	0	62	0	0	62
20714	64	0	0	0	0	64
20715	64	0	0	0	0	64
20716	0	0	0	64	0	64
20717	0	0	63	0	0	63
20718	0	63	0	0	0	63
20719	0	0	0	70	0	70
20720	69	0	0	0	0	69
20721	0	0	0	75	0	75
20722	0	0	0	75	0	75
20723	74	0	0	0	0	74
20724	0	0	71	0	0	71
20725	77	0	0	0	0	77
20726	80	0	0	0	0	80
20727	81	0	0	0	0	81
20728	81	0	0	0	0	81
20729	0	0	80	0	0	80
20730	0	0	0	80	0	80
20731	0	0	79	0	0	79
20732	0	0	0	80	0	80
20733	0	0	82	0	0	82
20734	83	0	0	0	0	83
20735	0	81	0	0	0	81
20736	0	81	0	0	0	81
20737	0	0	0	83	0	83
20738	0	0	0	83	0	83
20739	0	84	0	0	0	84
20740	87	0	0	0	0	87
20741	86	0	0	0	0	86
20742	87	0	0	0	0	87
20743	88	0	0	0	0	88
20744	0	0	0	84	0	84
20745	0	0	0	86	0	86
20746	85	0	0	0	0	85
20747	0	0	0	94	0	94
20748	0	0	93	0	0	93
20749	0	0	88	0	0	88
20750	0	0	0	94	0	94
20751	0	0	96	0	0	96
20752	98	0	0	0	0	98
20753	0	0	0	97	0	97
20754	101	0	0	0	0	101
20755	0	0	103	0	0	103
20756	0	0	0	100	0	100
20757	0	0	103	0	0	103
20758	0	102	0	0	0	102
20759	103	0	0	0	0	103
20760	105	0	0	0	0	105
20761	0	101	0	0	0	101
20762	102	0	0	0	0	102
20763	1	0	0	105	0	106
20764	0	0	0	106	0	106
20765	105	0	0	0	0	105
20766	0	100	0	0	0	100
20767	0	102	0	0	0	102
20768	0	0	0	101	0	101
20769	104	0	0	0	0	104
20770	105	0	0	0	0	105
20771	103	0	0	0	0	103
20772	0	0	100	0	0	100
20773	0	0	96	0	0	96
20774	0	99	0	0	0	99
20775	103	0	0	0	0	103
20776	0	0	0	97	0	97
20777	95	0	0	0	0	95
20778	92	0	0	0	0	92
20779	0	0	0	92	0	92
20780	0	0	89	0	0	89
20781	91	0	0	0	0	91
20782	0	0	0	92	0	92
20783	0	0	88	0	0	88
20784	89	0	0	0	0	89
20785	87	0	0	0	0	87
20786	0	0	0	92	0	92
20787	1	0	90	0	0	91
20788	0	0	0	86	0	86
20789	0	84	0	0	0	84
20790	0	0	84	0	0	84
20791	0	82	0	0	0	82
20792	89	0	0	0	0	89
20793	85	1	0	0	0	86
20794	88	0	0	1	0	89
20795	86	0	0	0	0	86
20796	0	0	0	84	0	84
20797	86	0	0	0	0	86
20798	0	0	0	82	0	82
20799	85	0	0	0	0	85
20800	0	82	0	0	0	82
20801	0	0	0	83	0	83
20802	0	85	0	0	0	85
20803	78	0	0	0	0	78
20804	78	0	0	0	0	78
20805	0	78	0	0	0	78
20806	0	0	0	78	0	78
20807	0	0	78	0	0	78
20808	0	0	0	81	0	81
20809	0	0	82	0	0	82
20810	0	0	0	75	0	75
20811	0	78	0	0	0	78
20812	75	0	0	0	0	75
20813	79	0	0	0	0	79
20814	0	0	0	73	0	73
20815	75	0	0	0	0	75
20816	0	0	0	73	0	73
20817	0	0	0	77	0	77
20818	0	0	0	73	0	73
20819	73	0	0	0	0	73
20820	76	0	0	0	0	76
20821	77	0	0	0	0	77
20822	0	76	0	0	0	76
20823	75	0	0	0	0	75
20824	0	76	0	0	0	76
20825	73	0	0	0	0	73
20826	0	0	0	76	0	76
20827	0	0	0	74	0	74
20828	71	0	0	0	0	71
20829	69	0	0	0	0	69
20830	0	75	0	0	0	75
20831	74	0	0	0	0	74
20832	0	0	0	75	0	75
20833	0	0	0	74	0	74
20834	75	0	0	0	0	75
20835	0	0	73	0	0	73
20836	0	73	0	0	0	73
20837	0	0	0	83	0	83
20838	0	0	84	0	0	84
20839	0	0	0	85	0	85
20840	78	0	0	0	0	78
20841	0	78	0	0	0	78
20842	0	74	0	0	0	74
20843	0	71	0	0	0	71
20844	0	0	0	71	0	71
20845	71	0	0	0	0	71
20846	0	0	0	63	0	63
20847	60	0	0	0	0	60
20848	61	0	0	0	0	61
20849	0	0	0	62	0	62
20850	67	0	0	0	0	67
20851	0	0	0	65	0	65
20852	0	1	70	0	0	71
20853	68	0	0	0	0	68
20854	0	1	70	0	0	71
20855	69	0	0	0	0	69
20856	0	0	66	0	0	66
20857	0	0	1	68	0	69
20858	0	0	0	75	0	75
20859	74	0	0	0	0	74
20860	0	0	0	72	0	72
20861	71	0	0	0	0	71
20862	0	73	0	0	0	73
20863	74	0	0	0	0	74
20864	0	0	0	76	0	76
20865	0	0	0	77	0	77
20866	0	0	0	76	0	76
20867	0	0	0	80	0	80
20868	0	0	78	0	0	78
20869	0	1	72	1	0	74
20870	0	0	0	82	0	82
20871	0	0	82	0	0	82
20872	0	81	0	0	0	81
20873	0	0	0	81	0	81
20874	0	0	83	0	0	83
20875	0	0	83	0	0	83
20876	0	0	0	89	0	89
20877	0	0	0	85	0	85
20878	0	85	0	0	0	85
20879	0	0	0	80	0	80
20880	0	0	81	0	0	81
20881	87	0	0	0	0	87
20882	0	0	0	84	0	84
20883	87	0	0	0	0	87
20884	92	0	0	0	0	92
20885	90	0	0	0	0	90
20886	0	0	89	0	0	89
20887	0	0	87	0	0	87
20888	92	0	0	0	0	92
20889	0	0	96	0	0	96
20890	0	0	0	91	0	91
20891	0	0	0	96	0	96
20892	0	0	98	0	0	98
20893	0	98	0	0	0	98
20894	97	0	0	0	0	97
20895	0	94	0	0	0	94
20896	1	101	0	0	0	102
20897	100	0	0	0	0	100
20898	0	0	95	0	0	95
20899	0	1	99	0	0	100
20900	0	0	1	99	0	100
20901	95	0	0	0	0	95
20902	0	98	0	0	0	98
20903	96	0	0	0	0	96
20904	0	0	90	0	0	90
20905	0	94	0	0	0	94
20906	0	0	0	98	0	98
20907	0	0	98	0	0	98
20908	1	0	0	100	0	101
20909	0	0	0	98	0	98
20910	0	0	0	101	0	101
20911	0	0	0	100	0	100
20912	101	0	0	0	0	101
20913	101	0	0	0	0	101
20914	0	0	102	0	0	102
20915	94	0	0	0	0	94
20916	0	104	0	0	0	104
20917	97	0	0	0	0	97
20918	0	0	100	0	0	100
20919	0	0	0	103	0	103
20920	0	0	100	0	0	100
20921	0	0	105	0	0	105
20922	1	0	0	102	0	103
20923	0	0	0	103	0	103
20924	0	0	105	0	0	105
20925	0	97	0	0	0	97
20926	0	101	0	0	0	101
20927	0	0	0	103	0	103
20928	99	0	0	0	0	99
20929	0	103	0	0	0	103
20930	0	0	93	0	0	93
20931	0	0	89	0	0	89
20932	0	0	91	0	0	91
20933	0	0	0	92	0	92
20934	96	0	0	0	0	96
20935	0	98	0	0	0	98
20936	0	0	97	0	0	97
20937	0	99	0	0	0	99
20938	0	0	0	105	0	105
20939	0	0	103	0	0	103
20940	0	101	0	0	0	101
20941	0	0	0	106	0	106
20942	0	0	0	108	0	108
20943	0	0	106	0	0	106
20944	0	0	0	101	0	101
20945	0	105	0	0	0	105
20946	0	0	103	0	0	103
20947	104	0	0	0	0	104
20948	0	0	0	106	0	106
20949	0	0	0	110	0	110
20950	0	108	0	0	0	108
20951	109	0	0	0	0	109
20952	0	0	109	0	0	109
20953	111	0	0	0	0	111
20954	0	0	0	112	0	112
20955	0	112	0	0	0	112
20956	0	0	0	114	0	114
20957	0	0	0	112	0	112
20958	116	0	0	0	0	116
20959	115	0	0	0	0	115
20960	0	0	0	117	0	117
20961	0	0	117	0	0	117
20962	114	1	0	1	0	116
20963	0	116	0	0	0	116
20964	0	0	0	118	0	118
20965	0	0	0	115	0	115
20966	0	0	0	115	0	115
20967	1	0	114	0	0	115
20968	0	0	0	115	0	115
20969	0	115	0	0	0	115
20970	0	0	0	124	0	124
20971	0	120	0	0	0	120
20972	0	0	0	129	0	129
20973	0	0	131	0	0	131
20974	127	0	0	0	0	127
20975	0	0	0	137	0	137
20976	0	0	134	0	0	134
20977	0	144	0	0	0	144
20978	144	0	0	0	0	144
20979	0	0	138	0	0	138
20980	144	0	0	0	0	144
20981	0	0	0	140	0	140
20982	0	0	0	148	0	148
20983	0	143	0	0	0	143
20984	143	0	0	0	0	143
20985	136	0	0	0	0	136
20986	0	141	0	0	0	141
20987	0	0	0	147	0	147
20988	0	0	2	143	0	145
20989	0	0	0	147	0	147
20990	0	0	141	0	0	141
20991	147	0	0	0	0	147
20992	0	0	0	144	0	144
20993	0	0	0	143	0	143
20994	0	0	142	0	0	142
20995	0	0	138	0	0	138
20996	0	0	0	150	0	150
20997	0	0	147	0	0	147
20998	149	0	0	0	0	149
20999	0	0	0	143	0	143
21000	0	0	0	144	0	144
21001	0	0	141	0	0	141
21002	0	0	0	145	0	145
21003	1	0	136	0	0	137
21004	0	136	0	0	0	136
21005	139	2	0	0	0	141
21006	139	1	3	0	0	143
21007	0	136	0	0	0	136
21008	0	0	0	142	0	142
21009	0	0	141	0	0	141
21010	0	0	1	139	0	140
21011	139	1	0	0	0	140
21012	0	140	0	0	0	140
21013	145	0	0	0	0	145
21014	0	0	0	143	0	143
21015	140	0	0	0	0	140
21016	0	146	0	0	0	146
21017	153	0	0	0	0	153
21018	0	0	142	0	0	142
21019	0	146	0	0	0	146
21020	0	0	0	151	0	151
21021	148	0	0	0	0	148
21022	142	0	0	0	0	142
21023	0	0	0	142	0	142
21024	147	0	0	0	0	147
21025	145	0	0	0	0	145
21026	144	0	0	1	0	145
21027	0	0	0	144	0	144
21028	0	0	136	0	0	136
21029	0	0	126	0	0	126
21030	0	0	130	0	0	130
21031	139	0	0	0	0	139
21032	0	0	0	135	0	135
21033	0	135	0	0	0	135
21034	0	0	0	143	0	143
21035	0	133	0	0	0	133
21036	136	0	0	0	0	136
21037	0	0	0	136	0	136
21038	0	1	0	135	0	136
21039	134	0	0	0	0	134
21040	0	0	1	134	0	135
21041	0	0	0	135	0	135
21042	133	0	0	0	0	133
21043	0	0	133	0	0	133
21044	0	0	0	136	0	136
21045	0	0	129	0	0	129
21046	132	0	0	0	0	132
21047	0	0	0	129	0	129
21048	127	0	0	0	0	127
21049	0	0	0	127	0	127
21050	0	0	127	0	0	127
21051	0	0	0	116	0	116
21052	119	2	0	0	0	121
21053	0	129	0	0	0	129
21054	0	0	123	0	0	123
21055	123	0	0	2	0	125
21056	0	114	0	2	0	116
21057	0	113	0	0	0	113
21058	0	117	1	0	0	118
21059	0	0	0	124	0	124
21060	114	1	0	0	0	115
21061	120	0	0	0	0	120
21062	0	0	115	0	0	115
21063	117	0	0	0	0	117
21064	0	115	0	0	0	115
21065	0	0	0	113	0	113
21066	109	0	0	0	0	109
21067	113	0	0	0	0	113
21068	114	0	0	0	0	114
21069	109	0	0	0	0	109
21070	109	0	0	0	0	109
21071	0	0	0	107	0	107
21072	0	0	105	0	0	105
21073	1	0	0	100	0	101
21074	2	0	0	100	0	102
21075	100	0	0	0	0	100
21076	0	101	0	0	0	101
21077	103	0	0	0	0	103
21078	97	0	0	2	0	99
21079	102	0	0	0	0	102
21080	101	0	0	0	0	101
21081	0	0	102	0	0	102
21082	104	0	0	0	0	104
21083	108	0	0	0	0	108
21084	98	0	0	0	0	98
21085	105	0	0	0	0	105
21086	0	0	0	106	0	106
21087	0	0	104	0	0	104
21088	99	0	0	0	0	99
21089	0	97	0	0	0	97
21090	0	0	0	104	0	104
21091	0	99	0	1	0	100
21092	0	0	0	105	0	105
21093	104	0	0	0	0	104
21094	104	0	0	0	0	104
21095	107	0	0	0	0	107
21096	0	0	105	0	0	105
21097	105	0	0	0	0	105
21098	0	0	96	1	0	97
21099	1	0	86	0	0	87
21100	0	0	99	1	0	100
21101	0	0	0	94	0	94
21102	0	0	0	101	0	101
21103	0	0	0	96	0	96
21104	0	0	0	102	0	102
21105	0	0	0	109	0	109
21106	0	0	0	106	0	106
21107	0	107	0	0	0	107
21108	106	0	0	0	0	106
21109	0	101	0	0	0	101
21110	0	0	0	99	0	99
21111	0	0	0	100	0	100
21112	96	0	0	0	0	96
21113	0	95	0	0	0	95
21114	97	0	0	0	0	97
21115	0	0	0	98	0	98
21116	0	0	0	94	0	94
21117	0	0	0	94	0	94
21118	0	0	87	0	0	87
21119	0	0	0	87	0	87
21120	0	0	84	0	0	84
21121	1	0	81	0	0	82
21122	0	0	89	0	0	89
21123	0	0	0	90	0	90
21124	0	0	0	90	0	90
21125	0	0	0	90	0	90
21126	91	0	0	0	0	91
21127	0	0	0	87	0	87
21128	87	0	0	0	0	87
21129	0	92	0	0	0	92
21130	93	0	0	0	0	93
21131	95	0	0	0	0	95
21132	0	103	0	0	0	103
21133	101	0	0	0	0	101
21134	107	0	0	0	0	107
21135	107	0	0	0	0	107
21136	109	0	0	0	0	109
21137	0	0	107	0	0	107
21138	0	106	0	0	0	106
21139	0	0	0	112	0	112
21140	115	0	0	1	0	116
21141	0	0	116	0	0	116
21142	0	107	0	0	0	107
21143	0	0	0	112	0	112
21144	0	113	0	0	0	113
21145	0	0	0	114	0	114
21146	0	0	0	112	0	112
21147	0	0	114	0	0	114
21148	0	0	114	0	0	114
21149	114	0	0	0	0	114
21150	0	0	119	0	0	119
21151	0	0	118	0	0	118
21152	2	0	0	109	0	111
21153	0	0	0	119	0	119
21154	0	118	0	0	0	118
21155	0	119	0	0	0	119
21156	0	0	122	0	0	122
21157	0	0	0	118	0	118
21158	0	0	116	0	0	116
21159	0	0	115	0	0	115
21160	0	123	0	0	0	123
21161	0	0	0	130	0	130
21162	127	0	0	0	0	127
21163	0	0	0	123	0	123
21164	120	0	0	0	0	120
21165	129	0	0	0	0	129
21166	131	0	0	0	0	131
21167	0	0	131	0	0	131
21168	130	0	0	0	0	130
21169	0	0	0	132	0	132
21170	134	0	0	0	0	134
21171	144	0	0	0	0	144
21172	0	145	0	0	0	145
21173	147	0	0	0	0	147
21174	0	0	168	0	0	168
21175	168	0	0	0	0	168
21176	169	0	0	0	0	169
21177	0	169	0	0	0	169
21178	176	0	0	0	0	176
21179	0	0	0	181	0	181
21180	0	0	0	185	0	185
21181	0	192	0	0	0	192
21182	0	0	0	196	0	196
21183	0	0	0	199	0	199
21184	0	0	196	0	0	196
21185	0	0	179	0	0	179
21186	204	0	0	0	0	204
21187	201	0	0	0	0	201
21188	0	0	0	199	0	199
21189	0	0	207	0	0	207
21190	0	208	0	0	0	208
21191	0	0	0	216	0	216
21192	0	0	212	0	0	212
21193	222	0	0	0	0	222
21194	0	0	0	222	0	222
21195	0	228	0	0	0	228
21196	0	0	0	229	0	229
21197	0	0	0	231	0	231
21198	0	0	0	226	0	226
21199	224	0	0	0	0	224
21200	0	0	0	226	0	226
21201	230	0	0	0	0	230
21202	234	0	0	0	0	234
21203	0	0	224	0	0	224
21204	0	234	0	0	0	234
21205	0	0	0	237	0	237
21206	0	240	1	0	0	241
21207	258	0	0	0	0	258
21208	0	0	0	254	0	254
21209	0	0	253	0	0	253
21210	0	0	226	1	0	227
21211	0	1	255	0	0	256
21212	258	0	0	0	0	258
21213	0	263	0	0	0	263
21214	256	0	0	0	0	256
21215	0	259	0	0	0	259
21216	0	0	0	260	0	260
21217	0	0	0	267	0	267
21218	0	262	0	0	0	262
21219	0	0	255	0	0	255
21220	0	263	0	0	0	263
21221	269	0	0	0	0	269
21222	0	0	0	272	0	272
21223	1	0	265	0	0	266
21224	0	1	255	0	0	256
21225	0	0	0	252	0	252
21226	0	0	267	0	0	267
21227	0	0	254	0	0	254
21228	256	0	0	0	0	256
21229	0	257	0	0	0	257
21230	255	0	1	0	0	256
21231	0	0	255	2	0	257
21232	0	245	0	1	0	246
21233	0	256	0	0	0	256
21234	0	0	0	273	0	273
21235	1	0	0	264	0	265
21236	0	0	0	275	0	275
21237	0	0	266	0	0	266
21238	0	0	0	265	0	265
21239	0	0	0	268	0	268
21240	258	0	0	0	0	258
21241	0	261	0	0	0	261
21242	0	0	0	266	0	266
21243	262	0	0	0	0	262
21244	262	0	0	0	0	262
21245	0	0	0	262	0	262
21246	0	0	267	0	0	267
21247	2	0	0	267	0	269
21248	0	1	262	0	0	263
21249	266	0	0	1	0	267
21250	266	0	0	0	0	266
21251	0	0	0	274	0	274
21252	0	0	268	0	0	268
21253	0	259	0	0	0	259
21254	0	0	252	1	0	253
21255	1	0	0	260	0	261
21256	0	261	0	0	0	261
21257	269	0	0	0	0	269
21258	0	0	0	262	0	262
21259	0	261	0	0	0	261
21260	261	0	0	0	0	261
21261	0	0	0	259	0	259
21262	0	257	0	0	0	257
21263	0	0	0	259	0	259
21264	0	0	265	0	0	265
21265	258	0	0	0	0	258
21266	257	0	0	1	0	258
21267	0	0	241	0	0	241
21268	0	235	0	0	0	235
21269	241	0	0	0	0	241
21270	0	0	0	246	0	246
21271	0	0	0	241	0	241
21272	0	0	0	238	0	238
21273	0	0	0	232	0	232
21274	0	0	0	223	0	223
21275	225	0	0	1	0	226
21276	224	0	0	0	0	224
21277	0	0	0	227	0	227
21278	0	0	0	225	0	225
21279	0	0	221	0	0	221
21280	0	0	213	0	0	213
21281	225	0	0	0	0	225
21282	0	1	0	218	0	219
21283	0	0	205	0	0	205
21284	0	0	1	204	0	205
21285	201	0	0	0	0	201
21286	204	0	0	0	0	204
21287	0	0	0	215	0	215
21288	0	0	0	218	0	218
21289	208	0	0	0	0	208
21290	0	0	0	213	0	213
21291	0	207	0	0	0	207
21292	0	0	0	219	0	219
21293	0	2	0	212	0	214
21294	0	0	211	0	0	211
21295	1	0	204	0	0	205
21296	0	216	0	0	0	216
21297	213	0	0	0	0	213
21298	199	2	0	0	0	201
21299	206	0	0	1	0	207
21300	0	198	0	1	0	199
21301	0	204	0	0	0	204
21302	198	0	0	0	0	198
21303	0	198	0	0	0	198
21304	0	0	193	0	0	193
21305	0	191	0	1	0	192
21306	1	0	194	0	0	195
21307	201	0	0	0	0	201
21308	192	0	0	0	0	192
21309	0	208	0	0	0	208
21310	208	0	0	0	0	208
21311	205	0	0	0	0	205
21312	199	0	0	0	0	199
21313	0	0	0	209	0	209
21314	204	0	0	0	0	204
21315	0	0	194	0	0	194
21316	202	0	0	0	0	202
21317	0	0	0	205	0	205
21318	0	0	200	0	0	200
21319	1	0	191	0	0	192
21320	0	0	0	198	0	198
21321	0	0	1	199	0	200
21322	214	1	0	0	0	215
21323	0	0	0	213	0	213
21324	0	0	208	0	0	208
21325	2	0	0	195	0	197
21326	0	198	0	0	0	198
21327	199	0	0	1	0	200
21328	0	0	1	200	0	201
21329	0	0	202	1	0	203
21330	0	204	0	0	0	204
21331	213	0	0	0	0	213
21332	0	0	0	217	0	217
21333	0	0	218	0	0	218
21334	0	218	0	0	0	218
21335	227	0	0	0	0	227
21336	221	0	0	1	0	222
21337	222	0	0	0	0	222
21338	0	0	0	220	0	220
21339	0	0	0	223	0	223
21340	223	1	0	0	0	224
21341	0	228	0	0	0	228
21342	232	0	0	0	0	232
21343	1	0	0	229	0	230
21344	228	0	0	0	0	228
21345	0	0	0	230	0	230
21346	1	0	0	232	0	233
21347	0	0	0	229	0	229
21348	0	0	0	239	0	239
21349	0	0	229	0	0	229
21350	2	0	224	0	0	226
21351	239	0	0	0	0	239
21352	0	0	231	0	0	231
21353	0	0	227	0	0	227
21354	235	0	0	0	0	235
21355	227	0	0	0	0	227
21356	0	0	0	243	0	243
21357	239	0	0	0	0	239
21358	0	254	1	0	0	255
21359	262	0	0	0	0	262
21360	254	0	0	0	0	254
21361	262	0	0	0	0	262
21362	0	0	0	257	0	257
21363	0	244	0	1	0	245
21364	0	260	1	0	0	261
21365	267	0	0	0	0	267
21366	271	0	0	0	0	271
21367	0	0	0	286	0	286
21368	0	0	0	289	0	289
21369	0	290	1	0	0	291
21370	287	0	0	0	0	287
21371	0	0	275	0	0	275
21372	0	0	0	281	0	281
21373	0	0	0	287	0	287
21374	0	0	285	0	0	285
21375	0	0	0	287	0	287
21376	1	269	1	0	0	271
21377	0	0	0	292	0	292
21378	0	0	0	292	0	292
21379	0	267	0	0	0	267
21380	1	285	0	1	0	287
21381	0	0	0	291	0	291
21382	285	0	1	0	0	286
21383	0	0	0	278	0	278
21384	0	0	0	291	0	291
21385	0	280	0	0	0	280
21386	0	0	0	290	0	290
21387	0	0	0	289	0	289
21388	0	0	0	290	0	290
21389	291	0	0	0	0	291
21390	0	0	0	284	0	284
21391	0	0	0	290	0	290
21392	0	0	0	295	0	295
21393	0	0	289	0	0	289
21394	281	0	0	0	0	281
21395	0	289	0	0	0	289
21396	288	0	0	0	0	288
21397	0	0	0	291	0	291
21398	0	1	291	0	0	292
21399	282	0	0	0	0	282
21400	0	0	282	0	0	282
21401	0	0	0	289	0	289
21402	291	0	0	0	0	291
21403	292	0	0	0	0	292
21404	291	0	0	1	0	292
21405	0	0	0	288	0	288
21406	0	0	0	283	0	283
21407	1	0	0	284	0	285
21408	0	285	0	0	0	285
21409	0	271	0	1	0	272
21410	0	275	0	0	0	275
21411	0	292	1	0	0	293
21412	0	0	0	303	0	303
21413	1	0	0	304	0	305
21414	306	0	0	0	0	306
21415	299	0	0	0	0	299
21416	296	0	0	0	0	296
21417	1	0	0	287	0	288
21418	0	0	0	298	0	298
21419	296	0	0	0	0	296
21420	297	0	0	0	0	297
21421	0	0	294	0	0	294
21422	1	0	256	1	0	258
21423	1	0	257	0	0	258
21424	1	0	267	0	0	268
21425	0	0	0	275	0	275
21426	271	0	1	0	0	272
21427	0	272	0	0	0	272
21428	0	0	0	270	0	270
21429	0	1	269	0	0	270
21430	0	258	0	0	0	258
21431	0	0	0	274	0	274
21432	0	0	267	0	0	267
21433	0	0	0	266	0	266
21434	0	0	0	271	0	271
21435	264	0	0	0	0	264
21436	0	0	0	272	0	272
21437	0	0	265	0	0	265
21438	0	0	0	253	0	253
21439	0	257	0	1	0	258
21440	0	0	0	257	0	257
21441	0	0	0	259	0	259
21442	0	0	0	259	0	259
21443	252	0	0	0	0	252
21444	244	0	0	1	0	245
21445	246	0	0	0	0	246
21446	238	0	0	0	0	238
21447	0	0	242	0	0	242
21448	237	0	0	1	0	238
21449	240	1	0	0	0	241
21450	0	0	230	0	0	230
21451	0	0	219	0	0	219
21452	0	0	0	208	0	208
21453	0	212	0	0	0	212
21454	202	0	0	0	0	202
21455	200	0	0	0	0	200
21456	199	0	0	0	0	199
21457	0	0	0	191	0	191
21458	0	189	0	0	0	189
21459	181	0	0	0	0	181
21460	184	1	0	0	0	185
21461	0	0	0	179	0	179
21462	0	0	174	0	0	174
21463	177	0	0	0	0	177
21464	0	0	0	165	0	165
21465	170	0	0	0	0	170
21466	0	0	0	164	0	164
21467	0	0	151	0	0	151
21468	156	0	0	0	0	156
21469	0	0	0	156	0	156
21470	0	0	1	150	0	151
21471	0	0	0	152	0	152
21472	0	0	0	162	0	162
21473	159	0	0	0	0	159
21474	0	0	0	156	0	156
21475	0	151	0	1	0	152
21476	0	0	0	155	0	155
21477	0	151	0	0	0	151
21478	0	0	0	146	0	146
21479	0	0	0	146	0	146
21480	0	145	0	0	0	145
21481	1	0	0	145	0	146
21482	0	0	0	142	0	142
21483	144	0	0	0	0	144
21484	0	0	134	0	0	134
21485	0	0	0	139	0	139
21486	139	0	0	0	0	139
21487	140	0	0	0	0	140
21488	140	0	0	0	0	140
21489	0	0	131	0	0	131
21490	0	0	130	0	0	130
21491	0	0	0	137	0	137
21492	137	0	0	0	0	137
21493	0	0	120	0	0	120
21494	123	0	0	0	0	123
21495	0	126	0	0	0	126
21496	0	0	0	130	0	130
21497	1	0	0	125	0	126
21498	127	0	0	0	0	127
21499	0	0	0	123	0	123
21500	122	0	0	0	0	122
21501	121	0	0	0	0	121
21502	1	0	0	114	0	115
21503	1	0	0	114	0	115
21504	115	0	0	0	0	115
21505	0	0	112	0	0	112
21506	110	0	0	0	0	110
21507	0	0	113	0	0	113
21508	108	0	0	0	0	108
21509	109	0	0	0	0	109
21510	104	0	0	0	0	104
21511	105	0	0	0	0	105
21512	0	102	0	0	0	102
21513	102	0	0	0	0	102
21514	98	0	0	0	0	98
21515	0	102	0	0	0	102
21516	104	0	0	0	0	104
21517	0	0	100	0	0	100
21518	102	0	0	0	0	102
21519	0	0	101	0	0	101
21520	0	0	0	97	0	97
21521	0	0	0	105	0	105
21522	0	0	105	0	0	105
21523	1	0	0	99	0	100
21524	1	0	3	87	0	91
21525	102	0	0	0	0	102
21526	0	0	0	101	0	101
21527	0	0	0	98	0	98
21528	0	0	0	102	0	102
21529	0	94	0	0	0	94
21530	0	0	0	97	0	97
21531	99	0	0	0	0	99
21532	0	0	105	0	0	105
21533	0	0	0	111	0	111
21534	0	0	117	0	0	117
21535	114	0	0	0	0	114
21536	0	0	0	112	0	112
21537	0	0	126	0	0	126
21538	0	0	0	130	0	130
21539	0	0	0	152	0	152
21540	0	167	0	0	0	167
21541	0	0	0	168	0	168
21542	0	0	0	172	0	172
21543	0	0	172	0	0	172
21544	0	0	0	185	0	185
21545	0	0	0	187	0	187
21546	187	1	0	0	0	188
21547	177	0	0	0	0	177
21548	0	184	0	0	0	184
21549	190	0	0	1	0	191
21550	188	0	0	0	0	188
21551	0	189	0	0	0	189
21552	0	0	0	201	0	201
21553	198	0	0	0	0	198
21554	194	0	0	0	0	194
21555	190	0	0	1	0	191
21556	0	185	0	1	0	186
21557	0	0	187	0	0	187
21558	181	0	0	0	0	181
21559	173	0	0	0	0	173
21560	0	188	0	0	0	188
21561	186	0	0	0	0	186
21562	182	0	0	2	0	184
21563	0	0	0	181	0	181
21564	0	0	179	0	0	179
21565	0	0	0	177	0	177
21566	0	0	0	180	0	180
21567	0	0	0	179	0	179
21568	0	0	175	0	0	175
21569	0	0	0	177	0	177
21570	0	0	0	175	0	175
21571	0	0	0	180	0	180
21572	0	0	0	181	0	181
21573	1	0	0	179	0	180
21574	0	175	0	0	0	175
21575	0	0	0	179	0	179
21576	0	0	0	178	0	178
21577	0	0	179	0	0	179
21578	0	0	0	184	0	184
21579	0	0	0	186	0	186
21580	0	0	0	183	0	183
21581	0	0	0	187	0	187
21582	179	2	0	0	0	181
21583	0	0	0	182	0	182
21584	0	0	0	186	0	186
21585	0	0	178	0	0	178
21586	0	164	0	0	0	164
21587	0	180	0	0	0	180
21588	180	0	0	0	0	180
21589	0	182	0	0	0	182
21590	0	0	0	185	0	185
21591	185	0	0	0	0	185
21592	0	0	181	0	0	181
21593	0	0	0	185	0	185
21594	0	172	0	0	0	172
21595	0	0	0	183	0	183
21596	0	176	0	0	0	176
21597	0	0	0	187	0	187
21598	186	0	0	0	0	186
21599	0	0	183	0	0	183
21600	1	0	0	182	0	183
21601	0	179	0	0	0	179
21602	184	0	0	0	0	184
21603	0	0	176	0	0	176
21604	0	0	0	170	0	170
21605	0	0	173	0	0	173
21606	0	0	0	178	0	178
21607	0	0	179	0	0	179
21608	0	0	0	177	0	177
21609	0	0	0	176	0	176
21610	177	0	0	0	0	177
21611	178	0	0	0	0	178
21612	0	0	0	179	0	179
21613	0	173	0	0	0	173
21614	1	0	0	176	0	177
21615	0	0	0	181	0	181
21616	174	0	0	0	0	174
21617	0	168	0	0	0	168
21618	166	0	0	0	0	166
21619	172	0	0	0	0	172
21620	0	137	0	0	0	137
21621	0	158	0	0	0	158
21622	172	0	0	0	0	172
21623	0	0	168	1	0	169
21624	163	0	0	0	0	163
21625	157	0	0	1	0	158
21626	0	152	0	1	0	153
21627	0	0	0	148	0	148
21628	0	138	0	0	0	138
21629	132	0	0	0	0	132
21630	132	0	0	0	0	132
21631	0	0	0	130	0	130
21632	0	0	0	102	0	102
21633	76	0	0	0	0	76
21634	0	92	0	1	0	93
21635	0	75	0	0	0	75
21636	0	56	0	0	0	56
21637	0	48	0	0	0	48
21638	0	55	0	0	0	55
21639	0	0	0	45	0	45
21640	0	0	44	0	0	44
21641	0	43	0	0	0	43
21642	41	0	0	0	0	41
21643	0	0	0	40	0	40
21644	39	0	0	0	0	39
21645	0	38	0	0	0	38
21646	38	0	0	0	0	38
21647	0	37	0	0	0	37
21648	0	0	0	39	0	39
21649	39	0	0	0	0	39
21650	38	0	0	0	0	38
21651	0	0	0	39	0	39
21652	0	0	0	37	0	37
21653	0	34	0	0	0	34
21654	0	0	0	36	0	36
21655	0	0	0	36	0	36
21656	0	0	0	38	0	38
21657	0	34	0	0	0	34
21658	35	0	0	0	0	35
21659	0	31	0	0	0	31
21660	36	0	0	0	0	36
21661	0	31	0	0	0	31
21662	0	0	36	0	0	36
21663	0	0	0	35	0	35
21664	0	0	33	0	0	33
21665	0	0	33	0	0	33
21666	0	0	0	30	0	30
21667	0	0	29	0	0	29
21668	0	0	0	28	0	28
21669	0	0	0	27	0	27
21670	0	0	0	21	0	21
21671	15	0	0	0	0	15
21672	0	0	0	14	0	14
21673	0	0	0	14	0	14
21674	13	0	0	0	0	13
21675	0	13	0	0	0	13
21676	0	10	0	0	0	10
21677	0	12	0	0	0	12
21678	0	0	0	12	0	12
21679	0	0	13	0	0	13
21680	12	0	0	0	0	12
21681	0	11	0	0	0	11
21682	11	0	0	0	0	11
21683	11	0	0	0	0	11
21684	9	0	0	0	0	9
21685	0	0	9	0	0	9
21686	0	0	0	9	0	9
21687	0	0	0	9	0	9
21688	0	0	0	9	0	9
21689	0	0	0	9	0	9
21690	0	8	0	0	0	8
21691	8	0	0	0	0	8
21692	0	0	8	0	0	8
21693	8	0	0	0	0	8
21694	0	0	0	8	0	8
21695	0	7	0	0	0	7
21696	0	8	0	0	0	8
21697	0	0	0	8	0	8
21698	0	8	0	0	0	8
21699	7	0	0	0	0	7
21700	0	0	6	0	0	6
21701	0	0	0	5	0	5
21702	0	0	0	5	0	5
21703	0	0	0	5	0	5
21704	0	0	0	5	0	5
21705	5	0	0	0	0	5
21706	0	5	0	0	0	5
21707	4	0	0	0	0	4
21708	0	0	0	4	0	4
21709	0	0	0	4	0	4
21710	0	4	0	0	0	4
21711	4	0	0	0	0	4
21712	4	0	0	0	0	4
21713	0	4	0	0	0	4
21714	0	0	0	4	0	4
21715	0	4	0	0	0	4
21716	4	0	0	0	0	4
21717	0	0	4	0	0	4
21718	0	0	4	0	0	4
21719	5	0	0	0	0	5
21720	0	5	0	0	0	5
21721	0	0	0	5	0	5
21722	0	0	0	5	0	5
21723	0	0	5	0	0	5
21724	0	0	0	5	0	5
21725	0	0	0	5	0	5
21726	0	4	0	0	0	4
21727	0	0	0	5	0	5
21728	0	0	0	5	0	5
21729	5	0	0	0	0	5
21730	0	1	0	0	0	1
21731	0	1	0	0	0	1
21732	0	0	0	1	0	1
21733	0	0	0	0	0
21734	0	0	0	4	0	4
21735	0	4	0	0	0	4
21736	0	0	0	4	0	4
21737	0	0	0	4	0	4
21738	0	0	0	5	0	5
21739	0	0	0	5	0	5
21740	0	5	0	0	0	5
21741	0	5	0	0	0	5
21742	7	0	0	0	0	7
21743	6	0	0	0	0	6
21744	0	0	0	7	0	7
21745	0	0	8	0	0	8
21746	0	0	0	8	0	8
21747	0	0	0	9	0	9
21748	7	0	0	0	0	7
21749	0	9	0	0	0	9
21750	0	0	0	9	0	9
21751	0	0	0	9	0	9
21752	0	0	9	0	0	9
21753	0	0	8	0	0	8
21754	0	0	0	10	0	10
21755	0	0	1	9	0	10
21756	0	9	0	0	0	9
21757	0	10	0	0	0	10
21758	10	0	1	0	0	11
21759	0	0	0	11	0	11
21760	0	0	12	0	0	12
21761	0	11	0	0	0	11
21762	0	0	0	12	0	12
21763	12	0	0	0	0	12
21764	0	0	0	11	0	11
21765	12	0	0	0	0	12
21766	0	11	0	0	0	11
21767	12	0	0	0	0	12
21768	0	0	0	12	0	12
21769	0	0	11	0	0	11
21770	0	0	0	11	0	11
21771	0	12	0	0	0	12
21772	0	0	0	12	0	12
21773	0	13	0	0	0	13
21774	0	0	0	14	0	14
21775	0	0	12	0	0	12
21776	0	0	13	0	0	13
21777	0	0	11	0	0	11
21778	12	0	0	0	0	12
21779	0	13	0	0	0	13
21780	0	12	0	0	0	12
21781	13	0	0	0	0	13
21782	13	0	0	0	0	13
21783	0	0	0	13	0	13
21784	0	0	12	1	0	13
21785	0	0	8	0	0	8
21786	0	0	0	10	0	10
21787	11	0	0	0	0	11
21788	0	11	0	0	0	11
21789	0	0	0	12	0	12
21790	13	0	0	0	0	13
21791	12	0	0	0	0	12
21792	0	0	15	0	0	15
21793	15	0	0	0	0	15
21794	0	0	15	0	0	15
21795	0	0	14	0	0	14
21796	0	0	0	16	0	16
21797	0	0	0	16	0	16
21798	0	0	0	18	0	18
21799	0	0	19	0	0	19
21800	20	0	0	0	0	20
21801	0	0	0	22	0	22
21802	21	0	0	0	0	21
21803	20	0	0	1	0	21
21804	0	22	0	0	0	22
21805	0	19	0	0	0	19
21806	0	20	0	0	0	20
21807	0	0	0	22	0	22
21808	0	0	22	0	0	22
21809	0	0	0	22	0	22
21810	0	22	0	0	0	22
21811	0	21	0	0	0	21
21812	0	0	0	21	0	21
21813	20	0	0	0	0	20
21814	0	22	0	0	0	22
21815	0	21	0	0	0	21
21816	22	0	0	0	0	22
21817	0	0	0	18	0	18
21818	0	0	0	22	0	22
21819	0	0	0	23	0	23
21820	21	0	0	0	0	21
21821	23	0	0	0	0	23
21822	0	0	0	22	0	22
21823	0	0	24	0	0	24
21824	24	0	0	0	0	24
21825	0	0	0	23	0	23
21826	0	0	26	0	0	26
21827	0	0	25	0	0	25
21828	0	0	0	22	0	22
21829	0	0	25	0	0	25
21830	0	0	0	23	0	23
21831	0	0	0	25	0	25
21832	0	0	0	25	0	25
21833	24	0	0	0	0	24
21834	0	0	0	22	0	22
21835	0	0	0	24	0	24
21836	0	0	0	24	0	24
21837	0	0	0	22	0	22
21838	0	0	23	0	0	23
21839	0	23	0	0	0	23
21840	0	0	0	22	0	22
21841	0	0	0	21	0	21
21842	0	21	0	0	0	21
21843	0	22	0	0	0	22
21844	20	0	0	0	0	20
21845	0	24	0	0	0	24
21846	0	0	0	25	0	25
21847	0	0	25	0	0	25
21848	25	0	0	0	0	25
21849	0	0	25	0	0	25
21850	25	0	0	0	0	25
21851	24	0	0	0	0	24
21852	0	0	23	0	0	23
21853	0	0	0	23	0	23
21854	0	19	0	0	0	19
21855	0	0	0	22	0	22
21856	23	0	0	0	0	23
21857	23	0	0	0	0	23
21858	0	23	0	0	0	23
21859	21	0	0	0	0	21
21860	0	0	0	22	0	22
21861	22	0	0	0	0	22
21862	23	0	0	0	0	23
21863	0	0	0	24	0	24
21864	27	0	0	0	0	27
21865	28	0	0	0	0	28
21866	0	0	27	0	0	27
21867	28	0	0	0	0	28
21868	0	0	26	0	0	26
21869	0	0	25	0	0	25
21870	0	26	0	0	0	26
21871	0	0	0	30	0	30
21872	0	0	28	0	0	28
21873	0	0	27	0	0	27
21874	34	0	0	0	0	34
21875	0	0	0	32	0	32
21876	0	0	0	34	0	34
21877	0	0	0	30	0	30
21878	0	0	0	34	0	34
21879	0	0	0	35	0	35
21880	0	0	37	0	0	37
21881	0	0	38	0	0	38
21882	0	0	0	38	0	38
21883	37	0	0	0	0	37
21884	0	36	0	0	0	36
21885	0	0	0	37	0	37
21886	35	0	0	0	0	35
21887	0	35	0	0	0	35
21888	0	0	0	34	0	34
21889	0	0	0	36	0	36
21890	0	0	0	43	0	43
21891	44	0	0	0	0	44
21892	0	0	40	0	0	40
21893	39	0	0	0	0	39
21894	0	0	0	36	0	36
21895	0	1	0	40	0	41
21896	0	47	0	0	0	47
21897	0	0	46	0	0	46
21898	47	0	0	0	0	47
21899	47	0	0	0	0	47
21900	0	1	47	0	0	48
21901	45	0	0	0	0	45
21902	0	43	0	0	0	43
21903	0	42	0	0	0	42
21904	0	45	0	0	0	45
21905	45	0	0	0	0	45
21906	0	0	46	0	0	46
21907	0	0	0	46	0	46
21908	0	45	0	0	0	45
21909	0	44	0	0	0	44
21910	0	47	0	0	0	47
21911	0	0	0	47	0	47
21912	47	0	0	0	0	47
21913	0	44	0	0	0	44
21914	0	0	0	47	0	47
21915	0	0	0	46	0	46
21916	46	0	0	0	0	46
21917	0	0	0	46	0	46
21918	0	0	0	46	0	46
21919	0	0	44	0	0	44
21920	0	0	0	41	0	41
21921	0	0	0	44	0	44
21922	44	0	0	0	0	44
21923	42	0	0	0	0	42
21924	0	0	0	42	0	42
21925	42	0	0	0	0	42
21926	43	0	0	0	0	43
21927	0	45	0	0	0	45
21928	0	0	40	0	0	40
21929	0	40	0	0	0	40
21930	0	0	0	39	0	39
21931	40	0	0	0	0	40
21932	0	43	0	0	0	43
21933	0	0	0	44	0	44
21934	42	0	0	0	0	42
21935	43	0	0	0	0	43
21936	0	0	0	43	0	43
21937	0	0	44	0	0	44
21938	0	0	0	41	0	41
21939	0	0	0	39	0	39
21940	0	0	40	0	0	40
21941	0	0	0	40	0	40
21942	0	0	0	40	0	40
21943	40	0	0	0	0	40
21944	0	0	0	39	0	39
21945	0	0	0	42	0	42
21946	42	0	0	0	0	42
21947	40	0	0	0	0	40
21948	39	0	0	0	0	39
21949	0	0	37	0	0	37
21950	0	0	0	37	0	37
21951	0	37	0	0	0	37
21952	0	0	0	40	0	40
21953	0	0	41	0	0	41
21954	0	0	0	41	0	41
21955	0	0	41	0	0	41
21956	38	0	0	0	0	38
21957	35	0	0	0	0	35
21958	0	0	0	37	0	37
21959	0	0	0	35	0	35
21960	0	0	0	37	0	37
21961	0	39	0	0	0	39
21962	41	0	0	0	0	41
21963	40	0	0	0	0	40
21964	0	0	0	38	0	38
21965	0	0	0	40	0	40
21966	0	0	0	42	0	42
21967	0	0	0	40	0	40
21968	0	0	41	0	0	41
21969	1	0	0	38	0	39
21970	37	0	0	0	0	37
21971	39	0	0	0	0	39
21972	0	0	0	42	0	42
21973	1	0	38	0	0	39
21974	38	0	0	0	0	38
21975	0	0	0	34	0	34
21976	0	35	0	0	0	35
21977	0	36	0	0	0	36
21978	38	0	0	0	0	38
21979	0	0	0	36	0	36
21980	0	0	0	37	0	37
21981	0	0	0	38	0	38
21982	0	0	0	36	0	36
21983	0	0	0	30	0	30
21984	0	0	30	0	0	30
21985	0	0	22	0	0	22
21986	0	0	26	0	0	26
21987	0	0	0	29	0	29
21988	0	0	29	0	0	29
21989	0	0	0	23	0	23
21990	0	0	0	21	0	21
21991	0	0	0	23	0	23
21992	21	0	0	0	0	21
21993	0	0	0	23	0	23
21994	0	0	0	26	0	26
21995	25	0	0	0	0	25
21996	0	23	0	0	0	23
21997	0	26	0	0	0	26
21998	26	0	0	0	0	26
21999	0	23	0	0	0	23
22000	23	0	0	0	0	23
22001	24	0	0	0	0	24
22002	25	0	0	0	0	25
22003	25	0	0	0	0	25
22004	25	0	0	0	0	25
22005	0	25	0	0	0	25
22006	25	0	0	0	0	25
22007	25	0	0	0	0	25
22008	0	24	0	0	0	24
22009	24	0	0	0	0	24
22010	24	0	0	0	0	24
22011	25	0	0	0	0	25
22012	25	0	0	0	0	25
22013	0	0	22	0	0	22
22014	0	0	0	24	0	24
22015	0	0	0	26	0	26
22016	0	0	25	0	0	25
22017	0	0	24	0	0	24
22018	26	0	0	0	0	26
22019	0	0	0	25	0	25
22020	0	0	21	0	0	21
22021	0	0	21	0	0	21
22022	21	0	0	0	0	21
22023	22	0	0	0	0	22
22024	19	0	0	0	0	19
22025	0	0	22	0	0	22
22026	0	0	0	20	0	20
22027	0	0	21	0	0	21
22028	21	0	0	0	0	21
22029	0	0	21	0	0	21
22030	0	0	0	19	0	19
22031	0	0	0	21	0	21
22032	0	22	0	0	0	22
22033	21	0	0	0	0	21
22034	0	0	19	0	0	19
22035	20	0	0	0	0	20
22036	0	0	21	0	0	21
22037	0	0	0	20	0	20
22038	0	0	0	17	0	17
22039	0	0	0	20	0	20
22040	20	0	0	0	0	20
22041	0	0	1	21	0	22
22042	0	0	0	22	0	22
22043	0	21	0	0	0	21
22044	0	0	0	22	0	22
22045	22	0	0	0	0	22
22046	0	0	19	0	0	19
22047	0	0	0	19	0	19
22048	0	0	18	0	0	18
22049	0	16	0	0	0	16
22050	0	0	15	0	0	15
22051	23	0	0	0	0	23
22052	23	0	0	0	0	23
22053	0	0	0	22	0	22
22054	18	0	0	0	0	18
22055	21	0	0	0	0	21
22056	0	0	0	21	0	21
22057	0	0	0	19	0	19
22058	0	0	18	0	0	18
22059	0	16	0	0	0	16
22060	17	0	0	0	0	17
22061	0	19	0	0	0	19
22062	0	0	0	19	0	19
22063	0	0	0	18	0	18
22064	0	0	0	21	0	21
22065	0	0	0	19	0	19
22066	0	0	18	0	0	18
22067	19	0	0	0	0	19
22068	17	0	0	0	0	17
22069	0	0	0	19	0	19
22070	19	0	0	0	0	19
22071	0	0	0	19	0	19
22072	0	0	19	0	0	19
22073	0	0	0	18	0	18
22074	0	18	0	0	0	18
22075	0	0	0	19	0	19
22076	0	19	0	0	0	19
22077	0	0	0	19	0	19
22078	0	19	0	0	0	19
22079	19	0	0	0	0	19
22080	0	0	18	0	0	18
22081	0	16	0	0	0	16
22082	0	16	0	0	0	16
22083	0	0	0	16	0	16
22084	0	0	0	18	0	18
22085	0	0	0	18	0	18
22086	0	0	0	18	0	18
22087	0	15	0	0	0	15
22088	0	0	0	15	0	15
22089	0	0	0	16	0	16
22090	16	0	0	0	0	16
22091	0	0	0	16	0	16
22092	0	0	15	0	0	15
22093	0	0	14	0	0	14
22094	13	0	0	0	0	13
22095	0	12	0	0	0	12
22096	0	12	0	0	0	12
22097	0	0	0	13	0	13
22098	0	0	0	13	0	13
22099	0	0	13	0	0	13
22100	13	0	0	0	0	13
22101	13	0	0	0	0	13
22102	0	0	13	0	0	13
22103	0	0	13	0	0	13
22104	13	0	0	0	0	13
22105	13	0	0	0	0	13
22106	13	0	0	0	0	13
22107	12	0	0	0	0	12
22108	0	12	0	0	0	12
22109	12	0	0	0	0	12
22110	0	0	11	0	0	11
22111	0	0	10	0	0	10
22112	0	0	12	0	0	12
22113	0	0	0	12	0	12
22114	10	0	0	0	0	10
22115	14	0	0	0	0	14
22116	0	0	0	16	0	16
22117	0	0	0	16	0	16
22118	0	0	0	16	0	16
22119	0	15	0	0	0	15
22120	17	0	0	0	0	17
22121	18	0	0	0	0	18
22122	16	0	0	0	0	16
22123	18	0	0	0	0	18
22124	18	0	0	0	0	18
22125	0	0	0	18	0	18
22126	0	18	0	0	0	18
22127	0	0	0	18	0	18
22128	0	0	0	18	0	18
22129	14	0	0	0	0	14
22130	0	0	17	0	0	17
22131	0	0	17	0	0	17
22132	0	0	17	0	0	17
22133	19	0	0	0	0	19
22134	18	0	0	0	0	18
22135	0	0	0	17	0	17
22136	0	0	0	16	0	16
22137	0	0	0	18	0	18
22138	0	0	17	0	0	17
22139	0	0	0	18	0	18
22140	0	0	19	0	0	19
22141	0	0	0	18	0	18
22142	0	0	0	18	0	18
22143	0	0	0	19	0	19
22144	14	0	0	0	0	14
22145	15	0	0	0	0	15
22146	0	0	14	0	0	14
22147	15	0	0	0	0	15
22148	15	0	0	0	0	15
22149	0	0	0	14	0	14
22150	14	0	0	0	0	14
22151	0	0	0	15	0	15
22152	0	0	0	15	0	15
22153	0	0	15	0	0	15
22154	13	0	0	0	0	13
22155	0	0	0	14	0	14
22156	0	0	13	0	0	13
22157	0	0	12	0	0	12
22158	0	0	0	12	0	12
22159	0	0	0	12	0	12
22160	11	0	2	0	0	13
22161	0	0	0	13	0	13
22162	0	0	0	13	0	13
22163	0	0	0	12	0	12
22164	0	0	0	13	0	13
22165	13	0	0	0	0	13
22166	13	0	0	0	0	13
22167	13	0	0	0	0	13
22168	12	0	0	0	0	12
22169	0	0	0	14	0	14
22170	15	0	0	0	0	15
22171	0	0	0	14	0	14
22172	15	0	0	0	0	15
22173	0	0	0	14	0	14
22174	0	0	0	17	0	17
22175	0	15	0	0	0	15
22176	0	0	0	20	0	20
22177	20	0	0	0	0	20
22178	20	0	0	0	0	20
22179	0	0	22	0	0	22
22180	0	23	0	0	0	23
22181	23	0	0	0	0	23
22182	0	22	0	0	0	22
22183	22	0	0	0	0	22
22184	0	24	0	0	0	24
22185	0	0	24	0	0	24
22186	0	22	1	0	0	23
22187	0	21	0	0	0	21
22188	0	0	0	24	0	24
22189	25	0	0	0	0	25
22190	0	0	0	24	0	24
22191	0	0	0	25	0	25
22192	25	0	0	0	0	25
22193	23	0	0	0	0	23
22194	0	0	0	22	0	22
22195	0	0	0	23	0	23
22196	0	0	0	25	0	25
22197	23	0	0	0	0	23
22198	0	0	25	0	0	25
22199	0	0	0	30	0	30
22200	0	0	30	0	0	30
22201	0	29	0	0	0	29
22202	0	0	28	0	0	28
22203	0	0	0	31	0	31
22204	0	0	30	0	0	30
22205	29	0	0	0	0	29
22206	0	0	0	31	0	31
22207	0	30	0	0	0	30
22208	0	0	0	29	0	29
22209	0	28	0	0	0	28
22210	0	25	0	0	0	25
22211	0	27	0	0	0	27
22212	0	0	0	27	0	27
22213	0	28	0	0	0	28
22214	27	0	0	0	0	27
22215	0	0	28	0	0	28
22216	0	0	26	0	0	26
22217	0	0	28	0	0	28
22218	0	0	0	27	0	27
22219	0	0	0	27	0	27
22220	0	0	0	28	0	28
22221	0	0	0	28	0	28
22222	0	0	0	28	0	28
22223	0	27	0	0	0	27
22224	0	0	27	0	0	27
22225	2	0	24	0	0	26
22226	0	27	0	0	0	27
22227	0	0	0	27	0	27
22228	0	0	0	25	0	25
22229	0	0	0	27	0	27
22230	27	0	0	0	0	27
22231	0	0	27	0	0	27
22232	27	0	0	0	0	27
22233	27	0	0	0	0	27
22234	0	26	0	0	0	26
22235	0	25	0	0	0	25
22236	28	0	0	0	0	28
22237	0	0	0	28	0	28
22238	0	0	0	28	0	28
22239	0	0	26	0	0	26
22240	0	0	27	0	0	27
22241	0	0	0	28	0	28
22242	27	0	0	0	0	27
22243	0	0	27	0	0	27
22244	27	0	0	0	0	27
22245	0	0	0	28	0	28
22246	0	0	0	28	0	28
22247	0	0	0	28	0	28
22248	0	0	28	0	0	28
22249	0	29	0	0	0	29
22250	0	25	0	0	0	25
22251	29	0	0	0	0	29
22252	29	0	0	0	0	29
22253	0	0	0	29	0	29
22254	29	0	0	0	0	29
22255	0	0	28	0	0	28
22256	0	0	28	0	0	28
22257	0	0	0	29	0	29
22258	28	0	0	0	0	28
22259	0	0	0	28	0	28
22260	0	0	0	29	0	29
22261	28	0	0	0	0	28
22262	26	0	0	0	0	26
22263	0	26	1	0	0	27
22264	24	0	0	0	0	24
22265	0	0	0	26	0	26
22266	0	26	0	0	0	26
22267	24	0	0	0	0	24
22268	0	24	0	0	0	24
22269	0	0	0	21	0	21
22270	21	0	0	0	0	21
22271	0	0	19	0	0	19
22272	0	0	20	0	0	20
22273	0	0	0	18	0	18
22274	0	0	0	19	0	19
22275	0	0	0	20	0	20
22276	0	17	0	0	0	17
22277	18	0	0	0	0	18
22278	17	0	0	0	0	17
22279	19	0	0	0	0	19
22280	0	19	0	0	0	19
22281	0	0	0	18	0	18
22282	0	0	0	19	0	19
22283	0	0	0	19	0	19
22284	18	0	0	0	0	18
22285	0	18	0	0	0	18
22286	0	0	0	19	0	19
22287	0	0	0	19	0	19
22288	0	0	18	0	0	18
22289	0	18	0	0	0	18
22290	0	0	0	19	0	19
22291	0	0	0	18	0	18
22292	0	0	0	14	0	14
22293	13	0	0	0	0	13
22294	0	13	0	0	0	13
22295	13	0	0	0	0	13
22296	0	0	0	14	0	14
22297	14	0	0	0	0	14
22298	0	0	15	0	0	15
22299	14	0	0	0	0	14
22300	15	0	0	0	0	15
22301	0	0	16	0	0	16
22302	0	0	0	16	0	16
22303	0	0	0	17	0	17
22304	16	0	0	0	0	16
22305	0	0	0	16	0	16
22306	0	0	0	15	0	15
22307	0	0	0	15	0	15
22308	0	0	11	0	0	11
22309	14	0	0	0	0	14
22310	0	13	0	0	0	13
22311	0	0	0	12	0	12
22312	0	14	0	0	0	14
22313	0	17	0	0	0	17
22314	0	0	0	17	0	17
22315	0	0	17	0	0	17
22316	0	0	18	0	0	18
22317	0	0	0	19	0	19
22318	0	0	18	0	0	18
22319	19	0	0	0	0	19
22320	0	0	0	19	0	19
22321	0	0	0	20	0	20
22322	0	19	0	0	0	19
22323	0	0	0	19	0	19
22324	0	0	0	23	0	23
22325	0	21	0	0	0	21
22326	0	0	0	20	0	20
22327	0	0	0	23	0	23
22328	0	22	0	0	0	22
22329	20	0	0	0	0	20
22330	0	0	21	0	0	21
22331	0	0	20	0	0	20
22332	0	0	0	20	0	20
22333	0	0	0	18	0	18
22334	0	0	19	0	0	19
22335	0	0	22	0	0	22
22336	22	0	0	0	0	22
22337	0	21	0	0	0	21
22338	21	0	2	0	0	23
22339	0	0	22	0	0	22
22340	0	21	0	0	0	21
22341	0	0	0	22	0	22
22342	0	0	23	0	0	23
22343	0	0	23	0	0	23
22344	0	0	0	20	0	20
22345	0	0	20	0	0	20
22346	0	20	0	0	0	20
22347	0	0	0	20	0	20
22348	0	0	19	0	0	19
22349	0	22	0	0	0	22
22350	22	0	0	0	0	22
22351	0	0	21	0	0	21
22352	0	21	0	0	0	21
22353	0	0	0	22	0	22
22354	0	0	0	22	0	22
22355	22	0	0	0	0	22
22356	0	0	0	21	0	21
22357	0	0	0	22	0	22
22358	20	0	0	0	0	20
22359	0	0	0	21	0	21
22360	0	0	22	0	0	22
22361	0	0	0	21	0	21
22362	0	0	22	0	0	22
22363	0	0	19	0	0	19
22364	0	0	22	0	0	22
22365	0	0	0	21	0	21
22366	0	0	0	22	0	22
22367	19	0	0	0	0	19
22368	0	0	0	19	0	19
22369	0	21	0	0	0	21
22370	0	0	0	21	0	21
22371	0	0	0	20	0	20
22372	0	22	0	0	0	22
22373	21	0	0	0	0	21
22374	21	0	0	0	0	21
22375	0	18	0	0	0	18
22376	0	17	0	0	0	17
22377	0	0	0	21	0	21
22378	21	0	0	0	0	21
22379	0	0	22	0	0	22
22380	0	0	19	0	0	19
22381	21	0	0	0	0	21
22382	0	22	0	0	0	22
22383	0	0	0	24	0	24
22384	0	0	0	21	0	21
22385	0	0	0	22	0	22
22386	0	0	0	23	0	23
22387	0	23	0	0	0	23
22388	0	0	0	25	0	25
22389	24	0	0	0	0	24
22390	0	0	0	25	0	25
22391	0	0	0	25	0	25
22392	25	0	0	0	0	25
22393	23	0	0	0	0	23
22394	23	0	0	0	0	23
22395	23	0	0	0	0	23
22396	0	0	0	23	0	23
22397	23	0	0	0	0	23
22398	0	0	0	23	0	23
22399	23	0	0	0	0	23
22400	22	0	0	0	0	22
22401	0	0	0	23	0	23
22402	0	0	23	0	0	23
22403	23	0	0	0	0	23
22404	23	0	0	0	0	23
22405	21	0	0	0	0	21
22406	21	0	0	0	0	21
22407	0	0	0	20	0	20
22408	0	0	20	0	0	20
22409	0	0	18	0	0	18
22410	19	0	0	0	0	19
22411	18	0	0	0	0	18
22412	0	13	0	1	0	14
22413	0	15	0	0	0	15
22414	13	0	0	0	0	13
22415	0	0	0	13	0	13
22416	0	0	0	15	0	15
22417	13	0	0	0	0	13
22418	0	15	0	0	0	15
22419	13	0	0	0	0	13
22420	0	0	14	0	0	14
22421	14	0	0	0	0	14
22422	0	0	0	15	0	15
22423	0	0	17	0	0	17
22424	0	17	0	0	0	17
22425	0	0	0	23	0	23
22426	0	0	23	0	0	23
22427	0	0	0	22	0	22
22428	24	0	0	0	0	24
22429	0	0	24	0	0	24
22430	24	0	0	0	0	24
22431	0	23	0	0	0	23
22432	0	0	0	23	0	23
22433	0	0	23	0	0	23
22434	0	0	0	21	0	21
22435	0	0	21	0	0	21
22436	0	20	0	0	0	20
22437	21	0	0	0	0	21
22438	0	22	0	0	0	22
22439	0	0	0	22	0	22
22440	0	0	0	21	0	21
22441	0	0	23	0	0	23
22442	20	0	0	0	0	20
22443	0	21	0	1	0	22
22444	0	21	0	0	0	21
22445	0	22	0	0	0	22
22446	0	0	0	22	0	22
22447	0	21	0	0	0	21
22448	0	0	0	21	0	21
22449	0	21	0	0	0	21
22450	0	0	0	22	0	22
22451	0	22	0	0	0	22
22452	22	0	0	0	0	22
22453	0	0	21	0	0	21
22454	21	0	0	0	0	21
22455	21	0	0	0	0	21
22456	25	0	0	0	0	25
22457	0	26	0	0	0	26
22458	26	0	0	0	0	26
22459	26	0	0	0	0	26
22460	28	0	0	0	0	28
22461	0	0	25	0	0	25
22462	0	0	0	25	0	25
22463	0	0	25	0	0	25
22464	0	0	0	26	0	26
22465	27	0	0	0	0	27
22466	0	25	0	0	0	25
22467	0	0	25	0	0	25
22468	0	0	0	28	0	28
22469	0	0	0	28	0	28
22470	0	0	26	0	0	26
22471	29	0	0	0	0	29
22472	28	0	0	0	0	28
22473	29	0	0	0	0	29
22474	0	0	0	25	0	25
22475	0	25	0	0	0	25
22476	0	27	0	0	0	27
22477	0	0	0	27	0	27
22478	0	0	0	28	0	28
22479	0	23	0	4	0	27
22480	26	0	0	0	0	26
22481	0	22	0	0	0	22
22482	0	0	0	24	0	24
22483	0	0	25	0	0	25
22484	0	0	0	23	0	23
22485	27	0	0	1	0	28
22486	0	0	29	0	0	29
22487	29	0	0	0	0	29
22488	27	0	0	0	0	27
22489	28	0	0	0	0	28
22490	28	0	0	0	0	28
22491	27	0	0	0	0	27
22492	0	0	23	0	0	23
22493	0	0	27	0	0	27
22494	29	0	0	0	0	29
22495	26	0	0	0	0	26
22496	0	0	0	29	0	29
22497	0	27	0	0	0	27
22498	0	0	0	29	0	29
22499	29	0	0	0	0	29
22500	0	0	0	29	0	29
22501	0	27	0	0	0	27
22502	28	0	0	0	0	28
22503	27	0	0	0	0	27
22504	29	0	0	0	0	29
22505	0	28	0	0	0	28
22506	0	0	0	29	0	29
22507	0	0	0	29	0	29
22508	0	29	0	0	0	29
22509	0	0	0	29	0	29
22510	27	0	0	0	0	27
22511	27	0	0	0	0	27
22512	0	27	0	0	0	27
22513	0	0	0	25	0	25
22514	0	0	0	26	0	26
22515	0	0	0	25	0	25
22516	24	0	0	0	0	24
22517	0	0	24	0	0	24
22518	19	0	0	0	0	19
22519	0	0	18	0	0	18
22520	0	0	0	17	0	17
22521	0	17	0	0	0	17
22522	0	20	0	0	0	20
22523	18	0	0	0	0	18
22524	17	0	0	0	0	17
22525	0	19	0	0	0	19
22526	0	19	0	0	0	19
22527	20	0	0	0	0	20
22528	20	0	0	0	0	20
22529	0	19	0	0	0	19
22530	20	0	0	0	0	20
22531	0	0	20	0	0	20
22532	19	0	0	0	0	19
22533	20	0	0	0	0	20
22534	0	0	0	20	0	20
22535	0	24	0	0	0	24
22536	0	0	0	23	0	23
22537	24	0	0	0	0	24
22538	0	0	0	24	0	24
22539	0	0	0	24	0	24
22540	0	0	26	0	0	26
22541	0	0	0	26	0	26
22542	0	0	0	26	0	26
22543	26	0	0	0	0	26
22544	0	0	26	0	0	26
22545	25	0	0	0	0	25
22546	0	0	0	26	0	26
22547	0	0	0	25	0	25
22548	0	0	0	26	0	26
22549	0	22	0	0	0	22
22550	0	21	0	0	0	21
22551	0	0	0	23	0	23
22552	20	0	0	0	0	20
22553	21	0	0	0	0	21
22554	0	0	0	20	0	20
22555	20	0	0	0	0	20
22556	0	0	0	26	0	26
22557	0	0	0	26	0	26
22558	23	0	0	0	0	23
22559	0	23	0	0	0	23
22560	22	0	0	0	0	22
22561	21	0	0	0	0	21
22562	22	0	0	0	0	22
22563	0	20	0	0	0	20
22564	0	0	0	20	0	20
22565	0	0	0	21	0	21
22566	0	0	23	0	0	23
22567	0	0	0	22	0	22
22568	0	0	19	0	0	19
22569	0	19	0	0	0	19
22570	0	19	0	0	0	19
22571	0	21	0	0	0	21
22572	0	0	0	23	0	23
22573	0	0	0	22	0	22
22574	0	0	0	23	0	23
22575	0	0	0	23	0	23
22576	0	0	23	0	0	23
22577	0	0	20	0	0	20
22578	0	0	0	21	0	21
22579	0	0	21	0	0	21
22580	22	0	0	0	0	22
22581	22	0	0	0	0	22
22582	0	0	25	0	0	25
22583	0	0	0	24	0	24
22584	0	0	0	24	0	24
22585	0	0	0	25	0	25
22586	0	0	0	24	0	24
22587	0	0	0	24	0	24
22588	20	0	0	0	0	20
22589	23	0	0	0	0	23
22590	0	25	0	0	0	25
22591	0	0	25	0	0	25
22592	0	22	0	0	0	22
22593	0	25	0	0	0	25
22594	23	0	0	0	0	23
22595	0	24	0	0	0	24
22596	0	24	0	0	0	24
22597	23	0	0	0	0	23
22598	0	0	27	0	0	27
22599	26	0	0	0	0	26
22600	0	0	0	27	0	27
22601	0	0	0	25	0	25
22602	0	0	0	27	0	27
22603	0	0	27	0	0	27
22604	0	25	0	0	0	25
22605	26	0	0	0	0	26
22606	0	0	0	27	0	27
22607	0	26	0	1	0	27
22608	0	0	0	27	0	27
22609	0	0	27	0	0	27
22610	0	0	0	27	0	27
22611	0	0	0	26	0	26
22612	0	0	0	26	0	26
22613	26	0	0	0	0	26
22614	0	0	0	28	0	28
22615	0	0	25	0	0	25
22616	0	26	0	0	0	26
22617	0	0	0	28	0	28
22618	0	0	0	26	0	26
22619	0	0	24	0	0	24
22620	0	0	24	0	0	24
22621	26	0	0	0	0	26
22622	24	0	0	0	0	24
22623	0	24	0	0	0	24
22624	25	0	0	1	0	26
22625	0	0	26	0	0	26
22626	0	0	25	0	0	25
22627	26	0	0	0	0	26
22628	21	0	0	0	0	21
22629	0	0	22	0	0	22
22630	23	0	0	0	0	23
22631	0	0	22	0	0	22
22632	24	0	0	0	0	24
22633	22	0	0	0	0	22
22634	0	0	0	21	0	21
22635	0	22	0	0	0	22
22636	25	0	0	0	0	25
22637	0	0	24	0	0	24
22638	0	24	0	0	0	24
22639	27	0	0	0	0	27
22640	27	0	0	0	0	27
22641	0	21	0	0	0	21
22642	0	0	0	27	0	27
22643	0	0	27	0	0	27
22644	0	0	0	28	0	28
22645	0	0	29	0	0	29
22646	0	0	0	29	0	29
22647	0	0	0	29	0	29
22648	0	0	29	0	0	29
22649	0	25	0	0	0	25
22650	0	0	0	24	0	24
22651	0	0	26	0	0	26
22652	27	0	0	0	0	27
22653	0	0	0	27	0	27
22654	0	0	0	30	0	30
22655	30	0	0	0	0	30
22656	0	0	0	31	0	31
22657	0	0	0	31	0	31
22658	0	30	0	0	0	30
22659	0	0	0	30	0	30
22660	0	0	31	0	0	31
22661	0	0	0	31	0	31
22662	0	25	0	0	0	25
22663	0	31	0	0	0	31
22664	0	0	0	28	0	28
22665	29	0	0	0	0	29
22666	0	0	0	28	0	28
22667	29	0	0	0	0	29
22668	0	0	0	29	0	29
22669	29	0	0	0	0	29
22670	28	0	0	0	0	28
22671	0	0	0	28	0	28
22672	0	0	0	28	0	28
22673	0	27	0	0	0	27
22674	0	29	0	0	0	29
22675	0	0	24	0	0	24
22676	0	29	0	0	0	29
22677	26	0	0	0	0	26
22678	0	0	0	26	0	26
22679	0	25	0	0	0	25
22680	24	0	0	0	0	24
22681	0	0	0	25	0	25
22682	0	0	0	26	0	26
22683	0	0	0	23	0	23
22684	0	0	0	23	0	23
22685	0	23	0	0	0	23
22686	0	24	0	0	0	24
22687	28	0	0	0	0	28
22688	0	28	0	0	0	28
22689	0	0	0	28	0	28
22690	0	0	0	29	0	29
22691	0	0	0	28	0	28
22692	0	0	0	28	0	28
22693	28	0	0	0	0	28
22694	28	0	0	0	0	28
22695	0	0	29	0	0	29
22696	0	0	0	28	0	28
22697	0	0	28	0	0	28
22698	0	0	0	29	0	29
22699	0	0	0	29	0	29
22700	28	0	0	0	0	28
22701	0	0	0	30	0	30
22702	0	0	30	0	0	30
22703	0	0	29	0	0	29
22704	30	0	0	0	0	30
22705	0	0	29	0	0	29
22706	0	0	0	31	0	31
22707	0	0	30	0	0	30
22708	1	0	0	30	0	31
22709	0	29	0	0	0	29
22710	0	0	0	31	0	31
22711	0	30	0	0	0	30
22712	0	31	0	0	0	31
22713	0	0	0	32	0	32
22714	31	0	0	0	0	31
22715	0	32	0	0	0	32
22716	0	0	0	33	0	33
22717	33	0	0	0	0	33
22718	31	0	0	0	0	31
22719	33	0	0	0	0	33
22720	0	0	0	35	0	35
22721	0	0	0	35	0	35
22722	36	0	0	0	0	36
22723	29	0	4	0	0	33
22724	32	0	0	0	0	32
22725	0	0	0	31	0	31
22726	0	0	31	0	0	31
22727	30	0	0	0	0	30
22728	0	0	0	31	0	31
22729	0	29	0	0	0	29
22730	0	0	0	31	0	31
22731	0	27	0	0	0	27
22732	0	0	0	26	0	26
22733	0	0	27	0	0	27
22734	0	32	0	0	0	32
22735	0	0	0	34	0	34
22736	0	0	0	33	0	33
22737	0	0	0	34	0	34
22738	34	0	0	0	0	34
22739	0	33	0	0	0	33
22740	0	0	0	37	0	37
22741	33	0	0	0	0	33
22742	36	0	0	1	0	37
22743	0	0	0	34	0	34
22744	0	0	31	0	0	31
22745	0	0	0	31	0	31
22746	0	32	0	0	0	32
22747	0	0	0	31	0	31
22748	29	0	0	0	0	29
22749	0	0	0	31	0	31
22750	0	0	31	0	0	31
22751	0	29	0	1	0	30
22752	32	0	0	0	0	32
22753	0	0	31	0	0	31
22754	32	0	0	0	0	32
22755	0	0	0	31	0	31
22756	0	0	0	34	0	34
22757	0	34	0	0	0	34
22758	35	0	0	0	0	35
22759	0	0	0	34	0	34
22760	0	0	0	34	0	34
22761	0	0	0	34	0	34
22762	0	0	33	0	0	33
22763	0	0	0	32	0	32
22764	35	0	0	0	0	35
22765	32	0	0	0	0	32
22766	0	0	0	35	0	35
22767	0	0	0	35	0	35
22768	35	0	0	0	0	35
22769	0	0	38	0	0	38
22770	35	0	0	0	0	35
22771	0	0	36	0	0	36
22772	0	0	37	0	0	37
22773	0	0	0	38	0	38
22774	0	0	38	0	0	38
22775	39	0	0	0	0	39
22776	0	0	0	35	0	35
22777	0	0	34	0	0	34
22778	32	0	0	0	0	32
22779	31	0	0	0	0	31
22780	0	0	31	0	0	31
22781	0	0	0	30	0	30
22782	0	29	0	0	0	29
22783	36	0	0	0	0	36
22784	0	0	35	0	0	35
22785	33	0	0	0	0	33
22786	0	36	0	0	0	36
22787	37	0	0	0	0	37
22788	37	0	0	0	0	37
22789	38	0	0	0	0	38
22790	0	0	0	38	0	38
22791	0	40	0	0	0	40
22792	0	0	38	0	0	38
22793	0	38	0	0	0	38
22794	0	0	0	38	0	38
22795	0	35	0	0	0	35
22796	0	37	0	0	0	37
22797	36	0	0	0	0	36
22798	0	0	37	0	0	37
22799	0	0	37	0	0	37
22800	0	0	34	0	0	34
22801	0	38	0	0	0	38
22802	40	0	0	0	0	40
22803	37	0	0	0	0	37
22804	41	0	0	0	0	41
22805	0	39	0	0	0	39
22806	0	0	0	42	0	42
22807	0	0	43	0	0	43
22808	0	0	41	0	0	41
22809	41	0	0	0	0	41
22810	41	0	0	0	0	41
22811	43	0	0	0	0	43
22812	0	0	47	0	0	47
22813	47	0	0	0	0	47
22814	0	0	0	43	0	43
22815	0	0	0	46	0	46
22816	0	0	41	0	0	41
22817	0	42	0	0	0	42
22818	0	0	0	44	0	44
22819	0	0	47	0	0	47
22820	45	0	0	0	0	45
22821	0	0	0	45	0	45
22822	0	0	0	44	0	44
22823	44	0	0	0	0	44
22824	0	0	0	47	0	47
22825	46	0	0	0	0	46
22826	47	0	0	0	0	47
22827	0	0	0	43	0	43
22828	0	0	0	41	0	41
22829	43	0	0	0	0	43
22830	0	0	0	44	0	44
22831	44	0	0	0	0	44
22832	39	0	0	1	0	40
22833	39	0	0	0	0	39
22834	0	0	0	41	0	41
22835	0	0	0	45	0	45
22836	44	0	0	0	0	44
22837	0	41	0	0	0	41
22838	0	47	0	0	0	47
22839	48	0	0	0	0	48
22840	0	0	46	1	0	47
22841	47	0	0	0	0	47
22842	0	0	0	49	0	49
22843	0	0	49	0	0	49
22844	51	0	0	0	0	51
22845	0	0	0	50	0	50
22846	0	0	0	52	0	52
22847	0	0	0	46	0	46
22848	0	0	0	51	0	51
22849	47	0	0	0	0	47
22850	0	50	0	0	0	50
22851	50	0	0	0	0	50
22852	0	0	48	0	0	48
22853	0	0	44	0	0	44
22854	0	51	0	0	0	51
22855	0	0	0	53	0	53
22856	0	0	51	1	0	52
22857	0	45	0	1	0	46
22858	0	0	52	0	0	52
22859	0	0	0	50	0	50
22860	0	0	0	52	0	52
22861	53	0	0	0	0	53
22862	1	0	0	45	0	46
22863	49	0	0	0	0	49
22864	0	0	45	0	0	45
22865	0	46	0	0	0	46
22866	0	0	0	44	0	44
22867	0	0	0	45	0	45
22868	0	0	46	0	0	46
22869	0	0	46	0	0	46
22870	49	0	0	0	0	49
22871	45	0	0	0	0	45
22872	0	0	0	46	0	46
22873	0	0	0	48	0	48
22874	0	47	0	0	0	47
22875	0	0	0	48	0	48
22876	42	0	0	0	0	42
22877	47	0	0	0	0	47
22878	0	46	0	0	0	46
22879	42	0	0	0	0	42
22880	44	0	0	0	0	44
22881	0	0	0	43	0	43
22882	0	40	0	0	0	40
22883	0	0	0	41	0	41
22884	0	0	0	44	0	44
22885	0	0	46	0	0	46
22886	45	0	0	0	0	45
22887	0	0	0	45	0	45
22888	0	0	0	45	0	45
22889	0	46	0	0	0	46
22890	0	0	0	52	0	52
22891	54	0	0	0	0	54
22892	56	0	0	0	0	56
22893	0	0	54	0	0	54
22894	1	0	55	0	0	56
22895	0	0	0	56	0	56
22896	0	0	0	56	0	56
22897	0	0	55	0	0	55
22898	0	0	50	0	0	50
22899	0	0	0	55	0	55
22900	0	0	54	0	0	54
22901	0	0	52	0	0	52
22902	0	0	0	55	0	55
22903	57	0	0	0	0	57
22904	56	0	0	0	0	56
22905	0	0	0	51	0	51
22906	0	0	0	53	0	53
22907	52	0	0	0	0	52
22908	0	0	0	53	0	53
22909	54	0	0	0	0	54
22910	53	0	0	0	0	53
22911	0	0	0	50	0	50
22912	0	0	0	53	0	53
22913	48	0	0	0	0	48
22914	0	48	0	0	0	48
22915	0	49	0	0	0	49
22916	0	0	0	54	0	54
22917	0	0	51	0	0	51
22918	0	0	0	53	0	53
22919	55	0	0	0	0	55
22920	0	0	0	54	0	54
22921	53	0	0	0	0	53
22922	0	0	52	0	0	52
22923	50	0	0	0	0	50
22924	0	0	0	52	0	52
22925	0	0	0	53	0	53
22926	0	0	51	0	0	51
22927	0	0	0	53	0	53
22928	0	0	0	52	0	52
22929	0	0	0	53	0	53
22930	52	0	0	0	0	52
22931	0	0	47	1	0	48
22932	0	0	45	0	0	45
22933	47	0	0	0	0	47
22934	48	0	0	0	0	48
22935	0	0	51	0	0	51
22936	0	0	0	42	0	42
22937	0	46	0	0	0	46
22938	0	0	0	47	0	47
22939	48	0	0	0	0	48
22940	46	1	0	0	0	47
22941	0	0	0	50	0	50
22942	0	49	0	0	0	49
22943	0	0	0	53	0	53
22944	0	50	0	0	0	50
22945	53	0	0	0	0	53
22946	54	0	0	0	0	54
22947	50	0	0	0	0	50
22948	0	51	0	0	0	51
22949	0	50	0	0	0	50
22950	0	0	0	56	0	56
22951	0	0	0	51	0	51
22952	0	0	0	53	0	53
22953	0	0	0	55	0	55
22954	0	0	52	0	0	52
22955	49	0	0	0	0	49
22956	0	0	54	0	0	54
22957	53	0	0	0	0	53
22958	0	0	53	0	0	53
22959	53	0	0	0	0	53
22960	0	0	52	0	0	52
22961	51	0	0	0	0	51
22962	0	0	0	48	0	48
22963	51	0	0	0	0	51
22964	0	0	0	51	0	51
22965	0	1	0	48	0	49
22966	0	0	0	49	0	49
22967	0	49	1	0	0	50
22968	49	0	0	0	0	49
22969	49	0	0	1	0	50
22970	0	49	0	0	0	49
22971	0	0	0	51	0	51
22972	0	0	51	0	0	51
22973	54	0	0	0	0	54
22974	53	0	0	0	0	53
22975	52	0	0	1	0	53
22976	0	0	0	52	0	52
22977	0	46	0	0	0	46
22978	0	0	0	49	0	49
22979	48	1	0	0	0	49
22980	0	0	0	47	0	47
22981	0	50	0	0	0	50
22982	47	0	0	0	0	47
22983	0	0	42	0	0	42
22984	0	0	44	0	0	44
22985	0	47	0	0	0	47
22986	2	38	0	0	0	40
22987	0	0	43	0	0	43
22988	0	0	43	0	0	43
22989	0	0	0	47	0	47
22990	45	0	0	0	0	45
22991	0	0	45	0	0	45
22992	0	45	0	0	0	45
22993	45	0	0	0	0	45
22994	0	47	0	0	0	47
22995	43	0	0	0	0	43
22996	0	45	0	0	0	45
22997	0	41	0	0	0	41
22998	0	0	0	41	0	41
22999	0	0	0	41	0	41
23000	0	0	44	0	0	44
23001	0	0	0	45	0	45
23002	47	0	0	1	0	48
23003	47	0	0	0	0	47
23004	0	0	0	48	0	48
23005	0	0	45	0	0	45
23006	0	0	48	0	0	48
23007	0	0	0	49	0	49
23008	0	0	53	0	0	53
23009	0	0	0	53	0	53
23010	0	0	0	50	0	50
23011	0	0	49	0	0	49
23012	51	0	0	0	0	51
23013	49	0	0	0	0	49
23014	0	0	44	0	0	44
23015	0	0	46	0	0	46
23016	0	0	0	45	0	45
23017	0	0	0	51	0	51
23018	0	0	0	53	0	53
23019	0	0	0	53	0	53
23020	50	0	0	0	0	50
23021	51	0	0	0	0	51
23022	0	0	0	52	0	52
23023	0	0	0	51	0	51
23024	0	0	49	0	0	49
23025	0	0	0	52	0	52
23026	0	0	0	54	0	54
23027	53	0	0	0	0	53
23028	0	54	0	0	0	54
23029	0	0	0	53	0	53
23030	0	0	0	50	0	50
23031	0	0	0	49	0	49
23032	0	49	0	0	0	49
23033	0	45	0	0	0	45
23034	0	0	0	50	0	50
23035	1	0	0	51	0	52
23036	0	0	0	55	0	55
23037	52	1	0	0	0	53
23038	0	55	0	0	0	55
23039	51	0	0	0	0	51
23040	48	0	0	0	0	48
23041	0	0	0	49	0	49
23042	0	61	0	0	0	61
23043	60	0	0	0	0	60
23044	0	0	0	60	0	60
23045	59	0	0	0	0	59
23046	0	0	0	60	0	60
23047	0	0	61	0	0	61
23048	0	0	56	0	0	56
23049	0	0	0	59	0	59
23050	0	0	0	59	0	59
23051	0	0	0	61	0	61
23052	0	57	0	0	0	57
23053	0	62	0	0	0	62
23054	64	0	0	0	0	64
23055	64	0	0	0	0	64
23056	0	64	0	0	0	64
23057	0	62	0	0	0	62
23058	0	70	0	0	0	70
23059	72	0	0	0	0	72
23060	0	71	0	0	0	71
23061	0	0	0	70	0	70
23062	71	0	0	0	0	71
23063	67	0	0	0	0	67
23064	0	0	0	67	0	67
23065	0	0	65	0	0	65
23066	0	0	64	0	0	64
23067	0	0	0	67	0	67
23068	0	0	65	0	0	65
23069	0	0	0	63	0	63
23070	0	0	0	64	0	64
23071	0	0	67	0	0	67
23072	0	0	66	0	0	66
23073	0	0	0	68	0	68
23074	0	0	0	69	0	69
23075	67	0	0	0	0	67
23076	0	65	0	0	0	65
23077	0	67	0	0	0	67
23078	65	0	0	0	0	65
23079	68	0	0	0	0	68
23080	0	65	0	0	0	65
23081	0	63	0	0	0	63
23082	65	0	0	0	0	65
23083	0	0	0	63	0	63
23084	61	0	0	0	0	61
23085	0	63	0	0	0	63
23086	64	0	0	0	0	64
23087	0	0	66	0	0	66
23088	67	0	0	0	0	67
23089	0	0	64	0	0	64
23090	0	0	0	68	0	68
23091	68	0	0	0	0	68
23092	0	0	66	0	0	66
23093	0	0	0	66	0	66
23094	64	0	0	0	0	64
23095	0	0	62	0	0	62
23096	0	0	0	57	0	57
23097	61	0	0	0	0	61
23098	0	60	0	0	0	60
23099	0	0	0	63	0	63
23100	0	0	0	59	0	59
23101	0	0	0	56	0	56
23102	0	56	0	0	0	56
23103	0	0	0	57	0	57
23104	0	0	0	57	0	57
23105	0	0	0	60	0	60
23106	0	0	0	61	0	61
23107	0	0	60	0	0	60
23108	60	0	0	0	0	60
23109	61	0	0	0	0	61
23110	0	62	0	0	0	62
23111	0	0	0	60	0	60
23112	0	0	0	61	0	61
23113	0	57	0	0	0	57
23114	0	0	0	62	0	62
23115	63	0	0	0	0	63
23116	0	59	0	0	0	59
23117	54	0	0	0	0	54
23118	0	0	0	58	0	58
23119	0	0	56	0	0	56
23120	0	56	0	0	0	56
23121	57	0	0	0	0	57
23122	0	55	0	0	0	55
23123	2	56	0	0	0	58
23124	55	0	0	0	0	55
23125	0	0	57	0	0	57
23126	0	53	0	0	0	53
23127	48	0	0	0	0	48
23128	47	0	0	0	0	47
23129	0	47	0	0	0	47
23130	0	0	0	52	0	52
23131	0	0	51	0	0	51
23132	0	0	0	50	0	50
23133	0	0	0	50	0	50
23134	0	0	0	51	0	51
23135	0	0	39	0	0	39
23136	0	0	0	31	0	31
23137	0	0	39	0	0	39
23138	0	0	35	0	0	35
23139	38	0	0	0	0	38
23140	0	35	0	0	0	35
23141	0	37	0	0	0	37
23142	0	0	0	41	0	41
23143	40	0	0	0	0	40
23144	36	0	0	0	0	36
23145	38	0	0	0	0	38
23146	40	0	0	0	0	40
23147	36	0	0	0	0	36
23148	0	0	35	0	0	35
23149	0	0	0	34	0	34
23150	0	34	0	0	0	34
23151	0	0	0	29	0	29
23152	29	0	0	0	0	29
23153	0	29	0	0	0	29
23154	0	0	0	29	0	29
23155	29	0	0	0	0	29
23156	30	0	0	0	0	30
23157	0	0	0	31	0	31
23158	0	0	0	29	0	29
23159	0	0	0	31	0	31
23160	0	0	29	0	0	29
23161	0	0	26	0	0	26
23162	0	0	0	29	0	29
23163	0	0	0	30	0	30
23164	28	0	0	0	0	28
23165	27	0	0	0	0	27
23166	28	0	0	0	0	28
23167	27	0	0	0	0	27
23168	27	0	0	0	0	27
23169	0	26	0	0	0	26
23170	25	0	0	0	0	25
23171	26	0	0	0	0	26
23172	26	0	0	0	0	26
23173	0	0	0	26	0	26
23174	0	0	26	0	0	26
23175	0	0	0	26	0	26
23176	0	0	24	0	0	24
23177	0	0	0	23	0	23
23178	0	27	0	0	0	27
23179	23	0	0	0	0	23
23180	23	0	0	0	0	23
23181	0	0	0	24	0	24
23182	0	0	0	25	0	25
23183	0	0	0	23	0	23
23184	0	24	0	0	0	24
23185	26	0	0	0	0	26
23186	25	0	0	0	0	25
23187	0	26	0	0	0	26
23188	0	0	0	25	0	25
23189	0	0	0	25	0	25
23190	0	25	0	0	0	25
23191	32	0	0	0	0	32
23192	32	0	0	0	0	32
23193	0	0	0	32	0	32
23194	0	0	29	0	0	29
23195	0	0	29	0	0	29
23196	0	0	0	29	0	29
23197	1	0	0	27	0	28
23198	0	0	0	34	0	34
23199	30	0	0	0	0	30
23200	31	0	0	0	0	31
23201	0	36	0	0	0	36
23202	35	0	0	0	0	35
23203	0	0	35	0	0	35
23204	0	0	34	0	0	34
23205	0	34	0	0	0	34
23206	34	0	0	0	0	34
23207	0	36	0	0	0	36
23208	34	0	0	0	0	34
23209	0	0	38	0	0	38
23210	0	0	37	0	0	37
23211	0	0	0	38	0	38
23212	0	0	43	0	0	43
23213	0	0	0	42	0	42
23214	0	0	0	42	0	42
23215	0	47	0	0	0	47
23216	0	0	0	47	0	47
23217	0	0	0	48	0	48
23218	47	0	0	1	0	48
23219	0	47	0	0	0	47
23220	0	0	0	49	0	49
23221	0	0	50	0	0	50
23222	49	0	0	0	0	49
23223	0	0	51	0	0	51
23224	0	0	0	49	0	49
23225	0	53	0	0	0	53
23226	0	0	0	52	0	52
23227	55	0	0	0	0	55
23228	54	0	0	0	0	54
23229	0	53	0	0	0	53
23230	62	0	0	0	0	62
23231	65	0	0	0	0	65
23232	65	0	0	0	0	65
23233	68	0	0	0	0	68
23234	65	0	0	0	0	65
23235	0	0	58	0	0	58
23236	0	0	0	58	0	58
23237	0	0	0	62	0	62
23238	0	0	0	63	0	63
23239	0	68	0	0	0	68
23240	0	0	0	66	0	66
23241	0	0	63	0	0	63
23242	0	63	0	0	0	63
23243	0	69	0	0	0	69
23244	0	0	0	64	0	64
23245	0	0	0	68	0	68
23246	0	0	0	70	0	70
23247	0	66	0	0	0	66
23248	0	66	0	0	0	66
23249	70	0	0	1	0	71
23250	68	1	0	0	0	69
23251	0	69	0	0	0	69
23252	71	0	0	0	0	71
23253	70	1	0	0	0	71
23254	0	0	0	69	0	69
23255	0	0	0	70	0	70
23256	0	0	0	71	0	71
23257	0	0	68	0	0	68
23258	1	0	60	0	0	61
23259	0	69	0	0	0	69
23260	71	0	0	0	0	71
23261	0	1	70	0	0	71
23262	72	0	0	0	0	72
23263	0	0	70	0	0	70
23264	71	0	0	0	0	71
23265	0	70	0	0	0	70
23266	71	0	0	0	0	71
23267	0	0	0	73	0	73
23268	0	0	0	75	0	75
23269	0	0	75	0	0	75
23270	0	84	0	0	0	84
23271	1	0	0	84	0	85
23272	0	0	80	0	0	80
23273	84	0	0	0	0	84
23274	0	82	0	0	0	82
23275	79	0	0	0	0	79
23276	0	79	0	0	0	79
23277	0	0	0	85	0	85
23278	84	0	0	0	0	84
23279	0	83	0	0	0	83
23280	0	0	0	85	0	85
23281	0	0	84	0	0	84
23282	82	0	0	0	0	82
23283	0	0	0	83	0	83
23284	0	0	81	0	0	81
23285	0	78	0	0	0	78
23286	0	0	0	78	0	78
23287	0	0	81	0	0	81
23288	0	0	0	79	0	79
23289	0	78	0	0	0	78
23290	0	79	0	0	0	79
23291	0	0	76	0	0	76
23292	0	0	0	73	0	73
23293	0	0	75	0	0	75
23294	70	0	0	0	0	70
23295	0	0	0	72	0	72
23296	0	71	0	0	0	71
23297	0	70	0	0	0	70
23298	73	0	0	0	0	73
23299	0	72	0	0	0	72
23300	72	0	0	0	0	72
23301	0	0	65	0	0	65
23302	64	0	0	0	0	64
23303	0	68	0	0	0	68
23304	65	0	0	0	0	65
23305	0	63	0	0	0	63
23306	0	0	0	60	0	60
23307	0	0	0	62	0	62
23308	0	0	60	0	0	60
23309	57	0	0	0	0	57
23310	0	0	57	0	0	57
23311	55	0	0	0	0	55
23312	0	0	0	57	0	57
23313	0	0	0	53	0	53
23314	0	54	0	0	0	54
23315	0	0	0	55	0	55
23316	0	0	0	55	0	55
23317	0	0	53	0	0	53
23318	49	0	0	0	0	49
23319	0	52	0	0	0	52
23320	51	0	0	0	0	51
23321	0	0	0	50	0	50
23322	0	0	0	50	0	50
23323	45	0	0	0	0	45
23324	0	45	0	0	0	45
23325	44	0	0	0	0	44
23326	0	41	0	0	0	41
23327	0	42	0	0	0	42
23328	43	0	0	0	0	43
23329	0	0	0	43	0	43
23330	0	0	42	0	0	42
23331	0	0	0	42	0	42
23332	0	0	0	40	0	40
23333	0	41	0	0	0	41
23334	0	0	0	42	0	42
23335	0	0	0	44	0	44
23336	0	0	0	47	0	47
23337	0	0	0	50	0	50
23338	0	0	48	0	0	48
23339	0	0	48	0	0	48
23340	0	0	0	48	0	48
23341	0	0	47	0	0	47
23342	0	0	44	0	0	44
23343	0	0	0	47	0	47
23344	0	0	46	0	0	46
23345	0	0	0	40	0	40
23346	0	42	0	0	0	42
23347	45	0	0	0	0	45
23348	0	0	44	0	0	44
23349	0	0	0	45	0	45
23350	0	0	46	0	0	46
23351	0	0	0	46	0	46
23352	1	0	0	45	0	46
23353	45	0	0	0	0	45
23354	0	0	0	44	0	44
23355	44	0	0	0	0	44
23356	48	0	0	0	0	48
23357	0	46	0	0	0	46
23358	48	0	0	0	0	48
23359	0	44	0	0	0	44
23360	0	46	0	0	0	46
23361	48	0	0	0	0	48
23362	0	0	40	0	0	40
23363	0	0	39	0	0	39
23364	37	0	0	0	0	37
23365	37	0	0	0	0	37
23366	0	36	0	0	0	36
23367	39	0	0	0	0	39
23368	35	0	0	0	0	35
23369	38	0	0	0	0	38
23370	0	0	0	34	0	34
23371	34	0	0	0	0	34
23372	0	34	0	0	0	34
23373	0	0	0	35	0	35
23374	0	0	0	35	0	35
23375	0	36	0	0	0	36
23376	0	0	0	38	0	38
23377	37	0	0	0	0	37
23378	36	0	0	0	0	36
23379	0	40	0	0	0	40
23380	0	43	0	0	0	43
23381	42	0	0	0	0	42
23382	0	0	42	0	0	42
23383	0	0	43	0	0	43
23384	0	0	0	43	0	43
23385	0	0	0	47	0	47
23386	0	0	44	0	0	44
23387	0	43	0	0	0	43
23388	0	0	0	47	0	47
23389	0	0	43	0	0	43
23390	0	0	0	42	0	42
23391	0	0	0	43	0	43
23392	0	41	0	0	0	41
23393	0	0	0	39	0	39
23394	0	0	0	42	0	42
23395	0	0	0	42	0	42
23396	41	0	0	0	0	41
23397	0	0	0	44	0	44
23398	0	47	0	0	0	47
23399	44	0	0	0	0	44
23400	0	0	44	0	0	44
23401	0	0	43	0	0	43
23402	48	0	0	0	0	48
23403	0	0	0	47	0	47
23404	0	0	49	0	0	49
23405	0	0	0	45	0	45
23406	0	0	0	49	0	49
23407	47	0	0	0	0	47
23408	44	1	0	0	0	45
23409	0	51	0	0	0	51
23410	0	0	0	48	0	48
23411	0	0	49	0	0	49
23412	0	54	0	0	0	54
23413	57	0	0	0	0	57
23414	0	60	0	0	0	60
23415	62	0	0	0	0	62
23416	0	0	60	0	0	60
23417	65	0	0	0	0	65
23418	65	0	0	0	0	65
23419	0	0	61	0	0	61
23420	0	0	0	62	0	62
23421	0	60	0	0	0	60
23422	0	61	0	0	0	61
23423	0	65	0	0	0	65
23424	0	0	0	65	0	65
23425	0	0	63	0	0	63
23426	0	0	0	59	0	59
23427	0	0	0	66	0	66
23428	0	0	62	0	0	62
23429	0	59	0	0	0	59
23430	0	0	0	59	0	59
23431	54	0	0	0	0	54
23432	0	0	0	61	0	61
23433	0	0	0	60	0	60
23434	0	62	0	0	0	62
23435	65	0	0	0	0	65
23436	0	0	0	63	0	63
23437	0	0	63	0	0	63
23438	0	64	0	0	0	64
23439	63	0	0	0	0	63
23440	0	0	60	0	0	60
23441	63	0	0	0	0	63
23442	0	0	0	61	0	61
23443	0	60	0	0	0	60
23444	60	0	0	0	0	60
23445	61	0	0	0	0	61
23446	0	59	0	0	0	59
23447	0	0	0	58	0	58
23448	0	0	0	59	0	59
23449	58	0	0	0	0	58
23450	0	57	0	0	0	57
23451	0	0	0	55	0	55
23452	0	56	0	0	0	56
23453	0	57	0	0	0	57
23454	0	0	0	59	0	59
23455	62	0	0	0	0	62
23456	0	62	0	0	0	62
23457	0	0	0	63	0	63
23458	0	0	0	64	0	64
23459	0	0	60	0	0	60
23460	0	0	54	0	0	54
23461	0	57	0	0	0	57
23462	0	0	63	0	0	63
23463	0	0	0	63	0	63
23464	0	0	62	0	0	62
23465	0	0	0	62	0	62
23466	0	0	0	62	0	62
23467	0	0	0	61	0	61
23468	58	0	0	0	0	58
23469	0	0	0	58	0	58
23470	0	0	0	59	0	59
23471	0	59	0	0	0	59
23472	0	0	0	55	0	55
23473	55	0	0	0	0	55
23474	0	55	0	0	0	55
23475	54	0	0	0	0	54
23476	2	0	52	0	0	54
23477	0	0	54	0	0	54
23478	0	0	0	53	0	53
23479	0	0	0	56	0	56
23480	0	53	0	0	0	53
23481	0	0	0	59	0	59
23482	59	0	0	0	0	59
23483	58	0	0	0	0	58
23484	0	0	0	58	0	58
23485	0	0	62	0	0	62
23486	0	0	0	56	0	56
23487	0	0	0	63	0	63
23488	0	0	0	64	0	64
23489	0	0	0	61	0	61
23490	0	0	0	59	0	59
23491	0	58	0	0	0	58
23492	56	0	0	0	0	56
23493	60	0	0	0	0	60
23494	57	0	0	0	0	57
23495	0	57	0	0	0	57
23496	57	0	0	0	0	57
23497	0	58	0	0	0	58
23498	0	0	58	0	0	58
23499	1	0	0	56	0	57
23500	0	0	59	0	0	59
23501	0	61	0	0	0	61
23502	60	0	0	0	0	60
23503	0	0	62	0	0	62
23504	0	0	53	0	0	53
23505	0	49	0	0	0	49
23506	0	0	0	58	0	58
23507	0	0	54	0	0	54
23508	0	0	0	56	0	56
23509	0	0	0	55	0	55
23510	0	0	0	58	0	58
23511	66	0	0	0	0	66
23512	67	0	0	0	0	67
23513	0	0	0	66	0	66
23514	66	0	0	0	0	66
23515	0	1	65	0	0	66
23516	0	0	63	0	0	63
23517	0	0	67	0	0	67
23518	0	0	67	0	0	67
23519	0	65	0	0	0	65
23520	0	0	0	73	0	73
23521	0	0	74	0	0	74
23522	77	0	0	0	0	77
23523	74	0	0	0	0	74
23524	0	70	0	0	0	70
23525	72	0	0	0	0	72
23526	0	0	0	75	0	75
23527	0	0	71	0	0	71
23528	0	0	0	68	0	68
23529	0	73	0	0	0	73
23530	78	0	0	0	0	78
23531	78	0	0	0	0	78
23532	0	77	0	0	0	77
23533	74	0	0	0	0	74
23534	74	0	0	0	0	74
23535	0	76	0	0	0	76
23536	1	0	0	78	0	79
23537	0	76	0	0	0	76
23538	80	0	0	0	0	80
23539	0	0	0	80	0	80
23540	79	0	0	1	0	80
23541	0	0	0	96	0	96
23542	0	0	94	0	0	94
23543	99	0	0	0	0	99
23544	0	0	92	0	0	92
23545	0	0	0	97	0	97
23546	0	0	96	0	0	96
23547	0	0	0	94	0	94
23548	0	0	90	0	0	90
23549	93	0	0	0	0	93
23550	0	96	0	0	0	96
23551	96	0	0	0	0	96
23552	0	0	0	96	0	96
23553	91	0	0	0	0	91
23554	0	93	0	0	0	93
23555	0	92	0	0	0	92
23556	0	92	0	0	0	92
23557	99	0	0	1	0	100
23558	0	0	0	99	0	99
23559	0	0	0	98	0	98
23560	0	0	103	0	0	103
23561	0	0	96	0	0	96
23562	0	0	0	102	0	102
23563	0	0	101	0	0	101
23564	0	105	0	0	0	105
23565	108	0	0	0	0	108
23566	0	0	102	0	0	102
23567	0	0	101	0	0	101
23568	0	0	0	101	0	101
23569	100	0	0	0	0	100
23570	0	0	0	103	0	103
23571	98	0	0	0	0	98
23572	0	0	0	100	0	100
23573	0	0	99	0	0	99
23574	0	95	0	0	0	95
23575	0	0	95	0	0	95
23576	0	98	0	0	0	98
23577	0	0	0	101	0	101
23578	102	0	0	0	0	102
23579	0	0	102	0	0	102
23580	0	0	1	96	0	97
23581	0	0	0	96	0	96
23582	100	0	0	0	0	100
23583	0	0	0	103	0	103
23584	0	102	0	0	0	102
23585	95	0	0	1	0	96
23586	0	0	100	0	0	100
23587	96	0	0	0	0	96
23588	0	102	0	0	0	102
23589	0	0	0	98	0	98
23590	0	104	0	0	0	104
23591	103	0	0	0	0	103
23592	0	0	99	0	0	99
23593	97	0	0	0	0	97
23594	1	95	0	0	0	96
23595	0	0	0	97	0	97
23596	97	0	0	0	0	97
23597	97	0	0	0	0	97
23598	0	0	0	100	0	100
23599	1	0	0	89	0	90
23600	0	93	0	0	0	93
23601	0	0	0	92	0	92
23602	0	82	0	0	0	82
23603	0	85	0	0	0	85
23604	0	0	0	75	0	75
23605	0	79	0	0	0	79
23606	0	0	71	0	0	71
23607	0	0	74	0	0	74
23608	0	80	0	0	0	80
23609	0	0	86	0	0	86
23610	0	0	79	0	0	79
23611	0	0	81	0	0	81
23612	0	84	0	0	0	84
23613	84	0	0	0	0	84
23614	0	81	0	0	0	81
23615	0	0	75	0	0	75
23616	0	0	0	78	0	78
23617	78	0	0	0	0	78
23618	0	0	78	0	0	78
23619	0	0	0	81	0	81
23620	0	0	83	0	0	83
23621	0	0	0	82	0	82
23622	82	0	0	0	0	82
23623	0	0	71	0	0	71
23624	0	74	0	0	0	74
23625	0	1	0	75	0	76
23626	75	0	0	1	0	76
23627	0	0	79	0	0	79
23628	0	0	0	78	0	78
23629	0	71	0	0	0	71
23630	76	0	0	0	0	76
23631	76	0	0	0	0	76
23632	0	0	0	76	0	76
23633	0	75	0	0	0	75
23634	0	55	0	0	0	55
23635	57	0	0	0	0	57
23636	0	0	0	60	0	60
23637	0	56	0	0	0	56
23638	60	0	0	0	0	60
23639	0	0	0	58	0	58
23640	0	0	0	59	0	59
23641	0	0	58	1	0	59
23642	0	57	0	0	0	57
23643	0	57	0	0	0	57
23644	0	0	0	60	0	60
23645	59	0	0	0	0	59
23646	0	60	0	0	0	60
23647	58	0	0	0	0	58
23648	0	61	0	0	0	61
23649	0	0	0	63	0	63
23650	59	0	0	0	0	59
23651	0	0	0	58	0	58
23652	0	1	55	0	0	56
23653	0	0	0	58	0	58
23654	0	56	0	0	0	56
23655	54	0	0	0	0	54
23656	0	54	0	0	0	54
23657	0	0	0	51	0	51
23658	0	0	0	52	0	52
23659	0	0	52	0	0	52
23660	0	0	48	1	0	49
23661	0	0	0	51	0	51
23662	0	0	51	0	0	51
23663	0	52	0	0	0	52
23664	57	0	0	0	0	57
23665	0	0	58	0	0	58
23666	59	0	0	1	0	60
23667	59	0	0	0	0	59
23668	57	0	0	0	0	57
23669	55	0	0	0	0	55
23670	0	0	0	56	0	56
23671	0	0	0	54	0	54
23672	0	56	0	0	0	56
23673	54	0	0	0	0	54
23674	0	0	56	0	0	56
23675	0	0	0	52	0	52
23676	0	0	0	56	0	56
23677	0	0	57	0	0	57
23678	0	52	0	0	0	52
23679	0	1	0	58	0	59
23680	0	0	0	59	0	59
23681	52	0	0	0	0	52
23682	0	53	0	0	0	53
23683	0	0	0	48	0	48
23684	0	51	0	0	0	51
23685	0	0	0	53	0	53
23686	54	0	0	0	0	54
23687	50	0	0	0	0	50
23688	0	0	0	54	0	54
23689	51	0	0	0	0	51
23690	51	0	0	0	0	51
23691	0	49	0	0	0	49
23692	0	0	0	54	0	54
23693	0	56	0	0	0	56
23694	0	0	0	52	0	52
23695	56	0	0	0	0	56
23696	0	0	0	53	0	53
23697	0	0	0	56	0	56
23698	0	0	50	0	0	50
23699	0	47	0	0	0	47
23700	0	49	0	0	0	49
23701	50	0	0	0	0	50
23702	0	0	0	42	0	42
23703	43	0	0	0	0	43
23704	0	42	0	0	0	42
23705	0	40	0	0	0	40
23706	0	42	0	0	0	42
23707	43	0	0	0	0	43
23708	0	44	0	0	0	44
23709	46	0	0	0	0	46
23710	43	0	0	0	0	43
23711	48	0	0	0	0	48
23712	0	1	0	46	0	47
23713	0	0	0	46	0	46
23714	0	0	0	46	0	46
23715	0	0	0	50	0	50
23716	46	0	0	1	0	47
23717	0	49	0	0	0	49
23718	0	0	0	49	0	49
23719	49	0	0	0	0	49
23720	0	0	1	43	0	44
23721	0	0	0	44	0	44
23722	44	0	0	0	0	44
23723	0	0	43	0	0	43
23724	0	0	0	45	0	45
23725	1	0	44	0	0	45
23726	0	0	1	45	0	46
23727	0	0	0	46	0	46
23728	46	0	0	0	0	46
23729	0	44	0	0	0	44
23730	0	48	0	0	0	48
23731	43	1	0	0	0	44
23732	0	48	0	0	0	48
23733	55	0	0	0	0	55
23734	0	0	52	0	0	52
23735	52	0	0	0	0	52
23736	52	0	0	0	0	52
23737	51	0	0	0	0	51
23738	0	0	0	49	0	49
23739	0	0	0	52	0	52
23740	0	46	0	0	0	46
23741	0	0	0	52	0	52
23742	52	0	0	0	0	52
23743	0	50	1	0	0	51
23744	0	50	0	0	0	50
23745	52	0	0	0	0	52
23746	0	0	50	0	0	50
23747	0	0	0	50	0	50
23748	0	0	53	0	0	53
23749	0	0	0	51	0	51
23750	0	52	0	0	0	52
23751	0	0	0	52	0	52
23752	53	0	0	0	0	53
23753	0	0	0	53	0	53
23754	0	0	53	0	0	53
23755	53	0	0	0	0	53
23756	0	51	0	0	0	51
23757	0	57	0	0	0	57
23758	55	0	0	0	0	55
23759	55	0	0	0	0	55
23760	0	0	49	0	0	49
23761	53	0	0	0	0	53
23762	0	53	0	0	0	53
23763	55	0	0	0	0	55
23764	1	0	0	53	0	54
23765	0	53	0	0	0	53
23766	55	0	0	0	0	55
23767	0	0	51	0	0	51
23768	0	0	0	50	0	50
23769	56	0	0	0	0	56
23770	0	0	48	0	0	48
23771	53	0	0	0	0	53
23772	0	0	0	52	0	52
23773	0	0	0	53	0	53
23774	0	0	52	0	0	52
23775	0	0	0	52	0	52
23776	53	0	0	0	0	53
23777	0	57	0	0	0	57
23778	56	0	0	0	0	56
23779	62	0	0	0	0	62
23780	0	0	0	60	0	60
23781	0	0	60	0	0	60
23782	0	0	0	60	0	60
23783	56	0	0	2	0	58
23784	0	59	0	0	0	59
23785	59	0	0	0	0	59
23786	0	0	0	51	0	51
23787	0	0	0	57	0	57
23788	1	0	0	55	0	56
23789	0	0	54	0	0	54
23790	0	0	0	54	0	54
23791	0	0	53	0	0	53
23792	0	0	55	0	0	55
23793	0	0	0	56	0	56
23794	0	0	56	4	0	60
23795	58	0	0	0	0	58
23796	0	0	0	55	0	55
23797	0	0	0	59	0	59
23798	0	58	0	0	0	58
23799	60	0	0	0	0	60
23800	58	0	0	0	0	58
23801	0	57	0	0	0	57
23802	0	0	0	58	0	58
23803	0	0	57	0	0	57
23804	55	0	0	0	0	55
23805	55	0	0	0	0	55
23806	0	0	0	55	0	55
23807	0	0	52	0	0	52
23808	0	46	0	0	0	46
23809	48	0	0	0	0	48
23810	0	0	47	0	0	47
23811	0	46	0	0	0	46
23812	48	0	0	1	0	49
23813	46	0	0	0	0	46
23814	0	0	0	52	0	52
23815	0	52	0	0	0	52
23816	0	0	0	52	0	52
23817	0	0	0	54	0	54
23818	0	0	0	55	0	55
23819	0	0	0	55	0	55
23820	0	0	51	0	0	51
23821	0	0	1	49	0	50
23822	0	0	0	51	0	51
23823	0	0	52	0	0	52
23824	0	52	0	0	0	52
23825	49	0	0	0	0	49
23826	41	0	0	0	0	41
23827	0	0	0	40	0	40
23828	40	0	1	0	0	41
23829	0	0	0	41	0	41
23830	0	0	42	0	0	42
23831	0	0	36	0	0	36
23832	0	41	0	0	0	41
23833	42	0	0	0	0	42
23834	0	0	41	0	0	41
23835	0	0	0	40	0	40
23836	0	0	0	43	0	43
23837	0	0	0	43	0	43
23838	1	0	0	42	0	43
23839	0	0	0	44	0	44
23840	0	0	42	0	0	42
23841	0	0	0	43	0	43
23842	43	0	0	0	0	43
23843	0	42	0	0	0	42
23844	40	0	0	0	0	40
23845	0	40	0	0	0	40
23846	40	0	0	0	0	40
23847	40	0	0	0	0	40
23848	0	0	0	37	0	37
23849	0	0	0	39	0	39
23850	35	0	0	0	0	35
23851	34	0	0	0	0	34
23852	34	0	0	0	0	34
23853	0	35	0	0	0	35
23854	0	34	0	0	0	34
23855	0	0	34	0	0	34
23856	1	0	0	33	0	34
23857	0	0	34	0	0	34
23858	0	35	0	0	0	35
23859	0	0	0	36	0	36
23860	0	0	0	36	0	36
23861	0	0	0	35	0	35
23862	36	0	0	0	0	36
23863	38	0	0	0	0	38
23864	0	38	0	0	0	38
23865	0	0	0	36	0	36
23866	0	0	34	0	0	34
23867	0	0	33	0	0	33
23868	33	0	0	0	0	33
23869	32	0	0	0	0	32
23870	0	0	0	31	0	31
23871	31	0	0	0	0	31
23872	0	0	22	0	0	22
23873	0	24	0	0	0	24
23874	0	0	0	26	0	26
23875	0	0	27	0	0	27
23876	0	0	0	25	0	25
23877	0	0	0	30	0	30
23878	0	0	25	0	0	25
23879	26	0	0	0	0	26
23880	24	0	0	1	0	25
23881	0	28	0	0	0	28
23882	30	0	0	0	0	30
23883	29	0	0	0	0	29
23884	0	0	30	0	0	30
23885	29	0	0	0	0	29
23886	0	31	0	0	0	31
23887	23	0	0	0	0	23
23888	27	0	0	0	0	27
23889	28	0	0	0	0	28
23890	27	0	0	0	0	27
23891	25	0	0	0	0	25
23892	0	27	0	0	0	27
23893	29	0	0	0	0	29
23894	0	23	0	0	0	23
23895	1	19	0	0	0	20
23896	0	26	0	0	0	26
23897	29	0	0	0	0	29
23898	29	0	0	0	0	29
23899	0	0	30	0	0	30
23900	30	0	0	0	0	30
23901	30	0	0	0	0	30
23902	0	0	26	0	0	26
23903	0	0	0	27	0	27
23904	0	0	0	28	0	28
23905	0	0	0	34	0	34
23906	0	0	0	31	0	31
23907	0	0	0	33	0	33
23908	0	0	34	0	0	34
23909	0	34	0	0	0	34
23910	33	0	0	0	0	33
23911	0	33	0	0	0	33
23912	34	0	0	0	0	34
23913	34	0	0	0	0	34
23914	0	0	32	0	0	32
23915	0	0	0	33	0	33
23916	0	33	0	0	0	33
23917	34	0	0	0	0	34
23918	33	0	0	0	0	33
23919	30	0	0	0	0	30
23920	0	34	0	0	0	34
23921	31	0	0	0	0	31
23922	31	0	0	0	0	31
23923	31	0	0	0	0	31
23924	0	0	0	32	0	32
23925	0	0	0	32	0	32
23926	0	0	0	30	0	30
23927	30	0	0	0	0	30
23928	0	32	0	0	0	32
23929	31	0	0	0	0	31
23930	30	0	0	0	0	30
23931	30	0	0	0	0	30
23932	30	0	0	0	0	30
23933	0	28	0	0	0	28
23934	29	0	0	0	0	29
23935	0	28	0	0	0	28
23936	0	26	0	0	0	26
23937	32	0	0	1	0	33
23938	0	31	0	0	0	31
23939	0	30	0	0	0	30
23940	35	0	0	0	0	35
23941	35	0	0	0	0	35
23942	0	0	0	34	0	34
23943	0	0	0	35	0	35
23944	34	0	0	0	0	34
23945	34	0	0	0	0	34
23946	35	0	0	0	0	35
23947	0	0	31	0	0	31
23948	34	0	0	0	0	34
23949	0	0	0	34	0	34
23950	0	0	0	32	0	32
23951	0	0	0	33	0	33
23952	0	0	1	33	0	34
23953	0	0	33	0	0	33
23954	0	0	30	1	0	31
23955	0	0	0	33	0	33
23956	0	0	34	0	0	34
23957	0	0	31	0	0	31
23958	0	0	0	31	0	31
23959	0	0	0	34	0	34
23960	0	0	0	32	0	32
23961	0	0	0	33	0	33
23962	33	0	0	0	0	33
23963	33	0	0	0	0	33
23964	0	0	1	30	0	31
23965	0	0	0	33	0	33
23966	0	0	0	33	0	33
23967	0	0	0	31	0	31
23968	0	0	0	33	0	33
23969	0	32	0	0	0	32
23970	29	0	0	0	0	29
23971	0	31	0	0	0	31
23972	29	0	0	0	0	29
23973	29	0	0	0	0	29
23974	24	0	0	0	0	24
23975	0	0	0	24	0	24
23976	23	0	0	0	0	23
23977	0	0	0	22	0	22
23978	0	0	0	24	0	24
23979	23	0	0	0	0	23
23980	0	23	0	0	0	23
23981	0	19	0	0	0	19
23982	19	0	0	0	0	19
23983	0	0	19	0	0	19
23984	19	0	1	0	0	20
23985	0	0	0	23	0	23
23986	0	23	0	0	0	23
23987	0	23	0	0	0	23
23988	23	0	0	0	0	23
23989	0	0	0	22	0	22
23990	0	21	0	0	0	21
23991	21	0	0	0	0	21
23992	20	0	0	0	0	20
23993	23	0	0	0	0	23
23994	21	0	0	0	0	21
23995	0	21	0	0	0	21
23996	0	19	0	1	0	20
23997	20	0	0	0	0	20
23998	15	0	0	0	0	15
23999	0	0	13	0	0	13
24000	0	16	0	0	0	16
24001	13	0	0	0	0	13
24002	12	0	0	0	0	12
24003	0	0	13	0	0	13
24004	13	0	0	0	0	13
24005	0	0	15	0	0	15
24006	0	0	18	0	0	18
24007	0	0	0	20	0	20
24008	0	23	0	0	0	23
24009	22	0	0	0	0	22
24010	0	0	0	22	0	22
24011	0	0	0	23	0	23
24012	0	0	0	23	0	23
24013	23	0	0	0	0	23
24014	0	0	0	23	0	23
24015	1	0	0	21	0	22
24016	0	0	22	0	0	22
24017	23	0	0	0	0	23
24018	24	0	0	0	0	24
24019	0	0	24	0	0	24
24020	23	0	0	0	0	23
24021	1	0	0	22	0	23
24022	0	22	0	0	0	22
24023	0	0	0	24	0	24
24024	23	0	0	0	0	23
24025	0	23	0	0	0	23
24026	0	0	0	24	0	24
24027	0	0	0	24	0	24
24028	0	0	0	24	0	24
24029	0	0	0	24	0	24
24030	0	20	0	0	0	20
24031	19	0	0	0	0	19
24032	21	0	0	0	0	21
24033	0	21	0	0	0	21
24034	22	0	0	0	0	22
24035	21	0	0	0	0	21
24036	22	0	0	0	0	22
24037	0	0	21	0	0	21
24038	0	0	0	23	0	23
24039	0	0	22	0	0	22
24040	22	1	0	0	0	23
24041	0	22	0	0	0	22
24042	21	0	1	0	0	22
24043	0	21	0	0	0	21
24044	0	0	0	23	0	23
24045	0	0	0	25	0	25
24046	0	0	23	0	0	23
24047	0	25	0	0	0	25
24048	26	0	0	0	0	26
24049	0	0	25	0	0	25
24050	26	0	0	0	0	26
24051	0	0	0	27	0	27
24052	0	0	25	0	0	25
24053	0	25	0	0	0	25
24054	0	0	0	25	0	25
24055	0	0	26	0	0	26
24056	0	0	25	0	0	25
24057	0	25	0	0	0	25
24058	0	0	0	24	0	24
24059	0	0	0	25	0	25
24060	0	23	0	0	0	23
24061	26	0	0	0	0	26
24062	0	0	0	26	0	26
24063	0	26	0	0	0	26
24064	30	0	0	0	0	30
24065	30	0	0	0	0	30
24066	30	0	0	0	0	30
24067	0	29	0	0	0	29
24068	30	0	0	0	0	30
24069	29	0	0	0	0	29
24070	0	0	0	30	0	30
24071	30	0	0	0	0	30
24072	0	0	0	30	0	30
24073	0	0	29	0	0	29
24074	0	0	28	0	0	28
24075	0	0	0	32	0	32
24076	0	0	31	0	0	31
24077	35	0	0	0	0	35
24078	0	0	0	30	0	30
24079	0	0	0	31	0	31
24080	0	0	31	0	0	31
24081	0	29	0	0	0	29
24082	0	33	0	0	0	33
24083	0	0	0	32	0	32
24084	0	0	0	30	0	30
24085	0	0	30	0	0	30
24086	0	0	28	0	0	28
24087	0	0	0	32	0	32
24088	0	0	30	0	0	30
24089	31	0	0	0	0	31
24090	0	0	0	29	0	29
24091	29	0	0	0	0	29
24092	0	0	0	32	0	32
24093	0	0	0	30	0	30
24094	0	0	29	0	0	29
24095	0	31	0	0	0	31
24096	0	0	0	34	0	34
24097	0	0	34	0	0	34
24098	0	31	0	0	0	31
24099	0	0	0	29	0	29
24100	26	0	0	0	0	26
24101	1	0	22	0	0	23
24102	26	0	0	0	0	26
24103	0	0	26	0	0	26
24104	24	0	0	0	0	24
24105	0	23	0	0	0	23
24106	0	26	0	0	0	26
24107	0	0	0	25	0	25
24108	0	15	0	0	0	15
24109	26	0	0	0	0	26
24110	0	0	0	25	0	25
24111	0	0	0	24	0	24
24112	0	0	0	26	0	26
24113	0	0	26	0	0	26
24114	0	0	0	25	0	25
24115	0	0	24	0	0	24
24116	0	24	0	0	0	24
24117	25	0	0	0	0	25
24118	0	26	0	0	0	26
24119	27	0	0	0	0	27
24120	27	0	0	0	0	27
24121	26	0	0	0	0	26
24122	26	0	0	0	0	26
24123	0	0	25	0	0	25
24124	0	0	0	26	0	26
24125	0	0	0	25	0	25
24126	0	0	0	24	0	24
24127	23	0	0	1	0	24
24128	25	0	0	0	0	25
24129	0	25	0	0	0	25
24130	0	0	21	0	0	21
24131	0	0	22	0	0	22
24132	0	25	0	0	0	25
24133	0	26	0	0	0	26
24134	0	0	0	26	0	26
24135	0	0	0	26	0	26
24136	25	0	0	0	0	25
24137	0	25	0	0	0	25
24138	0	0	0	23	0	23
24139	0	0	23	0	0	23
24140	0	0	0	22	0	22
24141	0	0	0	22	0	22
24142	0	0	0	21	0	21
24143	0	0	0	21	0	21
24144	0	0	20	0	0	20
24145	0	19	0	0	0	19
24146	0	20	0	0	0	20
24147	21	0	0	0	0	21
24148	0	18	0	0	0	18
24149	0	21	0	0	0	21
24150	0	0	0	22	0	22
24151	0	0	0	20	0	20
24152	0	0	0	22	0	22
24153	0	0	17	0	0	17
24154	0	21	0	0	0	21
24155	0	0	0	22	0	22
24156	0	22	0	0	0	22
24157	20	0	0	0	0	20
24158	0	19	0	0	0	19
24159	18	0	0	0	0	18
24160	0	0	17	0	0	17
24161	19	0	0	0	0	19
24162	0	0	0	20	0	20
24163	0	0	19	0	0	19
24164	19	0	0	0	0	19
24165	20	0	0	0	0	20
24166	18	0	0	0	0	18
24167	0	0	0	17	0	17
24168	0	0	18	0	0	18
24169	18	0	0	0	0	18
24170	0	0	0	13	0	13
24171	0	0	0	13	0	13
24172	0	0	22	0	0	22
24173	0	20	0	0	0	20
24174	0	0	0	27	0	27
24175	0	26	0	0	0	26
24176	26	0	0	0	0	26
24177	27	0	0	0	0	27
24178	0	0	0	28	0	28
24179	24	0	0	0	0	24
24180	0	27	0	0	0	27
24181	25	0	0	0	0	25
24182	0	26	0	0	0	26
24183	0	0	0	26	0	26
24184	0	0	0	23	0	23
24185	0	25	0	0	0	25
24186	0	0	0	21	0	21
24187	1	0	24	0	0	25
24188	0	22	0	0	0	22
24189	20	0	0	0	0	20
24190	0	23	0	0	0	23
24191	0	0	0	23	0	23
24192	0	0	24	0	0	24
24193	0	0	0	24	0	24
24194	0	0	0	24	0	24
24195	23	0	0	0	0	23
24196	0	0	25	0	0	25
24197	0	29	0	0	0	29
24198	0	0	29	0	0	29
24199	0	0	25	0	0	25
24200	0	0	28	0	0	28
24201	0	0	1	28	0	29
24202	30	0	0	0	0	30
24203	0	30	0	0	0	30
24204	31	0	0	0	0	31
24205	31	0	0	0	0	31
24206	0	0	0	31	0	31
24207	0	31	0	0	0	31
24208	31	0	0	0	0	31
24209	0	30	0	0	0	30
24210	0	0	0	32	0	32
24211	0	0	0	30	0	30
24212	0	34	0	0	0	34
24213	0	0	0	34	0	34
24214	0	0	34	0	0	34
24215	0	0	34	0	0	34
24216	0	0	0	33	0	33
24217	0	0	0	32	0	32
24218	0	0	33	0	0	33
24219	0	0	33	0	0	33
24220	33	0	0	0	0	33
24221	0	33	0	0	0	33
24222	0	32	0	0	0	32
24223	0	0	0	35	0	35
24224	0	0	0	35	0	35
24225	0	0	0	34	0	34
24226	0	0	36	0	0	36
24227	0	0	37	0	0	37
24228	0	0	0	34	0	34
24229	0	0	36	0	0	36
24230	0	35	0	0	0	35
24231	36	0	0	0	0	36
24232	0	0	36	0	0	36
24233	0	0	38	0	0	38
24234	0	0	0	37	0	37
24235	0	0	37	0	0	37
24236	0	35	0	0	0	35
24237	0	0	0	38	0	38
24238	0	0	36	0	0	36
24239	0	38	0	0	0	38
24240	37	0	0	0	0	37
24241	0	0	0	38	0	38
24242	0	0	0	42	0	42
24243	43	0	0	0	0	43
24244	0	44	0	0	0	44
24245	42	0	0	1	0	43
24246	40	0	0	0	0	40
24247	43	0	0	0	0	43
24248	0	0	0	46	0	46
24249	47	0	0	0	0	47
24250	0	44	0	0	0	44
24251	0	45	0	0	0	45
24252	46	0	0	0	0	46
24253	1	0	0	45	0	46
24254	0	0	0	47	0	47
24255	0	0	0	47	0	47
24256	0	0	46	0	0	46
24257	0	43	0	0	0	43
24258	0	0	0	47	0	47
24259	47	0	0	0	0	47
24260	0	0	0	47	0	47
24261	0	0	42	0	0	42
24262	0	45	0	0	0	45
24263	47	0	0	0	0	47
24264	47	0	0	0	0	47
24265	38	0	0	0	0	38
24266	0	0	0	39	0	39
24267	0	0	34	0	0	34
24268	0	0	28	0	0	28
24269	0	34	0	0	0	34
24270	0	0	0	32	0	32
24271	0	0	0	34	0	34
24272	34	0	0	0	0	34
24273	0	0	0	35	0	35
24274	35	0	0	0	0	35
24275	0	0	29	0	0	29
24276	0	0	31	0	0	31
24277	0	0	0	32	0	32
24278	0	0	0	32	0	32
24279	0	0	0	33	0	33
24280	34	0	0	0	0	34
24281	34	0	0	0	0	34
24282	0	0	0	33	0	33
24283	0	0	30	0	0	30
24284	0	0	31	0	0	31
24285	0	0	0	28	0	28
24286	32	0	0	0	0	32
24287	0	0	0	34	0	34
24288	0	0	0	34	0	34
24289	0	0	35	0	0	35
24290	0	0	28	0	0	28
24291	28	0	0	0	0	28
24292	0	0	27	0	0	27
24293	0	0	0	27	0	27
24294	0	0	0	27	0	27
24295	27	0	0	0	0	27
24296	0	26	0	0	0	26
24297	25	0	0	0	0	25
24298	0	24	0	0	0	24
24299	26	0	0	0	0	26
24300	0	0	27	0	0	27
24301	27	0	0	0	0	27
24302	27	0	0	0	0	27
24303	0	0	0	27	0	27
24304	0	0	31	0	0	31
24305	0	0	0	27	0	27
24306	0	0	0	27	0	27
24307	0	27	0	0	0	27
24308	0	0	0	25	0	25
24309	0	27	0	0	0	27
24310	0	0	0	27	0	27
24311	25	0	0	0	0	25
24312	0	0	0	25	0	25
24313	0	0	26	0	0	26
24314	26	0	0	0	0	26
24315	0	0	26	0	0	26
24316	25	0	0	0	0	25
24317	28	0	0	0	0	28
24318	0	24	0	0	0	24
24319	0	28	0	0	0	28
24320	28	0	0	0	0	28
24321	28	0	0	0	0	28
24322	25	0	0	0	0	25
24323	27	0	0	0	0	27
24324	26	0	0	0	0	26
24325	0	0	0	27	0	27
24326	0	0	0	30	0	30
24327	0	0	28	0	0	28
24328	29	0	0	0	0	29
24329	0	0	0	27	0	27
24330	1	0	0	28	0	29
24331	0	0	28	0	0	28
24332	0	26	0	0	0	26
24333	0	29	0	0	0	29
24334	27	0	0	0	0	27
24335	26	0	0	0	0	26
24336	0	24	0	0	0	24
24337	0	26	0	0	0	26
24338	25	0	0	0	0	25
24339	29	0	0	0	0	29
24340	0	0	0	29	0	29
24341	0	0	0	27	0	27
24342	0	0	0	28	0	28
24343	28	0	0	1	0	29
24344	28	0	0	0	0	28
24345	0	0	0	30	0	30
24346	34	0	0	0	0	34
24347	0	0	32	0	0	32
24348	0	0	0	31	0	31
24349	0	0	35	0	0	35
24350	0	31	0	1	0	32
24351	0	0	0	38	0	38
24352	38	0	0	0	0	38
24353	0	0	0	37	0	37
24354	0	0	0	38	0	38
24355	0	0	37	0	0	37
24356	0	1	38	0	0	39
24357	0	40	0	0	0	40
24358	45	0	0	0	0	45
24359	44	0	0	0	0	44
24360	41	0	0	0	0	41
24361	41	0	0	1	0	42
24362	0	0	0	44	0	44
24363	2	0	0	34	0	36
24364	0	39	0	0	0	39
24365	37	0	0	0	0	37
24366	38	0	0	0	0	38
24367	1	0	38	0	0	39
24368	37	0	0	0	0	37
24369	0	37	0	0	0	37
24370	0	0	0	35	0	35
24371	0	34	0	0	0	34
24372	38	0	0	0	0	38
24373	0	35	0	0	0	35
24374	0	0	0	37	0	37
24375	0	0	0	36	0	36
24376	0	0	0	38	0	38
24377	0	34	0	0	0	34
24378	0	0	0	37	0	37
24379	0	0	0	33	0	33
24380	0	35	0	0	0	35
24381	0	31	0	0	0	31
24382	32	0	0	0	0	32
24383	0	32	0	0	0	32
24384	32	0	0	0	0	32
24385	0	1	27	0	0	28
24386	0	32	0	0	0	32
24387	34	0	0	0	0	34
24388	33	0	0	0	0	33
24389	0	0	30	0	0	30
24390	0	0	0	33	0	33
24391	0	0	35	0	0	35
24392	0	34	0	0	0	34
24393	30	0	0	0	0	30
24394	0	35	0	0	0	35
24395	0	0	0	32	0	32
24396	0	0	0	32	0	32
24397	0	0	26	0	0	26
24398	0	0	25	0	0	25
24399	30	0	0	0	0	30
24400	27	0	0	0	0	27
24401	29	0	0	0	0	29
24402	30	0	0	0	0	30
24403	0	29	0	0	0	29
24404	0	0	0	27	0	27
24405	0	0	0	29	0	29
24406	0	30	0	0	0	30
24407	30	0	0	0	0	30
24408	34	0	0	0	0	34
24409	0	0	32	0	0	32
24410	33	0	0	0	0	33
24411	0	0	0	32	0	32
24412	0	0	33	0	0	33
24413	0	0	0	32	0	32
24414	0	0	32	0	0	32
24415	0	0	27	0	0	27
24416	0	0	0	33	0	33
24417	0	30	0	0	0	30
24418	31	0	0	0	0	31
24419	30	0	0	0	0	30
24420	0	29	0	0	0	29
24421	0	28	0	0	0	28
24422	30	0	0	0	0	30
24423	30	0	0	0	0	30
24424	26	0	0	1	0	27
24425	29	0	0	0	0	29
24426	0	0	0	29	0	29
24427	0	0	28	0	0	28
24428	0	28	0	0	0	28
24429	28	0	0	0	0	28
24430	1	28	0	0	0	29
24431	27	0	0	0	0	27
24432	25	0	0	0	0	25
24433	0	0	26	0	0	26
24434	0	28	0	0	0	28
24435	0	0	0	29	0	29
24436	0	0	0	29	0	29
24437	0	0	0	29	0	29
24438	28	0	0	0	0	28
24439	25	0	0	0	0	25
24440	27	0	0	0	0	27
24441	0	24	0	0	0	24
24442	23	0	0	0	0	23
24443	0	27	0	0	0	27
24444	0	0	25	0	0	25
24445	0	25	0	0	0	25
24446	0	0	0	25	0	25
24447	0	0	0	25	0	25
24448	0	0	21	0	0	21
24449	0	0	0	18	0	18
24450	0	0	0	19	0	19
24451	24	0	0	0	0	24
24452	24	0	0	0	0	24
24453	28	0	0	0	0	28
24454	0	27	0	0	0	27
24455	28	0	0	0	0	28
24456	28	0	0	0	0	28
24457	0	28	0	0	0	28
24458	0	0	0	27	0	27
24459	0	0	0	27	0	27
24460	26	0	0	0	0	26
24461	0	0	25	0	0	25
24462	0	24	0	0	0	24
24463	0	0	0	26	0	26
24464	0	23	0	0	0	23
24465	0	23	0	0	0	23
24466	26	0	0	0	0	26
24467	26	0	0	0	0	26
24468	0	0	0	26	0	26
24469	0	0	0	26	0	26
24470	0	0	0	26	0	26
24471	0	0	0	25	0	25
24472	0	0	27	0	0	27
24473	0	0	25	0	0	25
24474	0	0	0	30	0	30
24475	0	0	30	0	0	30
24476	0	31	0	0	0	31
24477	30	0	0	1	0	31
24478	31	0	0	0	0	31
24479	0	0	0	29	0	29
24480	0	0	0	29	0	29
24481	0	0	0	28	0	28
24482	0	29	0	0	0	29
24483	32	0	0	0	0	32
24484	31	0	0	0	0	31
24485	0	0	32	0	0	32
24486	0	0	0	31	0	31
24487	0	0	30	0	0	30
24488	0	0	0	30	0	30
24489	0	0	0	32	0	32
24490	0	0	0	34	0	34
24491	0	0	0	33	0	33
24492	35	0	0	0	0	35
24493	34	0	0	0	0	34
24494	30	0	0	0	0	30
24495	0	0	0	30	0	30
24496	0	0	28	0	0	28
24497	32	0	0	0	0	32
24498	0	0	0	31	0	31
24499	33	0	0	0	0	33
24500	0	0	0	39	0	39
24501	0	36	0	0	0	36
24502	0	36	0	0	0	36
24503	0	0	0	41	0	41
24504	0	0	0	39	0	39
24505	0	0	0	40	0	40
24506	0	40	0	0	0	40
24507	44	0	0	0	0	44
24508	0	44	0	0	0	44
24509	0	0	42	0	0	42
24510	0	0	0	42	0	42
24511	0	43	0	0	0	43
24512	0	0	0	44	0	44
24513	0	0	0	41	0	41
24514	0	0	43	0	0	43
24515	43	0	0	0	0	43
24516	0	44	1	0	0	45
24517	40	0	1	0	0	41
24518	45	0	0	0	0	45
24519	43	0	0	0	0	43
24520	0	0	47	0	0	47
24521	0	0	0	45	0	45
24522	0	0	0	47	0	47
24523	0	0	47	0	0	47
24524	44	0	0	0	0	44
24525	0	0	44	0	0	44
24526	0	0	36	1	0	37
24527	0	45	0	0	0	45
24528	0	0	0	41	0	41
24529	0	0	43	0	0	43
24530	42	0	0	0	0	42
24531	43	0	0	0	0	43
24532	0	0	41	0	0	41
24533	0	0	0	41	0	41
24534	0	0	43	0	0	43
24535	0	47	0	0	0	47
24536	47	0	0	0	0	47
24537	48	0	0	0	0	48
24538	47	0	0	0	0	47
24539	0	0	0	48	0	48
24540	0	0	0	48	0	48
24541	0	0	49	0	0	49
24542	44	0	0	1	0	45
24543	0	0	0	47	0	47
24544	43	0	0	0	0	43
24545	0	0	43	0	0	43
24546	0	0	39	0	0	39
24547	0	0	0	37	0	37
24548	0	0	0	37	0	37
24549	0	0	40	0	0	40
24550	39	0	0	0	0	39
24551	0	0	0	40	0	40
24552	0	39	0	0	0	39
24553	39	0	0	0	0	39
24554	0	37	0	0	0	37
24555	39	0	0	0	0	39
24556	0	0	43	0	0	43
24557	1	0	38	0	0	39
24558	0	44	0	0	0	44
24559	45	0	0	0	0	45
24560	0	0	44	0	0	44
24561	43	0	0	0	0	43
24562	0	44	0	0	0	44
24563	0	0	0	43	0	43
24564	0	0	0	44	0	44
24565	0	43	0	0	0	43
24566	45	0	0	0	0	45
24567	41	0	0	0	0	41
24568	40	0	0	0	0	40
24569	0	0	48	0	0	48
24570	0	0	0	48	0	48
24571	1	0	0	46	0	47
24572	0	0	0	49	0	49
24573	0	0	49	0	0	49
24574	0	43	0	0	0	43
24575	49	0	0	0	0	49
24576	0	0	50	0	0	50
24577	47	0	0	0	0	47
24578	0	46	0	0	0	46
24579	48	0	0	1	0	49
24580	0	0	0	48	0	48
24581	48	0	0	0	0	48
24582	0	0	0	48	0	48
24583	0	0	50	0	0	50
24584	0	0	0	49	0	49
24585	0	0	46	0	0	46
24586	46	0	0	0	0	46
24587	0	47	0	0	0	47
24588	0	0	0	49	0	49
24589	0	49	0	0	0	49
24590	49	0	0	0	0	49
24591	48	0	0	0	0	48
24592	0	46	0	0	0	46
24593	46	0	0	0	0	46
24594	46	0	0	0	0	46
24595	0	0	0	47	0	47
24596	0	0	0	45	0	45
24597	41	0	0	0	0	41
24598	41	0	0	0	0	41
24599	0	0	0	46	0	46
24600	0	0	0	45	0	45
24601	44	0	0	0	0	44
24602	0	0	45	0	0	45
24603	43	0	0	0	0	43
24604	0	0	45	0	0	45
24605	0	43	0	0	0	43
24606	0	0	0	44	0	44
24607	0	0	48	0	0	48
24608	0	45	0	0	0	45
24609	50	0	0	0	0	50
24610	0	0	49	0	0	49
24611	51	0	0	0	0	51
24612	51	0	0	0	0	51
24613	49	0	0	0	0	49
24614	0	0	0	49	0	49
24615	0	47	0	0	0	47
24616	52	0	0	0	0	52
24617	0	0	52	0	0	52
24618	52	0	0	0	0	52
24619	2	0	45	0	0	47
24620	0	49	0	0	0	49
24621	0	0	0	50	0	50
24622	0	0	0	50	0	50
24623	0	50	0	0	0	50
24624	0	0	0	51	0	51
24625	0	0	53	0	0	53
24626	0	55	0	0	0	55
24627	0	0	0	49	0	49
24628	47	0	0	0	0	47
24629	47	0	0	0	0	47
24630	0	0	0	46	0	46
24631	0	45	0	0	0	45
24632	0	0	0	47	0	47
24633	1	0	0	46	0	47
24634	0	0	40	0	0	40
24635	0	48	0	0	0	48
24636	0	0	0	53	0	53
24637	0	0	52	0	0	52
24638	0	51	0	0	0	51
24639	0	0	0	53	0	53
24640	53	0	0	0	0	53
24641	0	53	0	0	0	53
24642	0	0	0	56	0	56
24643	58	0	0	0	0	58
24644	57	0	0	0	0	57
24645	56	0	0	0	0	56
24646	53	0	0	0	0	53
24647	0	0	0	52	0	52
24648	0	0	55	0	0	55
24649	0	0	0	48	0	48
24650	0	49	0	0	0	49
24651	50	0	0	0	0	50
24652	0	0	51	0	0	51
24653	49	0	0	0	0	49
24654	0	0	49	0	0	49
24655	0	0	0	51	0	51
24656	0	0	53	0	0	53
24657	0	0	0	53	0	53
24658	0	0	52	0	0	52
24659	0	0	0	52	0	52
24660	50	0	0	0	0	50
24661	0	52	0	0	0	52
24662	0	0	0	47	0	47
24663	0	0	0	44	0	44
24664	0	0	47	0	0	47
24665	0	0	42	0	0	42
24666	44	0	0	0	0	44
24667	0	46	0	0	0	46
24668	44	0	0	0	0	44
24669	38	0	0	0	0	38
24670	0	0	0	40	0	40
24671	0	41	0	0	0	41
24672	45	0	0	0	0	45
24673	42	0	0	0	0	42
24674	44	0	0	0	0	44
24675	47	0	0	0	0	47
24676	46	0	0	0	0	46
24677	0	0	47	0	0	47
24678	44	0	0	1	0	45
24679	0	0	40	1	0	41
24680	0	0	0	45	0	45
24681	0	0	0	45	0	45
24682	0	0	45	0	0	45
24683	43	0	0	0	0	43
24684	0	0	0	43	0	43
24685	0	0	0	40	0	40
24686	0	0	0	40	0	40
24687	0	0	0	40	0	40
24688	0	0	0	42	0	42
24689	0	0	39	0	0	39
24690	0	0	0	40	0	40
24691	0	0	41	0	0	41
24692	0	0	35	0	0	35
24693	35	0	0	0	0	35
24694	38	0	0	0	0	38
24695	37	0	0	0	0	37
24696	0	0	38	0	0	38
24697	0	0	37	0	0	37
24698	0	0	34	0	0	34
24699	0	35	0	0	0	35
24700	0	0	0	38	0	38
24701	38	0	0	0	0	38
24702	0	0	0	34	0	34
24703	0	34	0	0	0	34
24704	38	0	0	0	0	38
24705	0	0	0	38	0	38
24706	0	37	0	0	0	37
24707	0	0	0	43	0	43
24708	0	0	0	44	0	44
24709	41	0	0	0	0	41
24710	0	0	0	45	0	45
24711	0	0	46	0	0	46
24712	0	0	0	46	0	46
24713	0	42	0	0	0	42
24714	0	48	0	1	0	49
24715	0	0	0	51	0	51
24716	0	0	0	49	0	49
24717	0	45	0	0	0	45
24718	0	44	0	0	0	44
24719	0	49	0	0	0	49
24720	0	0	0	51	0	51
24721	0	49	1	0	0	50
24722	52	0	0	0	0	52
24723	0	0	50	0	0	50
24724	0	1	0	50	0	51
24725	0	51	0	0	0	51
24726	54	0	0	0	0	54
24727	0	0	52	0	0	52
24728	0	50	0	0	0	50
24729	46	0	0	0	0	46
24730	0	52	0	0	0	52
24731	0	45	0	0	0	45
24732	0	0	0	47	0	47
24733	0	44	0	0	0	44
24734	43	0	0	0	0	43
24735	0	0	0	43	0	43
24736	0	0	41	0	0	41
24737	0	0	39	0	0	39
24738	0	0	0	42	0	42
24739	0	0	43	0	0	43
24740	0	0	0	41	0	41
24741	39	0	0	0	0	39
24742	0	0	46	0	0	46
24743	0	0	0	46	0	46
24744	0	45	0	0	0	45
24745	0	0	0	47	0	47
24746	0	0	0	45	0	45
24747	0	46	0	0	0	46
24748	0	0	0	47	0	47
24749	0	0	0	43	0	43
24750	0	0	45	0	0	45
24751	0	48	0	0	0	48
24752	45	0	0	0	0	45
24753	0	0	0	46	0	46
24754	0	0	50	0	0	50
24755	0	0	0	50	0	50
24756	0	0	45	0	0	45
24757	49	0	0	0	0	49
24758	0	49	0	0	0	49
24759	0	0	0	49	0	49
24760	0	0	0	49	0	49
24761	49	0	0	0	0	49
24762	0	0	0	49	0	49
24763	0	0	48	0	0	48
24764	0	0	0	47	0	47
24765	0	46	0	0	0	46
24766	0	42	0	0	0	42
24767	0	42	0	0	0	42
24768	0	0	0	44	0	44
24769	0	0	45	0	0	45
24770	0	43	0	0	0	43
24771	44	0	0	0	0	44
24772	0	45	0	0	0	45
24773	46	0	0	0	0	46
24774	47	0	0	0	0	47
24775	0	0	46	0	0	46
24776	48	0	0	0	0	48
24777	49	0	0	0	0	49
24778	46	1	0	0	0	47
24779	46	0	0	0	0	46
24780	0	0	46	0	0	46
24781	44	0	0	0	0	44
24782	45	0	0	0	0	45
24783	0	51	0	0	0	51
24784	0	0	0	50	0	50
24785	0	0	0	51	0	51
24786	0	54	0	0	0	54
24787	49	0	0	0	0	49
24788	0	52	1	0	0	53
24789	50	0	0	0	0	50
24790	49	0	0	0	0	49
24791	0	50	0	0	0	50
24792	0	0	0	50	0	50
24793	0	1	46	0	0	47
24794	0	48	0	0	0	48
24795	0	0	0	50	0	50
24796	0	48	0	0	0	48
24797	0	45	0	0	0	45
24798	0	0	0	46	0	46
24799	0	0	52	0	0	52
24800	0	43	0	0	0	43
24801	0	45	0	0	0	45
24802	41	0	0	0	0	41
24803	0	0	0	40	0	40
24804	1	0	0	32	0	33
24805	0	0	0	34	0	34
24806	0	0	35	0	0	35
24807	0	0	0	30	0	30
24808	1	29	0	0	0	30
24809	31	0	0	0	0	31
24810	0	0	0	31	0	31
24811	0	0	33	0	0	33
24812	30	0	0	0	0	30
24813	0	0	0	30	0	30
24814	0	0	31	0	0	31
24815	0	0	29	0	0	29
24816	31	0	0	0	0	31
24817	30	0	0	0	0	30
24818	30	0	0	0	0	30
24819	30	0	0	0	0	30
24820	0	0	31	0	0	31
24821	0	34	0	0	0	34
24822	32	0	0	0	0	32
24823	0	33	0	0	0	33
24824	33	0	0	0	0	33
24825	0	35	0	0	0	35
24826	0	0	0	36	0	36
24827	0	0	0	36	0	36
24828	0	0	0	34	0	34
24829	0	35	0	0	0	35
24830	0	34	0	0	0	34
24831	0	0	0	36	0	36
24832	0	36	0	0	0	36
24833	0	0	35	0	0	35
24834	0	0	0	36	0	36
24835	0	0	35	0	0	35
24836	34	0	0	0	0	34
24837	33	0	0	0	0	33
24838	0	0	31	0	0	31
24839	0	0	34	0	0	34
24840	0	0	0	32	0	32
24841	0	0	32	0	0	32
24842	0	2	0	29	0	31
24843	0	32	0	0	0	32
24844	0	0	2	32	0	34
24845	0	0	0	32	0	32
24846	0	0	0	35	0	35
24847	0	0	31	0	0	31
24848	0	0	0	32	0	32
24849	0	0	0	33	0	33
24850	0	0	0	36	0	36
24851	0	36	0	0	0	36
24852	35	0	0	0	0	35
24853	36	0	0	0	0	36
24854	37	0	0	0	0	37
24855	0	0	0	38	0	38
24856	1	0	35	0	0	36
24857	0	0	31	0	0	31
24858	0	36	0	0	0	36
24859	37	0	0	0	0	37
24860	0	37	0	0	0	37
24861	39	0	0	0	0	39
24862	0	39	0	0	0	39
24863	41	0	0	0	0	41
24864	0	41	0	0	0	41
24865	0	0	0	42	0	42
24866	0	0	39	0	0	39
24867	0	0	41	0	0	41
24868	0	0	0	39	0	39
24869	0	0	0	42	0	42
24870	0	0	0	43	0	43
24871	0	0	39	0	0	39
24872	0	0	0	38	0	38
24873	40	0	0	0	0	40
24874	41	0	0	0	0	41
24875	0	42	1	0	0	43
24876	38	0	0	0	0	38
24877	0	37	0	0	0	37
24878	38	0	0	0	0	38
24879	35	0	0	0	0	35
24880	37	0	0	0	0	37
24881	0	0	38	0	0	38
24882	0	0	33	0	0	33
24883	41	0	0	0	0	41
24884	41	0	0	0	0	41
24885	0	0	0	45	0	45
24886	0	0	0	45	0	45
24887	0	0	0	43	0	43
24888	0	0	0	44	0	44
24889	0	0	0	45	0	45
24890	43	0	0	0	0	43
24891	0	0	0	48	0	48
24892	0	0	39	0	0	39
24893	44	0	0	0	0	44
24894	45	0	0	1	0	46
24895	0	44	0	0	0	44
24896	0	42	0	0	0	42
24897	48	0	0	0	0	48
24898	0	47	0	0	0	47
24899	47	0	0	0	0	47
24900	50	0	0	0	0	50
24901	49	0	0	0	0	49
24902	0	0	0	46	0	46
24903	0	45	0	0	0	45
24904	48	0	0	0	0	48
24905	0	0	0	50	0	50
24906	0	0	0	48	0	48
24907	47	0	0	0	0	47
24908	0	50	0	0	0	50
24909	0	0	0	49	0	49
24910	48	0	0	0	0	48
24911	0	48	0	0	0	48
24912	48	0	0	0	0	48
24913	0	0	44	0	0	44
24914	47	0	0	0	0	47
24915	0	53	0	0	0	53
24916	48	0	0	0	0	48
24917	47	0	0	0	0	47
24918	0	50	0	0	0	50
24919	50	0	0	0	0	50
24920	0	49	0	0	0	49
24921	51	0	0	0	0	51
24922	0	0	0	50	0	50
24923	0	0	0	51	0	51
24924	0	0	0	51	0	51
24925	0	0	49	0	0	49
24926	0	0	0	50	0	50
24927	0	0	50	0	0	50
24928	0	0	0	47	0	47
24929	0	51	0	0	0	51
24930	0	0	0	53	0	53
24931	0	0	50	0	0	50
24932	1	0	48	0	0	49
24933	0	0	0	53	0	53
24934	53	0	0	0	0	53
24935	51	0	0	1	0	52
24936	0	49	0	0	0	49
24937	0	0	0	49	0	49
24938	0	0	51	0	0	51
24939	0	0	0	49	0	49
24940	0	0	49	0	0	49
24941	49	0	0	0	0	49
24942	0	0	0	46	0	46
24943	0	0	47	0	0	47
24944	0	0	0	45	0	45
24945	0	0	0	46	0	46
24946	0	0	45	0	0	45
24947	0	0	0	42	0	42
24948	44	0	0	0	0	44
24949	40	0	0	0	0	40
24950	0	0	0	43	0	43
24951	44	0	0	0	0	44
24952	0	0	41	0	0	41
24953	0	0	40	0	0	40
24954	42	0	0	0	0	42
24955	41	0	0	0	0	41
24956	0	0	0	41	0	41
24957	0	0	0	41	0	41
24958	0	0	39	0	0	39
24959	0	0	0	38	0	38
24960	0	39	0	0	0	39
24961	38	0	0	0	0	38
24962	38	0	0	0	0	38
24963	0	37	0	0	0	37
24964	34	0	0	0	0	34
24965	31	0	0	0	0	31
24966	0	34	0	0	0	34
24967	35	0	0	0	0	35
24968	0	27	0	0	0	27
24969	30	0	0	0	0	30
24970	0	0	33	0	0	33
24971	0	0	0	35	0	35
24972	0	0	0	36	0	36
24973	0	0	0	36	0	36
24974	36	0	0	0	0	36
24975	0	0	0	34	0	34
24976	0	0	30	0	0	30
24977	33	0	0	0	0	33
24978	0	0	0	30	0	30
24979	0	30	1	0	0	31
24980	0	30	0	0	0	30
24981	1	0	0	31	0	32
24982	0	0	0	31	0	31
24983	0	0	0	28	0	28
24984	0	0	24	0	0	24
24985	0	27	1	0	0	28
24986	24	0	0	0	0	24
24987	22	0	0	0	0	22
24988	0	23	0	0	0	23
24989	0	24	1	0	0	25
24990	0	0	0	26	0	26
24991	0	0	23	0	0	23
24992	23	0	0	0	0	23
24993	23	0	0	0	0	23
24994	0	0	0	24	0	24
24995	0	0	0	26	0	26
24996	26	0	0	0	0	26
24997	0	0	26	0	0	26
24998	26	0	0	0	0	26
24999	0	25	0	0	0	25
25000	0	0	0	26	0	26
25001	0	24	0	0	0	24
25002	28	0	0	0	0	28
25003	0	0	0	27	0	27
25004	0	0	0	28	0	28
25005	0	30	0	0	0	30
25006	31	0	0	0	0	31
25007	31	0	0	0	0	31
25008	0	0	28	0	0	28
25009	0	0	24	0	0	24
25010	30	0	0	0	0	30
25011	0	0	29	0	0	29
25012	0	0	28	0	0	28
25013	24	0	0	0	0	24
25014	0	0	23	0	0	23
25015	0	0	0	24	0	24
25016	0	0	0	20	0	20
25017	26	0	0	0	0	26
25018	0	0	27	0	0	27
25019	27	0	0	0	0	27
25020	0	0	0	30	0	30
25021	31	0	0	0	0	31
25022	32	0	0	0	0	32
25023	29	0	0	0	0	29
25024	0	0	0	31	0	31
25025	32	0	0	0	0	32
25026	0	0	0	32	0	32
25027	0	0	0	32	0	32
25028	0	0	0	32	0	32
25029	0	0	0	33	0	33
25030	36	0	0	0	0	36
25031	37	0	0	0	0	37
25032	0	0	38	0	0	38
25033	38	0	0	0	0	38
25034	38	0	0	0	0	38
25035	0	0	0	39	0	39
25036	0	38	0	0	0	38
25037	39	0	0	0	0	39
25038	0	0	0	41	0	41
25039	41	0	0	0	0	41
25040	0	41	0	0	0	41
25041	41	0	0	0	0	41
25042	0	0	0	41	0	41
25043	0	41	0	0	0	41
25044	41	0	0	0	0	41
25045	0	39	0	0	0	39
25046	0	41	0	0	0	41
25047	42	0	0	0	0	42
25048	0	0	42	0	0	42
25049	40	0	0	0	0	40
25050	0	0	0	40	0	40
25051	0	0	39	0	0	39
25052	0	0	0	38	0	38
25053	0	0	0	40	0	40
25054	0	0	39	0	0	39
25055	40	0	0	0	0	40
25056	0	0	0	40	0	40
25057	0	0	0	40	0	40
25058	0	0	0	40	0	40
25059	40	0	0	0	0	40
25060	0	0	36	0	0	36
25061	0	0	41	0	0	41
25062	0	0	0	36	0	36
25063	0	0	35	0	0	35
25064	32	0	0	1	0	33
25065	0	32	0	0	0	32
25066	33	0	0	0	0	33
25067	0	0	0	33	0	33
25068	0	33	0	0	0	33
25069	0	0	0	34	0	34
25070	0	35	0	0	0	35
25071	0	0	0	35	0	35
25072	0	1	34	0	0	35
25073	0	0	33	0	0	33
25074	0	34	0	0	0	34
25075	33	0	0	0	0	33
25076	0	0	0	34	0	34
25077	0	0	0	34	0	34
25078	33	0	0	0	0	33
25079	34	0	0	0	0	34
25080	0	0	0	33	0	33
25081	0	0	33	0	0	33
25082	0	26	0	0	0	26
25083	0	0	0	29	0	29
25084	0	0	0	29	0	29
25085	0	29	0	0	0	29
25086	29	0	0	0	0	29
25087	0	0	27	0	0	27
25088	0	0	0	31	0	31
25089	0	0	0	31	0	31
25090	0	0	30	0	0	30
25091	0	0	0	29	0	29
25092	32	0	0	0	0	32
25093	31	0	0	0	0	31
25094	31	0	0	0	0	31
25095	0	27	0	0	0	27
25096	28	0	0	0	0	28
25097	0	0	0	30	0	30
25098	0	0	0	26	0	26
25099	0	25	0	0	0	25
25100	26	0	0	0	0	26
25101	26	0	0	0	0	26
25102	26	0	0	0	0	26
25103	30	0	0	0	0	30
25104	36	0	0	0	0	36
25105	0	0	32	0	0	32
25106	36	0	0	0	0	36
25107	34	0	0	0	0	34
25108	36	0	0	0	0	36
25109	0	0	0	32	0	32
25110	0	0	0	34	0	34
25111	0	0	38	0	0	38
25112	36	0	0	0	0	36
25113	0	36	0	0	0	36
25114	0	33	0	0	0	33
25115	0	0	35	0	0	35
25116	0	34	0	0	0	34
25117	0	33	0	0	0	33
25118	0	0	0	33	0	33
25119	0	34	0	0	0	34
25120	32	0	0	0	0	32
25121	28	0	0	0	0	28
25122	0	0	0	32	0	32
25123	0	0	27	0	0	27
25124	30	0	0	0	0	30
25125	0	0	27	0	0	27
25126	0	0	26	0	0	26
25127	0	0	0	26	0	26
25128	1	0	0	26	0	27
25129	0	0	29	0	0	29
25130	0	21	0	1	0	22
25131	0	27	0	0	0	27
25132	24	0	0	0	0	24
25133	26	0	0	0	0	26
25134	0	0	28	0	0	28
25135	27	0	0	0	0	27
25136	27	0	0	0	0	27
25137	0	0	0	28	0	28
25138	0	0	0	27	0	27
25139	0	0	0	28	0	28
25140	25	0	0	0	0	25
25141	28	0	0	0	0	28
25142	28	0	0	0	0	28
25143	0	0	0	29	0	29
25144	0	0	28	0	0	28
25145	31	0	0	0	0	31
25146	29	0	0	0	0	29
25147	0	0	0	31	0	31
25148	0	29	0	0	0	29
25149	0	0	0	31	0	31
25150	0	31	0	0	0	31
25151	0	0	0	31	0	31
25152	0	29	0	0	0	29
25153	32	0	0	0	0	32
25154	0	0	0	32	0	32
25155	0	30	0	0	0	30
25156	0	0	31	0	0	31
25157	32	0	0	1	0	33
25158	0	0	0	33	0	33
25159	0	33	0	0	0	33
25160	0	0	0	35	0	35
25161	0	33	0	0	0	33
25162	0	35	0	0	0	35
25163	33	0	0	0	0	33
25164	31	0	0	0	0	31
25165	0	0	31	0	0	31
25166	29	0	0	0	0	29
25167	31	0	0	0	0	31
25168	0	33	0	0	0	33
25169	0	0	0	33	0	33
25170	0	0	0	31	0	31
25171	0	0	31	0	0	31
25172	0	1	29	0	0	30
25173	32	0	0	0	0	32
25174	32	0	0	0	0	32
25175	30	0	0	0	0	30
25176	0	0	33	0	0	33
25177	0	0	0	31	0	31
25178	32	0	0	0	0	32
25179	0	0	0	31	0	31
25180	0	0	32	0	0	32
25181	32	0	0	0	0	32
25182	0	0	29	0	0	29
25183	0	29	0	0	0	29
25184	32	0	0	0	0	32
25185	0	0	30	0	0	30
25186	0	0	0	30	0	30
25187	30	0	0	0	0	30
25188	1	0	0	30	0	31
25189	31	0	0	0	0	31
25190	0	0	0	30	0	30
25191	30	0	0	0	0	30
25192	30	0	0	0	0	30
25193	30	0	0	0	0	30
25194	28	0	0	0	0	28
25195	0	0	0	29	0	29
25196	0	0	25	0	0	25
25197	0	0	18	0	0	18
25198	0	20	0	0	0	20
25199	0	19	0	0	0	19
25200	21	0	0	0	0	21
25201	0	0	0	18	0	18
25202	0	0	19	0	0	19
25203	0	0	17	0	0	17
25204	0	0	0	18	0	18
25205	18	0	0	0	0	18
25206	0	16	0	0	0	16
25207	16	0	0	0	0	16
25208	0	0	0	16	0	16
25209	0	0	0	16	0	16
25210	0	0	0	15	0	15
25211	0	0	18	0	0	18
25212	0	0	14	0	0	14
25213	0	17	0	0	0	17
25214	0	0	0	18	0	18
25215	20	0	0	0	0	20
25216	0	0	20	0	0	20
25217	0	0	20	0	0	20
25218	0	0	0	23	0	23
25219	0	0	1	22	0	23
25220	0	0	0	24	0	24
25221	0	0	0	23	0	23
25222	22	0	0	0	0	22
25223	0	0	0	23	0	23
25224	21	0	0	0	0	21
25225	0	0	23	0	0	23
25226	0	22	0	0	0	22
25227	0	0	0	29	0	29
25228	0	0	29	0	0	29
25229	0	0	29	0	0	29
25230	0	29	0	0	0	29
25231	0	0	0	30	0	30
25232	0	0	0	32	0	32
25233	0	0	32	0	0	32
25234	31	0	0	0	0	31
25235	0	0	0	34	0	34
25236	0	0	0	33	0	33
25237	0	0	32	0	0	32
25238	0	29	1	2	0	32
25239	0	35	0	0	0	35
25240	34	0	0	0	0	34
25241	0	0	0	34	0	34
25242	33	0	0	0	0	33
25243	0	0	35	0	0	35
25244	0	0	0	36	0	36
25245	36	0	0	0	0	36
25246	33	0	0	0	0	33
25247	0	0	0	35	0	35
25248	0	0	34	0	0	34
25249	0	0	34	0	0	34
25250	0	0	0	36	0	36
25251	0	0	37	0	0	37
25252	36	0	0	0	0	36
25253	0	32	0	0	0	32
25254	35	0	0	0	0	35
25255	32	0	0	1	0	33
25256	0	0	0	35	0	35
25257	0	0	0	37	0	37
25258	37	0	0	0	0	37
25259	0	0	0	37	0	37
25260	0	0	36	0	0	36
25261	0	37	0	0	0	37
25262	0	0	0	39	0	39
25263	0	0	0	40	0	40
25264	0	0	0	40	0	40
25265	0	0	40	0	0	40
25266	0	37	0	0	0	37
25267	0	0	0	40	0	40
25268	0	0	40	0	0	40
25269	0	0	0	41	0	41
25270	37	0	0	0	0	37
25271	0	0	0	40	0	40
25272	0	0	40	0	0	40
25273	38	0	0	0	0	38
25274	0	36	0	0	0	36
25275	0	38	0	0	0	38
25276	40	0	0	0	0	40
25277	0	0	39	0	0	39
25278	0	0	0	40	0	40
25279	0	0	0	41	0	41
25280	0	0	39	0	0	39
25281	0	35	0	0	0	35
25282	0	0	0	41	0	41
25283	0	0	42	0	0	42
25284	0	0	0	42	0	42
25285	41	0	0	0	0	41
25286	0	0	42	0	0	42
25287	0	0	0	43	0	43
25288	0	0	0	44	0	44
25289	0	0	44	0	0	44
25290	0	0	0	42	0	42
25291	0	45	0	0	0	45
25292	0	0	0	43	0	43
25293	0	47	0	0	0	47
25294	46	0	0	0	0	46
25295	47	0	0	0	0	47
25296	0	0	45	0	0	45
25297	0	0	42	0	0	42
25298	0	0	43	0	0	43
25299	0	43	0	0	0	43
25300	0	0	0	46	0	46
25301	0	0	42	0	0	42
25302	0	0	0	48	0	48
25303	0	0	0	45	0	45
25304	0	0	48	0	0	48
25305	0	0	0	43	0	43
25306	0	0	0	45	0	45
25307	0	45	0	0	0	45
25308	0	0	0	43	0	43
25309	0	0	0	43	0	43
25310	0	0	40	0	0	40
25311	0	0	0	35	0	35
25312	0	0	35	0	0	35
25313	0	0	33	0	0	33
25314	37	0	0	0	0	37
25315	0	0	0	36	0	36
25316	0	32	0	0	0	32
25317	0	33	0	0	0	33
25318	0	0	0	36	0	36
25319	0	0	34	0	0	34
25320	0	27	0	0	0	27
25321	0	0	0	28	0	28
25322	0	0	32	0	0	32
25323	0	30	0	0	0	30
25324	33	0	0	0	0	33
25325	33	0	0	0	0	33
25326	32	0	0	0	0	32
25327	0	0	0	31	0	31
25328	0	0	0	31	0	31
25329	0	0	0	31	0	31
25330	0	0	28	0	0	28
25331	26	0	0	0	0	26
25332	0	0	0	24	0	24
25333	0	0	21	0	0	21
25334	24	0	0	0	0	24
25335	24	0	0	0	0	24
25336	0	0	18	0	0	18
25337	23	0	0	0	0	23
25338	0	28	0	0	0	28
25339	0	0	26	0	0	26
25340	28	0	0	0	0	28
25341	0	27	0	0	0	27
25342	0	0	0	25	0	25
25343	0	30	0	0	0	30
25344	0	0	0	28	0	28
25345	0	0	23	0	0	23
25346	28	0	0	0	0	28
25347	0	0	26	0	0	26
25348	0	27	0	0	0	27
25349	0	28	0	0	0	28
25350	30	0	0	0	0	30
25351	0	0	29	0	0	29
25352	0	0	0	24	0	24
25353	0	0	27	0	0	27
25354	0	24	0	0	0	24
25355	0	0	0	22	0	22
25356	0	23	0	0	0	23
25357	26	0	0	0	0	26
25358	28	0	0	0	0	28
25359	29	0	0	0	0	29
25360	0	0	27	0	0	27
25361	1	0	24	0	0	25
25362	29	0	0	0	0	29
25363	0	0	28	0	0	28
25364	0	0	0	25	0	25
25365	0	29	0	0	0	29
25366	28	0	0	0	0	28
25367	29	0	0	0	0	29
25368	29	0	0	0	0	29
25369	0	0	0	28	0	28
25370	0	0	0	30	0	30
25371	27	0	0	0	0	27
25372	0	30	0	0	0	30
25373	28	0	0	0	0	28
25374	0	0	0	27	0	27
25375	0	0	0	27	0	27
25376	26	0	0	0	0	26
25377	0	25	0	0	0	25
25378	30	0	0	0	0	30
25379	0	30	0	0	0	30
25380	30	0	0	0	0	30
25381	0	0	0	33	0	33
25382	31	0	0	1	0	32
25383	34	0	0	0	0	34
25384	30	0	0	0	0	30
25385	0	31	0	0	0	31
25386	0	0	31	0	0	31
25387	32	0	0	0	0	32
25388	30	0	0	0	0	30
25389	0	33	0	0	0	33
25390	0	0	0	32	0	32
25391	0	0	0	33	0	33
25392	32	0	0	0	0	32
25393	0	0	0	33	0	33
25394	0	0	30	0	0	30
25395	0	0	28	0	0	28
25396	30	0	0	0	0	30
25397	0	0	1	29	0	30
25398	0	0	0	31	0	31
25399	0	0	0	30	0	30
25400	0	0	33	0	0	33
25401	0	0	0	29	0	29
25402	0	0	0	30	0	30
25403	0	0	0	33	0	33
25404	33	0	0	0	0	33
25405	0	0	0	34	0	34
25406	0	0	37	0	0	37
25407	34	0	0	0	0	34
25408	0	0	36	0	0	36
25409	37	0	0	0	0	37
25410	38	0	0	0	0	38
25411	0	0	0	39	0	39
25412	0	36	0	0	0	36
25413	0	0	0	36	0	36
25414	0	0	0	36	0	36
25415	0	37	0	0	0	37
25416	37	0	0	0	0	37
25417	0	37	0	0	0	37
25418	36	0	0	0	0	36
25419	36	0	0	0	0	36
25420	0	0	0	36	0	36
25421	0	0	0	39	0	39
25422	0	0	36	0	0	36
25423	0	0	36	0	0	36
25424	39	0	0	0	0	39
25425	39	0	0	0	0	39
25426	0	36	0	0	0	36
25427	0	0	0	39	0	39
25428	0	0	39	0	0	39
25429	0	0	0	37	0	37
25430	33	0	0	5	0	38
25431	34	0	0	0	0	34
25432	0	33	0	0	0	33
25433	0	0	0	33	0	33
25434	0	0	0	34	0	34
25435	0	0	0	34	0	34
25436	0	0	34	0	0	34
25437	34	0	0	0	0	34
25438	33	0	0	0	0	33
25439	0	0	34	0	0	34
25440	0	34	0	0	0	34
25441	33	0	0	0	0	33
25442	34	0	0	0	0	34
25443	0	0	29	0	0	29
25444	0	0	27	0	0	27
25445	0	0	0	28	0	28
25446	0	0	29	0	0	29
25447	30	0	0	0	0	30
25448	30	0	0	0	0	30
25449	31	0	0	0	0	31
25450	0	0	0	26	0	26
25451	0	28	0	0	0	28
25452	26	0	0	0	0	26
25453	27	0	0	0	0	27
25454	0	0	29	0	0	29
25455	0	0	25	0	0	25
25456	27	0	0	0	0	27
25457	0	0	0	28	0	28
25458	0	0	26	0	0	26
25459	0	27	0	0	0	27
25460	0	0	0	28	0	28
25461	25	0	0	0	0	25
25462	0	29	0	0	0	29
25463	0	0	0	30	0	30
25464	0	27	0	0	0	27
25465	0	29	0	0	0	29
25466	0	0	0	29	0	29
25467	0	1	0	29	0	30
25468	0	29	1	0	0	30
25469	30	0	0	0	0	30
25470	0	0	32	0	0	32
25471	31	0	0	0	0	31
25472	0	0	0	30	0	30
25473	0	0	0	27	0	27
25474	0	0	0	28	0	28
25475	0	0	0	28	0	28
25476	0	0	26	0	0	26
25477	0	0	0	28	0	28
25478	0	0	0	28	0	28
25479	0	27	0	0	0	27
25480	0	0	26	0	0	26
25481	0	25	0	0	0	25
25482	0	0	25	0	0	25
25483	0	25	0	0	0	25
25484	0	0	0	28	0	28
25485	29	0	0	0	0	29
25486	0	33	0	0	0	33
25487	0	0	0	31	0	31
25488	0	0	35	0	0	35
25489	0	36	0	0	0	36
25490	34	0	0	0	0	34
25491	35	0	0	0	0	35
25492	0	36	0	0	0	36
25493	0	0	33	0	0	33
25494	34	0	0	0	0	34
25495	0	0	0	32	0	32
25496	33	0	0	0	0	33
25497	0	34	0	0	0	34
25498	0	35	0	0	0	35
25499	0	0	29	0	0	29
25500	29	0	0	0	0	29
25501	0	0	0	28	0	28
25502	28	0	0	0	0	28
25503	0	29	0	0	0	29
25504	28	0	0	0	0	28
25505	29	0	0	0	0	29
25506	0	0	28	0	0	28
25507	0	27	0	0	0	27
25508	0	27	0	0	0	27
25509	0	0	0	28	0	28
25510	0	26	0	0	0	26
25511	27	0	0	0	0	27
25512	0	32	0	0	0	32
25513	0	1	0	32	0	33
25514	0	31	0	0	0	31
25515	0	30	0	1	0	31
25516	0	29	0	0	0	29
25517	0	0	0	31	0	31
25518	0	0	0	31	0	31
25519	0	0	0	31	0	31
25520	0	31	0	0	0	31
25521	0	0	31	0	0	31
25522	0	0	31	0	0	31
25523	31	0	0	0	0	31
25524	0	0	0	32	0	32
25525	0	0	32	0	0	32
25526	0	0	31	0	0	31
25527	0	30	0	0	0	30
25528	0	0	0	31	0	31
25529	0	0	0	31	0	31
25530	31	0	0	0	0	31
25531	0	0	0	31	0	31
25532	0	0	0	31	0	31
25533	0	0	31	0	0	31
25534	0	0	0	28	0	28
25535	0	0	0	29	0	29
25536	0	0	32	0	0	32
25537	0	0	30	0	0	30
25538	0	28	0	0	0	28
25539	0	0	35	0	0	35
25540	0	0	0	33	0	33
25541	0	0	0	36	0	36
25542	0	0	37	0	0	37
25543	0	38	0	0	0	38
25544	37	0	0	0	0	37
25545	0	37	0	0	0	37
25546	0	0	0	38	0	38
25547	0	0	0	36	0	36
25548	0	37	0	0	0	37
25549	0	0	0	33	0	33
25550	0	0	0	36	0	36
25551	0	0	37	0	0	37
25552	0	36	0	0	0	36
25553	0	0	0	36	0	36
25554	0	0	35	0	0	35
25555	0	0	0	34	0	34
25556	0	0	0	34	0	34
25557	0	0	0	35	0	35
25558	0	0	0	35	0	35
25559	0	0	0	34	0	34
25560	0	34	0	0	0	34
25561	35	0	0	0	0	35
25562	0	0	34	0	0	34
25563	29	0	0	0	0	29
25564	0	0	34	0	0	34
25565	0	35	0	0	0	35
25566	0	0	32	0	0	32
25567	0	30	0	0	0	30
25568	0	0	0	29	0	29
25569	0	0	0	30	0	30
25570	0	27	0	0	0	27
25571	0	35	0	0	0	35
25572	38	0	0	0	0	38
25573	39	0	0	0	0	39
25574	39	0	0	0	0	39
25575	39	0	0	0	0	39
25576	1	0	0	37	0	38
25577	0	35	0	0	0	35
25578	33	0	0	0	0	33
25579	0	0	0	34	0	34
25580	34	0	0	0	0	34
25581	28	0	0	0	0	28
25582	0	29	0	0	0	29
25583	0	24	0	0	0	24
25584	0	29	0	0	0	29
25585	0	0	0	26	0	26
25586	0	30	0	0	0	30
25587	30	0	0	0	0	30
25588	28	0	0	0	0	28
25589	30	0	0	0	0	30
25590	29	0	0	0	0	29
25591	29	0	0	0	0	29
25592	0	0	29	0	0	29
25593	29	0	0	0	0	29
25594	0	0	29	0	0	29
25595	30	0	0	0	0	30
25596	0	0	0	29	0	29
25597	0	0	30	0	0	30
25598	0	0	24	1	0	25
25599	0	36	0	0	0	36
25600	37	0	0	0	0	37
25601	33	0	0	0	0	33
25602	0	37	0	0	0	37
25603	0	0	0	39	0	39
25604	38	0	0	0	0	38
25605	0	0	30	0	0	30
25606	0	31	0	0	0	31
25607	32	0	0	0	0	32
25608	0	31	0	0	0	31
25609	0	0	0	32	0	32
25610	0	32	0	0	0	32
25611	0	0	0	32	0	32
25612	0	30	0	2	0	32
25613	0	29	0	0	0	29
25614	32	0	0	0	0	32
25615	29	0	0	0	0	29
25616	0	0	27	0	0	27
25617	0	0	22	0	0	22
25618	0	0	26	0	0	26
25619	0	0	0	29	0	29
25620	0	0	30	0	0	30
25621	0	0	0	31	0	31
25622	0	0	0	31	0	31
25623	0	31	0	0	0	31
25624	30	0	0	0	0	30
25625	0	27	0	0	0	27
25626	0	0	0	35	0	35
25627	0	0	0	34	0	34
25628	0	0	0	32	0	32
25629	0	0	33	0	0	33
25630	0	0	0	30	0	30
25631	0	0	0	32	0	32
25632	0	0	0	32	0	32
25633	0	0	30	0	0	30
25634	0	32	0	0	0	32
25635	29	0	0	0	0	29
25636	27	0	0	0	0	27
25637	0	30	0	0	0	30
25638	0	0	0	30	0	30
25639	0	0	0	30	0	30
25640	0	0	27	0	0	27
25641	0	30	0	0	0	30
25642	0	0	0	32	0	32
25643	0	0	32	0	0	32
25644	0	0	0	29	0	29
25645	0	0	0	33	0	33
25646	0	0	31	0	0	31
25647	0	0	0	32	0	32
25648	0	0	0	33	0	33
25649	0	0	33	0	0	33
25650	0	0	0	33	0	33
25651	0	0	0	33	0	33
25652	0	0	0	33	0	33
25653	0	0	33	0	0	33
25654	0	0	0	32	0	32
25655	31	0	0	0	0	31
25656	31	0	0	0	0	31
25657	0	32	0	0	0	32
25658	32	0	0	0	0	32
25659	0	0	32	0	0	32
25660	0	0	0	31	0	31
25661	0	0	0	31	0	31
25662	0	0	0	32	0	32
25663	33	0	0	0	0	33
25664	0	25	0	0	0	25
25665	0	0	0	29	0	29
25666	0	29	0	0	0	29
25667	28	0	0	0	0	28
25668	0	28	0	0	0	28
25669	29	0	0	0	0	29
25670	0	28	0	0	0	28
25671	0	29	0	0	0	29
25672	0	0	0	29	0	29
25673	0	0	0	29	0	29
25674	0	0	0	29	0	29
25675	0	0	0	29	0	29
25676	0	0	29	0	0	29
25677	0	28	0	0	0	28
25678	0	0	0	29	0	29
25679	0	31	0	0	0	31
25680	0	0	30	0	0	30
25681	0	0	0	29	0	29
25682	0	0	0	30	0	30
25683	0	0	30	0	0	30
25684	0	29	0	0	0	29
25685	0	0	0	30	0	30
25686	0	0	29	0	0	29
25687	0	30	0	0	0	30
25688	0	0	0	30	0	30
25689	0	0	30	0	0	30
25690	0	0	30	0	0	30
25691	0	31	0	0	0	31
25692	0	28	0	0	0	28
25693	0	0	0	28	0	28
25694	0	0	0	28	0	28
25695	0	0	28	0	0	28
25696	28	0	0	0	0	28
25697	27	0	0	0	0	27
25698	0	0	26	0	0	26
25699	0	25	0	0	0	25
25700	0	25	0	0	0	25
25701	0	24	0	0	0	24
25702	0	27	0	0	0	27
25703	0	0	0	27	0	27
25704	0	0	0	30	0	30
25705	0	0	0	30	0	30
25706	0	0	0	30	0	30
25707	0	29	0	0	0	29
25708	0	0	0	30	0	30
25709	0	29	0	1	0	30
25710	0	0	0	33	0	33
25711	32	0	0	0	0	32
25712	0	0	0	32	0	32
25713	0	30	0	0	0	30
25714	0	0	0	31	0	31
25715	0	0	0	32	0	32
25716	0	0	0	32	0	32
25717	32	0	0	0	0	32
25718	0	0	0	32	0	32
25719	0	0	24	0	0	24
25720	0	26	0	0	0	26
25721	0	0	0	28	0	28
25722	0	0	0	28	0	28
25723	0	0	0	29	0	29
25724	28	0	0	0	0	28
25725	0	0	29	0	0	29
25726	0	0	0	29	0	29
25727	0	28	0	0	0	28
25728	0	0	0	28	0	28
25729	28	0	0	0	0	28
25730	0	27	0	0	0	27
25731	0	0	0	30	0	30
25732	0	0	0	30	0	30
25733	0	27	0	0	0	27
25734	0	0	0	29	0	29
25735	0	0	0	28	0	28
25736	0	0	29	0	0	29
25737	0	27	0	0	0	27
25738	26	0	0	0	0	26
25739	0	0	26	0	0	26
25740	25	0	0	0	0	25
25741	0	0	26	0	0	26
25742	0	0	0	24	0	24
25743	26	0	0	0	0	26
25744	0	0	0	27	0	27
25745	27	0	0	0	0	27
25746	26	0	0	0	0	26
25747	26	0	0	0	0	26
25748	0	27	0	0	0	27
25749	0	0	0	25	0	25
25750	0	0	0	26	0	26
25751	0	0	0	26	0	26
25752	0	0	27	0	0	27
25753	0	0	0	26	0	26
25754	26	0	0	0	0	26
25755	26	0	0	0	0	26
25756	0	0	24	0	0	24
25757	27	0	0	0	0	27
25758	25	0	0	0	0	25
25759	0	0	0	27	0	27
25760	27	0	0	0	0	27
25761	25	0	0	1	0	26
25762	0	0	0	32	0	32
25763	32	0	0	0	0	32
25764	28	0	0	0	0	28
25765	0	0	0	33	0	33
25766	0	0	27	0	0	27
25767	33	0	0	0	0	33
25768	0	0	32	0	0	32
25769	0	0	26	0	0	26
25770	0	32	0	0	0	32
25771	0	0	0	30	0	30
25772	0	0	0	33	0	33
25773	0	0	0	35	0	35
25774	0	0	31	0	0	31
25775	0	0	33	1	0	34
25776	0	31	0	1	0	32
25777	0	0	0	37	0	37
25778	0	0	0	36	0	36
25779	0	0	0	36	0	36
25780	0	0	31	0	0	31
25781	0	29	0	0	0	29
25782	0	0	0	34	0	34
25783	0	0	35	0	0	35
25784	0	0	27	0	0	27
25785	30	0	0	0	0	30
25786	26	1	0	0	0	27
25787	27	0	0	0	0	27
25788	0	0	0	30	0	30
25789	0	0	30	0	0	30
25790	0	25	0	0	0	25
25791	0	29	0	0	0	29
25792	0	0	32	0	0	32
25793	0	0	0	31	0	31
25794	0	0	0	32	0	32
25795	0	29	0	1	0	30
25796	0	34	0	0	0	34
25797	36	0	0	0	0	36
25798	36	0	0	0	0	36
25799	35	0	0	0	0	35
25800	33	0	0	0	0	33
25801	30	0	0	1	0	31
25802	0	36	0	0	0	36
25803	0	32	0	0	0	32
25804	0	41	0	0	0	41
25805	36	0	0	0	0	36
25806	0	0	0	38	0	38
25807	0	0	0	39	0	39
25808	38	0	0	0	0	38
25809	0	38	0	0	0	38
25810	0	0	0	37	0	37
25811	0	0	0	38	0	38
25812	0	0	0	39	0	39
25813	39	0	0	0	0	39
25814	0	0	0	38	0	38
25815	0	0	38	0	0	38
25816	39	0	0	0	0	39
25817	0	0	0	37	0	37
25818	0	0	37	0	0	37
25819	0	38	0	0	0	38
25820	0	38	0	0	0	38
25821	36	0	0	0	0	36
25822	35	0	0	0	0	35
25823	0	38	0	0	0	38
25824	0	0	0	38	0	38
25825	43	0	0	0	0	43
25826	0	0	0	45	0	45
25827	0	0	0	46	0	46
25828	0	0	0	47	0	47
25829	0	0	0	47	0	47
25830	0	50	0	0	0	50
25831	0	0	0	49	0	49
25832	0	0	0	48	0	48
25833	0	0	0	49	0	49
25834	0	0	47	0	0	47
25835	0	50	0	0	0	50
25836	0	0	0	47	0	47
25837	0	0	44	2	0	46
25838	0	0	44	0	0	44
25839	0	48	0	0	0	48
25840	48	0	0	0	0	48
25841	0	0	0	48	0	48
25842	51	0	0	0	0	51
25843	0	50	0	0	0	50
25844	0	0	0	50	0	50
25845	52	0	0	0	0	52
25846	51	0	0	0	0	51
25847	0	0	0	51	0	51
25848	0	0	0	51	0	51
25849	0	0	53	0	0	53
25850	0	0	0	48	0	48
25851	0	0	0	51	0	51
25852	49	0	0	0	0	49
25853	0	51	0	0	0	51
25854	0	0	49	0	0	49
25855	44	0	0	0	0	44
25856	0	45	0	0	0	45
25857	0	0	0	45	0	45
25858	46	0	0	0	0	46
25859	0	0	0	43	0	43
25860	0	0	0	47	0	47
25861	0	0	45	0	0	45
25862	0	0	0	45	0	45
25863	45	0	0	0	0	45
25864	0	0	0	52	0	52
25865	48	0	0	0	0	48
25866	0	48	0	0	0	48
25867	0	48	0	0	0	48
25868	0	0	0	43	0	43
25869	0	0	0	43	0	43
25870	42	0	0	0	0	42
25871	0	42	0	0	0	42
25872	39	0	0	0	0	39
25873	40	0	0	0	0	40
25874	0	0	0	40	0	40
25875	41	0	0	0	0	41
25876	0	0	41	0	0	41
25877	0	0	0	42	0	42
25878	0	0	43	0	0	43
25879	0	0	0	43	0	43
25880	43	0	0	0	0	43
25881	41	0	0	0	0	41
25882	0	43	0	0	0	43
25883	0	0	0	42	0	42
25884	0	0	0	42	0	42
25885	0	43	0	0	0	43
25886	0	0	0	43	0	43
25887	0	0	0	43	0	43
25888	0	42	0	0	0	42
25889	41	0	0	0	0	41
25890	38	0	0	0	0	38
25891	0	0	0	37	0	37
25892	0	0	0	41	0	41
25893	0	0	43	0	0	43
25894	0	0	0	42	0	42
25895	0	43	0	0	0	43
25896	41	0	0	0	0	41
25897	0	0	0	41	0	41
25898	0	0	0	38	0	38
25899	41	0	0	0	0	41
25900	0	36	0	0	0	36
25901	0	0	0	40	0	40
25902	0	0	0	36	0	36
25903	0	37	0	0	0	37
25904	37	0	0	0	0	37
25905	0	0	35	0	0	35
25906	0	0	34	0	0	34
25907	0	0	0	34	0	34
25908	0	0	35	0	0	35
25909	33	0	0	0	0	33
25910	0	0	0	35	0	35
25911	0	0	35	0	0	35
25912	0	0	28	0	0	28
25913	0	33	0	0	0	33
25914	31	0	0	0	0	31
25915	0	30	0	0	0	30
25916	31	0	0	0	0	31
25917	29	0	1	0	0	30
25918	0	26	0	0	0	26
25919	25	0	0	0	0	25
25920	25	0	0	0	0	25
25921	0	0	25	0	0	25
25922	0	0	0	22	0	22
25923	0	21	0	0	0	21
25924	0	22	0	0	0	22
25925	0	0	0	22	0	22
25926	21	0	0	0	0	21
25927	0	0	0	22	0	22
25928	0	0	0	22	0	22
25929	0	0	0	22	0	22
25930	0	22	0	0	0	22
25931	0	0	0	23	0	23
25932	0	0	23	0	0	23
25933	23	0	0	0	0	23
25934	22	0	0	0	0	22
25935	0	20	0	0	0	20
25936	20	0	0	0	0	20
25937	0	0	0	20	0	20
25938	0	0	18	0	0	18
25939	17	0	0	0	0	17
25940	0	18	0	0	0	18
25941	0	0	0	18	0	18
25942	19	0	0	0	0	19
25943	0	17	0	1	0	18
25944	0	20	0	0	0	20
25945	18	0	0	0	0	18
25946	0	0	19	0	0	19
25947	18	0	0	0	0	18
25948	0	0	0	19	0	19
25949	0	0	0	21	0	21
25950	0	0	23	0	0	23
25951	0	0	24	0	0	24
25952	0	0	0	24	0	24
25953	0	0	24	0	0	24
25954	0	0	24	0	0	24
25955	0	0	0	25	0	25
25956	0	0	0	24	0	24
25957	20	0	0	0	0	20
25958	0	0	0	20	0	20
25959	20	0	0	0	0	20
25960	0	19	0	0	0	19
25961	0	0	0	23	0	23
25962	0	0	22	0	0	22
25963	22	0	0	0	0	22
25964	22	0	0	0	0	22
25965	24	0	0	0	0	24
25966	25	0	0	0	0	25
25967	22	0	0	0	0	22
25968	0	0	0	24	0	24
25969	0	0	21	0	0	21
25970	0	0	21	0	0	21
25971	0	0	21	0	0	21
25972	24	0	0	0	0	24
25973	28	0	0	0	0	28
25974	0	0	0	29	0	29
25975	0	26	0	0	0	26
25976	0	0	0	29	0	29
25977	0	0	30	0	0	30
25978	0	0	28	0	0	28
25979	29	0	0	0	0	29
25980	0	0	32	0	0	32
25981	0	0	0	29	0	29
25982	33	0	0	0	0	33
25983	32	0	0	0	0	32
25984	32	0	0	0	0	32
25985	33	0	0	0	0	33
25986	0	0	31	0	0	31
25987	30	0	0	0	0	30
25988	0	30	0	0	0	30
25989	0	0	0	28	0	28
25990	0	0	30	0	0	30
25991	0	0	0	29	0	29
25992	0	0	30	0	0	30
25993	0	0	0	30	0	30
25994	0	0	0	31	0	31
25995	0	0	30	0	0	30
25996	0	0	0	33	0	33
25997	33	0	0	0	0	33
25998	0	0	0	32	0	32
25999	0	0	0	32	0	32
26000	32	0	0	0	0	32
26001	0	34	0	0	0	34
26002	31	0	0	0	0	31
26003	0	34	0	0	0	34
26004	35	0	0	0	0	35
26005	0	1	33	0	0	34
26006	0	0	0	35	0	35
26007	0	0	0	37	0	37
26008	36	0	0	0	0	36
26009	0	37	0	0	0	37
26010	0	0	0	39	0	39
26011	0	0	0	37	0	37
26012	0	39	0	0	0	39
26013	38	0	0	0	0	38
26014	0	39	0	0	0	39
26015	0	0	0	38	0	38
26016	0	0	0	40	0	40
26017	0	41	0	0	0	41
26018	42	0	0	0	0	42
26019	0	0	40	0	0	40
26020	40	0	0	1	0	41
26021	0	42	0	0	0	42
26022	0	0	0	41	0	41
26023	41	0	0	0	0	41
26024	0	0	0	39	0	39
26025	0	0	0	40	0	40
26026	43	0	0	0	0	43
26027	0	41	0	0	0	41
26028	0	43	0	0	0	43
26029	46	0	0	0	0	46
26030	0	0	44	0	0	44
26031	0	43	0	0	0	43
26032	0	0	0	45	0	45
26033	0	0	46	0	0	46
26034	0	0	0	44	0	44
26035	42	0	0	0	0	42
26036	0	46	0	0	0	46
26037	0	0	0	43	0	43
26038	0	44	0	0	0	44
26039	44	0	0	0	0	44
26040	48	0	0	0	0	48
26041	0	47	0	0	0	47
26042	0	0	0	46	0	46
26043	0	40	0	0	0	40
26044	41	0	0	0	0	41
26045	41	0	0	0	0	41
26046	0	0	0	39	0	39
26047	0	0	0	41	0	41
26048	0	0	41	0	0	41
26049	41	0	0	0	0	41
26050	0	0	41	0	0	41
26051	0	0	0	39	0	39
26052	43	0	0	0	0	43
26053	0	41	0	0	0	41
26054	39	0	0	0	0	39
26055	0	0	40	0	0	40
26056	39	0	0	0	0	39
26057	0	36	0	0	0	36
26058	33	0	0	0	0	33
26059	0	34	0	0	0	34
26060	0	0	0	35	0	35
26061	0	0	35	0	0	35
26062	0	0	33	0	0	33
26063	0	0	0	32	0	32
26064	0	0	33	0	0	33
26065	0	0	0	32	0	32
26066	0	0	0	28	0	28
26067	0	0	27	0	0	27
26068	27	0	0	0	0	27
26069	25	0	0	0	0	25
26070	0	27	0	0	0	27
26071	26	0	0	0	0	26
26072	0	0	0	25	0	25
26073	0	0	23	0	0	23
26074	0	0	0	23	0	23
26075	0	0	0	24	0	24
26076	24	0	0	0	0	24
26077	0	23	0	0	0	23
26078	0	20	0	2	0	22
26079	0	0	0	24	0	24
26080	0	0	0	25	0	25
26081	0	23	0	0	0	23
26082	0	0	0	25	0	25
26083	0	0	0	25	0	25
26084	0	23	0	0	0	23
26085	25	0	0	0	0	25
26086	0	0	0	25	0	25
26087	0	23	0	0	0	23
26088	0	0	0	23	0	23
26089	19	0	0	1	0	20
26090	0	19	0	0	0	19
26091	22	0	0	0	0	22
26092	22	0	0	0	0	22
26093	0	0	0	22	0	22
26094	21	0	0	0	0	21
26095	22	0	0	0	0	22
26096	23	0	0	0	0	23
26097	23	0	0	0	0	23
26098	0	0	0	22	0	22
26099	0	0	0	23	0	23
26100	0	0	22	0	0	22
26101	0	0	0	23	0	23
26102	0	0	0	21	0	21
26103	0	0	20	0	0	20
26104	19	0	0	0	0	19
26105	0	0	0	19	0	19
26106	0	0	22	0	0	22
26107	21	0	0	1	0	22
26108	0	0	22	0	0	22
26109	0	17	0	0	0	17
26110	0	18	0	0	0	18
26111	0	0	1	15	0	16
26112	0	0	16	0	0	16
26113	19	0	0	0	0	19
26114	17	0	0	0	0	17
26115	0	0	20	0	0	20
26116	19	0	0	0	0	19
26117	19	0	0	0	0	19
26118	0	18	0	0	0	18
26119	17	0	0	0	0	17
26120	0	0	0	14	0	14
26121	0	0	16	0	0	16
26122	0	0	0	19	0	19
26123	0	22	0	0	0	22
26124	0	22	0	0	0	22
26125	21	0	0	0	0	21
26126	19	0	0	0	0	19
26127	21	0	0	0	0	21
26128	0	0	0	25	0	25
26129	0	0	0	28	0	28
26130	0	28	0	0	0	28
26131	28	0	0	0	0	28
26132	0	26	0	0	0	26
26133	24	0	0	0	0	24
26134	0	26	0	0	0	26
26135	24	0	0	0	0	24
26136	26	0	0	0	0	26
26137	0	0	0	27	0	27
26138	0	27	2	0	0	29
26139	0	0	32	0	0	32
26140	33	0	0	0	0	33
26141	0	33	0	0	0	33
26142	0	0	30	0	0	30
26143	0	0	31	0	0	31
26144	0	0	0	37	0	37
26145	0	0	0	39	0	39
26146	0	39	0	0	0	39
26147	38	0	0	0	0	38
26148	0	0	0	39	0	39
26149	0	41	0	0	0	41
26150	0	44	0	0	0	44
26151	0	0	43	0	0	43
26152	0	0	43	0	0	43
26153	43	0	0	0	0	43
26154	0	0	46	0	0	46
26155	0	0	0	45	0	45
26156	0	0	0	43	0	43
26157	0	0	44	0	0	44
26158	0	0	0	47	0	47
26159	0	0	0	46	0	46
26160	45	0	0	0	0	45
26161	46	0	0	0	0	46
26162	0	0	0	47	0	47
26163	0	39	0	0	0	39
26164	0	46	0	0	0	46
26165	46	0	0	0	0	46
26166	0	0	50	0	0	50
26167	0	0	0	46	0	46
26168	48	0	0	0	0	48
26169	51	0	0	0	0	51
26170	0	0	0	53	0	53
26171	0	0	55	0	0	55
26172	0	0	48	0	0	48
26173	55	0	0	0	0	55
26174	53	0	0	1	0	54
26175	0	52	0	0	0	52
26176	0	55	0	0	0	55
26177	56	0	0	0	0	56
26178	53	0	0	1	0	54
26179	0	0	0	55	0	55
26180	0	0	0	55	0	55
26181	0	0	0	57	0	57
26182	55	0	0	0	0	55
26183	0	0	0	57	0	57
26184	0	0	56	0	0	56
26185	57	0	0	0	0	57
26186	0	0	0	57	0	57
26187	0	0	57	0	0	57
26188	58	0	0	0	0	58
26189	50	0	0	0	0	50
26190	0	57	0	0	0	57
26191	0	55	0	0	0	55
26192	0	0	48	0	0	48
26193	53	0	0	0	0	53
26194	0	52	0	0	0	52
26195	0	0	52	0	0	52
26196	56	0	0	1	0	57
26197	0	55	0	1	0	56
26198	0	0	57	0	0	57
26199	57	0	0	0	0	57
26200	0	57	0	0	0	57
26201	0	0	0	51	0	51
26202	54	0	0	0	0	54
26203	0	56	0	0	0	56
26204	0	0	0	56	0	56
26205	57	0	0	0	0	57
26206	0	0	53	0	0	53
26207	0	50	0	0	0	50
26208	0	0	50	0	0	50
26209	0	0	0	50	0	50
26210	1	0	52	0	0	53
26211	0	48	0	0	0	48
26212	0	50	0	0	0	50
26213	0	0	0	52	0	52
26214	0	0	0	48	0	48
26215	0	0	0	49	0	49
26216	0	0	45	0	0	45
26217	0	0	0	44	0	44
26218	48	0	0	0	0	48
26219	49	0	0	0	0	49
26220	0	0	46	0	0	46
26221	0	49	0	0	0	49
26222	42	0	0	0	0	42
26223	0	43	0	0	0	43
26224	43	0	0	0	0	43
26225	43	0	0	0	0	43
26226	0	0	40	0	0	40
26227	0	44	0	0	0	44
26228	0	0	0	43	0	43
26229	0	0	41	0	0	41
26230	41	0	0	0	0	41
26231	0	0	0	39	0	39
26232	0	0	30	0	0	30
26233	32	0	0	0	0	32
26234	0	0	32	0	0	32
26235	0	0	0	31	0	31
26236	31	0	0	0	0	31
26237	0	29	0	0	0	29
26238	0	0	31	0	0	31
26239	28	0	0	0	0	28
26240	33	0	0	0	0	33
26241	0	34	0	0	0	34
26242	0	0	0	33	0	33
26243	0	0	0	31	0	31
26244	31	0	0	0	0	31
26245	0	0	0	31	0	31
26246	0	0	33	0	0	33
26247	0	0	0	33	0	33
26248	32	0	0	0	0	32
26249	0	32	0	0	0	32
26250	0	0	0	32	0	32
26251	0	31	0	0	0	31
26252	30	0	0	0	0	30
26253	0	0	0	32	0	32
26254	0	0	0	32	0	32
26255	0	26	0	0	0	26
26256	0	0	28	0	0	28
26257	0	0	0	27	0	27
26258	0	0	0	29	0	29
26259	0	0	0	28	0	28
26260	0	29	0	0	0	29
26261	0	0	26	0	0	26
26262	0	0	27	0	0	27
26263	25	0	0	0	0	25
26264	25	0	0	0	0	25
26265	0	0	25	0	0	25
26266	24	0	0	0	0	24
26267	0	0	28	0	0	28
26268	26	0	0	0	0	26
26269	0	29	0	0	0	29
26270	29	0	0	0	0	29
26271	0	1	28	0	0	29
26272	0	0	26	0	0	26
26273	0	0	0	28	0	28
26274	29	0	0	0	0	29
26275	0	28	0	0	0	28
26276	0	0	28	0	0	28
26277	0	0	0	27	0	27
26278	0	0	0	29	0	29
26279	27	0	0	0	0	27
26280	29	0	0	0	0	29
26281	0	0	0	29	0	29
26282	29	0	0	0	0	29
26283	0	0	28	0	0	28
26284	0	0	0	27	0	27
26285	0	0	0	27	0	27
26286	28	0	0	0	0	28
26287	28	0	0	0	0	28
26288	0	0	0	29	0	29
26289	31	0	0	0	0	31
26290	0	0	31	0	0	31
26291	0	29	0	0	0	29
26292	0	0	29	0	0	29
26293	0	0	0	31	0	31
26294	28	0	0	0	0	28
26295	0	31	0	0	0	31
26296	0	0	0	28	0	28
26297	0	0	0	30	0	30
26298	0	28	0	0	0	28
26299	0	0	0	35	0	35
26300	0	0	0	34	0	34
26301	1	0	0	32	0	33
26302	0	0	0	38	0	38
26303	0	0	0	37	0	37
26304	0	41	0	0	0	41
26305	0	0	0	39	0	39
26306	0	0	0	39	0	39
26307	0	0	39	0	0	39
26308	0	37	0	0	0	37
26309	0	0	0	39	0	39
26310	0	0	0	41	0	41
26311	0	0	0	37	0	37
26312	0	38	0	0	0	38
26313	0	0	39	0	0	39
26314	0	0	0	36	0	36
26315	0	0	36	0	0	36
26316	0	0	33	0	0	33
26317	0	0	0	39	0	39
26318	37	0	0	0	0	37
26319	0	0	0	37	0	37
26320	0	0	0	39	0	39
26321	0	42	0	0	0	42
26322	0	0	0	41	0	41
26323	0	0	0	43	0	43
26324	0	0	41	0	0	41
26325	0	42	0	0	0	42
26326	0	0	0	46	0	46
26327	44	0	0	0	0	44
26328	0	0	44	0	0	44
26329	0	0	0	48	0	48
26330	0	0	0	44	0	44
26331	41	0	0	0	0	41
26332	0	44	0	0	0	44
26333	41	0	0	0	0	41
26334	0	45	0	0	0	45
26335	0	0	0	37	0	37
26336	40	0	0	0	0	40
26337	0	0	36	0	0	36
26338	0	37	0	0	0	37
26339	0	41	0	0	0	41
26340	40	0	0	0	0	40
26341	0	0	0	40	0	40
26342	0	39	0	0	0	39
26343	0	41	0	0	0	41
26344	0	0	0	41	0	41
26345	0	0	0	39	0	39
26346	39	0	0	0	0	39
26347	0	40	0	0	0	40
26348	0	0	0	42	0	42
26349	0	0	40	0	0	40
26350	0	39	0	0	0	39
26351	0	0	40	0	0	40
26352	0	41	0	0	0	41
26353	0	0	0	42	0	42
26354	0	0	0	42	0	42
26355	0	41	0	0	0	41
26356	0	0	41	0	0	41
26357	42	0	0	0	0	42
26358	0	0	0	43	0	43
26359	0	0	0	43	0	43
26360	0	0	38	0	0	38
26361	0	0	0	37	0	37
26362	0	0	40	0	0	40
26363	0	0	0	41	0	41
26364	0	0	39	0	0	39
26365	0	41	0	0	0	41
26366	0	0	51	0	0	51
26367	0	0	0	48	0	48
26368	49	0	0	0	0	49
26369	0	52	0	0	0	52
26370	0	0	0	51	0	51
26371	0	0	51	0	0	51
26372	0	51	0	0	0	51
26373	0	0	0	51	0	51
26374	0	0	52	0	0	52
26375	0	47	0	0	0	47
26376	52	0	0	0	0	52
26377	53	0	0	0	0	53
26378	0	0	0	53	0	53
26379	51	0	0	1	0	52
26380	0	0	0	49	0	49
26381	0	0	0	51	0	51
26382	0	0	49	0	0	49
26383	0	0	0	49	0	49
26384	0	0	0	48	0	48
26385	48	0	0	0	0	48
26386	50	0	0	0	0	50
26387	0	50	0	0	0	50
26388	0	0	50	0	0	50
26389	0	0	0	49	0	49
26390	0	0	48	0	0	48
26391	49	0	0	0	0	49
26392	0	0	43	0	0	43
26393	0	0	0	45	0	45
26394	0	45	0	0	0	45
26395	0	0	0	40	0	40
26396	0	0	0	40	0	40
26397	0	0	37	0	0	37
26398	0	0	0	38	0	38
26399	32	2	0	0	0	34
26400	36	0	0	0	0	36
26401	38	0	0	0	0	38
26402	36	0	0	0	0	36
26403	0	42	0	0	0	42
26404	0	41	0	0	0	41
26405	0	0	0	40	0	40
26406	0	0	0	47	0	47
26407	0	43	0	0	0	43
26408	0	0	0	46	0	46
26409	0	0	0	45	0	45
26410	0	0	0	45	0	45
26411	0	0	0	43	0	43
26412	0	0	0	44	0	44
26413	43	0	0	0	0	43
26414	0	41	0	0	0	41
26415	0	0	40	0	0	40
26416	0	0	0	40	0	40
26417	0	0	0	38	0	38
26418	0	0	0	40	0	40
26419	37	0	0	0	0	37
26420	0	40	0	0	0	40
26421	0	0	0	38	0	38
26422	0	35	0	0	0	35
26423	0	0	0	37	0	37
26424	0	37	0	0	0	37
26425	0	0	36	0	0	36
26426	0	0	0	36	0	36
26427	0	0	40	0	0	40
26428	0	0	0	40	0	40
26429	0	0	0	37	0	37
26430	37	0	0	1	0	38
26431	38	0	0	0	0	38
26432	41	0	0	0	0	41
26433	39	0	0	0	0	39
26434	38	0	0	1	0	39
26435	0	0	0	40	0	40
26436	0	41	0	0	0	41
26437	0	0	0	43	0	43
26438	0	0	41	0	0	41
26439	43	0	0	0	0	43
26440	41	0	0	0	0	41
26441	0	0	0	39	0	39
26442	0	0	0	43	0	43
26443	0	40	0	0	0	40
26444	0	0	0	37	0	37
26445	0	0	0	42	0	42
26446	0	40	0	0	0	40
26447	0	0	0	42	0	42
26448	42	0	0	0	0	42
26449	0	0	41	0	0	41
26450	42	0	0	0	0	42
26451	0	0	36	0	0	36
26452	0	0	0	42	0	42
26453	0	0	0	43	0	43
26454	0	42	0	0	0	42
26455	0	43	0	0	0	43
26456	0	0	0	45	0	45
26457	0	0	43	0	0	43
26458	44	0	0	0	0	44
26459	0	0	0	35	0	35
26460	0	33	0	0	0	33
26461	0	0	0	33	0	33
26462	0	0	0	31	0	31
26463	0	33	0	0	0	33
26464	0	0	0	32	0	32
26465	0	0	30	0	0	30
26466	0	1	29	0	0	30
26467	0	0	0	30	0	30
26468	0	31	0	0	0	31
26469	0	0	0	28	0	28
26470	28	0	0	0	0	28
26471	28	0	0	0	0	28
26472	25	0	0	0	0	25
26473	0	25	0	0	0	25
26474	0	0	28	0	0	28
26475	27	0	0	0	0	27
26476	28	0	0	0	0	28
26477	0	24	1	1	0	26
26478	0	0	0	27	0	27
26479	27	0	0	0	0	27
26480	29	0	0	0	0	29
26481	28	0	0	0	0	28
26482	0	0	0	28	0	28
26483	28	0	0	1	0	29
26484	0	0	0	30	0	30
26485	0	0	0	31	0	31
26486	34	0	0	0	0	34
26487	0	0	0	34	0	34
26488	37	0	0	0	0	37
26489	0	0	0	38	0	38
26490	0	0	0	37	0	37
26491	38	0	0	0	0	38
26492	0	0	37	0	0	37
26493	0	0	0	39	0	39
26494	0	0	0	38	0	38
26495	0	1	0	38	0	39
26496	0	0	0	37	0	37
26497	0	0	0	37	0	37
26498	0	37	0	0	0	37
26499	0	0	0	33	0	33
26500	0	0	30	0	0	30
26501	0	0	0	29	0	29
26502	0	0	0	35	0	35
26503	0	0	0	36	0	36
26504	0	0	34	0	0	34
26505	0	1	31	0	0	32
26506	34	0	0	0	0	34
26507	35	0	0	0	0	35
26508	0	36	0	0	0	36
26509	0	0	0	37	0	37
26510	0	0	0	38	0	38
26511	0	0	0	38	0	38
26512	32	0	0	0	0	32
26513	34	0	0	0	0	34
26514	0	0	0	33	0	33
26515	0	0	0	34	0	34
26516	0	0	0	33	0	33
26517	0	0	0	34	0	34
26518	34	0	0	0	0	34
26519	0	0	34	0	0	34
26520	1	28	0	0	0	29
26521	0	32	0	0	0	32
26522	30	0	0	0	0	30
26523	0	0	0	26	0	26
26524	0	0	30	0	0	30
26525	0	0	30	0	0	30
26526	0	30	0	0	0	30
26527	32	0	0	0	0	32
26528	0	0	33	0	0	33
26529	34	0	0	0	0	34
26530	0	0	0	35	0	35
26531	0	0	0	34	0	34
26532	1	31	0	0	0	32
26533	0	33	0	0	0	33
26534	30	0	0	1	0	31
26535	34	0	0	0	0	34
26536	0	32	0	0	0	32
26537	0	0	33	0	0	33
26538	0	0	33	0	0	33
26539	1	0	0	39	0	40
26540	40	0	0	0	0	40
26541	0	37	0	0	0	37
26542	0	0	0	39	0	39
26543	38	0	0	0	0	38
26544	0	0	0	38	0	38
26545	1	0	0	35	0	36
26546	38	0	0	0	0	38
26547	0	34	0	0	0	34
26548	0	37	0	0	0	37
26549	0	0	36	0	0	36
26550	0	0	0	39	0	39
26551	0	0	0	39	0	39
26552	0	0	37	0	0	37
26553	39	0	0	0	0	39
26554	38	0	0	0	0	38
26555	0	0	37	0	0	37
26556	37	0	0	0	0	37
26557	0	0	36	0	0	36
26558	0	39	0	0	0	39
26559	0	0	0	40	0	40
26560	0	0	0	41	0	41
26561	41	0	0	0	0	41
26562	41	0	0	0	0	41
26563	42	0	0	0	0	42
26564	42	0	0	0	0	42
26565	40	0	0	0	0	40
26566	0	0	39	0	0	39
26567	0	37	0	0	0	37
26568	0	0	0	40	0	40
26569	0	36	0	0	0	36
26570	0	40	0	0	0	40
26571	0	0	0	40	0	40
26572	0	0	0	41	0	41
26573	0	0	44	0	0	44
26574	44	0	0	0	0	44
26575	43	0	0	0	0	43
26576	0	46	0	0	0	46
26577	44	0	0	0	0	44
26578	43	0	0	0	0	43
26579	0	0	0	44	0	44
26580	0	0	41	0	0	41
26581	0	0	40	0	0	40
26582	43	0	0	0	0	43
26583	41	0	0	0	0	41
26584	0	44	0	0	0	44
26585	0	41	0	0	0	41
26586	0	0	0	43	0	43
26587	43	0	0	0	0	43
26588	0	0	41	0	0	41
26589	0	0	0	43	0	43
26590	42	0	0	0	0	42
26591	43	0	0	0	0	43
26592	0	0	0	42	0	42
26593	41	0	0	0	0	41
26594	0	0	40	0	0	40
26595	0	0	33	0	0	33
26596	1	0	0	34	0	35
26597	0	0	0	36	0	36
26598	0	0	0	37	0	37
26599	0	36	0	0	0	36
26600	0	36	0	0	0	36
26601	0	0	0	38	0	38
26602	36	0	0	0	0	36
26603	0	0	0	34	0	34
26604	0	0	0	36	0	36
26605	0	34	0	0	0	34
26606	0	35	0	0	0	35
26607	0	0	0	37	0	37
26608	0	0	0	37	0	37
26609	37	0	0	0	0	37
26610	0	39	0	0	0	39
26611	37	0	0	0	0	37
26612	0	0	0	38	0	38
26613	0	0	36	0	0	36
26614	0	0	34	0	0	34
26615	38	0	0	0	0	38
26616	0	0	0	37	0	37
26617	0	0	0	38	0	38
26618	0	0	0	40	0	40
26619	0	0	42	0	0	42
26620	0	0	0	37	0	37
26621	0	34	0	0	0	34
26622	0	0	0	36	0	36
26623	0	0	0	35	0	35
26624	0	33	0	0	0	33
26625	0	0	0	35	0	35
26626	33	0	0	0	0	33
26627	0	34	0	0	0	34
26628	34	0	0	0	0	34
26629	36	0	0	0	0	36
26630	0	0	0	36	0	36
26631	0	0	0	36	0	36
26632	0	0	0	34	0	34
26633	0	0	35	1	0	36
26634	0	37	0	0	0	37
26635	0	34	0	0	0	34
26636	0	0	0	34	0	34
26637	33	0	0	0	0	33
26638	0	0	0	37	0	37
26639	0	0	34	1	0	35
26640	0	32	0	0	0	32
26641	0	36	0	0	0	36
26642	40	0	0	0	0	40
26643	35	0	0	0	0	35
26644	0	35	0	0	0	35
26645	36	0	0	0	0	36
26646	0	0	34	0	0	34
26647	1	0	33	0	0	34
26648	33	0	0	0	0	33
26649	36	0	0	0	0	36
26650	0	0	0	35	0	35
26651	34	0	0	0	0	34
26652	0	0	36	0	0	36
26653	0	0	29	0	0	29
26654	0	0	0	38	0	38
26655	0	0	0	34	0	34
26656	0	0	0	37	0	37
26657	0	0	0	36	0	36
26658	0	0	0	36	0	36
26659	0	0	35	0	0	35
26660	0	0	0	35	0	35
26661	37	0	0	0	0	37
26662	0	0	0	37	0	37
26663	36	0	0	0	0	36
26664	0	0	0	36	0	36
26665	37	0	0	0	0	37
26666	35	0	0	0	0	35
26667	0	0	0	34	0	34
26668	0	0	0	32	0	32
26669	32	0	0	0	0	32
26670	32	0	0	0	0	32
26671	0	0	32	0	0	32
26672	0	0	0	31	0	31
26673	0	0	0	32	0	32
26674	36	0	0	0	0	36
26675	33	0	0	1	0	34
26676	0	0	0	38	0	38
26677	0	0	0	39	0	39
26678	0	0	0	40	0	40
26679	0	0	0	41	0	41
26680	0	40	0	0	0	40
26681	0	40	0	1	0	41
26682	0	0	0	42	0	42
26683	0	42	0	0	0	42
26684	0	0	0	46	0	46
26685	0	0	44	0	0	44
26686	0	0	43	0	0	43
26687	0	43	0	0	0	43
26688	0	0	0	52	0	52
26689	0	0	50	0	0	50
26690	0	0	0	49	0	49
26691	0	0	0	52	0	52
26692	49	0	0	0	0	49
26693	0	0	0	50	0	50
26694	0	0	47	0	0	47
26695	0	0	46	0	0	46
26696	0	51	0	0	0	51
26697	0	51	0	0	0	51
26698	55	0	0	0	0	55
26699	0	0	63	0	0	63
26700	0	0	0	61	0	61
26701	63	0	0	0	0	63
26702	64	0	0	0	0	64
26703	0	64	0	0	0	64
26704	0	0	0	64	0	64
26705	0	0	0	63	0	63
26706	0	0	0	65	0	65
26707	65	0	0	0	0	65
26708	0	0	64	0	0	64
26709	0	65	0	0	0	65
26710	0	0	0	65	0	65
26711	0	0	0	66	0	66
26712	0	0	58	0	0	58
26713	0	0	0	58	0	58
26714	0	0	0	59	0	59
26715	0	0	0	62	0	62
26716	0	0	0	63	0	63
26717	0	0	64	0	0	64
26718	0	0	0	62	0	62
26719	0	0	63	0	0	63
26720	0	68	0	1	0	69
26721	0	0	0	76	0	76
26722	1	0	0	73	0	74
26723	0	0	70	0	0	70
26724	0	73	0	0	0	73
26725	0	0	0	76	0	76
26726	0	0	74	0	0	74
26727	0	70	0	0	0	70
26728	0	0	0	75	0	75
26729	0	0	76	0	0	76
26730	0	0	0	72	0	72
26731	0	0	0	75	0	75
26732	0	0	0	74	0	74
26733	75	0	0	0	0	75
26734	0	77	0	0	0	77
26735	76	0	0	0	0	76
26736	0	0	75	0	0	75
26737	74	0	0	0	0	74
26738	77	0	0	0	0	77
26739	0	0	0	75	0	75
26740	80	0	0	0	0	80
26741	80	0	0	0	0	80
26742	83	0	0	0	0	83
26743	0	0	0	77	0	77
26744	1	0	0	85	0	86
26745	0	0	81	0	0	81
26746	0	0	81	0	0	81
26747	83	0	0	0	0	83
26748	0	0	0	81	0	81
26749	0	81	0	0	0	81
26750	81	0	0	0	0	81
26751	0	83	0	0	0	83
26752	0	81	0	0	0	81
26753	0	0	84	0	0	84
26754	0	0	80	0	0	80
26755	0	0	0	84	0	84
26756	0	0	84	0	0	84
26757	0	0	79	0	0	79
26758	85	0	0	0	0	85
26759	84	0	0	0	0	84
26760	0	0	0	84	0	84
26761	0	0	0	86	0	86
26762	0	0	89	0	0	89
26763	0	89	0	0	0	89
26764	0	0	0	92	0	92
26765	90	0	0	0	0	90
26766	0	0	0	89	0	89
26767	0	88	0	0	0	88
26768	0	0	84	0	0	84
26769	0	84	0	0	0	84
26770	87	0	0	0	0	87
26771	84	0	0	0	0	84
26772	0	0	0	81	0	81
26773	0	0	85	0	0	85
26774	0	0	81	0	0	81
26775	0	89	0	0	0	89
26776	0	0	0	87	0	87
26777	0	0	0	88	0	88
26778	0	0	89	0	0	89
26779	0	0	0	88	0	88
26780	0	91	0	0	0	91
26781	0	0	0	85	0	85
26782	0	0	0	86	0	86
26783	0	0	86	0	0	86
26784	0	0	0	88	0	88
26785	88	0	0	0	0	88
26786	0	0	85	0	0	85
26787	0	0	88	0	0	88
26788	0	81	0	0	0	81
26789	0	0	0	86	0	86
26790	0	0	0	84	0	84
26791	0	0	83	0	0	83
26792	79	0	0	0	0	79
26793	0	0	0	78	0	78
26794	0	0	75	0	0	75
26795	0	0	0	74	0	74
26796	0	0	75	0	0	75
26797	0	0	71	1	0	72
26798	0	75	1	0	0	76
26799	0	0	0	73	0	73
26800	0	76	0	0	0	76
26801	75	0	0	0	0	75
26802	0	0	75	0	0	75
26803	0	75	0	0	0	75
26804	0	0	0	76	0	76
26805	73	0	0	0	0	73
26806	0	74	0	0	0	74
26807	0	0	0	74	0	74
26808	0	0	0	75	0	75
26809	0	74	0	0	0	74
26810	74	0	0	0	0	74
26811	0	0	0	70	0	70
26812	0	0	0	71	0	71
26813	0	1	65	0	0	66
26814	0	62	0	0	0	62
26815	0	0	0	61	0	61
26816	0	0	0	65	0	65
26817	0	65	0	0	0	65
26818	0	0	0	65	0	65
26819	0	0	0	65	0	65
26820	0	0	0	66	0	66
26821	0	63	0	0	0	63
26822	64	0	0	0	0	64
26823	0	0	62	0	0	62
26824	64	0	0	0	0	64
26825	0	65	0	0	0	65
26826	0	0	0	61	0	61
26827	0	0	65	0	0	65
26828	0	0	0	66	0	66
26829	0	0	0	65	0	65
26830	0	0	0	63	0	63
26831	0	0	65	0	0	65
26832	0	63	0	0	0	63
26833	0	0	58	0	0	58
26834	0	64	0	0	0	64
26835	0	0	63	0	0	63
26836	0	0	0	63	0	63
26837	63	0	0	0	0	63
26838	0	67	0	0	0	67
26839	0	0	64	0	0	64
26840	0	66	0	0	0	66
26841	0	0	63	0	0	63
26842	0	0	0	65	0	65
26843	0	0	0	66	0	66
26844	0	62	0	1	0	63
26845	0	68	0	0	0	68
26846	67	0	0	0	0	67
26847	0	0	0	67	0	67
26848	0	0	66	0	0	66
26849	0	0	0	65	0	65
26850	0	0	64	0	0	64
26851	0	0	61	0	0	61
26852	0	0	0	66	0	66
26853	0	65	0	0	0	65
26854	69	0	0	0	0	69
26855	0	0	0	62	0	62
26856	0	0	0	64	0	64
26857	0	65	0	0	0	65
26858	63	0	0	0	0	63
26859	68	0	0	0	0	68
26860	0	0	0	68	0	68
26861	0	62	0	0	0	62
26862	0	66	0	0	0	66
26863	68	0	0	0	0	68
26864	0	0	65	0	0	65
26865	68	0	0	0	0	68
26866	63	0	0	0	0	63
26867	61	0	0	0	0	61
26868	0	65	0	0	0	65
26869	0	0	0	68	0	68
26870	63	0	0	0	0	63
26871	61	0	0	0	0	61
26872	0	64	0	0	0	64
26873	66	0	0	0	0	66
26874	0	0	0	66	0	66
26875	0	0	0	65	0	65
26876	0	63	0	0	0	63
26877	0	0	0	65	0	65
26878	1	0	0	64	0	65
26879	0	62	0	0	0	62
26880	0	0	0	64	0	64
26881	0	66	0	0	0	66
26882	67	0	0	0	0	67
26883	62	0	0	0	0	62
26884	0	68	0	0	0	68
26885	0	0	68	0	0	68
26886	0	0	0	69	0	69
26887	0	0	72	0	0	72
26888	0	73	0	0	0	73
26889	0	74	0	0	0	74
26890	71	0	0	0	0	71
26891	0	73	1	0	0	74
26892	0	0	0	74	0	74
26893	0	69	0	0	0	69
26894	0	72	0	0	0	72
26895	74	0	0	0	0	74
26896	0	0	0	79	0	79
26897	0	0	78	0	0	78
26898	0	0	82	0	0	82
26899	0	86	0	0	0	86
26900	77	0	0	0	0	77
26901	0	82	0	0	0	82
26902	0	0	0	80	0	80
26903	77	0	0	0	0	77
26904	0	0	0	79	0	79
26905	0	0	0	80	0	80
26906	0	82	0	0	0	82
26907	0	0	0	77	0	77
26908	0	0	82	0	0	82
26909	75	0	0	1	0	76
26910	0	82	0	0	0	82
26911	0	86	0	0	0	86
26912	79	0	0	0	0	79
26913	0	0	81	0	0	81
26914	75	0	0	1	0	76
26915	0	80	0	0	0	80
26916	0	81	3	0	0	84
26917	0	0	86	0	0	86
26918	0	88	0	0	0	88
26919	0	0	0	89	0	89
26920	2	0	0	81	0	83
26921	0	83	0	0	0	83
26922	0	0	0	81	0	81
26923	83	0	0	0	0	83
26924	0	0	83	0	0	83
26925	78	0	1	0	0	79
26926	79	0	0	0	0	79
26927	81	0	0	0	0	81
26928	0	0	83	0	0	83
26929	0	0	0	82	0	82
26930	0	0	83	0	0	83
26931	81	0	0	0	0	81
26932	80	0	0	0	0	80
26933	0	83	0	0	0	83
26934	0	0	0	80	0	80
26935	0	83	0	0	0	83
26936	0	0	85	0	0	85
26937	0	0	0	82	0	82
26938	83	0	0	0	0	83
26939	84	0	1	0	0	85
26940	0	0	0	81	0	81
26941	0	78	0	0	0	78
26942	0	0	84	0	0	84
26943	0	0	80	0	0	80
26944	81	0	0	0	0	81
26945	0	1	77	0	0	78
26946	0	80	0	0	0	80
26947	0	0	0	79	0	79
26948	0	0	79	0	0	79
26949	0	0	0	76	0	76
26950	0	0	75	0	0	75
26951	71	0	0	0	0	71
26952	0	0	0	77	0	77
26953	0	70	0	0	0	70
26954	0	78	0	0	0	78
26955	0	0	1	77	0	78
26956	0	0	0	79	0	79
26957	0	76	0	0	0	76
26958	0	0	76	0	0	76
26959	0	0	0	77	0	77
26960	0	0	73	0	0	73
26961	0	0	76	0	0	76
26962	74	0	0	1	0	75
26963	0	75	0	0	0	75
26964	76	0	0	0	0	76
26965	0	0	0	73	0	73
26966	0	72	0	0	0	72
26967	0	0	0	74	0	74
26968	0	0	0	72	0	72
26969	0	76	0	0	0	76
26970	0	0	75	0	0	75
26971	0	0	0	75	0	75
26972	75	0	0	0	0	75
26973	0	0	0	72	0	72
26974	0	0	0	73	0	73
26975	0	0	69	0	0	69
26976	0	72	0	0	0	72
26977	0	0	0	72	0	72
26978	0	0	68	0	0	68
26979	0	0	64	0	0	64
26980	62	0	0	0	0	62
26981	0	70	0	0	0	70
26982	63	0	0	1	0	64
26983	0	64	0	0	0	64
26984	0	66	0	0	0	66
26985	70	0	0	0	0	70
26986	0	0	0	70	0	70
26987	0	68	0	0	0	68
26988	0	0	0	69	0	69
26989	67	0	0	0	0	67
26990	0	0	67	0	0	67
26991	0	0	60	0	0	60
26992	62	0	0	0	0	62
26993	0	63	0	0	0	63
26994	0	0	58	0	0	58
26995	0	56	1	0	0	57
26996	0	0	0	58	0	58
26997	0	0	61	0	0	61
26998	0	0	0	60	0	60
26999	0	0	59	0	0	59
27000	62	0	0	0	0	62
27001	0	59	0	0	0	59
27002	56	0	0	0	0	56
27003	0	0	0	54	0	54
27004	0	51	0	0	0	51
27005	50	0	0	0	0	50
27006	50	0	0	0	0	50
27007	0	0	46	0	0	46
27008	0	0	41	0	0	41
27009	40	0	0	0	0	40
27010	0	46	0	0	0	46
27011	0	45	0	0	0	45
27012	0	0	0	46	0	46
27013	0	0	46	0	0	46
27014	0	43	0	0	0	43
27015	0	43	0	0	0	43
27016	0	0	0	45	0	45
27017	43	0	0	0	0	43
27018	46	0	0	0	0	46
27019	46	0	0	0	0	46
27020	0	0	44	0	0	44
27021	43	0	0	0	0	43
27022	45	0	0	0	0	45
27023	42	0	0	0	0	42
27024	0	0	0	45	0	45
27025	0	49	0	0	0	49
27026	49	0	0	0	0	49
27027	0	48	0	0	0	48
27028	0	0	0	53	0	53
27029	0	0	48	0	0	48
27030	0	0	0	49	0	49
27031	0	0	0	48	0	48
27032	0	0	47	0	0	47
27033	0	50	0	0	0	50
27034	0	0	0	48	0	48
27035	49	0	0	0	0	49
27036	0	50	0	0	0	50
27037	48	0	0	0	0	48
27038	0	0	0	49	0	49
27039	0	48	0	0	0	48
27040	47	0	0	0	0	47
27041	0	50	0	0	0	50
27042	0	0	52	0	0	52
27043	54	0	0	0	0	54
27044	52	0	0	0	0	52
27045	0	60	0	0	0	60
27046	1	0	56	0	0	57
27047	0	60	0	0	0	60
27048	0	1	0	58	0	59
27049	0	0	0	60	0	60
27050	0	0	0	66	0	66
27051	0	66	0	0	0	66
27052	0	0	0	66	0	66
27053	0	0	0	68	0	68
27054	66	0	0	0	0	66
27055	0	0	0	68	0	68
27056	0	0	0	66	0	66
27057	70	0	0	0	0	70
27058	0	68	0	0	0	68
27059	67	0	0	0	0	67
27060	66	0	0	0	0	66
27061	64	0	0	0	0	64
27062	0	0	0	69	0	69
27063	0	0	0	68	0	68
27064	0	0	65	0	0	65
27065	0	0	60	0	0	60
27066	0	0	67	0	0	67
27067	66	0	0	0	0	66
27068	0	0	66	0	0	66
27069	0	67	0	0	0	67
27070	0	0	0	64	0	64
27071	0	0	0	60	0	60
27072	0	68	0	0	0	68
27073	0	0	65	0	0	65
27074	0	65	0	0	0	65
27075	65	0	0	0	0	65
27076	0	0	67	0	0	67
27077	0	64	0	0	0	64
27078	0	0	68	0	0	68
27079	0	0	0	68	0	68
27080	0	0	71	0	0	71
27081	0	0	0	68	0	68
27082	69	0	0	0	0	69
27083	0	0	66	0	0	66
27084	0	68	0	0	0	68
27085	66	0	0	0	0	66
27086	0	0	63	0	0	63
27087	0	0	66	0	0	66
27088	0	0	0	66	0	66
27089	0	0	69	0	0	69
27090	65	0	0	0	0	65
27091	0	71	0	0	0	71
27092	0	0	0	70	0	70
27093	0	70	0	0	0	70
27094	72	0	0	0	0	72
27095	0	0	74	0	0	74
27096	0	0	76	0	0	76
27097	0	0	0	77	0	77
27098	0	0	0	78	0	78
27099	0	0	0	76	0	76
27100	0	0	0	79	0	79
27101	0	0	78	0	0	78
27102	0	80	0	0	0	80
27103	1	0	0	75	0	76
27104	0	0	79	0	0	79
27105	0	77	0	0	0	77
27106	77	0	0	0	0	77
27107	0	0	0	76	0	76
27108	78	0	0	0	0	78
27109	0	69	0	0	0	69
27110	76	0	5	0	0	81
27111	0	0	75	0	0	75
27112	0	0	0	79	0	79
27113	0	78	0	0	0	78
27114	0	0	76	0	0	76
27115	0	75	0	0	0	75
27116	0	0	0	68	0	68
27117	73	0	0	0	0	73
27118	0	67	0	0	0	67
27119	66	0	0	0	0	66
27120	0	0	65	0	0	65
27121	0	0	66	0	0	66
27122	67	0	0	0	0	67
27123	0	0	0	66	0	66
27124	0	0	0	69	0	69
27125	0	0	65	0	0	65
27126	0	0	63	0	0	63
27127	0	71	0	0	0	71
27128	73	0	0	0	0	73
27129	72	0	0	1	0	73
27130	0	76	0	0	0	76
27131	0	0	0	77	0	77
27132	75	0	0	0	0	75
27133	0	0	0	72	0	72
27134	77	0	0	0	0	77
27135	73	0	0	0	0	73
27136	72	0	0	0	0	72
27137	0	1	0	70	0	71
27138	0	0	0	67	0	67
27139	66	0	0	0	0	66
27140	66	0	0	0	0	66
27141	64	0	0	0	0	64
27142	0	64	0	0	0	64
27143	66	0	0	0	0	66
27144	0	64	0	0	0	64
27145	65	0	0	0	0	65
27146	0	0	60	0	0	60
27147	68	0	0	0	0	68
27148	0	65	0	0	0	65
27149	0	68	0	0	0	68
27150	69	0	0	0	0	69
27151	1	0	0	69	0	70
27152	0	0	0	69	0	69
27153	0	72	0	0	0	72
27154	0	74	0	0	0	74
27155	74	0	0	0	0	74
27156	0	1	75	0	0	76
27157	0	0	0	77	0	77
27158	76	0	0	0	0	76
27159	0	0	75	0	0	75
27160	0	76	0	0	0	76
27161	79	0	0	0	0	79
27162	0	1	79	0	0	80
27163	0	0	0	83	0	83
27164	0	0	78	0	0	78
27165	77	1	0	3	0	81
27166	0	82	0	0	0	82
27167	76	0	1	0	0	77
27168	74	0	0	0	0	74
27169	0	0	0	76	0	76
27170	77	0	0	0	0	77
27171	0	0	0	76	0	76
27172	0	0	0	77	0	77
27173	0	0	73	0	0	73
27174	0	76	0	0	0	76
27175	0	0	0	82	0	82
27176	0	0	0	78	0	78
27177	0	0	0	80	0	80
27178	0	0	78	0	0	78
27179	0	81	0	0	0	81
27180	0	0	0	87	0	87
27181	1	0	0	84	0	85
27182	0	0	83	0	0	83
27183	0	0	0	78	0	78
27184	83	0	0	0	0	83
27185	0	90	0	0	0	90
27186	90	0	0	0	0	90
27187	0	0	89	0	0	89
27188	0	0	0	90	0	90
27189	89	0	0	0	0	89
27190	84	0	1	0	0	85
27191	0	0	83	0	0	83
27192	0	0	0	80	0	80
27193	0	0	84	0	0	84
27194	83	0	0	0	0	83
27195	0	83	0	0	0	83
27196	86	0	0	0	0	86
27197	78	0	0	1	0	79
27198	0	83	0	0	0	83
27199	82	0	0	0	0	82
27200	0	0	78	0	0	78
27201	82	0	0	0	0	82
27202	0	0	0	81	0	81
27203	0	0	82	0	0	82
27204	0	0	0	81	0	81
27205	0	0	0	89	0	89
27206	0	0	0	88	0	88
27207	0	86	0	0	0	86
27208	89	0	0	0	0	89
27209	0	0	0	89	0	89
27210	0	86	0	0	0	86
27211	0	0	0	82	0	82
27212	0	86	0	0	0	86
27213	0	0	80	0	0	80
27214	0	0	0	83	0	83
27215	0	0	0	86	0	86
27216	0	0	87	0	0	87
27217	75	0	0	0	0	75
27218	0	83	0	0	0	83
27219	0	0	0	80	0	80
27220	0	0	0	79	0	79
27221	1	0	0	77	0	78
27222	0	78	0	0	0	78
27223	75	0	0	0	0	75
27224	0	0	73	1	0	74
27225	0	0	71	0	0	71
27226	0	0	0	66	0	66
27227	0	0	0	70	0	70
27228	71	0	0	0	0	71
27229	0	70	0	0	0	70
27230	0	0	0	69	0	69
27231	70	0	0	0	0	70
27232	0	0	0	69	0	69
27233	66	0	0	0	0	66
27234	0	0	68	0	0	68
27235	0	64	0	1	0	65
27236	69	0	0	0	0	69
27237	0	0	65	0	0	65
27238	62	0	0	0	0	62
27239	0	0	61	0	0	61
27240	62	0	0	0	0	62
27241	0	0	0	62	0	62
27242	61	0	0	0	0	61
27243	0	0	0	61	0	61
27244	0	0	0	59	0	59
27245	62	0	0	0	0	62
27246	0	66	0	0	0	66
27247	0	0	0	63	0	63
27248	63	0	0	0	0	63
27249	61	0	0	0	0	61
27250	0	0	0	62	0	62
27251	0	0	0	61	0	61
27252	63	0	0	0	0	63
27253	0	0	0	64	0	64
27254	0	0	0	62	0	62
27255	59	0	0	0	0	59
27256	0	0	0	60	0	60
27257	0	0	59	0	0	59
27258	51	0	0	0	0	51
27259	0	0	54	0	0	54
27260	0	0	45	0	0	45
27261	43	0	0	0	0	43
27262	0	43	0	0	0	43
27263	0	0	0	42	0	42
27264	0	0	0	42	0	42
27265	0	0	0	41	0	41
27266	0	0	0	41	0	41
27267	40	0	0	0	0	40
27268	40	0	0	0	0	40
27269	42	0	0	0	0	42
27270	0	0	45	0	0	45
27271	0	0	0	49	0	49
27272	0	0	0	53	0	53
27273	0	0	0	55	0	55
27274	0	57	0	0	0	57
27275	0	64	0	0	0	64
27276	64	0	0	0	0	64
27277	0	0	0	65	0	65
27278	0	0	0	63	0	63
27279	0	0	0	62	0	62
27280	0	0	62	0	0	62
27281	0	0	59	0	0	59
27282	61	0	0	0	0	61
27283	59	0	0	0	0	59
27284	0	0	0	59	0	59
27285	0	61	0	0	0	61
27286	0	0	0	59	0	59
27287	0	0	0	59	0	59
27288	0	0	57	0	0	57
27289	58	0	0	0	0	58
27290	0	0	0	56	0	56
27291	0	0	0	58	0	58
27292	63	0	0	0	0	63
27293	0	61	0	0	0	61
27294	63	0	0	0	0	63
27295	0	0	0	64	0	64
27296	0	61	0	0	0	61
27297	64	0	0	0	0	64
27298	0	0	0	56	0	56
27299	57	0	0	0	0	57
27300	58	0	0	0	0	58
27301	62	0	0	0	0	62
27302	0	53	0	0	0	53
27303	0	60	0	0	0	60
27304	0	0	0	63	0	63
27305	0	62	0	0	0	62
27306	64	0	0	0	0	64
27307	0	0	0	64	0	64
27308	62	0	0	0	0	62
27309	61	0	0	0	0	61
27310	0	0	0	60	0	60
27311	0	0	0	62	0	62
27312	65	0	0	0	0	65
27313	65	0	0	0	0	65
27314	64	0	0	0	0	64
27315	65	0	0	0	0	65
27316	67	0	0	1	0	68
27317	0	0	0	66	0	66
27318	0	0	0	74	0	74
27319	0	0	0	75	0	75
27320	74	0	0	0	0	74
27321	0	0	0	73	0	73
27322	0	73	0	0	0	73
27323	0	0	0	75	0	75
27324	75	0	0	0	0	75
27325	73	0	0	0	0	73
27326	0	0	73	0	0	73
27327	1	0	0	70	0	71
27328	0	73	0	0	0	73
27329	74	0	0	0	0	74
27330	0	70	0	0	0	70
27331	0	0	0	79	0	79
27332	81	0	0	0	0	81
27333	82	0	0	0	0	82
27334	0	80	0	0	0	80
27335	0	0	0	78	0	78
27336	0	0	78	0	0	78
27337	78	0	0	0	0	78
27338	0	0	79	0	0	79
27339	79	0	0	0	0	79
27340	77	0	0	0	0	77
27341	0	0	0	79	0	79
27342	76	0	0	0	0	76
27343	78	0	0	0	0	78
27344	78	0	0	0	0	78
27345	0	0	0	77	0	77
27346	74	0	0	0	0	74
27347	0	0	0	72	0	72
27348	0	0	0	73	0	73
27349	0	73	0	0	0	73
27350	0	0	0	76	0	76
27351	0	76	0	0	0	76
27352	69	0	0	0	0	69
27353	75	0	0	0	0	75
27354	0	0	0	75	0	75
27355	0	0	0	74	0	74
27356	75	0	0	0	0	75
27357	0	0	68	0	0	68
27358	77	0	0	0	0	77
27359	0	0	0	71	0	71
27360	0	0	68	0	0	68
27361	72	0	0	0	0	72
27362	71	0	0	0	0	71
27363	0	0	68	0	0	68
27364	71	0	1	0	0	72
27365	0	0	64	0	0	64
27366	0	65	0	0	0	65
27367	56	0	0	1	0	57
27368	55	0	0	0	0	55
27369	0	50	0	1	0	51
27370	0	47	0	0	0	47
27371	55	0	0	0	0	55
27372	55	0	0	0	0	55
27373	0	0	0	55	0	55
27374	0	0	55	0	0	55
27375	0	0	46	0	0	46
27376	55	0	0	0	0	55
27377	0	0	54	0	0	54
27378	58	0	0	0	0	58
27379	0	0	0	55	0	55
27380	0	0	0	55	0	55
27381	0	0	51	0	0	51
27382	57	0	0	0	0	57
27383	1	0	0	57	0	58
27384	0	0	0	60	0	60
27385	57	0	0	0	0	57
27386	50	0	0	1	0	51
27387	54	0	0	1	0	55
27388	0	55	0	0	0	55
27389	0	0	50	0	0	50
27390	50	0	0	0	0	50
27391	52	0	0	0	0	52
27392	0	51	0	0	0	51
27393	49	0	0	0	0	49
27394	0	0	0	48	0	48
27395	0	0	49	0	0	49
27396	45	0	0	0	0	45
27397	46	0	0	0	0	46
27398	46	0	0	1	0	47
27399	47	0	0	0	0	47
27400	0	0	0	46	0	46
27401	0	0	0	47	0	47
27402	47	0	0	0	0	47
27403	0	0	0	47	0	47
27404	0	0	0	43	0	43
27405	0	40	0	0	0	40
27406	0	0	0	45	0	45
27407	0	0	0	42	0	42
27408	0	0	0	44	0	44
27409	0	0	0	44	0	44
27410	0	42	0	0	0	42
27411	0	0	0	38	0	38
27412	0	1	0	41	0	42
27413	0	0	41	0	0	41
27414	0	0	36	0	0	36
27415	0	42	0	0	0	42
27416	40	0	0	0	0	40
27417	0	42	0	0	0	42
27418	0	0	0	43	0	43
27419	0	0	45	0	0	45
27420	43	0	0	0	0	43
27421	0	0	0	46	0	46
27422	46	0	0	0	0	46
27423	46	0	0	1	0	47
27424	0	46	0	0	0	46
27425	45	0	0	0	0	45
27426	0	47	0	0	0	47
27427	0	0	0	48	0	48
27428	0	46	0	0	0	46
27429	0	0	48	0	0	48
27430	0	51	0	0	0	51
27431	0	0	0	51	0	51
27432	51	0	0	0	0	51
27433	0	50	0	0	0	50
27434	0	0	0	51	0	51
27435	0	0	0	51	0	51
27436	0	0	50	0	0	50
27437	0	0	0	48	0	48
27438	0	0	49	0	0	49
27439	52	0	0	0	0	52
27440	0	0	51	0	0	51
27441	0	49	0	0	0	49
27442	0	0	0	49	0	49
27443	0	0	0	49	0	49
27444	0	0	0	47	0	47
27445	48	0	0	0	0	48
27446	0	0	0	47	0	47
27447	0	44	0	0	0	44
27448	46	0	0	0	0	46
27449	0	47	0	0	0	47
27450	0	0	0	48	0	48
27451	42	0	0	0	0	42
27452	0	44	0	0	0	44
27453	0	46	0	0	0	46
27454	47	0	0	0	0	47
27455	48	0	0	0	0	48
27456	0	0	44	0	0	44
27457	44	0	0	0	0	44
27458	0	0	40	0	0	40
27459	0	0	0	43	0	43
27460	0	0	43	0	0	43
27461	0	0	0	40	0	40
27462	0	0	45	0	0	45
27463	0	0	0	45	0	45
27464	0	0	0	44	0	44
27465	43	0	0	0	0	43
27466	0	0	41	0	0	41
27467	41	0	0	0	0	41
27468	0	0	38	0	0	38
27469	0	0	43	0	0	43
27470	0	0	0	46	0	46
27471	46	0	0	0	0	46
27472	0	45	0	0	0	45
27473	46	0	0	0	0	46
27474	46	0	0	0	0	46
27475	0	45	0	0	0	45
27476	48	0	0	0	0	48
27477	0	0	50	0	0	50
27478	0	0	0	53	0	53
27479	51	0	0	0	0	51
27480	0	51	0	0	0	51
27481	0	0	0	53	0	53
27482	0	0	0	56	0	56
27483	0	0	0	49	0	49
27484	0	0	0	49	0	49
27485	53	0	0	0	0	53
27486	54	0	0	0	0	54
27487	53	0	0	0	0	53
27488	59	0	0	0	0	59
27489	0	0	55	0	0	55
27490	56	0	0	0	0	56
27491	56	0	0	0	0	56
27492	0	58	0	0	0	58
27493	0	60	0	0	0	60
27494	0	0	0	63	0	63
27495	0	0	0	66	0	66
27496	0	0	64	0	0	64
27497	0	62	0	0	0	62
27498	0	0	0	65	0	65
27499	0	55	0	0	0	55
27500	0	0	0	60	0	60
27501	0	0	0	58	0	58
27502	0	56	0	0	0	56
27503	0	0	0	57	0	57
27504	0	0	58	0	0	58
27505	1	0	48	0	0	49
27506	54	0	0	0	0	54
27507	56	0	0	0	0	56
27508	0	53	0	0	0	53
27509	56	0	0	0	0	56
27510	0	0	0	56	0	56
27511	55	0	0	0	0	55
27512	0	56	0	0	0	56
27513	0	0	59	0	0	59
27514	50	0	0	0	0	50
27515	0	0	55	0	0	55
27516	0	0	49	0	0	49
27517	0	0	55	0	0	55
27518	0	59	0	0	0	59
27519	58	0	0	0	0	58
27520	57	0	0	0	0	57
27521	0	0	0	57	0	57
27522	0	0	0	58	0	58
27523	0	56	0	0	0	56
27524	58	0	0	0	0	58
27525	0	57	0	0	0	57
27526	0	65	0	0	0	65
27527	61	0	0	0	0	61
27528	0	0	1	66	0	67
27529	0	0	0	68	0	68
27530	0	0	0	71	0	71
27531	0	70	0	0	0	70
27532	69	0	0	0	0	69
27533	0	0	0	70	0	70
27534	0	66	0	0	0	66
27535	0	70	0	0	0	70
27536	0	0	0	71	0	71
27537	0	70	0	0	0	70
27538	0	0	0	69	0	69
27539	71	0	0	0	0	71
27540	0	0	70	0	0	70
27541	0	70	0	1	0	71
27542	0	0	0	69	0	69
27543	0	0	70	0	0	70
27544	70	0	0	0	0	70
27545	0	0	0	69	0	69
27546	67	0	0	0	0	67
27547	62	0	0	0	0	62
27548	0	67	0	0	0	67
27549	71	0	0	0	0	71
27550	72	0	0	0	0	72
27551	74	0	0	1	0	75
27552	0	0	0	72	0	72
27553	0	2	0	74	0	76
27554	0	0	2	72	0	74
27555	0	0	70	0	0	70
27556	0	75	0	0	0	75
27557	77	0	0	0	0	77
27558	0	73	0	0	0	73
27559	0	0	0	74	0	74
27560	0	0	73	0	0	73
27561	70	0	0	0	0	70
27562	0	66	0	0	0	66
27563	0	0	0	70	0	70
27564	0	0	0	70	0	70
27565	0	0	66	0	0	66
27566	0	66	0	0	0	66
27567	0	0	0	69	0	69
27568	0	0	0	62	0	62
27569	0	2	0	60	0	62
27570	60	0	2	0	0	62
27571	0	0	59	0	0	59
27572	0	64	0	0	0	64
27573	60	0	0	0	0	60
27574	0	64	0	0	0	64
27575	0	0	0	61	0	61
27576	0	61	0	0	0	61
27577	62	0	0	0	0	62
27578	64	0	0	0	0	64
27579	0	0	0	64	0	64
27580	0	0	0	61	0	61
27581	0	0	0	63	0	63
27582	0	0	61	0	0	61
27583	0	68	0	0	0	68
27584	0	0	0	72	0	72
27585	0	0	0	75	0	75
27586	0	0	0	72	0	72
27587	0	0	0	73	0	73
27588	0	0	65	0	0	65
27589	0	69	0	0	0	69
27590	0	0	0	72	0	72
27591	0	0	0	72	0	72
27592	0	0	66	0	0	66
27593	0	0	0	72	0	72
27594	0	71	0	0	0	71
27595	0	73	0	0	0	73
27596	0	0	0	71	0	71
27597	1	0	69	0	0	70
27598	69	0	0	0	0	69
27599	0	68	0	0	0	68
27600	0	0	72	0	0	72
27601	0	0	72	0	0	72
27602	0	71	0	0	0	71
27603	0	0	71	0	0	71
27604	0	0	0	67	0	67
27605	73	0	0	0	0	73
27606	78	0	0	0	0	78
27607	78	0	0	0	0	78
27608	69	0	0	1	0	70
27609	0	73	0	0	0	73
27610	71	0	0	0	0	71
27611	0	64	0	0	0	64
27612	0	0	69	0	0	69
27613	0	0	0	74	0	74
27614	0	74	0	0	0	74
27615	0	0	0	73	0	73
27616	72	0	0	0	0	72
27617	0	0	0	69	0	69
27618	0	67	0	0	0	67
27619	61	0	0	0	0	61
27620	0	0	67	0	0	67
27621	0	0	0	55	0	55
27622	0	0	0	57	0	57
27623	54	0	0	0	0	54
27624	0	56	0	0	0	56
27625	0	0	58	0	0	58
27626	0	0	0	58	0	58
27627	0	0	63	0	0	63
27628	0	57	0	0	0	57
27629	0	62	0	0	0	62
27630	61	0	1	0	0	62
27631	0	0	60	0	0	60
27632	65	0	0	0	0	65
27633	0	0	0	63	0	63
27634	0	63	0	0	0	63
27635	65	0	0	0	0	65
27636	0	0	64	0	0	64
27637	0	0	0	66	0	66
27638	0	0	0	64	0	64
27639	0	0	0	66	0	66
27640	0	66	0	0	0	66
27641	57	0	1	0	0	58
27642	0	57	0	0	0	57
27643	0	58	0	0	0	58
27644	0	0	0	61	0	61
27645	61	0	0	0	0	61
27646	57	0	0	0	0	57
27647	63	0	0	0	0	63
27648	0	63	0	0	0	63
27649	0	0	0	63	0	63
27650	0	0	65	0	0	65
27651	0	0	0	66	0	66
27652	0	0	0	67	0	67
27653	0	64	0	5	0	69
27654	68	0	0	0	0	68
27655	0	0	0	66	0	66
27656	0	67	0	0	0	67
27657	68	0	0	0	0	68
27658	0	0	64	0	0	64
27659	65	0	0	0	0	65
27660	0	66	0	0	0	66
27661	65	0	0	0	0	65
27662	73	0	0	0	0	73
27663	0	0	73	0	0	73
27664	75	0	0	0	0	75
27665	1	0	71	0	0	72
27666	0	0	72	0	0	72
27667	74	0	0	0	0	74
27668	71	0	0	0	0	71
27669	0	0	71	0	0	71
27670	0	0	0	72	0	72
27671	0	0	0	67	0	67
27672	0	67	0	0	0	67
27673	69	0	0	0	0	69
27674	72	0	0	0	0	72
27675	0	0	67	0	0	67
27676	67	0	0	0	0	67
27677	61	0	0	0	0	61
27678	0	68	0	0	0	68
27679	0	0	0	61	0	61
27680	1	0	0	61	0	62
27681	0	0	0	64	0	64
27682	61	0	0	0	0	61
27683	0	62	0	0	0	62
27684	0	0	0	63	0	63
27685	0	63	0	0	0	63
27686	0	0	0	63	0	63
27687	0	59	0	0	0	59
27688	0	61	0	0	0	61
27689	62	0	0	0	0	62
27690	59	0	0	0	0	59
27691	0	0	0	62	0	62
27692	0	0	0	60	0	60
27693	0	0	0	61	0	61
27694	0	0	0	57	0	57
27695	0	0	0	61	0	61
27696	0	57	0	0	0	57
27697	0	0	0	59	0	59
27698	0	0	0	60	0	60
27699	58	0	0	0	0	58
27700	0	0	0	55	0	55
27701	0	0	0	57	0	57
27702	0	0	57	0	0	57
27703	0	0	0	59	0	59
27704	0	0	0	59	0	59
27705	0	0	60	0	0	60
27706	0	57	0	0	0	57
27707	0	0	63	0	0	63
27708	0	0	59	0	0	59
27709	1	62	0	0	0	63
27710	65	0	0	0	0	65
27711	64	0	0	0	0	64
27712	0	1	0	62	0	63
27713	67	0	0	0	0	67
27714	0	1	63	0	0	64
27715	0	0	0	67	0	67
27716	0	0	66	0	0	66
27717	0	0	0	67	0	67
27718	0	0	0	63	0	63
27719	0	0	0	61	0	61
27720	64	0	0	0	0	64
27721	0	0	0	61	0	61
27722	62	0	0	0	0	62
27723	64	0	0	0	0	64
27724	0	64	0	0	0	64
27725	63	0	0	0	0	63
27726	0	64	0	0	0	64
27727	0	0	0	62	0	62
27728	0	0	0	62	0	62
27729	0	0	0	61	0	61
27730	0	0	63	0	0	63
27731	0	60	0	0	0	60
27732	0	0	0	60	0	60
27733	0	0	0	61	0	61
27734	0	58	0	0	0	58
27735	63	0	0	0	0	63
27736	0	61	0	0	0	61
27737	59	0	0	0	0	59
27738	0	61	0	0	0	61
27739	0	0	0	61	0	61
27740	0	51	0	0	0	51
27741	54	0	0	0	0	54
27742	55	0	0	0	0	55
27743	55	0	0	0	0	55
27744	55	0	0	0	0	55
27745	0	0	53	0	0	53
27746	55	0	0	0	0	55
27747	52	0	0	0	0	52
27748	54	0	0	0	0	54
27749	0	0	51	0	0	51
27750	53	0	0	0	0	53
27751	0	53	0	0	0	53
27752	54	0	0	0	0	54
27753	0	0	65	0	0	65
27754	66	0	0	0	0	66
27755	58	0	0	0	0	58
27756	0	0	0	57	0	57
27757	0	0	56	0	0	56
27758	60	0	0	1	0	61
27759	0	0	0	59	0	59
27760	0	0	0	60	0	60
27761	0	0	62	0	0	62
27762	63	0	0	0	0	63
27763	60	0	0	1	0	61
27764	0	62	0	0	0	62
27765	0	0	0	65	0	65
27766	1	0	0	64	0	65
27767	0	0	0	66	0	66
27768	0	63	0	0	0	63
27769	65	0	0	0	0	65
27770	0	0	0	64	0	64
27771	0	0	0	64	0	64
27772	60	0	0	0	0	60
27773	60	0	0	0	0	60
27774	0	0	0	61	0	61
27775	0	0	0	60	0	60
27776	0	0	60	0	0	60
27777	56	0	0	0	0	56
27778	0	56	0	0	0	56
27779	0	0	0	58	0	58
27780	0	0	0	57	0	57
27781	0	54	0	0	0	54
27782	0	0	0	59	0	59
27783	59	0	0	0	0	59
27784	0	0	0	61	0	61
27785	0	0	0	62	0	62
27786	0	0	0	62	0	62
27787	0	0	67	0	0	67
27788	0	0	0	70	0	70
27789	0	0	69	0	0	69
27790	0	69	0	0	0	69
27791	0	0	0	75	0	75
27792	0	0	0	70	0	70
27793	0	0	0	72	0	72
27794	0	0	0	78	0	78
27795	0	0	0	76	0	76
27796	75	0	0	0	0	75
27797	1	0	73	0	0	74
27798	0	63	0	0	0	63
27799	0	73	0	0	0	73
27800	0	0	0	73	0	73
27801	0	0	0	73	0	73
27802	0	0	0	74	0	74
27803	0	77	0	0	0	77
27804	0	0	0	77	0	77
27805	0	0	72	0	0	72
27806	0	69	0	0	0	69
27807	0	0	0	73	0	73
27808	71	0	0	0	0	71
27809	0	0	0	73	0	73
27810	0	0	0	72	0	72
27811	0	68	0	0	0	68
27812	0	69	0	0	0	69
27813	0	0	0	71	0	71
27814	0	0	0	70	0	70
27815	0	0	69	0	0	69
27816	0	0	0	70	0	70
27817	0	0	0	66	0	66
27818	0	0	0	69	0	69
27819	0	0	0	71	0	71
27820	65	0	0	0	0	65
27821	66	0	0	1	0	67
27822	0	0	0	71	0	71
27823	0	0	0	69	0	69
27824	69	0	0	0	0	69
27825	0	0	0	70	0	70
27826	0	0	67	0	0	67
27827	0	66	0	0	0	66
27828	0	0	0	70	0	70
27829	0	0	0	71	0	71
27830	72	0	0	0	0	72
27831	0	0	0	72	0	72
27832	0	0	0	73	0	73
27833	70	1	0	0	0	71
27834	0	0	0	71	0	71
27835	0	70	0	0	0	70
27836	0	0	0	72	0	72
27837	0	0	0	70	0	70
27838	0	0	0	71	0	71
27839	0	0	0	70	0	70
27840	0	0	68	0	0	68
27841	0	0	63	0	0	63
27842	0	0	0	70	0	70
27843	0	0	0	70	0	70
27844	0	68	0	0	0	68
27845	0	0	0	68	0	68
27846	0	58	0	0	0	58
27847	58	0	0	0	0	58
27848	0	61	0	0	0	61
27849	0	0	0	66	0	66
27850	0	0	0	68	0	68
27851	0	0	61	0	0	61
27852	63	0	0	0	0	63
27853	57	0	0	0	0	57
27854	0	61	0	0	0	61
27855	0	0	0	60	0	60
27856	0	0	61	0	0	61
27857	0	70	0	0	0	70
27858	69	0	0	0	0	69
27859	69	0	0	0	0	69
27860	0	0	67	0	0	67
27861	68	0	0	0	0	68
27862	0	0	0	69	0	69
27863	0	67	0	0	0	67
27864	71	0	0	0	0	71
27865	0	0	0	73	0	73
27866	71	0	0	0	0	71
27867	72	0	0	0	0	72
27868	0	0	0	72	0	72
27869	0	0	72	0	0	72
27870	73	0	0	0	0	73
27871	74	0	0	0	0	74
27872	76	0	0	0	0	76
27873	0	74	0	0	0	74
27874	0	0	0	74	0	74
27875	0	0	0	72	0	72
27876	0	0	75	0	0	75
27877	0	0	1	71	0	72
27878	0	71	0	0	0	71
27879	73	0	0	0	0	73
27880	0	74	0	0	0	74
27881	0	0	69	0	0	69
27882	0	70	0	0	0	70
27883	0	67	0	0	0	67
27884	0	0	0	70	0	70
27885	72	0	0	0	0	72
27886	71	0	0	0	0	71
27887	68	0	0	0	0	68
27888	0	68	0	0	0	68
27889	0	0	64	0	0	64
27890	68	0	0	0	0	68
27891	67	0	0	0	0	67
27892	0	66	0	0	0	66
27893	67	0	0	0	0	67
27894	0	0	1	69	0	70
27895	0	1	71	0	0	72
27896	69	0	0	0	0	69
27897	64	0	0	0	0	64
27898	69	0	0	0	0	69
27899	0	0	0	70	0	70
27900	0	0	0	72	0	72
27901	0	0	0	73	0	73
27902	0	70	0	0	0	70
27903	0	0	0	71	0	71
27904	0	0	0	74	0	74
27905	0	0	68	0	0	68
27906	1	0	0	70	0	71
27907	0	0	0	65	0	65
27908	0	0	0	69	0	69
27909	0	0	0	71	0	71
27910	0	72	0	0	0	72
27911	0	0	0	73	0	73
27912	0	0	0	73	0	73
27913	71	0	0	0	0	71
27914	0	0	68	0	0	68
27915	0	0	65	0	0	65
27916	69	0	0	0	0	69
27917	72	0	0	0	0	72
27918	0	0	0	68	0	68
27919	0	76	0	0	0	76
27920	75	0	0	0	0	75
27921	0	0	0	74	0	74
27922	0	72	0	0	0	72
27923	81	0	0	0	0	81
27924	0	82	0	0	0	82
27925	81	0	0	0	0	81
27926	89	0	0	0	0	89
27927	0	89	0	0	0	89
27928	0	0	0	89	0	89
27929	0	0	84	0	0	84
27930	0	0	0	82	0	82
27931	86	0	0	0	0	86
27932	0	0	85	0	0	85
27933	0	84	0	0	0	84
27934	0	0	1	84	0	85
27935	0	0	85	0	0	85
27936	0	82	0	0	0	82
27937	87	0	0	0	0	87
27938	0	0	0	86	0	86
27939	0	0	0	85	0	85
27940	0	0	0	85	0	85
27941	0	87	0	0	0	87
27942	85	0	0	0	0	85
27943	1	77	0	0	0	78
27944	0	86	0	0	0	86
27945	90	0	0	0	0	90
27946	90	0	0	0	0	90
27947	0	0	93	0	0	93
27948	90	0	0	0	0	90
27949	86	0	0	0	0	86
27950	0	0	0	81	0	81
27951	0	0	77	0	0	77
27952	1	0	0	78	0	79
27953	80	0	0	0	0	80
27954	0	0	82	0	0	82
27955	0	0	0	81	0	81
27956	0	0	0	80	0	80
27957	0	0	0	81	0	81
27958	78	0	0	0	0	78
27959	0	79	0	0	0	79
27960	86	0	0	0	0	86
27961	0	0	88	0	0	88
27962	0	0	0	85	0	85
27963	0	83	0	0	0	83
27964	87	0	0	0	0	87
27965	0	0	0	85	0	85
27966	0	0	87	0	0	87
27967	0	0	0	90	0	90
27968	85	0	0	1	0	86
27969	0	92	0	0	0	92
27970	0	0	0	92	0	92
27971	0	95	0	0	0	95
27972	97	0	0	0	0	97
27973	91	0	0	0	0	91
27974	0	87	0	0	0	87
27975	90	0	0	0	0	90
27976	0	0	0	89	0	89
27977	0	90	0	0	0	90
27978	89	0	0	0	0	89
27979	89	0	0	0	0	89
27980	0	81	0	0	0	81
27981	0	86	0	0	0	86
27982	89	0	0	0	0	89
27983	0	0	0	92	0	92
27984	93	0	0	0	0	93
27985	0	0	0	94	0	94
27986	0	0	90	0	0	90
27987	0	0	0	89	0	89
27988	87	0	0	0	0	87
27989	0	0	89	0	0	89
27990	0	0	0	88	0	88
27991	0	0	0	86	0	86
27992	0	0	93	0	0	93
27993	86	0	0	0	0	86
27994	0	0	0	87	0	87
27995	0	0	89	0	0	89
27996	80	0	0	0	0	80
27997	0	84	0	0	0	84
27998	0	81	0	0	0	81
27999	0	88	0	0	0	88
28000	0	0	91	0	0	91
28001	0	0	0	92	0	92
28002	0	0	97	0	0	97
28003	0	4	0	91	0	95
28004	0	88	0	0	0	88
28005	0	89	4	0	0	93
28006	0	0	0	92	0	92
28007	96	0	0	0	0	96
28008	0	0	0	95	0	95
28009	0	0	0	97	0	97
28010	0	101	0	1	0	102
28011	99	0	0	0	0	99
28012	0	94	0	0	0	94
28013	0	0	0	97	0	97
28014	0	0	0	96	0	96
28015	0	92	0	0	0	92
28016	0	0	0	87	0	87
28017	89	0	0	0	0	89
28018	0	0	0	92	0	92
28019	0	0	0	87	0	87
28020	0	92	0	0	0	92
28021	0	0	0	88	0	88
28022	83	0	0	0	0	83
28023	91	0	0	0	0	91
28024	89	0	0	0	0	89
28025	0	0	0	92	0	92
28026	0	0	85	0	0	85
28027	0	1	83	1	0	85
28028	0	0	0	85	0	85
28029	94	0	0	0	0	94
28030	0	0	0	94	0	94
28031	96	0	0	0	0	96
28032	0	0	0	95	0	95
28033	0	0	0	97	0	97
28034	91	0	0	0	0	91
28035	0	0	87	0	0	87
28036	90	0	0	0	0	90
28037	0	0	81	0	0	81
28038	0	0	0	86	0	86
28039	86	0	0	0	0	86
28040	0	0	87	0	0	87
28041	1	0	77	0	0	78
28042	85	0	0	0	0	85
28043	0	0	78	0	0	78
28044	0	82	0	0	0	82
28045	1	0	0	87	0	88
28046	99	0	0	0	0	99
28047	0	0	90	0	0	90
28048	97	0	0	0	0	97
28049	105	0	0	0	0	105
28050	100	0	0	0	0	100
28051	102	0	0	0	0	102
28052	2	0	0	106	0	108
28053	0	114	0	0	0	114
28054	110	0	0	0	0	110
28055	0	0	111	0	0	111
28056	0	106	0	0	0	106
28057	114	0	0	0	0	114
28058	0	108	0	0	0	108
28059	0	107	0	0	0	107
28060	0	0	0	106	0	106
28061	0	0	0	107	0	107
28062	0	0	0	108	0	108
28063	98	0	0	0	0	98
28064	103	0	0	0	0	103
28065	0	0	0	101	0	101
28066	0	0	0	105	0	105
28067	0	0	100	0	0	100
28068	106	0	0	0	0	106
28069	104	0	0	0	0	104
28070	0	0	0	102	0	102
28071	0	0	0	104	0	104
28072	0	0	105	0	0	105
28073	0	0	0	104	0	104
28074	0	0	96	0	0	96
28075	2	97	0	0	0	99
28076	0	0	102	0	0	102
28077	0	0	0	99	0	99
28078	0	0	93	0	0	93
28079	0	0	89	0	0	89
28080	102	0	0	0	0	102
28081	0	0	0	100	0	100
28082	0	0	100	0	0	100
28083	101	0	0	0	0	101
28084	1	0	94	0	0	95
28085	0	0	86	1	0	87
28086	0	102	0	0	0	102
28087	0	0	0	104	0	104
28088	0	0	106	0	0	106
28089	0	0	94	0	0	94
28090	1	0	0	100	0	101
28091	0	0	0	96	0	96
28092	0	105	0	0	0	105
28093	0	0	0	109	0	109
28094	109	0	0	0	0	109
28095	101	0	0	0	0	101
28096	98	0	0	0	0	98
28097	1	0	0	102	0	103
28098	0	101	0	0	0	101
28099	96	0	0	0	0	96
28100	0	95	0	0	0	95
28101	0	92	0	1	0	93
28102	0	96	0	0	0	96
28103	100	0	0	0	0	100
28104	0	0	0	96	0	96
28105	0	0	0	98	0	98
28106	0	96	0	0	0	96
28107	95	0	0	0	0	95
28108	0	0	91	0	0	91
28109	1	0	0	92	0	93
28110	92	0	0	0	0	92
28111	0	94	0	0	0	94
28112	102	0	0	0	0	102
28113	0	0	0	102	0	102
28114	0	96	0	0	0	96
28115	0	0	95	0	0	95
28116	105	0	0	0	0	105
28117	1	0	0	103	0	104
28118	99	0	0	0	0	99
28119	0	0	0	97	0	97
28120	0	98	0	0	0	98
28121	0	0	100	0	0	100
28122	0	0	89	0	0	89
28123	0	0	0	98	0	98
28124	96	0	0	0	0	96
28125	95	0	0	0	0	95
28126	0	0	0	88	0	88
28127	0	0	0	96	0	96
28128	94	0	0	0	0	94
28129	0	0	0	91	0	91
28130	90	0	0	0	0	90
28131	0	93	0	0	0	93
28132	98	0	0	0	0	98
28133	1	0	97	0	0	98
28134	0	0	0	97	0	97
28135	0	0	0	94	0	94
28136	0	0	0	100	0	100
28137	0	97	0	0	0	97
28138	0	90	0	0	0	90
28139	0	0	0	93	0	93
28140	0	0	94	0	0	94
28141	0	0	0	90	0	90
28142	0	0	0	88	0	88
28143	0	0	0	87	0	87
28144	85	0	0	0	0	85
28145	0	80	0	0	0	80
28146	0	75	0	0	0	75
28147	0	0	0	77	0	77
28148	0	0	0	75	0	75
28149	0	0	0	74	0	74
28150	0	0	0	76	0	76
28151	74	0	0	0	0	74
28152	0	78	0	0	0	78
28153	76	0	0	0	0	76
28154	77	0	0	0	0	77
28155	0	0	0	79	0	79
28156	0	0	0	78	0	78
28157	77	0	0	0	0	77
28158	77	0	0	0	0	77
28159	1	0	0	77	0	78
28160	0	0	0	75	0	75
28161	0	0	80	0	0	80
28162	0	69	0	0	0	69
28163	0	85	0	0	0	85
28164	86	0	0	0	0	86
28165	0	0	80	2	0	82
28166	0	0	78	0	0	78
28167	82	0	0	0	0	82
28168	86	0	0	0	0	86
28169	0	84	1	0	0	85
28170	0	84	0	0	0	84
28171	0	0	0	88	0	88
28172	92	0	0	0	0	92
28173	92	0	0	0	0	92
28174	92	0	0	0	0	92
28175	0	0	0	89	0	89
28176	0	0	0	91	0	91
28177	0	0	89	0	0	89
28178	0	0	74	0	0	74
28179	0	0	82	0	0	82
28180	0	0	0	87	0	87
28181	91	0	0	0	0	91
28182	0	1	89	0	0	90
28183	0	0	0	92	0	92
28184	0	89	0	0	0	89
28185	0	0	1	89	0	90
28186	0	0	0	93	0	93
28187	0	0	94	0	0	94
28188	0	0	0	94	0	94
28189	93	0	0	4	0	97
28190	0	0	111	0	0	111
28191	0	0	0	109	0	109
28192	0	0	108	1	0	109
28193	0	116	0	0	0	116
28194	0	6	116	0	0	122
28195	2	0	6	110	0	118
28196	0	0	0	117	0	117
28197	0	0	120	0	0	120
28198	0	0	0	123	0	123
28199	0	0	0	122	0	122
28200	0	125	0	1	0	126
28201	0	0	127	0	0	127
28202	0	0	0	128	0	128
28203	0	0	0	131	0	131
28204	0	121	0	0	0	121
28205	0	0	0	123	0	123
28206	123	0	0	0	0	123
28207	0	0	0	129	0	129
28208	0	1	130	0	0	131
28209	126	0	0	1	0	127
28210	126	0	0	0	0	126
28211	0	0	124	0	0	124
28212	128	0	1	0	0	129
28213	0	130	0	0	0	130
28214	0	0	0	131	0	131
28215	0	0	0	131	0	131
28216	0	0	1	132	0	133
28217	0	0	0	135	0	135
28218	0	0	0	146	0	146
28219	147	0	0	0	0	147
28220	0	0	147	0	0	147
28221	148	0	0	0	0	148
28222	0	0	146	0	0	146
28223	0	0	0	147	0	147
28224	148	0	0	0	0	148
28225	0	0	0	143	0	143
28226	0	138	0	0	0	138
28227	141	0	0	0	0	141
28228	0	0	0	143	0	143
28229	0	1	138	0	0	139
28230	137	0	0	0	0	137
28231	0	142	0	0	0	142
28232	0	0	142	0	0	142
28233	0	0	0	141	0	141
28234	1	0	0	140	0	141
28235	0	138	0	0	0	138
28236	0	0	140	0	0	140
28237	0	0	0	149	0	149
28238	0	0	142	0	0	142
28239	0	0	0	147	0	147
28240	0	0	0	148	0	148
28241	0	0	143	0	0	143
28242	0	0	0	145	0	145
28243	0	0	0	138	0	138
28244	0	0	0	150	0	150
28245	0	0	0	147	0	147
28246	146	0	0	0	0	146
28247	0	1	141	0	0	142
28248	148	0	0	0	0	148
28249	0	0	0	143	0	143
28250	1	0	0	144	0	145
28251	0	0	0	145	0	145
28252	0	145	0	0	0	145
28253	140	0	0	0	0	140
28254	0	0	0	141	0	141
28255	0	143	0	0	0	143
28256	0	0	0	138	0	138
28257	136	0	0	0	0	136
28258	130	0	0	1	0	131
28259	132	0	0	0	0	132
28260	0	136	0	0	0	136
28261	0	0	135	0	0	135
28262	140	0	0	0	0	140
28263	141	0	0	0	0	141
28264	0	142	0	0	0	142
28265	134	0	0	0	0	134
28266	133	0	0	0	0	133
28267	133	0	0	0	0	133
28268	0	131	0	0	0	131
28269	0	0	0	139	0	139
28270	143	0	0	0	0	143
28271	145	0	0	0	0	145
28272	145	0	0	0	0	145
28273	139	0	0	1	0	140
28274	0	0	0	139	0	139
28275	0	0	136	0	0	136
28276	0	0	1	130	0	131
28277	0	135	0	0	0	135
28278	0	0	0	132	0	132
28279	0	0	137	0	0	137
28280	139	0	0	0	0	139
28281	0	0	0	139	0	139
28282	134	0	0	0	0	134
28283	128	0	0	0	0	128
28284	0	0	0	124	0	124
28285	0	0	122	0	0	122
28286	0	0	113	0	0	113
28287	113	0	0	0	0	113
28288	0	114	0	0	0	114
28289	0	102	0	0	0	102
28290	0	106	0	0	0	106
28291	0	121	0	0	0	121
28292	121	0	0	0	0	121
28293	120	0	0	0	0	120
28294	122	0	0	0	0	122
28295	119	0	0	0	0	119
28296	0	0	0	117	0	117
28297	0	118	0	0	0	118
28298	123	0	0	0	0	123
28299	1	1	115	0	0	117
28300	0	113	0	1	0	114
28301	0	0	118	0	0	118
28302	108	0	0	0	0	108
28303	105	0	0	1	0	106
28304	108	0	0	0	0	108
28305	0	0	0	106	0	106
28306	0	0	110	0	0	110
28307	0	110	0	0	0	110
28308	106	0	0	0	0	106
28309	0	102	0	0	0	102
28310	0	89	0	0	0	89
28311	0	92	0	0	0	92
28312	0	96	0	0	0	96
28313	0	0	90	0	0	90
28314	0	90	0	0	0	90
28315	90	0	0	0	0	90
28316	1	0	0	89	0	90
28317	0	0	0	91	0	91
28318	91	0	0	0	0	91
28319	0	91	0	0	0	91
28320	0	0	90	0	0	90
28321	0	0	0	94	0	94
28322	0	0	0	97	0	97
28323	0	0	0	97	0	97
28324	0	0	90	0	0	90
28325	0	0	91	0	0	91
28326	0	0	1	93	0	94
28327	0	1	94	0	0	95
28328	1	0	90	0	0	91
28329	92	0	0	0	0	92
28330	0	93	0	0	0	93
28331	0	91	0	0	0	91
28332	0	91	0	0	0	91
28333	0	0	0	94	0	94
28334	0	94	0	0	0	94
28335	90	0	0	1	0	91
28336	0	0	88	0	0	88
28337	102	0	0	0	0	102
28338	0	0	0	102	0	102
28339	0	0	0	99	0	99
28340	0	103	0	0	0	103
28341	102	0	0	0	0	102
28342	107	0	0	0	0	107
28343	0	106	0	0	0	106
28344	0	0	0	112	0	112
28345	0	0	108	0	0	108
28346	0	0	109	0	0	109
28347	0	113	0	0	0	113
28348	119	0	0	0	0	119
28349	0	0	109	0	0	109
28350	0	0	0	113	0	113
28351	120	0	0	0	0	120
28352	122	0	0	0	0	122
28353	0	115	1	0	0	116
28354	0	121	0	0	0	121
28355	120	0	0	0	0	120
28356	0	0	115	0	0	115
28357	123	0	0	0	0	123
28358	122	0	0	0	0	122
28359	0	2	0	121	0	123
28360	1	0	126	0	0	127
28361	1	0	128	0	0	129
28362	127	0	0	0	0	127
28363	0	0	128	0	0	128
28364	125	0	0	0	0	125
28365	121	1	0	0	0	122
28366	0	121	0	0	0	121
28367	0	0	123	0	0	123
28368	0	126	0	0	0	126
28369	127	0	0	0	0	127
28370	0	0	125	0	0	125
28371	0	0	0	116	0	116
28372	0	0	122	0	0	122
28373	0	0	116	0	0	116
28374	0	0	112	0	0	112
28375	0	0	117	0	0	117
28376	0	116	0	0	0	116
28377	0	0	117	0	0	117
28378	0	116	0	0	0	116
28379	0	0	120	0	0	120
28380	120	0	0	0	0	120
28381	0	0	0	116	0	116
28382	0	119	0	0	0	119
28383	116	0	0	0	0	116
28384	109	0	0	0	0	109
28385	107	0	0	0	0	107
28386	106	1	0	0	0	107
28387	0	110	0	0	0	110
28388	106	0	0	0	0	106
28389	107	0	0	0	0	107
28390	0	109	0	0	0	109
28391	0	0	101	0	0	101
28392	1	0	0	105	0	106
28393	0	113	0	0	0	113
28394	0	0	113	0	0	113
28395	0	0	112	0	0	112
28396	1	110	0	0	0	111
28397	0	112	0	0	0	112
28398	0	109	0	0	0	109
28399	0	114	0	0	0	114
28400	113	0	0	0	0	113
28401	114	0	0	0	0	114
28402	0	0	113	0	0	113
28403	0	0	111	0	0	111
28404	0	0	0	111	0	111
28405	0	0	0	111	0	111
28406	0	0	0	111	0	111
28407	111	0	0	0	0	111
28408	0	107	0	0	0	107
28409	0	99	0	0	0	99
28410	0	112	0	0	0	112
28411	109	0	0	0	0	109
28412	111	0	0	0	0	111
28413	1	0	0	110	0	111
28414	111	0	0	1	0	112
28415	115	0	0	0	0	115
28416	0	0	0	114	0	114
28417	117	0	0	0	0	117
28418	0	121	0	0	0	121
28419	0	0	0	123	0	123
28420	0	0	118	0	0	118
28421	0	122	0	1	0	123
28422	0	0	126	0	0	126
28423	0	0	0	122	0	122
28424	0	126	0	0	0	126
28425	0	0	0	121	0	121
28426	0	0	0	126	0	126
28427	0	0	119	0	0	119
28428	0	0	112	0	0	112
28429	0	0	0	126	0	126
28430	0	0	0	117	0	117
28431	0	122	0	0	0	122
28432	117	0	0	0	0	117
28433	0	112	0	0	0	112
28434	0	115	0	1	0	116
28435	0	0	102	0	0	102
28436	0	121	0	0	0	121
28437	0	0	0	115	0	115
28438	0	115	0	0	0	115
28439	0	0	0	107	0	107
28440	0	104	0	0	0	104
28441	105	0	0	0	0	105
28442	0	102	0	0	0	102
28443	0	0	0	98	0	98
28444	0	104	0	0	0	104
28445	100	0	0	0	0	100
28446	103	0	0	0	0	103
28447	0	97	0	0	0	97
28448	97	0	0	0	0	97
28449	0	5	0	98	0	103
28450	0	0	99	0	0	99
28451	0	0	96	0	0	96
28452	0	95	0	0	0	95
28453	95	0	0	0	0	95
28454	85	5	0	0	0	90
28455	0	0	86	0	0	86
28456	0	0	78	0	0	78
28457	82	0	0	0	0	82
28458	84	0	0	0	0	84
28459	0	0	86	0	0	86
28460	84	0	0	0	0	84
28461	0	81	0	0	0	81
28462	0	85	1	0	0	86
28463	0	0	0	85	0	85
28464	0	0	0	88	0	88
28465	89	0	0	0	0	89
28466	89	0	0	0	0	89
28467	86	0	0	0	0	86
28468	0	0	0	83	0	83
28469	0	0	0	82	0	82
28470	0	80	0	0	0	80
28471	0	80	0	0	0	80
28472	0	80	0	0	0	80
28473	0	0	0	84	0	84
28474	0	80	0	0	0	80
28475	0	0	84	0	0	84
28476	82	0	0	0	0	82
28477	0	0	85	0	0	85
28478	0	0	86	0	0	86
28479	83	0	0	1	0	84
28480	0	85	0	0	0	85
28481	85	0	0	0	0	85
28482	89	0	0	0	0	89
28483	0	0	86	0	0	86
28484	0	0	85	0	0	85
28485	0	80	0	0	0	80
28486	0	0	81	0	0	81
28487	0	0	0	81	0	81
28488	0	0	0	77	0	77
28489	0	81	0	0	0	81
28490	0	86	0	0	0	86
28491	89	0	0	0	0	89
28492	87	0	0	0	0	87
28493	0	0	0	87	0	87
28494	0	0	1	89	0	90
28495	86	0	0	0	0	86
28496	86	0	0	0	0	86
28497	0	88	0	0	0	88
28498	88	0	0	0	0	88
28499	0	87	0	0	0	87
28500	0	86	0	0	0	86
28501	87	0	0	0	0	87
28502	86	0	0	0	0	86
28503	0	0	0	86	0	86
28504	85	0	0	0	0	85
28505	0	0	80	0	0	80
28506	0	87	0	0	0	87
28507	83	0	0	0	0	83
28508	0	0	82	0	0	82
28509	0	0	0	83	0	83
28510	1	73	1	0	0	75
28511	0	80	0	0	0	80
28512	73	0	0	0	0	73
28513	0	0	66	0	0	66
28514	67	0	0	0	0	67
28515	0	0	0	68	0	68
28516	0	0	66	0	0	66
28517	68	0	0	0	0	68
28518	0	61	0	0	0	61
28519	0	63	0	0	0	63
28520	69	0	0	0	0	69
28521	68	0	0	0	0	68
28522	63	0	0	0	0	63
28523	0	0	0	65	0	65
28524	0	0	0	64	0	64
28525	0	0	64	0	0	64
28526	0	0	56	0	0	56
28527	0	59	0	0	0	59
28528	0	0	0	59	0	59
28529	55	0	0	0	0	55
28530	0	57	0	0	0	57
28531	0	0	0	58	0	58
28532	58	0	0	0	0	58
28533	0	58	0	0	0	58
28534	0	57	0	0	0	57
28535	0	0	55	0	0	55
28536	60	0	0	0	0	60
28537	59	0	0	0	0	59
28538	0	0	55	0	0	55
28539	54	0	0	0	0	54
28540	0	0	54	0	0	54
28541	0	53	0	0	0	53
28542	0	1	0	55	0	56
28543	54	0	0	0	0	54
28544	0	54	0	0	0	54
28545	0	56	0	0	0	56
28546	58	0	0	0	0	58
28547	0	0	55	0	0	55
28548	58	0	0	0	0	58
28549	0	57	0	0	0	57
28550	0	0	55	0	0	55
28551	55	0	0	0	0	55
28552	55	0	0	0	0	55
28553	0	0	0	55	0	55
28554	0	0	0	55	0	55
28555	0	55	0	0	0	55
28556	0	0	51	0	0	51
28557	0	0	0	52	0	52
28558	0	0	53	0	0	53
28559	0	0	55	0	0	55
28560	0	0	0	54	0	54
28561	0	0	54	0	0	54
28562	0	0	51	0	0	51
28563	0	0	0	52	0	52
28564	0	0	57	0	0	57
28565	54	0	0	0	0	54
28566	0	53	0	0	0	53
28567	0	0	51	0	0	51
28568	0	0	53	0	0	53
28569	0	0	0	52	0	52
28570	55	0	0	0	0	55
28571	54	0	0	0	0	54
28572	53	0	0	0	0	53
28573	52	0	0	0	0	52
28574	0	0	0	50	0	50
28575	0	0	48	0	0	48
28576	52	0	0	0	0	52
28577	54	0	0	0	0	54
28578	54	0	0	0	0	54
28579	0	0	52	0	0	52
28580	53	0	0	0	0	53
28581	0	0	0	53	0	53
28582	0	50	0	0	0	50
28583	0	0	0	53	0	53
28584	0	48	0	0	0	48
28585	45	0	0	0	0	45
28586	0	0	45	0	0	45
28587	0	0	0	44	0	44
28588	0	43	0	0	0	43
28589	0	45	0	0	0	45
28590	49	0	0	0	0	49
28591	50	0	0	0	0	50
28592	0	0	48	0	0	48
28593	52	0	0	0	0	52
28594	0	0	0	53	0	53
28595	0	0	51	0	0	51
28596	1	0	51	0	0	52
28597	0	0	0	53	0	53
28598	55	0	0	0	0	55
28599	0	0	0	56	0	56
28600	0	0	1	59	0	60
28601	0	0	0	59	0	59
28602	0	57	0	0	0	57
28603	0	0	0	60	0	60
28604	66	0	0	0	0	66
28605	0	71	0	0	0	71
28606	0	0	0	70	0	70
28607	65	0	0	0	0	65
28608	0	67	0	0	0	67
28609	0	63	0	0	0	63
28610	0	0	0	66	0	66
28611	64	0	0	0	0	64
28612	0	0	66	0	0	66
28613	1	0	67	0	0	68
28614	68	0	0	0	0	68
28615	68	0	0	0	0	68
28616	0	69	0	0	0	69
28617	0	0	0	70	0	70
28618	0	0	67	0	0	67
28619	0	0	69	0	0	69
28620	0	0	68	0	0	68
28621	0	70	0	0	0	70
28622	0	70	0	0	0	70
28623	74	0	0	0	0	74
28624	0	0	74	0	0	74
28625	75	0	0	0	0	75
28626	74	0	0	0	0	74
28627	0	0	75	0	0	75
28628	0	73	0	0	0	73
28629	0	0	0	71	0	71
28630	0	0	75	0	0	75
28631	0	0	72	0	0	72
28632	73	0	0	0	0	73
28633	0	80	0	0	0	80
28634	0	0	0	81	0	81
28635	0	0	0	77	0	77
28636	0	77	0	0	0	77
28637	0	77	1	0	0	78
28638	0	75	0	0	0	75
28639	0	0	0	75	0	75
28640	75	0	0	0	0	75
28641	0	0	0	76	0	76
28642	0	0	71	0	0	71
28643	0	0	76	0	0	76
28644	0	0	0	77	0	77
28645	0	0	76	0	0	76
28646	0	73	0	0	0	73
28647	0	0	0	78	0	78
28648	78	0	0	0	0	78
28649	77	0	0	0	0	77
28650	0	75	0	0	0	75
28651	81	0	0	0	0	81
28652	77	0	0	0	0	77
28653	80	0	0	0	0	80
28654	0	0	83	0	0	83
28655	83	0	0	0	0	83
28656	0	87	0	0	0	87
28657	0	0	81	1	0	82
28658	0	0	85	0	0	85
28659	0	88	0	0	0	88
28660	89	0	0	0	0	89
28661	0	4	0	82	0	86
28662	0	82	0	0	0	82
28663	83	0	0	0	0	83
28664	0	0	0	81	0	81
28665	83	0	0	0	0	83
28666	0	0	0	85	0	85
28667	0	0	85	0	0	85
28668	0	1	74	0	0	75
28669	0	0	75	0	0	75
28670	1	0	0	75	0	76
28671	0	0	0	79	0	79
28672	0	0	78	0	0	78
28673	0	81	0	0	0	81
28674	81	0	0	0	0	81
28675	89	0	0	0	0	89
28676	0	87	0	0	0	87
28677	0	0	0	92	0	92
28678	0	0	89	0	0	89
28679	90	0	0	0	0	90
28680	0	0	89	0	0	89
28681	0	0	82	0	0	82
28682	0	0	80	0	0	80
28683	88	0	0	0	0	88
28684	0	0	89	0	0	89
28685	0	77	0	0	0	77
28686	0	85	0	0	0	85
28687	0	0	0	83	0	83
28688	0	0	0	87	0	87
28689	0	0	79	0	0	79
28690	82	0	0	0	0	82
28691	81	0	0	0	0	81
28692	0	0	0	79	0	79
28693	77	0	0	0	0	77
28694	0	80	0	0	0	80
28695	75	0	0	0	0	75
28696	0	76	0	0	0	76
28697	0	71	0	0	0	71
28698	76	0	0	0	0	76
28699	73	0	0	0	0	73
28700	73	0	0	0	0	73
28701	73	0	0	0	0	73
28702	0	0	72	0	0	72
28703	74	0	0	0	0	74
28704	0	0	0	73	0	73
28705	0	69	0	0	0	69
28706	72	0	0	0	0	72
28707	0	72	0	0	0	72
28708	74	0	0	0	0	74
28709	0	0	0	72	0	72
28710	0	0	0	74	0	74
28711	0	0	75	0	0	75
28712	0	0	75	0	0	75
28713	0	73	0	0	0	73
28714	74	0	0	0	0	74
28715	0	71	0	0	0	71
28716	0	71	0	0	0	71
28717	0	75	0	0	0	75
28718	0	1	73	0	0	74
28719	0	75	0	0	0	75
28720	78	0	0	0	0	78
28721	77	0	0	0	0	77
28722	0	0	0	76	0	76
28723	0	77	0	0	0	77
28724	0	81	0	0	0	81
28725	0	0	0	81	0	81
28726	0	0	75	0	0	75
28727	0	77	0	0	0	77
28728	0	0	0	77	0	77
28729	79	0	0	0	0	79
28730	79	0	0	0	0	79
28731	0	81	0	0	0	81
28732	81	0	0	0	0	81
28733	82	0	0	0	0	82
28734	0	0	0	82	0	82
28735	0	0	83	0	0	83
28736	0	86	0	0	0	86
28737	0	0	0	90	0	90
28738	0	0	89	0	0	89
28739	1	89	0	0	0	90
28740	95	0	0	0	0	95
28741	91	0	0	0	0	91
28742	0	0	0	92	0	92
28743	0	97	0	0	0	97
28744	0	0	90	0	0	90
28745	0	0	0	97	0	97
28746	0	0	99	0	0	99
28747	0	95	0	0	0	95
28748	0	0	0	91	0	91
28749	90	0	0	0	0	90
28750	0	92	0	0	0	92
28751	93	0	0	0	0	93
28752	90	1	0	0	0	91
28753	0	91	0	0	0	91
28754	0	0	0	95	0	95
28755	0	0	0	95	0	95
28756	0	91	0	0	0	91
28757	0	93	0	0	0	93
28758	0	0	0	94	0	94
28759	0	96	0	0	0	96
28760	91	0	0	0	0	91
28761	95	0	0	0	0	95
28762	0	0	90	0	0	90
28763	0	0	88	0	0	88
28764	93	0	0	1	0	94
28765	92	0	0	0	0	92
28766	0	97	0	0	0	97
28767	93	0	0	0	0	93
28768	86	0	0	0	0	86
28769	0	89	0	0	0	89
28770	87	0	0	0	0	87
28771	0	0	0	87	0	87
28772	0	0	0	87	0	87
28773	0	0	86	0	0	86
28774	0	78	0	0	0	78
28775	0	86	0	0	0	86
28776	89	0	0	0	0	89
28777	88	0	0	0	0	88
28778	86	0	0	0	0	86
28779	87	0	0	0	0	87
28780	0	0	86	0	0	86
28781	0	0	81	0	0	81
28782	0	83	0	0	0	83
28783	0	0	0	86	0	86
28784	0	0	0	86	0	86
28785	0	87	0	0	0	87
28786	0	0	0	91	0	91
28787	91	0	0	0	0	91
28788	0	91	0	0	0	91
28789	0	0	87	0	0	87
28790	0	90	0	0	0	90
28791	88	0	0	0	0	88
28792	0	0	88	0	0	88
28793	94	0	0	0	0	94
28794	94	0	0	0	0	94
28795	0	0	92	0	0	92
28796	0	0	92	1	0	93
28797	0	0	85	0	0	85
28798	92	0	0	0	0	92
28799	0	0	88	0	0	88
28800	3	88	0	0	0	91
28801	88	0	0	0	0	88
28802	0	0	85	0	0	85
28803	87	0	0	0	0	87
28804	0	0	86	0	0	86
28805	1	0	86	0	0	87
28806	0	90	0	0	0	90
28807	0	0	86	0	0	86
28808	0	0	85	0	0	85
28809	0	71	0	3	0	74
28810	85	0	0	0	0	85
28811	0	1	79	0	0	80
28812	0	0	0	80	0	80
28813	0	80	0	0	0	80
28814	78	0	0	0	0	78
28815	76	0	0	0	0	76
28816	0	0	77	0	0	77
28817	0	77	0	0	0	77
28818	0	77	0	0	0	77
28819	0	0	0	80	0	80
28820	1	78	0	0	0	79
28821	0	0	0	77	0	77
28822	0	0	0	82	0	82
28823	0	80	0	0	0	80
28824	0	0	0	82	0	82
28825	0	79	0	0	0	79
28826	0	0	80	0	0	80
28827	0	0	0	81	0	81
28828	0	0	0	77	0	77
28829	0	75	0	0	0	75
28830	0	78	0	0	0	78
28831	0	0	0	77	0	77
28832	0	71	0	0	0	71
28833	71	0	0	0	0	71
28834	0	0	0	72	0	72
28835	0	75	0	0	0	75
28836	73	0	0	0	0	73
28837	0	78	0	0	0	78
28838	1	0	77	0	0	78
28839	0	0	0	71	0	71
28840	74	0	0	0	0	74
28841	0	0	75	0	0	75
28842	0	0	0	77	0	77
28843	0	74	0	0	0	74
28844	0	0	71	0	0	71
28845	0	79	0	0	0	79
28846	76	0	0	0	0	76
28847	75	0	0	0	0	75
28848	0	77	0	0	0	77
28849	75	0	0	0	0	75
28850	0	0	73	0	0	73
28851	0	0	0	72	0	72
28852	0	0	0	69	0	69
28853	0	78	0	0	0	78
28854	87	0	0	0	0	87
28855	94	0	0	0	0	94
28856	0	0	91	0	0	91
28857	91	0	0	0	0	91
28858	86	0	0	0	0	86
28859	81	0	0	0	0	81
28860	0	1	0	83	0	84
28861	0	0	0	80	0	80
28862	0	89	0	0	0	89
28863	86	0	0	0	0	86
28864	84	1	0	0	0	85
28865	0	88	0	0	0	88
28866	0	0	0	90	0	90
28867	0	89	0	0	0	89
28868	0	87	0	0	0	87
28869	89	0	0	0	0	89
28870	0	0	83	0	0	83
28871	0	0	81	0	0	81
28872	0	95	0	0	0	95
28873	93	1	0	0	0	94
28874	0	0	92	0	0	92
28875	0	85	0	0	0	85
28876	93	0	0	0	0	93
28877	0	0	92	0	0	92
28878	0	0	0	85	0	85
28879	91	0	0	0	0	91
28880	0	0	91	0	0	91
28881	0	0	83	0	0	83
28882	1	0	82	0	0	83
28883	0	0	83	0	0	83
28884	86	0	0	0	0	86
28885	81	0	0	0	0	81
28886	0	82	0	0	0	82
28887	0	0	0	83	0	83
28888	0	0	0	83	0	83
28889	0	80	0	0	0	80
28890	0	0	0	85	0	85
28891	0	83	0	0	0	83
28892	0	79	0	0	0	79
28893	0	0	0	83	0	83
28894	0	0	76	0	0	76
28895	0	87	0	0	0	87
28896	0	0	0	84	0	84
28897	82	0	0	0	0	82
28898	0	0	81	0	0	81
28899	82	0	0	0	0	82
28900	78	0	0	0	0	78
28901	0	0	0	83	0	83
28902	0	0	82	0	0	82
28903	0	0	83	0	0	83
28904	0	90	0	0	0	90
28905	0	0	0	90	0	90
28906	0	0	92	0	0	92
28907	0	0	85	0	0	85
28908	0	89	0	0	0	89
28909	90	0	0	0	0	90
28910	96	0	0	0	0	96
28911	0	0	0	95	0	95
28912	0	0	96	0	0	96
28913	0	0	95	0	0	95
28914	0	97	0	0	0	97
28915	0	0	91	0	0	91
28916	0	0	96	0	0	96
28917	0	0	2	95	0	97
28918	0	0	104	0	0	104
28919	103	0	0	0	0	103
28920	0	0	0	106	0	106
28921	0	0	115	0	0	115
28922	0	115	0	0	0	115
28923	0	0	0	118	0	118
28924	0	0	117	0	0	117
28925	0	111	1	0	0	112
28926	0	0	0	117	0	117
28927	0	115	0	0	0	115
28928	0	0	0	116	0	116
28929	0	0	0	117	0	117
28930	0	0	114	0	0	114
28931	0	113	0	0	0	113
28932	0	0	0	122	0	122
28933	0	0	0	120	0	120
28934	0	0	0	120	0	120
28935	0	0	117	0	0	117
28936	0	117	1	0	0	118
28937	0	0	0	114	0	114
28938	0	0	108	1	0	109
28939	0	106	0	0	0	106
28940	0	0	0	111	0	111
28941	0	1	110	0	0	111
28942	0	120	0	0	0	120
28943	0	0	0	122	0	122
28944	0	0	0	124	0	124
28945	0	0	120	0	0	120
28946	127	0	0	1	0	128
28947	0	121	0	0	0	121
28948	117	0	0	0	0	117
28949	0	0	115	0	0	115
28950	121	0	0	0	0	121
28951	0	0	0	121	0	121
28952	0	0	0	125	0	125
28953	0	0	130	0	0	130
28954	129	0	0	0	0	129
28955	127	0	0	0	0	127
28956	0	127	0	0	0	127
28957	0	127	0	0	0	127
28958	130	0	0	0	0	130
28959	0	0	126	0	0	126
28960	0	125	0	0	0	125
28961	0	0	0	133	0	133
28962	0	0	0	137	0	137
28963	0	0	131	0	0	131
28964	126	0	0	0	0	126
28965	0	0	127	0	0	127
28966	126	0	0	0	0	126
28967	0	0	120	0	0	120
28968	0	122	0	0	0	122
28969	125	0	0	0	0	125
28970	126	0	0	0	0	126
28971	128	0	0	0	0	128
28972	128	0	0	0	0	128
28973	0	0	0	123	0	123
28974	0	0	130	0	0	130
28975	0	0	0	124	0	124
28976	0	125	0	0	0	125
28977	0	0	0	126	0	126
28978	0	0	127	0	0	127
28979	0	0	125	0	0	125
28980	0	0	0	123	0	123
28981	129	0	0	0	0	129
28982	124	0	0	0	0	124
28983	125	0	0	0	0	125
28984	0	0	133	0	0	133
28985	0	0	129	1	0	130
28986	0	127	0	1	0	128
28987	0	135	0	0	0	135
28988	138	0	0	0	0	138
28989	132	0	0	0	0	132
28990	0	137	0	0	0	137
28991	138	0	0	0	0	138
28992	135	0	0	0	0	135
28993	0	133	0	0	0	133
28994	134	0	0	0	0	134
28995	130	0	0	0	0	130
28996	0	130	0	0	0	130
28997	133	0	0	0	0	133
28998	131	0	0	0	0	131
28999	0	0	129	0	0	129
29000	0	0	130	0	0	130
29001	0	118	0	0	0	118
29002	0	129	1	0	0	130
29003	138	0	0	0	0	138
29004	136	0	0	0	0	136
29005	133	0	0	0	0	133
29006	0	133	0	0	0	133
29007	0	0	0	139	0	139
29008	0	0	141	0	0	141
29009	0	0	0	129	0	129
29010	0	132	0	0	0	132
29011	132	0	0	0	0	132
29012	0	129	0	0	0	129
29013	0	0	0	123	0	123
29014	117	0	0	0	0	117
29015	120	0	0	0	0	120
29016	0	0	119	0	0	119
29017	122	0	0	0	0	122
29018	126	0	0	0	0	126
29019	125	0	0	0	0	125
29020	0	0	0	125	0	125
29021	0	135	0	0	0	135
29022	0	0	0	138	0	138
29023	0	0	140	0	0	140
29024	0	136	0	0	0	136
29025	0	0	0	133	0	133
29026	0	0	135	0	0	135
29027	0	135	0	0	0	135
29028	0	0	0	130	0	130
29029	0	0	134	0	0	134
29030	128	0	0	0	0	128
29031	0	0	139	0	0	139
29032	0	0	139	0	0	139
29033	0	140	0	0	0	140
29034	0	0	0	138	0	138
29035	0	0	0	125	0	125
29036	0	130	0	0	0	130
29037	0	0	0	133	0	133
29038	132	0	0	0	0	132
29039	129	0	0	0	0	129
29040	1	0	117	0	0	118
29041	126	0	0	0	0	126
29042	126	0	0	0	0	126
29043	0	0	114	0	0	114
29044	0	118	0	0	0	118
29045	0	115	0	0	0	115
29046	0	0	0	112	0	112
29047	0	115	0	0	0	115
29048	0	0	108	0	0	108
29049	0	0	113	0	0	113
29050	0	117	0	0	0	117
29051	123	0	0	0	0	123
29052	123	0	0	0	0	123
29053	121	0	0	0	0	121
29054	117	0	0	0	0	117
29055	116	0	0	0	0	116
29056	0	113	0	0	0	113
29057	2	0	113	0	0	115
29058	0	0	0	117	0	117
29059	118	0	0	0	0	118
29060	0	118	1	0	0	119
29061	0	0	0	118	0	118
29062	0	0	121	0	0	121
29063	0	114	0	0	0	114
29064	0	124	0	0	0	124
29065	125	0	1	0	0	126
29066	0	123	0	0	0	123
29067	0	0	0	125	0	125
29068	122	0	0	0	0	122
29069	121	0	0	0	0	121
29070	122	0	0	0	0	122
29071	0	0	123	0	0	123
29072	0	119	0	0	0	119
29073	121	0	0	0	0	121
29074	0	0	0	121	0	121
29075	126	0	0	0	0	126
29076	0	129	0	0	0	129
29077	123	0	0	0	0	123
29078	121	0	0	0	0	121
29079	0	0	0	121	0	121
29080	0	0	113	0	0	113
29081	0	0	0	120	0	120
29082	120	0	0	0	0	120
29083	122	0	0	0	0	122
29084	0	123	0	0	0	123
29085	125	0	0	0	0	125
29086	0	125	0	0	0	125
29087	123	1	0	0	0	124
29088	121	0	0	0	0	121
29089	1	0	118	0	0	119
29090	0	117	0	0	0	117
29091	0	0	0	122	0	122
29092	0	0	0	120	0	120
29093	0	0	0	115	0	115
29094	0	111	0	0	0	111
29095	0	0	109	0	0	109
29096	0	0	104	0	0	104
29097	0	113	0	0	0	113
29098	109	0	0	1	0	110
29099	0	0	105	0	0	105
29100	108	0	0	0	0	108
29101	0	110	0	0	0	110
29102	0	0	110	0	0	110
29103	0	0	0	110	0	110
29104	0	1	109	0	0	110
29105	0	0	116	0	0	116
29106	0	0	0	108	0	108
29107	0	106	0	0	0	106
29108	0	120	0	0	0	120
29109	113	0	0	0	0	113
29110	0	0	113	0	0	113
29111	107	0	0	0	0	107
29112	102	0	0	0	0	102
29113	0	102	0	0	0	102
29114	101	0	0	0	0	101
29115	96	0	0	0	0	96
29116	94	0	0	0	0	94
29117	0	92	0	0	0	92
29118	0	93	0	0	0	93
29119	0	102	0	0	0	102
29120	106	0	0	0	0	106
29121	105	0	0	0	0	105
29122	0	0	96	0	0	96
29123	0	0	98	0	0	98
29124	103	0	0	0	0	103
29125	102	0	0	0	0	102
29126	104	0	0	0	0	104
29127	0	0	0	104	0	104
29128	0	0	0	105	0	105
29129	0	0	0	105	0	105
29130	0	0	0	105	0	105
29131	0	0	101	0	0	101
29132	1	1	87	0	0	89
29133	0	0	95	0	0	95
29134	0	0	100	0	0	100
29135	104	0	1	0	0	105
29136	0	102	0	0	0	102
29137	0	108	0	0	0	108
29138	110	0	0	0	0	110
29139	1	0	109	0	0	110
29140	0	0	106	0	0	106
29141	111	0	0	0	0	111
29142	108	0	0	0	0	108
29143	0	114	0	0	0	114
29144	0	0	0	110	0	110
29145	114	0	0	0	0	114
29146	113	0	0	0	0	113
29147	0	0	0	115	0	115
29148	3	108	0	0	0	111
29149	123	0	0	0	0	123
29150	0	0	121	0	0	121
29151	121	0	0	0	0	121
29152	0	123	0	0	0	123
29153	119	0	0	0	0	119
29154	120	0	0	0	0	120
29155	0	0	117	0	0	117
29156	1	0	116	0	0	117
29157	126	0	0	0	0	126
29158	127	0	0	0	0	127
29159	0	125	0	0	0	125
29160	0	0	0	128	0	128
29161	0	0	126	0	0	126
29162	128	0	0	0	0	128
29163	0	0	0	120	0	120
29164	0	0	0	130	0	130
29165	129	0	0	0	0	129
29166	0	131	0	0	0	131
29167	129	0	0	0	0	129
29168	126	0	0	0	0	126
29169	123	0	0	0	0	123
29170	0	122	0	0	0	122
29171	127	0	0	0	0	127
29172	0	0	0	121	0	121
29173	0	0	0	123	0	123
29174	0	0	117	0	0	117
29175	0	0	104	0	0	104
29176	0	114	0	1	0	115
29177	0	114	0	0	0	114
29178	0	0	117	0	0	117
29179	0	117	0	0	0	117
29180	123	0	0	0	0	123
29181	117	0	0	0	0	117
29182	124	0	0	0	0	124
29183	0	0	0	117	0	117
29184	0	0	0	121	0	121
29185	0	0	129	0	0	129
29186	0	123	0	2	0	125
29187	130	0	0	0	0	130
29188	0	131	0	0	0	131
29189	131	0	0	0	0	131
29190	135	0	0	0	0	135
29191	0	0	0	131	0	131
29192	0	0	1	132	0	133
29193	0	0	0	133	0	133
29194	0	0	130	0	0	130
29195	0	139	0	0	0	139
29196	0	128	0	0	0	128
29197	0	121	1	0	0	122
29198	0	122	1	0	0	123
29199	0	122	0	0	0	122
29200	118	0	0	0	0	118
29201	0	0	113	0	0	113
29202	0	112	0	0	0	112
29203	0	0	107	0	0	107
29204	0	116	0	0	0	116
29205	0	0	0	111	0	111
29206	0	0	0	109	0	109
29207	0	112	0	0	0	112
29208	113	0	0	0	0	113
29209	0	0	105	0	0	105
29210	0	109	0	0	0	109
29211	0	0	109	0	0	109
29212	0	0	0	107	0	107
29213	0	0	0	110	0	110
29214	0	109	0	0	0	109
29215	0	0	0	113	0	113
29216	0	0	0	109	0	109
29217	0	107	0	0	0	107
29218	0	0	96	0	0	96
29219	0	0	97	0	0	97
29220	102	0	0	0	0	102
29221	105	0	0	0	0	105
29222	0	0	0	102	0	102
29223	0	0	106	0	0	106
29224	0	0	0	96	0	96
29225	0	101	0	0	0	101
29226	0	0	95	0	0	95
29227	0	96	0	0	0	96
29228	0	0	99	0	0	99
29229	0	101	0	0	0	101
29230	98	0	0	0	0	98
29231	0	0	1	97	0	98
29232	0	0	0	95	0	95
29233	0	0	97	0	0	97
29234	0	1	89	1	0	91
29235	0	94	0	0	0	94
29236	93	0	0	0	0	93
29237	0	0	1	93	0	94
29238	0	0	91	0	0	91
29239	0	0	89	0	0	89
29240	87	0	0	0	0	87
29241	87	0	0	0	0	87
29242	0	0	78	0	0	78
29243	0	0	0	72	0	72
29244	0	75	0	0	0	75
29245	70	0	0	0	0	70
29246	0	69	0	0	0	69
29247	70	0	0	0	0	70
29248	0	59	1	0	0	60
29249	0	61	0	0	0	61
29250	0	0	0	61	0	61
29251	0	0	0	62	0	62
29252	0	62	0	0	0	62
29253	0	0	61	0	0	61
29254	0	0	52	0	0	52
29255	0	0	61	0	0	61
29256	74	0	0	0	0	74
29257	72	0	0	0	0	72
29258	0	74	0	0	0	74
29259	0	0	72	0	0	72
29260	0	0	0	74	0	74
29261	0	0	74	0	0	74
29262	0	0	71	0	0	71
29263	0	0	0	73	0	73
29264	0	0	0	77	0	77
29265	0	0	117	0	0	117
29266	118	0	0	0	0	118
29267	0	120	0	0	0	120
29268	0	133	0	0	0	133
29269	0	0	0	131	0	131
29270	131	0	0	0	0	131
29271	0	139	0	0	0	139
29272	138	0	0	0	0	138
29273	0	139	0	0	0	139
29274	140	0	0	0	0	140
29275	0	0	142	0	0	142
29276	0	1	139	0	0	140
29277	0	0	0	142	0	142
29278	0	0	138	0	0	138
29279	0	128	0	0	0	128
29280	0	139	0	0	0	139
29281	136	0	0	0	0	136
29282	0	0	0	132	0	132
29283	2	125	0	0	0	127
29284	128	0	0	0	0	128
29285	127	0	0	0	0	127
29286	130	0	0	0	0	130
29287	0	0	0	131	0	131
29288	0	0	0	128	0	128
29289	0	0	132	0	0	132
29290	0	0	128	0	0	128
29291	129	0	0	0	0	129
29292	0	0	0	129	0	129
29293	0	0	123	0	0	123
29294	121	0	0	0	0	121
29295	0	123	0	0	0	123
29296	121	0	0	1	0	122
29297	126	0	0	0	0	126
29298	124	0	0	0	0	124
29299	0	0	123	0	0	123
29300	126	0	0	0	0	126
29301	0	0	0	121	0	121
29302	0	119	0	0	0	119
29303	0	129	0	0	0	129
29304	127	0	0	0	0	127
29305	123	0	0	0	0	123
29306	127	0	0	0	0	127
29307	0	0	0	126	0	126
29308	0	0	0	128	0	128
29309	0	0	0	123	0	123
29310	0	123	0	0	0	123
29311	130	0	0	0	0	130
29312	131	0	0	0	0	131
29313	132	0	0	0	0	132
29314	0	0	126	0	0	126
29315	132	0	0	0	0	132
29316	1	0	0	124	0	125
29317	0	126	0	0	0	126
29318	131	0	0	0	0	131
29319	128	0	0	0	0	128
29320	0	1	123	0	0	124
29321	1	0	0	121	0	122
29322	0	120	0	0	0	120
29323	128	0	0	0	0	128
29324	0	0	0	124	0	124
29325	0	0	0	115	0	115
29326	0	0	0	125	0	125
29327	0	0	0	125	0	125
29328	0	0	126	0	0	126
29329	0	120	0	0	0	120
29330	0	0	0	120	0	120
29331	0	0	132	0	0	132
29332	129	0	0	0	0	129
29333	131	0	0	0	0	131
29334	0	0	0	132	0	132
29335	135	0	0	0	0	135
29336	130	0	0	0	0	130
29337	0	0	135	0	0	135
29338	0	134	0	0	0	134
29339	138	0	0	0	0	138
29340	0	0	0	139	0	139
29341	139	0	0	0	0	139
29342	0	0	0	143	0	143
29343	0	0	0	127	0	127
29344	0	0	144	0	0	144
29345	135	0	0	0	0	135
29346	0	133	0	0	0	133
29347	0	0	136	0	0	136
29348	0	132	0	0	0	132
29349	127	0	0	0	0	127
29350	0	0	0	119	0	119
29351	118	0	0	1	0	119
29352	0	117	0	0	0	117
29353	115	0	0	0	0	115
29354	116	0	0	0	0	116
29355	116	0	0	0	0	116
29356	113	0	0	0	0	113
29357	0	111	0	0	0	111
29358	72	0	0	0	0	72
29359	0	0	0	62	0	62
29360	0	0	0	63	0	63
29361	0	54	0	0	0	54
29362	0	51	0	0	0	51
29363	0	45	0	0	0	45
29364	43	0	0	0	0	43
29365	0	40	0	0	0	40
29366	0	40	0	0	0	40
29367	37	0	0	0	0	37
29368	35	0	0	0	0	35
29369	0	37	0	0	0	37
29370	36	0	0	0	0	36
29371	1	0	31	0	0	32
29372	33	0	0	0	0	33
29373	0	0	32	0	0	32
29374	0	33	0	0	0	33
29375	0	31	0	0	0	31
29376	0	0	0	32	0	32
29377	31	0	0	0	0	31
29378	33	0	0	0	0	33
29379	32	0	0	0	0	32
29380	33	0	0	0	0	33
29381	32	0	0	0	0	32
29382	0	0	29	0	0	29
29383	0	0	29	0	0	29
29384	30	0	0	0	0	30
29385	0	30	0	0	0	30
29386	30	0	0	0	0	30
29387	30	0	0	0	0	30
29388	30	0	0	0	0	30
29389	29	0	0	0	0	29
29390	29	0	0	0	0	29
29391	0	0	30	0	0	30
29392	30	0	0	0	0	30
29393	29	0	0	0	0	29
29394	0	0	27	0	0	27
29395	28	0	0	0	0	28
29396	27	0	0	0	0	27
29397	0	0	26	0	0	26
29398	0	0	26	0	0	26
29399	0	23	0	0	0	23
29400	0	0	0	26	0	26
29401	0	0	23	0	0	23
29402	25	0	0	0	0	25
29403	0	0	0	25	0	25
29404	0	0	22	0	0	22
29405	22	0	0	0	0	22
29406	20	0	0	0	0	20
29407	22	0	0	0	0	22
29408	0	19	0	0	0	19
29409	0	0	0	21	0	21
29410	0	21	0	0	0	21
29411	22	0	0	0	0	22
29412	22	0	0	0	0	22
29413	0	0	18	0	0	18
29414	0	17	0	0	0	17
29415	0	20	0	0	0	20
29416	0	0	0	18	0	18
29417	0	0	0	21	0	21
29418	22	0	0	0	0	22
29419	0	22	0	0	0	22
29420	0	23	0	0	0	23
29421	0	0	17	0	0	17
29422	0	18	0	0	0	18
29423	16	0	0	0	0	16
29424	0	0	16	0	0	16
29425	15	0	0	0	0	15
29426	0	0	13	0	0	13
29427	15	0	0	0	0	15
29428	0	14	0	0	0	14
29429	15	0	0	0	0	15
29430	0	0	15	0	0	15
29431	13	0	0	0	0	13
29432	12	0	0	0	0	12
29433	0	0	9	0	0	9
29434	9	0	0	0	0	9
29435	9	0	0	0	0	9
29436	9	0	0	0	0	9
29437	0	11	0	0	0	11
29438	11	0	0	0	0	11
29439	0	0	9	0	0	9
29440	0	8	0	0	0	8
29441	9	0	0	0	0	9
29442	8	0	0	0	0	8
29443	10	0	0	0	0	10
29444	0	9	0	0	0	9
29445	0	0	0	9	0	9
29446	0	0	11	0	0	11
29447	0	0	0	11	0	11
29448	0	0	11	0	0	11
29449	11	0	0	0	0	11
29450	0	10	0	0	0	10
29451	0	0	0	11	0	11
29452	0	11	0	0	0	11
29453	0	0	0	11	0	11
29454	0	0	0	10	0	10
29455	0	11	0	0	0	11
29456	0	0	0	10	0	10
29457	0	0	0	11	0	11
29458	0	11	0	0	0	11
29459	0	11	0	0	0	11
29460	0	0	0	11	0	11
29461	0	0	10	0	0	10
29462	0	10	0	0	0	10
29463	0	0	0	11	0	11
29464	0	0	11	0	0	11
29465	0	11	0	0	0	11
29466	12	0	0	0	0	12
29467	0	0	12	0	0	12
29468	12	0	0	0	0	12
29469	0	0	0	12	0	12
29470	0	0	0	11	0	11
29471	0	0	0	12	0	12
29472	0	0	11	0	0	11
29473	0	0	13	0	0	13
29474	12	0	0	0	0	12
29475	0	0	0	13	0	13
29476	0	0	12	0	0	12
29477	12	0	0	0	0	12
29478	0	0	0	13	0	13
29479	0	0	0	13	0	13
29480	0	0	0	12	0	12
29481	0	12	0	0	0	12
29482	0	0	0	12	0	12
29483	0	13	0	0	0	13
29484	0	11	0	0	0	11
29485	14	0	0	0	0	14
29486	12	0	0	0	0	12
29487	14	0	0	0	0	14
29488	0	14	0	0	0	14
29489	14	0	0	0	0	14
29490	13	0	0	0	0	13
29491	0	0	0	14	0	14
29492	0	0	0	11	0	11
29493	0	0	13	0	0	13
29494	0	15	0	0	0	15
29495	15	0	0	0	0	15
29496	14	0	0	0	0	14
29497	0	13	0	0	0	13
29498	14	0	0	0	0	14
29499	12	0	0	0	0	12
29500	0	0	0	13	0	13
29501	0	10	0	0	0	10
29502	0	13	0	0	0	13
29503	14	0	0	0	0	14
29504	0	0	0	13	0	13
29505	0	0	17	0	0	17
29506	13	0	0	0	0	13
29507	0	0	16	0	0	16
29508	0	15	0	0	0	15
29509	17	0	0	0	0	17
29510	0	0	18	0	0	18
29511	0	0	0	13	0	13
29512	0	0	16	0	0	16
29513	0	17	0	0	0	17
29514	0	0	0	16	0	16
29515	0	0	17	0	0	17
29516	16	0	0	0	0	16
29517	0	17	0	0	0	17
29518	0	0	0	18	0	18
29519	0	16	0	0	0	16
29520	18	0	0	0	0	18
29521	18	0	0	0	0	18
29522	0	19	0	0	0	19
29523	0	0	0	20	0	20
29524	0	19	0	0	0	19
29525	20	0	0	0	0	20
29526	0	0	17	0	0	17
29527	0	0	17	0	0	17
29528	0	20	0	0	0	20
29529	0	20	0	0	0	20
29530	0	0	0	17	0	17
29531	19	0	0	0	0	19
29532	21	0	0	0	0	21
29533	20	0	0	0	0	20
29534	0	20	0	0	0	20
29535	0	0	0	18	0	18
29536	0	20	0	0	0	20
29537	19	0	0	0	0	19
29538	0	0	0	20	0	20
29539	0	0	16	0	0	16
29540	0	20	0	0	0	20
29541	16	0	0	0	0	16
29542	0	0	15	0	0	15
29543	16	0	0	0	0	16
29544	0	17	0	0	0	17
29545	0	19	0	0	0	19
29546	19	0	0	0	0	19
29547	0	18	0	0	0	18
29548	16	0	0	0	0	16
29549	0	17	0	0	0	17
29550	18	0	0	0	0	18
29551	18	0	0	0	0	18
29552	0	0	17	0	0	17
29553	0	0	15	0	0	15
29554	0	16	0	0	0	16
29555	18	0	0	0	0	18
29556	0	0	18	0	0	18
29557	17	0	0	0	0	17
29558	0	0	0	16	0	16
29559	0	0	16	0	0	16
29560	0	0	15	0	0	15
29561	0	0	18	0	0	18
29562	0	19	0	0	0	19
29563	0	0	0	20	0	20
29564	19	0	0	0	0	19
29565	0	0	0	20	0	20
29566	22	0	0	0	0	22
29567	0	0	0	23	0	23
29568	26	0	0	0	0	26
29569	26	0	0	0	0	26
29570	26	0	0	0	0	26
29571	0	24	0	0	0	24
29572	0	0	22	0	0	22
29573	0	0	0	26	0	26
29574	0	0	0	21	0	21
29575	0	0	0	26	0	26
29576	0	0	0	28	0	28
29577	0	29	0	0	0	29
29578	0	0	20	0	0	20
29579	0	26	0	0	0	26
29580	0	0	0	27	0	27
29581	0	0	0	27	0	27
29582	0	0	0	27	0	27
29583	0	0	0	27	0	27
29584	0	27	0	0	0	27
29585	0	27	0	0	0	27
29586	0	0	27	0	0	27
29587	0	0	0	27	0	27
29588	0	0	0	27	0	27
29589	0	0	0	28	0	28
29590	26	0	0	0	0	26
29591	0	24	0	0	0	24
29592	0	0	26	0	0	26
29593	26	0	0	0	0	26
29594	0	0	0	28	0	28
29595	27	0	0	0	0	27
29596	0	0	0	28	0	28
29597	27	0	0	0	0	27
29598	0	0	0	27	0	27
29599	27	0	0	0	0	27
29600	0	0	24	0	0	24
29601	0	0	0	25	0	25
29602	0	26	0	0	0	26
29603	0	0	0	26	0	26
29604	25	0	0	0	0	25
29605	0	23	0	0	0	23
29606	0	0	0	23	0	23
29607	0	24	0	0	0	24
29608	0	0	0	24	0	24
29609	0	0	0	24	0	24
29610	0	0	23	0	0	23
29611	0	0	0	23	0	23
29612	0	0	21	0	0	21
29613	0	21	0	0	0	21
29614	22	0	0	0	0	22
29615	0	0	22	0	0	22
29616	22	0	0	0	0	22
29617	22	0	0	0	0	22
29618	0	0	0	21	0	21
29619	0	0	21	0	0	21
29620	21	0	0	0	0	21
29621	22	0	0	0	0	22
29622	0	0	0	22	0	22
29623	0	0	0	22	0	22
29624	0	19	0	0	0	19
29625	0	0	0	23	0	23
29626	0	21	0	0	0	21
29627	0	0	24	0	0	24
29628	0	0	0	23	0	23
29629	24	0	0	0	0	24
29630	24	0	0	0	0	24
29631	0	21	0	0	0	21
29632	0	0	0	24	0	24
29633	24	0	0	0	0	24
29634	0	24	0	0	0	24
29635	24	0	0	0	0	24
29636	0	0	0	24	0	24
29637	23	0	0	0	0	23
29638	0	0	18	0	0	18
29639	0	20	0	0	0	20
29640	20	0	0	0	0	20
29641	0	21	0	0	0	21
29642	21	0	0	0	0	21
29643	24	0	0	0	0	24
29644	0	0	24	0	0	24
29645	0	0	0	23	0	23
29646	24	0	0	0	0	24
29647	0	0	24	0	0	24
29648	25	0	0	0	0	25
29649	0	0	0	25	0	25
29650	0	0	24	0	0	24
29651	0	0	0	24	0	24
29652	24	0	0	0	0	24
29653	0	0	24	0	0	24
29654	0	0	0	27	0	27
29655	0	0	0	27	0	27
29656	28	0	0	0	0	28
29657	27	0	0	0	0	27
29658	0	27	0	0	0	27
29659	0	0	0	26	0	26
29660	0	0	0	25	0	25
29661	0	0	0	24	0	24
29662	23	0	0	0	0	23
29663	23	0	0	0	0	23
29664	0	0	0	24	0	24
29665	0	24	0	0	0	24
29666	0	0	0	22	0	22
29667	0	23	0	0	0	23
29668	25	0	0	0	0	25
29669	0	24	0	0	0	24
29670	25	0	3	0	0	28
29671	0	0	0	26	0	26
29672	28	0	0	0	0	28
29673	0	0	27	0	0	27
29674	0	28	0	0	0	28
29675	25	3	0	0	0	28
29676	24	0	0	0	0	24
29677	0	0	0	28	0	28
29678	0	29	0	0	0	29
29679	0	0	0	28	0	28
29680	0	0	0	28	0	28
29681	0	0	0	27	0	27
29682	25	0	0	0	0	25
29683	27	0	0	0	0	27
29684	0	0	0	27	0	27
29685	0	27	0	0	0	27
29686	25	0	0	0	0	25
29687	0	0	24	0	0	24
29688	0	0	0	25	0	25
29689	0	0	24	0	0	24
29690	0	0	0	22	0	22
29691	0	0	26	0	0	26
29692	0	0	0	27	0	27
29693	26	0	0	0	0	26
29694	27	0	0	0	0	27
29695	0	25	0	0	0	25
29696	27	0	0	0	0	27
29697	0	0	0	27	0	27
29698	0	0	0	27	0	27
29699	27	0	0	0	0	27
29700	0	0	23	0	0	23
29701	0	0	26	0	0	26
29702	0	0	26	0	0	26
29703	29	0	0	0	0	29
29704	0	0	28	0	0	28
29705	0	0	29	0	0	29
29706	24	0	0	0	0	24
29707	0	26	0	0	0	26
29708	0	0	0	30	0	30
29709	0	0	0	28	0	28
29710	0	0	30	0	0	30
29711	29	0	0	0	0	29
29712	31	0	0	0	0	31
29713	30	0	0	0	0	30
29714	0	0	30	0	0	30
29715	31	0	0	0	0	31
29716	0	0	27	0	0	27
29717	0	27	0	0	0	27
29718	0	27	0	0	0	27
29719	28	0	0	0	0	28
29720	0	28	0	0	0	28
29721	0	28	0	0	0	28
29722	28	0	0	0	0	28
29723	0	26	0	0	0	26
29724	25	0	0	0	0	25
29725	0	0	0	28	0	28
29726	0	0	0	28	0	28
29727	0	0	0	27	0	27
29728	0	0	0	28	0	28
29729	0	26	0	0	0	26
29730	28	0	0	0	0	28
29731	0	27	0	0	0	27
29732	0	22	0	0	0	22
29733	0	0	22	0	0	22
29734	22	0	0	0	0	22
29735	0	0	21	0	0	21
29736	0	0	18	0	0	18
29737	0	26	0	0	0	26
29738	0	24	0	0	0	24
29739	24	0	0	0	0	24
29740	0	25	0	0	0	25
29741	0	0	23	0	0	23
29742	0	24	0	0	0	24
29743	0	0	26	0	0	26
29744	0	0	25	0	0	25
29745	26	0	0	0	0	26
29746	0	0	26	0	0	26
29747	0	0	0	19	0	19
29748	21	0	0	0	0	21
29749	0	21	0	0	0	21
29750	0	0	21	0	0	21
29751	19	0	0	0	0	19
29752	0	0	0	20	0	20
29753	0	20	0	0	0	20
29754	0	0	21	0	0	21
29755	21	0	0	0	0	21
29756	0	0	20	0	0	20
29757	0	0	0	20	0	20
29758	0	0	21	0	0	21
29759	0	0	0	21	0	21
29760	21	0	0	0	0	21
29761	0	21	0	0	0	21
29762	21	0	0	0	0	21
29763	0	0	21	0	0	21
29764	0	0	0	21	0	21
29765	0	0	23	0	0	23
29766	22	0	0	0	0	22
29767	22	0	0	0	0	22
29768	0	22	0	0	0	22
29769	23	0	0	0	0	23
29770	19	0	1	0	0	20
29771	0	0	0	21	0	21
29772	0	0	22	0	0	22
29773	0	22	0	0	0	22
29774	0	0	0	22	0	22
29775	22	0	0	0	0	22
29776	0	0	20	0	0	20
29777	0	0	22	0	0	22
29778	0	0	22	0	0	22
29779	25	0	0	0	0	25
29780	0	0	26	0	0	26
29781	26	0	0	0	0	26
29782	0	1	22	0	0	23
29783	0	25	0	0	0	25
29784	0	0	0	23	0	23
29785	0	0	23	0	0	23
29786	0	21	0	0	0	21
29787	0	24	0	0	0	24
29788	0	0	0	24	0	24
29789	23	0	0	0	0	23
29790	0	0	0	24	0	24
29791	24	0	0	0	0	24
29792	0	0	1	23	0	24
29793	0	0	24	0	0	24
29794	0	0	24	0	0	24
29795	22	0	0	0	0	22
29796	24	0	0	0	0	24
29797	0	0	23	0	0	23
29798	24	0	0	0	0	24
29799	0	0	24	0	0	24
29800	0	16	0	0	0	16
29801	0	15	0	0	0	15
29802	0	17	0	0	0	17
29803	0	0	0	18	0	18
29804	20	0	0	0	0	20
29805	20	0	0	0	0	20
29806	0	0	0	20	0	20
29807	0	0	20	0	0	20
29808	0	0	0	20	0	20
29809	0	0	20	0	0	20
29810	0	0	0	18	0	18
29811	17	0	0	0	0	17
29812	16	0	0	0	0	16
29813	18	0	0	0	0	18
29814	18	0	0	0	0	18
29815	0	0	0	15	0	15
29816	0	0	0	18	0	18
29817	18	0	0	0	0	18
29818	18	0	0	0	0	18
29819	0	0	0	17	0	17
29820	0	0	0	18	0	18
29821	0	0	0	18	0	18
29822	0	0	0	16	0	16
29823	18	0	0	0	0	18
29824	0	0	18	0	0	18
29825	0	0	0	18	0	18
29826	17	0	0	0	0	17
29827	0	0	16	0	0	16
29828	0	0	0	17	0	17
29829	0	0	16	0	0	16
29830	0	10	0	0	0	10
29831	0	0	0	11	0	11
29832	9	0	0	0	0	9
29833	0	0	0	11	0	11
29834	0	10	0	0	0	10
29835	0	9	0	0	0	9
29836	0	8	0	0	0	8
29837	0	10	0	0	0	10
29838	7	0	0	0	0	7
29839	0	0	0	7	0	7
29840	0	0	7	0	0	7
29841	0	0	0	7	0	7
29842	0	0	5	0	0	5
29843	6	0	0	0	0	6
29844	0	0	0	7	0	7
29845	0	0	0	7	0	7
29846	0	0	0	6	0	6
29847	0	0	0	7	0	7
29848	7	0	0	0	0	7
29849	6	0	0	0	0	6
29850	0	0	0	7	0	7
29851	7	0	0	0	0	7
29852	0	0	6	0	0	6
29853	0	5	0	0	0	5
29854	0	0	0	7	0	7
29855	0	0	0	7	0	7
29856	0	6	0	0	0	6
29857	0	0	0	4	0	4
29858	0	0	0	5	0	5
29859	5	0	0	0	0	5
29860	0	0	5	0	0	5
29861	0	0	4	0	0	4
29862	4	0	0	0	0	4
29863	0	0	4	0	0	4
29864	1	0	0	0	0	1
29865	4	0	0	0	0	4
29866	0	0	0	4	0	4
29867	0	0	5	0	0	5
29868	4	0	0	0	0	4
29869	0	4	0	0	0	4
29870	5	0	0	0	0	5
29871	4	0	0	0	0	4
29872	1	0	0	0	0	1
29873	1	0	0	0	0	1
29874	1	0	0	0	0	1
29875	1	0	0	0	0	1
29876	1	0	0	0	0	1
29877	1	0	0	0	0	1
29878	1	0	0	0	0	1
29879	1	0	0	0	0	1
29880	1	0	0	0	0	1
29881	1	0	0	0	0	1
29882	1	0	0	0	0	1
29883	1	0	0	0	0	1
29884	1	0	0	0	0	1
29885	1	0	0	0	0	1
29886	1	0	0	0	0	1
29887	1	0	0	0	0	1
29888	1	0	0	0	0	1
29889	1	0	0	0	0	1
29890	1	0	0	0	0	1
29891	1	0	0	0	0	1
29892	1	0	0	0	0	1
29893	1	0	0	0	0	1
29894	1	0	0	0	0	1
29895	1	0	0	0	0	1
29896	1	0	0	0	0	1
