Pos	A	C	G	T	Other	Total
0	0	0	0	0	0
1	0	0	0	0	0
2	0	0	0	0	0
3	0	0	0	0	0
4	1	0	0	0	0	1
5	1	0	0	0	0	1
6	0	0	6	0	0	6
7	0	0	33	0	0	33
8	0	0	0	33	0	33
9	0	0	0	33	0	33
10	0	0	0	35	0	35
11	2	0	0	35	0	37
12	0	0	0	45	0	45
13	48	0	0	0	0	48
14	0	53	0	0	0	53
15	0	59	0	0	0	59
16	0	0	0	65	0	65
17	0	0	0	68	0	68
18	0	77	0	0	0	77
19	0	87	0	0	0	87
20	0	87	0	0	0	87
21	87	0	0	0	0	87
22	0	0	115	0	0	115
23	0	0	156	0	0	156
24	0	0	0	162	0	162
25	161	0	1	0	0	162
26	161	0	0	0	0	161
27	0	169	0	0	0	169
28	169	2	0	0	0	171
29	174	0	0	0	0	174
30	174	0	0	0	0	174
31	0	184	0	0	0	184
32	0	183	0	0	0	183
33	186	0	0	0	0	186
34	195	0	0	0	0	195
35	0	194	0	0	0	194
36	0	197	0	0	0	197
37	196	0	0	0	0	196
38	207	0	0	0	0	207
39	0	214	0	2	0	216
40	0	0	0	225	0	225
41	0	1	0	227	0	228
42	0	0	0	227	0	227
43	0	234	0	0	0	234
44	0	0	235	0	0	235
45	244	0	0	0	0	244
46	0	0	0	246	0	246
47	0	264	0	0	0	264
48	0	0	0	261	0	261
49	0	335	0	0	0	335
50	0	0	0	337	0	337
51	0	1	0	343	0	344
52	0	0	350	0	0	350
53	0	1	0	352	0	353
54	351	0	0	0	0	351
55	0	0	357	0	0	357
56	364	0	1	0	0	365
57	0	5	0	370	0	375
58	0	377	0	0	0	377
59	0	2	0	404	0	406
60	0	0	416	0	0	416
61	0	0	0	423	0	423
62	0	5	0	420	0	425
63	0	433	0	0	0	433
64	5	0	0	427	0	432
65	0	444	0	0	0	444
66	0	1	0	442	0	443
67	444	0	0	0	0	444
68	439	0	1	0	0	440
69	442	0	0	0	0	442
70	0	445	0	0	0	445
71	0	0	445	0	0	445
72	459	0	0	0	0	459
73	463	0	1	0	0	464
74	0	499	0	0	0	499
75	0	0	0	496	0	496
76	0	5	0	499	0	504
77	0	0	0	502	0	502
78	501	0	3	0	0	504
79	510	0	0	0	0	510
80	505	0	1	0	0	506
81	516	0	1	0	0	517
82	0	0	0	516	0	516
83	0	494	0	0	0	494
84	0	2	0	490	0	492
85	0	0	501	0	0	501
86	0	0	0	504	0	504
87	0	0	499	0	0	499
88	1	2	0	491	0	494
89	0	0	486	0	0	486
90	0	0	486	0	0	486
91	0	461	0	0	0	461
92	0	0	0	464	0	464
93	0	0	473	0	0	473
94	0	0	0	482	0	482
95	0	479	0	2	0	481
96	481	0	1	1	0	483
97	0	420	0	0	0	420
98	0	0	1	413	0	414
99	0	418	0	0	0	418
100	0	0	412	0	0	412
101	1	0	422	0	0	423
102	0	416	0	0	0	416
103	0	2	0	417	0	419
104	0	0	418	0	0	418
105	0	428	0	0	0	428
106	435	0	0	0	0	435
107	0	1	0	444	0	445
108	1	0	451	0	0	452
109	0	449	0	0	0	449
110	0	0	0	453	0	453
111	0	0	0	457	0	457
112	453	0	1	0	0	454
113	0	0	470	0	0	470
114	0	2	0	459	0	461
115	0	0	453	0	0	453
116	1	459	0	0	0	460
117	452	0	0	0	0	452
118	0	466	0	0	0	466
119	0	0	0	453	0	453
120	0	456	0	0	0	456
121	460	0	2	0	0	462
122	0	441	0	0	0	441
123	0	0	441	0	0	441
124	0	403	0	0	0	403
125	400	0	0	0	0	400
126	2	0	515	0	0	517
127	0	0	0	513	0	513
128	514	0	0	0	0	514
129	0	0	0	515	0	515
130	512	0	1	0	0	513
131	551	0	1	0	0	552
132	0	0	0	554	0	554
133	0	0	0	540	0	540
134	536	0	0	0	0	536
135	497	0	1	0	0	498
136	0	1	0	505	0	506
137	502	0	0	0	0	502
138	518	0	1	1	0	520
139	0	519	0	0	0	519
140	0	0	0	507	0	507
141	526	0	0	0	0	526
142	524	0	1	0	0	525
143	0	0	0	536	0	536
144	0	1	0	536	0	537
145	533	0	1	0	0	534
146	0	514	0	0	0	514
147	0	1	0	498	0	499
148	0	0	513	0	0	513
149	0	0	0	514	0	514
150	0	511	0	0	0	511
151	0	0	515	0	0	515
152	0	1	0	516	0	517
153	0	1	0	513	0	514
154	0	0	518	0	0	518
155	515	0	1	0	0	516
156	0	510	0	2	0	512
157	505	0	0	0	0	505
158	0	0	512	0	0	512
159	0	0	504	0	0	504
160	503	0	11	0	0	514
161	0	511	0	2	0	513
162	526	0	0	0	0	526
163	0	548	0	0	0	548
164	0	0	556	0	0	556
165	560	0	1	0	0	561
166	0	0	562	0	0	562
167	0	0	0	569	0	569
168	562	0	0	0	0	562
169	557	0	2	0	0	559
170	0	562	0	0	0	562
171	0	0	0	555	0	555
172	0	565	0	0	0	565
173	0	0	571	0	0	571
174	1	2	0	583	0	586
175	0	576	0	0	0	576
176	0	5	0	573	0	578
177	599	0	0	1	0	600
178	0	2	0	593	0	595
179	0	612	0	0	0	612
180	0	5	0	607	0	612
181	0	0	0	624	0	624
182	0	589	0	0	0	589
183	0	0	0	589	0	589
184	0	0	583	0	0	583
185	0	586	0	1	0	587
186	579	0	1	0	0	580
187	2	0	576	0	0	578
188	0	0	566	1	0	567
189	0	546	0	0	0	546
190	0	0	0	547	0	547
191	0	0	570	1	0	571
192	0	576	0	0	0	576
193	0	0	0	596	0	596
194	0	0	0	599	0	599
195	599	0	0	0	0	599
196	0	591	0	0	0	591
197	0	0	592	0	0	592
198	0	0	602	0	0	602
199	0	0	0	617	0	617
200	1	4	0	587	0	592
201	0	1	0	591	0	592
202	0	475	0	0	0	475
203	1	0	477	0	0	478
204	0	1	0	469	0	470
205	0	483	0	1	0	484
206	1	435	0	1	0	437
207	0	0	451	0	0	451
208	0	2	0	453	0	455
209	0	0	450	0	0	450
210	0	1	0	469	0	470
211	0	0	0	467	0	467
212	0	0	454	0	0	454
213	0	437	0	1	0	438
214	438	0	1	0	0	439
215	0	0	428	0	0	428
216	1	408	0	0	0	409
217	0	410	0	0	0	410
218	1	0	413	0	0	414
219	421	0	0	0	0	421
220	0	6	0	415	0	421
221	0	429	0	1	0	430
222	432	0	0	0	0	432
223	1	1	0	434	0	436
224	0	420	0	0	0	420
225	419	0	0	0	0	419
226	0	0	426	0	0	426
227	1	427	0	2	0	430
228	432	0	1	0	0	433
229	0	451	0	0	0	451
230	452	0	0	0	0	452
231	0	3	0	472	0	475
232	0	479	0	0	0	479
233	0	0	0	474	0	474
234	475	0	0	0	0	475
235	0	1	477	0	0	478
236	0	0	486	0	0	486
237	0	0	0	503	0	503
238	0	0	0	495	0	495
239	0	1	0	478	0	479
240	0	464	0	1	0	465
241	0	0	480	0	0	480
242	0	0	0	479	0	479
243	0	471	0	0	0	471
244	0	466	0	0	0	466
245	0	0	475	1	0	476
246	0	0	478	0	0	478
247	1	0	485	0	0	486
248	0	0	1	478	0	479
249	0	0	473	0	0	473
250	0	0	0	463	0	463
251	0	0	463	0	0	463
252	468	0	0	2	0	470
253	0	453	0	0	0	453
254	0	434	0	0	0	434
255	0	0	432	0	0	432
256	460	0	0	0	0	460
257	446	0	1	0	0	447
258	456	0	2	0	0	458
259	0	0	482	0	0	482
260	0	0	517	0	0	517
261	0	0	0	514	0	514
262	517	0	0	0	0	517
263	511	0	1	0	0	512
264	0	0	526	0	0	526
265	540	0	0	0	0	540
266	1	0	0	542	0	543
267	0	0	516	0	0	516
268	0	0	510	0	0	510
269	486	1	1	0	0	488
270	0	0	492	0	0	492
271	484	0	2	0	0	486
272	0	0	503	0	0	503
273	0	506	0	0	0	506
274	0	503	0	0	0	503
275	0	0	0	512	0	512
276	0	0	0	523	0	523
277	1	0	516	0	0	517
278	0	2	0	525	0	527
279	0	539	0	0	0	539
280	0	536	1	0	0	537
281	0	509	0	1	0	510
282	0	1	0	509	0	510
283	0	0	518	0	0	518
284	0	0	522	0	0	522
285	1	1	0	520	0	522
286	0	0	0	527	0	527
287	0	3	0	526	0	529
288	0	525	0	0	0	525
289	528	0	0	0	0	528
290	538	0	3	0	0	541
291	0	535	0	2	0	537
292	0	0	539	0	0	539
293	529	0	4	0	0	533
294	0	1	543	0	0	544
295	525	0	2	0	0	527
296	535	0	1	0	0	536
297	529	0	2	0	0	531
298	563	0	2	0	0	565
299	0	568	0	0	0	568
300	569	0	0	1	0	570
301	0	560	0	1	0	561
302	550	0	1	0	0	551
303	0	570	0	0	0	570
304	2	0	584	0	0	586
305	0	0	0	561	0	561
306	0	526	0	0	0	526
307	0	534	0	0	0	534
308	567	0	1	1	0	569
309	581	0	0	0	0	581
310	0	582	0	1	0	583
311	0	3	0	576	0	579
312	0	588	0	0	0	588
313	555	0	2	0	0	557
314	0	0	563	0	0	563
315	0	0	0	592	0	592
316	0	2	0	586	0	588
317	0	0	0	575	0	575
318	1	0	575	0	0	576
319	1	572	0	0	0	573
320	0	560	0	0	0	560
321	0	0	0	559	0	559
322	0	0	597	0	0	597
323	0	1	0	604	0	605
324	0	0	0	621	0	621
325	0	6	0	610	0	616
326	0	0	0	627	0	627
327	625	0	0	0	0	625
328	0	615	0	0	0	615
329	599	0	4	0	0	603
330	0	0	620	0	0	620
331	4	0	610	0	0	614
332	0	0	0	657	0	657
333	0	1	0	664	0	665
334	0	630	0	0	0	630
335	1	0	628	0	0	629
336	0	606	0	3	0	609
337	1	0	611	0	0	612
338	606	0	2	0	0	608
339	0	603	0	0	0	603
340	2	0	602	0	0	604
341	0	2	0	597	0	599
342	0	0	592	0	0	592
343	0	595	0	0	0	595
344	0	0	0	589	0	589
345	0	600	0	0	0	600
346	0	0	606	0	0	606
347	0	5	0	615	0	620
348	602	0	0	0	0	602
349	0	583	0	0	0	583
350	0	0	572	0	0	572
351	0	33	0	533	0	566
352	0	0	552	0	0	552
353	1	0	588	0	0	589
354	0	576	0	0	0	576
355	2	3	0	578	0	583
356	0	0	0	584	0	584
357	0	0	0	589	0	589
358	0	0	594	0	0	594
359	0	0	593	0	0	593
360	584	0	1	0	0	585
361	0	0	590	0	0	590
362	580	0	0	0	0	580
363	0	581	0	0	0	581
364	0	0	0	573	0	573
365	0	601	0	0	0	601
366	0	594	0	0	0	594
367	0	0	607	0	0	607
368	0	0	0	605	0	605
369	1	0	595	0	0	596
370	0	0	593	0	0	593
371	588	0	0	0	0	588
372	0	0	586	0	0	586
373	0	0	579	0	0	579
374	547	0	0	0	0	547
375	0	0	563	0	0	563
376	0	0	582	0	0	582
377	0	2	0	584	0	586
378	0	556	0	1	0	557
379	0	1	0	550	0	551
380	0	0	0	588	0	588
381	593	0	0	0	0	593
382	0	6	0	586	0	592
383	0	588	0	0	0	588
384	539	0	1	0	0	540
385	0	0	527	0	0	527
386	532	0	2	0	0	534
387	2	0	538	0	0	540
388	2	0	531	0	0	533
389	0	496	0	0	0	496
390	507	0	3	0	0	510
391	0	523	0	1	0	524
392	0	0	527	0	0	527
393	1	2	0	522	0	525
394	0	535	0	0	0	535
395	561	0	0	0	0	561
396	578	0	0	0	0	578
397	0	561	0	0	0	561
398	600	0	3	0	0	603
399	0	4	0	628	0	632
400	0	635	0	0	0	635
401	0	3	0	627	0	630
402	0	0	0	632	0	632
403	636	0	2	0	0	638
404	639	0	0	0	0	639
405	644	0	2	0	0	646
406	0	0	637	0	0	637
407	595	0	0	0	0	595
408	0	0	0	574	0	574
409	2	0	560	0	0	562
410	0	0	561	0	0	561
411	0	563	0	0	0	563
412	566	0	3	0	0	569
413	0	580	0	0	0	580
414	0	5	0	569	0	574
415	0	0	0	576	0	576
416	0	0	571	0	0	571
417	0	1	0	564	0	565
418	0	0	565	0	0	565
419	0	0	575	0	0	575
420	0	564	0	0	0	564
421	0	1	0	553	0	554
422	0	0	0	559	0	559
423	567	0	0	0	0	567
424	1	0	573	0	0	574
425	0	0	0	579	0	579
426	574	0	0	0	0	574
427	0	0	569	0	0	569
428	557	0	1	0	0	558
429	532	0	1	0	0	533
430	0	0	544	0	0	544
431	0	0	0	541	0	541
432	0	0	0	541	0	541
433	0	0	545	0	0	545
434	538	0	3	0	0	541
435	550	0	0	1	0	551
436	556	0	0	0	0	556
437	551	1	1	0	0	553
438	550	0	2	0	0	552
439	1	0	541	0	0	542
440	0	0	542	0	0	542
441	0	535	0	0	0	535
442	0	0	534	0	0	534
443	0	0	0	548	0	548
444	0	1	0	546	0	547
445	0	1	0	563	0	564
446	0	3	0	602	0	605
447	2	0	600	0	0	602
448	0	612	0	0	0	612
449	0	597	0	0	0	597
450	2	6	0	586	0	594
451	0	587	0	0	0	587
452	621	0	0	0	0	621
453	622	0	10	0	0	632
454	0	607	0	0	0	607
455	0	1	0	607	0	608
456	0	0	0	600	0	600
457	0	0	609	0	0	609
458	618	0	0	0	0	618
459	616	0	1	0	0	617
460	0	621	0	0	0	621
461	573	0	12	0	0	585
462	0	0	648	0	0	648
463	0	670	0	0	0	670
464	1	669	0	1	0	671
465	0	674	0	0	0	674
466	1	0	0	660	0	661
467	662	0	0	0	0	662
468	0	0	0	670	0	670
469	0	0	679	0	0	679
470	0	2	0	672	0	674
471	0	0	649	1	0	650
472	0	2	0	636	0	638
473	0	2	0	625	0	627
474	1	558	0	0	0	559
475	565	0	1	0	0	566
476	0	2	0	541	0	543
477	0	552	0	0	0	552
478	552	0	0	1	0	553
479	555	0	1	0	0	556
480	574	0	1	0	0	575
481	0	561	0	0	0	561
482	0	0	560	0	0	560
483	0	2	0	569	0	571
484	0	0	0	573	0	573
485	0	583	0	0	0	583
486	0	0	584	0	0	584
487	0	0	579	0	0	579
488	584	0	0	0	0	584
489	0	0	0	595	0	595
490	1	0	591	1	0	593
491	0	623	0	1	0	624
492	0	12	2	602	0	616
493	1	624	0	0	0	625
494	2	0	621	0	0	623
495	617	0	0	0	0	617
496	617	0	2	0	0	619
497	0	614	0	0	0	614
498	0	0	0	615	0	615
499	0	0	615	0	0	615
500	0	619	0	0	0	619
501	626	0	0	0	0	626
502	0	653	0	0	0	653
503	1	645	0	0	0	646
504	0	1	0	638	0	639
505	0	651	0	0	0	651
506	648	0	0	0	0	648
507	0	2	0	646	0	648
508	0	0	645	0	0	645
509	0	0	675	1	0	676
510	0	4	0	676	0	680
511	0	668	0	1	0	669
512	674	0	0	0	0	674
513	0	3	0	733	0	736
514	1	0	749	0	0	750
515	1	0	0	761	0	762
516	0	0	0	759	0	759
517	757	0	0	0	0	757
518	1	2	0	733	0	736
519	0	0	728	0	0	728
520	0	0	738	0	0	738
521	0	1	1	761	0	763
522	0	1	0	714	0	715
523	0	0	706	0	0	706
524	680	0	0	0	0	680
525	0	0	701	0	0	701
526	0	666	0	0	0	666
527	0	0	0	662	0	662
528	1	0	660	0	0	661
529	0	0	662	0	0	662
530	0	1	0	665	0	666
531	661	0	1	1	0	663
532	0	0	664	0	0	664
533	0	650	0	1	0	651
534	651	0	0	0	0	651
535	1	0	653	0	0	654
536	663	0	0	0	0	663
537	668	0	9	0	0	677
538	0	606	0	0	0	606
539	0	1	0	605	0	606
540	0	608	0	0	0	608
541	0	0	604	0	0	604
542	602	0	0	0	0	602
543	592	0	9	0	0	601
544	0	0	597	1	0	598
545	0	0	602	1	0	603
546	0	609	0	0	0	609
547	637	0	3	0	0	640
548	0	0	0	638	0	638
549	0	0	0	637	0	637
550	0	636	0	0	0	636
551	628	0	2	0	0	630
552	2	0	639	0	0	641
553	0	0	0	647	0	647
554	645	0	1	0	0	646
555	0	641	0	0	0	641
556	1	0	620	0	0	621
557	1	0	652	0	0	653
558	0	2	0	671	0	673
559	0	656	0	0	0	656
560	1	0	662	0	0	663
561	0	0	0	648	0	648
562	649	0	2	0	0	651
563	0	0	653	0	0	653
564	0	14	0	638	0	652
565	0	0	643	0	0	643
566	0	0	632	0	0	632
567	0	0	0	623	0	623
568	0	0	618	0	0	618
569	599	1	9	0	0	609
570	0	0	618	0	0	618
571	615	0	1	0	0	616
572	0	616	0	0	0	616
573	612	0	5	0	0	617
574	0	623	0	0	0	623
575	0	4	0	613	0	617
576	0	0	0	620	0	620
577	0	0	617	0	0	617
578	0	0	618	0	0	618
579	0	2	1	656	0	659
580	0	0	662	0	0	662
581	1	0	0	671	0	672
582	0	671	0	1	0	672
583	0	646	0	0	0	646
584	0	0	0	641	0	641
585	0	1	0	639	0	640
586	0	0	653	0	0	653
587	0	2	0	654	0	656
588	0	598	0	0	0	598
589	0	591	0	0	0	591
590	0	567	0	0	0	567
591	0	0	0	564	0	564
592	0	572	0	0	0	572
593	573	0	1	0	0	574
594	0	1	0	573	0	574
595	1	0	567	0	0	568
596	0	2	1	544	0	547
597	0	0	536	0	0	536
598	0	0	545	0	0	545
599	0	0	556	0	0	556
600	0	561	0	0	0	561
601	0	0	560	0	0	560
602	588	0	0	1	0	589
603	584	0	0	0	0	584
604	584	0	5	0	0	589
605	0	0	1	597	0	598
606	607	0	0	0	0	607
607	0	608	0	0	0	608
608	0	603	0	0	0	603
609	598	0	2	0	0	600
610	0	0	602	0	0	602
611	0	0	1	587	0	588
612	1	0	598	0	0	599
613	0	0	607	0	0	607
614	0	619	0	0	0	619
615	0	2	0	610	0	612
616	0	0	0	615	0	615
617	617	0	1	0	0	618
618	0	621	0	0	0	621
619	0	616	0	2	0	618
620	0	0	618	0	0	618
621	0	581	0	0	0	581
622	609	0	0	0	0	609
623	576	0	0	0	0	576
624	0	0	575	0	0	575
625	0	0	591	0	0	591
626	0	4	1	577	0	582
627	0	1	0	583	0	584
628	0	573	0	0	0	573
629	0	1	0	575	0	576
630	2	2	0	569	0	573
631	0	548	0	0	0	548
632	0	2	0	535	0	537
633	0	1	0	552	0	553
634	0	532	0	0	0	532
635	0	0	537	0	0	537
636	0	1	0	533	0	534
637	531	0	1	0	0	532
638	529	0	0	0	0	529
639	0	0	523	0	0	523
640	517	0	3	0	0	520
641	544	0	0	0	0	544
642	0	550	0	1	0	551
643	0	0	546	0	0	546
644	1	0	626	0	0	627
645	0	5	0	624	0	629
646	640	0	2	0	0	642
647	641	0	2	0	0	643
648	0	0	0	639	0	639
649	638	0	1	0	0	639
650	624	0	2	0	0	626
651	607	0	1	0	0	608
652	0	0	610	0	0	610
653	0	0	614	0	0	614
654	545	0	2	0	0	547
655	0	0	572	0	0	572
656	0	559	0	0	0	559
657	0	0	0	557	0	557
658	0	0	554	0	0	554
659	0	0	555	0	0	555
660	0	1	0	557	0	558
661	7	0	559	0	0	566
662	0	0	556	0	0	556
663	0	534	0	2	0	536
664	1	539	0	0	0	540
665	544	0	0	0	0	544
666	0	1	0	568	0	569
667	576	0	2	0	0	578
668	0	0	571	0	0	571
669	0	0	0	574	0	574
670	0	1	0	562	0	563
671	556	0	0	0	0	556
672	0	555	0	0	0	555
673	0	0	553	1	0	554
674	0	0	534	1	0	535
675	0	522	0	1	0	523
676	1	0	521	0	0	522
677	0	502	0	0	0	502
678	0	500	0	0	0	500
679	13	0	506	0	0	519
680	518	0	0	0	0	518
681	0	2	0	508	0	510
682	0	529	0	0	0	529
683	0	2	0	525	0	527
684	551	0	0	0	0	551
685	543	1	0	1	0	545
686	539	0	2	1	0	542
687	0	0	551	0	0	551
688	0	1	0	559	0	560
689	0	565	0	0	0	565
690	573	0	1	0	0	574
691	0	0	0	573	0	573
692	0	2	0	574	0	576
693	0	0	1	573	0	574
694	0	0	568	0	0	568
695	582	0	4	0	0	586
696	0	585	0	0	0	585
697	0	2	0	584	0	586
698	0	0	0	576	0	576
699	575	0	2	0	0	577
700	0	0	578	0	0	578
701	0	0	595	0	0	595
702	1	590	0	1	0	592
703	0	0	583	0	0	583
704	581	0	4	0	0	585
705	0	584	0	0	0	584
706	0	0	583	0	0	583
707	596	0	2	0	0	598
708	0	0	615	0	0	615
709	0	605	0	0	0	605
710	0	1	0	604	0	605
711	0	2	0	606	0	608
712	0	0	604	0	0	604
713	0	0	617	0	0	617
714	0	609	0	2	0	611
715	625	0	0	0	0	625
716	0	607	0	0	0	607
717	0	0	0	583	0	583
718	0	0	594	0	0	594
719	596	0	3	1	0	600
720	0	1	0	525	0	526
721	0	526	0	1	0	527
722	1	505	0	0	0	506
723	0	3	0	516	0	519
724	0	0	1	525	0	526
725	560	0	0	0	0	560
726	0	3	0	553	0	556
727	0	0	549	0	0	549
728	536	0	1	0	0	537
729	522	0	0	0	0	522
730	0	0	522	0	0	522
731	518	0	0	1	0	519
732	0	0	0	511	0	511
733	0	0	0	511	0	511
734	0	3	0	509	0	512
735	0	0	0	515	0	515
736	0	513	0	0	0	513
737	535	0	0	0	0	535
738	530	0	0	0	0	530
739	0	0	529	0	0	529
740	531	0	3	0	0	534
741	536	0	0	0	0	536
742	520	0	1	0	0	521
743	530	0	1	0	0	531
744	0	531	0	1	0	532
745	0	0	0	529	0	529
746	1	0	530	0	0	531
747	0	1	541	0	0	542
748	547	0	3	0	0	550
749	565	0	3	0	0	568
750	0	576	0	0	0	576
751	580	0	0	0	0	580
752	0	585	0	0	0	585
753	0	0	0	600	0	600
754	638	0	0	0	0	638
755	619	0	0	0	0	619
756	652	0	3	1	0	656
757	0	658	0	0	0	658
758	628	0	0	0	0	628
759	0	0	0	642	0	642
760	624	0	0	0	0	624
761	1	0	649	0	0	650
762	0	649	0	0	0	649
763	610	0	0	0	0	610
764	0	0	615	0	0	615
765	0	2	0	586	0	588
766	1	0	601	0	0	602
767	0	0	630	0	0	630
768	0	0	0	633	0	633
769	0	0	628	0	0	628
770	0	0	0	605	0	605
771	0	1	0	605	0	606
772	610	0	1	0	0	611
773	0	614	0	0	0	614
774	0	620	0	1	0	621
775	0	591	0	1	0	592
776	1	0	589	0	0	590
777	0	0	0	590	0	590
778	0	0	586	0	0	586
779	605	0	0	0	0	605
780	607	0	1	0	0	608
781	0	604	0	0	0	604
782	0	2	0	589	0	591
783	0	581	0	0	0	581
784	607	0	0	0	0	607
785	0	0	0	611	0	611
786	0	0	611	0	0	611
787	0	645	0	2	0	647
788	0	0	647	0	0	647
789	0	1	1	637	0	639
790	0	0	629	0	0	629
791	626	0	1	0	0	627
792	0	0	656	0	0	656
793	0	636	0	0	0	636
794	0	0	0	633	0	633
795	0	1	0	642	0	643
796	639	0	1	0	0	640
797	647	0	2	0	0	649
798	0	667	0	0	0	667
799	0	0	665	0	0	665
800	0	1	660	0	0	661
801	610	0	2	1	0	613
802	0	0	620	0	0	620
803	1	0	615	0	0	616
804	0	0	642	0	0	642
805	0	0	647	0	0	647
806	0	662	0	1	0	663
807	686	0	1	2	0	689
808	0	2	0	705	0	707
809	713	0	0	0	0	713
810	0	723	0	0	0	723
811	714	0	1	0	0	715
812	0	721	0	0	0	721
813	0	4	0	690	0	694
814	0	708	0	0	0	708
815	0	0	710	0	0	710
816	0	707	0	0	0	707
817	0	1	0	707	0	708
818	728	0	0	0	0	728
819	0	1	0	717	0	718
820	2	0	736	0	0	738
821	0	2	0	740	0	742
822	0	743	0	0	0	743
823	0	0	731	0	0	731
824	748	0	1	0	0	749
825	0	0	0	733	0	733
826	727	0	2	0	0	729
827	724	0	0	0	0	724
828	0	738	0	0	0	738
829	713	0	0	0	0	713
830	690	0	0	0	0	690
831	0	668	0	0	0	668
832	0	0	0	661	0	661
833	0	0	0	669	0	669
834	0	637	0	1	0	638
835	0	0	0	637	0	637
836	0	0	636	0	0	636
837	0	0	0	641	0	641
838	1	0	638	0	0	639
839	0	0	643	1	0	644
840	0	639	0	2	0	641
841	0	630	1	1	0	632
842	0	620	0	0	0	620
843	0	1	0	612	0	613
844	1	0	619	0	0	620
845	615	0	0	0	0	615
846	0	0	0	623	0	623
847	0	0	616	0	0	616
848	0	0	619	0	0	619
849	0	621	0	0	0	621
850	0	0	0	621	0	621
851	633	0	2	0	0	635
852	0	641	0	0	0	641
853	2	635	0	0	0	637
854	0	661	0	0	0	661
855	0	0	0	647	0	647
856	0	663	0	1	0	664
857	0	6	0	657	0	663
858	0	0	0	661	0	661
859	0	0	654	0	0	654
860	616	0	6	0	0	622
861	0	0	638	0	0	638
862	0	0	0	619	0	619
863	0	0	616	0	0	616
864	0	620	0	2	0	622
865	638	0	1	0	0	639
866	0	0	0	674	0	674
867	0	0	0	678	0	678
868	654	0	1	0	0	655
869	677	0	0	0	0	677
870	674	0	1	0	0	675
871	0	0	665	0	0	665
872	670	0	1	0	0	671
873	0	667	0	0	0	667
874	0	644	0	0	0	644
875	0	6	0	647	0	653
876	0	3	1	732	0	736
877	0	734	0	0	0	734
878	0	0	0	742	0	742
879	734	0	0	0	0	734
880	0	0	714	0	0	714
881	0	725	0	1	0	726
882	730	0	1	0	0	731
883	0	698	0	0	0	698
884	1	0	686	0	0	687
885	0	5	0	687	0	692
886	0	0	679	0	0	679
887	0	662	0	0	0	662
888	0	0	0	658	0	658
889	1	0	664	0	0	665
890	1	0	678	0	0	679
891	0	0	0	682	0	682
892	682	0	1	0	0	683
893	681	0	0	0	0	681
894	651	0	5	0	0	656
895	0	0	666	0	0	666
896	0	655	0	0	0	655
897	0	1	0	650	0	651
898	0	38	0	606	0	644
899	0	626	0	0	0	626
900	630	0	0	0	0	630
901	1	7	0	627	0	635
902	0	0	636	0	0	636
903	0	649	0	0	0	649
904	639	0	2	0	0	641
905	0	632	0	1	0	633
906	0	0	0	626	0	626
907	0	1	0	629	0	630
908	0	1	0	626	0	627
909	1	0	622	0	0	623
910	0	0	0	619	0	619
911	0	612	0	0	0	612
912	0	611	0	2	0	613
913	0	0	614	0	0	614
914	604	0	2	0	0	606
915	597	0	3	0	0	600
916	0	595	0	1	0	596
917	628	0	0	0	0	628
918	637	0	1	0	0	638
919	0	635	0	0	0	635
920	0	1	0	633	0	634
921	1	0	637	0	0	638
922	0	0	634	0	0	634
923	637	0	1	0	0	638
924	0	633	0	0	0	633
925	0	0	0	620	0	620
926	1	3	0	618	0	622
927	0	3	0	605	0	608
928	636	0	0	2	0	638
929	0	0	0	633	0	633
930	0	2	0	614	0	616
931	0	0	617	0	0	617
932	592	0	0	0	0	592
933	0	610	0	0	0	610
934	614	0	2	0	0	616
935	0	617	0	0	0	617
936	0	0	0	615	0	615
937	614	0	1	0	0	615
938	610	2	0	0	0	612
939	0	0	608	0	0	608
940	599	0	4	0	0	603
941	0	0	585	0	0	585
942	0	0	575	0	0	575
943	0	0	588	0	0	588
944	0	0	610	0	0	610
945	1	1	0	593	0	595
946	0	0	605	1	0	606
947	0	0	0	610	0	610
948	601	0	1	0	0	602
949	1	1	0	601	0	603
950	590	0	0	0	0	590
951	0	588	0	0	0	588
952	0	0	0	502	0	502
953	0	0	498	0	0	498
954	0	489	0	0	0	489
955	0	1	0	469	0	470
956	0	0	715	1	0	716
957	0	802	0	0	0	802
958	0	838	0	0	0	838
959	1	0	978	0	0	979
960	0	0	0	965	0	965
961	2	0	1207	0	0	1209
962	1216	0	1	1	0	1218
963	1237	0	2	0	0	1239
964	0	1256	0	3	0	1259
965	1255	0	1	0	0	1256
966	1	1	0	1255	0	1257
967	0	0	1287	1	0	1288
968	1291	0	7	0	0	1298
969	0	2	1535	0	0	1537
970	1	1540	0	1	0	1542
971	1543	0	6	0	0	1549
972	0	1	0	1578	0	1579
973	2	0	1580	0	0	1582
974	1652	0	2	0	0	1654
975	1642	0	10	0	0	1652
976	1658	1	3	0	0	1662
977	0	3	0	1663	0	1666
978	0	6	0	1646	0	1652
979	0	0	1773	0	0	1773
980	0	1785	0	1	0	1786
981	0	0	0	1807	0	1807
982	0	6	0	1820	0	1826
983	1	0	1849	0	0	1850
984	3	0	2259	1	0	2263
985	1	0	2	2274	0	2277
986	2351	0	1	0	0	2352
987	0	2369	0	3	0	2372
988	2368	0	6	1	0	2375
989	0	2396	0	2	0	2398
990	10	0	2395	1	0	2406
991	2	1	2442	1	0	2446
992	2477	3	1	0	0	2481
993	2468	1	4	0	0	2473
994	0	2484	0	3	0	2487
995	0	0	2806	1	0	2807
996	0	34	0	2798	0	2832
997	1	7	0	2842	0	2850
998	0	2868	0	1	0	2869
999	1	6	0	2857	0	2864
1000	5	0	2997	0	0	3002
1001	2977	0	8	2	0	2987
1002	2976	1	4	2	0	2983
1003	2984	0	11	0	0	2995
1004	2944	0	16	0	0	2960
1005	0	0	3068	1	0	3069
1006	3046	0	8	0	0	3054
1007	3	0	3169	1	0	3173
1008	1	3184	0	2	0	3187
1009	0	5	1	3178	0	3184
1010	3224	0	11	0	0	3235
1011	0	5	1	3227	0	3233
1012	0	1	3375	0	0	3376
1013	3386	0	6	2	0	3394
1014	3425	0	6	1	0	3432
1015	2	6	0	3476	0	3484
1016	0	3	0	3471	0	3474
1017	2	0	3504	0	0	3506
1018	0	3495	0	2	0	3497
1019	3480	1	20	1	0	3502
1020	0	0	3493	0	0	3493
1021	3462	0	3	2	0	3467
1022	0	3520	0	0	0	3520
1023	3548	1	9	0	0	3558
1024	0	3722	0	0	0	3722
1025	0	3718	0	1	0	3719
1026	1	16	0	3721	0	3738
1027	0	8	0	3745	0	3753
1028	0	7	0	3763	0	3770
1029	0	8	1	3765	0	3774
1030	1	0	3761	1	0	3763
1031	3798	1	9	1	0	3809
1032	3571	0	4	1	0	3576
1033	3523	1	2	1	0	3527
1034	0	1	0	3492	0	3493
1035	0	2	0	3373	0	3375
1036	3378	1	3	0	0	3382
1037	3333	0	7	0	0	3340
1038	3354	0	0	0	0	3354
1039	0	6	0	3356	0	3362
1040	0	7	0	3319	0	3326
1041	2	1	3315	1	0	3319
1042	32	0	3277	2	0	3311
1043	0	3303	0	0	0	3303
1044	3289	0	3	2	0	3294
1045	3175	1	7	1	0	3184
1046	3154	0	6	0	0	3160
1047	0	0	3221	0	0	3221
1048	3271	0	0	0	0	3271
1049	3295	1	7	1	0	3304
1050	3288	1	3	0	0	3292
1051	0	4	0	3333	0	3337
1052	0	1	0	3397	0	3398
1053	1	2	0	3398	0	3401
1054	0	0	3382	0	0	3382
1055	3259	0	1	2	0	3262
1056	0	3244	0	2	0	3246
1057	3282	0	7	0	0	3289
1058	0	3453	0	0	0	3453
1059	0	3305	0	1	0	3306
1060	0	15	0	3309	0	3324
1061	0	7	0	3442	0	3449
1062	1	3415	0	1	0	3417
1063	3455	0	3	0	0	3458
1064	3454	0	5	0	0	3459
1065	1	4	2	3443	0	3450
1066	1	0	3443	1	0	3445
1067	4	0	3398	0	0	3402
1068	0	0	3417	3	0	3420
1069	0	0	3439	1	0	3440
1070	3394	0	8	1	0	3403
1071	3103	0	7	1	0	3111
1072	0	4	0	3147	0	3151
1073	4	0	3245	1	0	3250
1074	1	19	1	3250	0	3271
1075	0	3116	0	2	0	3118
1076	0	3110	0	1	0	3111
1077	3115	0	3	1	0	3119
1078	3118	0	4	1	0	3123
1079	3207	2	18	1	0	3228
1080	0	3	0	3276	0	3279
1081	0	3	0	3210	0	3213
1082	0	47	0	3230	0	3277
1083	1	7	0	3208	0	3216
1084	0	0	3254	0	0	3254
1085	0	7	0	3259	0	3266
1086	3204	0	7	1	0	3212
1087	0	9	0	3198	0	3207
1088	0	3	0	3023	0	3026
1089	0	8	0	3028	0	3036
1090	0	3187	0	0	0	3187
1091	0	3177	0	7	0	3184
1092	0	3195	0	1	0	3196
1093	0	7	0	3250	0	3257
1094	2	4	0	3342	0	3348
1095	3369	0	2	0	0	3371
1096	3345	1	14	0	0	3360
1097	3368	0	6	0	0	3374
1098	0	5	0	3419	0	3424
1099	0	12	0	3365	0	3377
1100	0	3355	0	1	0	3356
1101	0	3325	0	3	0	3328
1102	3351	1	6	1	0	3359
1103	0	7	0	3527	0	3534
1104	4107	0	3	0	0	4110
1105	4254	0	2	0	0	4256
1106	0	7	0	4252	0	4259
1107	1	4223	0	0	0	4224
1108	4255	0	1	0	0	4256
1109	4396	1	7	0	0	4404
1110	3	0	4381	3	0	4387
1111	4385	1	10	0	0	4396
1112	0	4698	0	1	0	4699
1113	2	3	4	4477	0	4486
1114	4638	1	54	1	0	4694
1115	0	11	0	4688	0	4699
1116	2	12	0	4681	0	4695
1117	0	4713	0	0	0	4713
1118	4700	0	6	1	0	4707
1119	4936	1	15	3	0	4955
1120	0	4985	0	2	0	4987
1121	0	4868	0	7	0	4875
1122	4893	0	3	1	0	4897
1123	4731	3	7	2	0	4743
1124	1	0	4814	0	0	4815
1125	4	0	4819	1	0	4824
1126	4	0	4844	2	0	4850
1127	1	15	1	4790	0	4807
1128	0	7	1	4743	0	4751
1129	1	0	4767	1	0	4769
1130	4736	0	9	1	0	4746
1131	4751	0	13	1	0	4765
1132	4771	3	7	0	0	4781
1133	4727	0	28	0	0	4755
1134	1	0	4672	1	0	4674
1135	4532	0	6	0	0	4538
1136	4491	1	14	0	0	4506
1137	4412	0	17	1	0	4430
1138	4385	0	10	0	0	4395
1139	4352	0	11	0	0	4363
1140	2	0	4394	1	0	4397
1141	0	4380	0	2	0	4382
1142	0	7	0	4385	0	4392
1143	0	13	0	4336	0	4349
1144	4	0	4315	0	0	4319
1145	4369	0	6	1	0	4376
1146	0	2	0	4405	0	4407
1147	4	0	4452	0	0	4456
1148	0	0	4611	0	0	4611
1149	0	4547	1	3	0	4551
1150	0	8	0	4542	0	4550
1151	1	8	1	4540	0	4550
1152	0	1	0	4607	0	4608
1153	4686	0	3	0	0	4689
1154	2	3	4	4668	0	4677
1155	2	0	4611	0	0	4613
1156	5	0	4879	0	0	4884
1157	2	0	4941	3	0	4946
1158	2	10	0	5005	0	5017
1159	4960	3	7	0	0	4970
1160	0	0	5109	0	0	5109
1161	5184	1	8	0	0	5193
1162	5312	1	8	2	0	5323
1163	0	16	0	5469	0	5485
1164	5	4	1	5481	0	5491
1165	0	5329	0	3	0	5332
1166	18	0	5283	1	0	5302
1167	5362	0	12	1	0	5375
1168	2	14	1	5284	0	5301
1169	0	5234	0	2	0	5236
1170	1	7	1	5242	0	5251
1171	16	0	5876	0	0	5892
1172	1	9	0	5955	0	5965
1173	0	6038	0	1	0	6039
1174	1	9	0	6037	0	6047
1175	6352	0	7	2	0	6361
1176	0	11	0	6199	0	6210
1177	1	6238	0	3	0	6242
1178	0	6229	0	2	0	6231
1179	6071	0	3	1	0	6075
1180	37	1	5458	2	0	5498
1181	0	10	0	5389	0	5399
1182	0	18	0	5341	0	5359
1183	7	0	5283	4	0	5294
1184	0	5308	0	1	0	5309
1185	9	0	5298	0	0	5307
1186	0	12	0	5339	0	5351
1187	0	5147	0	3	0	5150
1188	5168	2	8	0	0	5178
1189	0	5020	0	0	0	5020
1190	2	5053	0	3	0	5058
1191	5126	1	7	3	0	5137
1192	5228	1	8	0	0	5237
1193	5183	1	8	0	0	5192
1194	0	11	0	5161	0	5172
1195	2	0	5011	3	0	5016
1196	4950	1	12	1	0	4964
1197	5002	0	9	0	0	5011
1198	0	8	0	5021	0	5029
1199	3	1	4993	1	0	4998
1200	0	4977	0	2	0	4979
1201	5105	0	9	0	0	5114
1202	5136	0	5	6	0	5147
1203	0	5136	0	2	0	5138
1204	1	5173	0	0	0	5174
1205	5279	2	3	0	0	5284
1206	5354	0	2	3	0	5359
1207	5351	0	15	1	0	5367
1208	1	10	0	5361	0	5372
1209	3	0	5371	0	0	5374
1210	1	17	1	5170	0	5189
1211	3	0	5187	0	0	5190
1212	3	5272	2	0	0	5277
1213	0	5236	0	1	0	5237
1214	0	29	0	5329	0	5358
1215	1	13	3	5353	0	5370
1216	2	10	0	5368	0	5380
1217	0	5333	0	1	0	5334
1218	5363	2	5	1	0	5371
1219	5382	0	24	0	0	5406
1220	0	5492	0	0	0	5492
1221	0	20	1	5384	0	5405
1222	0	5732	0	0	0	5732
1223	1	20	0	5573	0	5594
1224	1	5862	0	4	0	5867
1225	5847	1	9	1	0	5858
1226	2	15	1	5893	0	5911
1227	1	0	5891	1	0	5893
1228	5836	0	10	3	0	5849
1229	5822	0	19	4	0	5845
1230	7	0	6162	0	0	6169
1231	8	13	1	5886	0	5908
1232	29	0	5897	1	0	5927
1233	0	33	1	5735	0	5769
1234	8	0	5806	1	0	5815
1235	5797	2	13	0	0	5812
1236	2	11	2	5765	0	5780
1237	0	5711	0	4	0	5715
1238	5682	0	9	1	0	5692
1239	0	6	2	5585	0	5593
1240	2	9	0	5544	0	5555
1241	5	0	5521	1	0	5527
1242	0	11	0	5490	0	5501
1243	6	0	5524	0	0	5530
1244	5	0	5609	0	0	5614
1245	2	13	1	5716	0	5732
1246	8	0	5602	0	0	5610
1247	5089	0	10	1	0	5100
1248	5094	0	11	1	0	5106
1249	5036	1	11	0	0	5048
1250	0	4995	0	0	0	4995
1251	0	19	1	4929	0	4949
1252	0	18	0	4927	0	4945
1253	0	4903	0	1	0	4904
1254	4917	1	4	0	0	4922
1255	4	5	2	5058	0	5069
1256	3	0	5027	0	0	5030
1257	9	0	5146	1	0	5156
1258	0	5179	0	1	0	5180
1259	5001	0	5	2	0	5008
1260	3	0	5021	0	0	5024
1261	5191	0	3	1	0	5195
1262	0	5178	0	2	0	5180
1263	2	0	5166	0	0	5168
1264	211	0	5076	2	0	5289
1265	3	0	5316	1	0	5320
1266	0	5251	0	4	0	5255
1267	7	0	5275	1	0	5283
1268	5427	3	10	1	0	5441
1269	0	14	1	5438	0	5453
1270	2	6	0	5479	0	5487
1271	0	5	0	5446	0	5451
1272	0	8	1	5506	0	5515
1273	1	0	5666	2	0	5669
1274	3	14	1	5698	0	5716
1275	0	2	0	5678	0	5680
1276	5594	0	3	0	0	5597
1277	5417	0	10	0	0	5427
1278	5347	1	10	1	0	5359
1279	2	1	5371	0	0	5374
1280	1	5444	0	71	0	5516
1281	0	5425	0	2	0	5427
1282	5374	0	3	1	0	5378
1283	1	5394	0	1	0	5396
1284	1	21	0	5383	0	5405
1285	0	2	0	5495	0	5497
1286	3	0	5460	1	0	5464
1287	0	5374	0	10	0	5384
1288	2	0	5380	0	0	5382
1289	5373	0	7	0	0	5380
1290	5255	1	5	0	0	5261
1291	1	12	2	5293	0	5308
1292	0	2	0	5280	0	5282
1293	0	7	0	5426	0	5433
1294	0	12	0	5430	0	5442
1295	2	0	5351	0	0	5353
1296	1	15	0	5301	0	5317
1297	6	0	5254	1	0	5261
1298	3	0	4831	2	0	4836
1299	1	4675	0	3	0	4679
1300	4668	4	3	2	0	4677
1301	0	4718	0	0	0	4718
1302	0	18	1	4637	0	4656
1303	2	0	4681	0	0	4683
1304	4641	1	5	2	0	4649
1305	0	0	4678	0	0	4678
1306	4564	0	10	0	0	4574
1307	4552	0	19	0	0	4571
1308	0	4	0	4430	0	4434
1309	1	4	0	4395	0	4400
1310	0	8	0	4306	0	4314
1311	0	0	4438	0	0	4438
1312	4496	1	12	2	0	4511
1313	0	4481	0	1	0	4482
1314	0	7	0	4410	0	4417
1315	4478	0	3	0	0	4481
1316	4550	0	7	2	0	4559
1317	4501	0	12	1	0	4514
1318	0	0	4530	0	0	4530
1319	4441	0	41	0	0	4482
1320	4240	0	15	0	0	4255
1321	1	0	4237	0	0	4238
1322	8	0	4547	0	0	4555
1323	0	6	1	4565	0	4572
1324	5	0	4549	1	0	4555
1325	2	4407	0	3	0	4412
1326	2	4502	0	3	0	4507
1327	4589	0	8	2	0	4599
1328	0	4796	0	0	0	4796
1329	0	1	0	4861	0	4862
1330	5092	0	1	0	0	5093
1331	0	4923	0	6	0	4929
1332	0	18	0	4823	0	4841
1333	1	14	0	4989	0	5004
1334	2	0	5058	1	0	5061
1335	0	8	0	5103	0	5111
1336	8	0	5084	2	0	5094
1337	2	0	5078	0	0	5080
1338	4	10	0	5192	0	5206
1339	0	2	0	5156	0	5158
1340	5227	0	5	2	0	5234
1341	0	5213	0	2	0	5215
1342	2	18	2	5138	0	5160
1343	0	7	1	5134	0	5142
1344	4927	1	3	0	0	4931
1345	1	5306	0	0	0	5307
1346	0	5211	1	5	0	5217
1347	2	5223	0	2	0	5227
1348	3	5046	0	0	0	5049
1349	5055	2	5	0	0	5062
1350	5256	1	5	0	0	5262
1351	5241	2	9	1	0	5253
1352	5292	2	6	0	0	5300
1353	0	8	0	5372	0	5380
1354	1	0	5164	0	0	5165
1355	0	5142	0	3	0	5145
1356	0	15	1	5076	0	5092
1357	2	0	5127	1	0	5130
1358	1	14	2	5300	0	5317
1359	2	16	0	5332	0	5350
1360	0	0	5479	0	0	5479
1361	1	3	0	5515	0	5519
1362	2	8	0	5520	0	5530
1363	5527	1	5	1	0	5534
1364	5519	1	7	1	0	5528
1365	5580	0	4	0	0	5584
1366	5644	0	3	2	0	5649
1367	0	3	1	5599	0	5603
1368	0	8	0	5674	0	5682
1369	0	2	0	5564	0	5566
1370	5535	0	2	1	0	5538
1371	0	7	0	5597	0	5604
1372	1	12	0	5558	0	5571
1373	5	0	5818	3	0	5826
1374	1	14	0	5782	0	5797
1375	1	5711	0	1	0	5713
1376	1	5695	0	9	0	5705
1377	5638	0	11	2	0	5651
1378	2	0	5774	0	0	5776
1379	0	5768	0	1	0	5769
1380	5800	0	17	2	0	5819
1381	1	13	0	5783	0	5797
1382	3	0	5611	1	0	5615
1383	2	16	1	5676	0	5695
1384	0	5660	0	1	0	5661
1385	5663	0	17	4	0	5684
1386	2	5585	0	0	0	5587
1387	5435	0	12	3	0	5450
1388	6137	0	10	1	0	6148
1389	0	9	0	6079	0	6088
1390	4	13	0	6053	0	6070
1391	0	6000	0	4	0	6004
1392	5943	0	6	0	0	5949
1393	1	0	5987	0	0	5988
1394	5968	1	9	1	0	5979
1395	6057	0	9	2	0	6068
1396	0	0	6090	0	0	6090
1397	1	9	0	5907	0	5917
1398	5755	0	9	0	0	5764
1399	0	0	5745	3	0	5748
1400	0	0	5825	5	0	5830
1401	5907	0	16	1	0	5924
1402	2	5799	0	2	0	5803
1403	0	5437	0	2	0	5439
1404	0	9	0	5483	0	5492
1405	6	0	5739	0	0	5745
1406	5804	0	10	1	0	5815
1407	2	0	5928	1	0	5931
1408	0	5938	1	3	0	5942
1409	5803	0	6	3	0	5812
1410	0	71	1	5712	0	5784
1411	5607	0	2	0	0	5609
1412	1	0	5894	0	0	5895
1413	7	18	1	6066	0	6092
1414	0	5768	0	2	0	5770
1415	1	8	0	5696	0	5705
1416	0	12	0	5619	0	5631
1417	3	0	5741	3	0	5747
1418	0	5798	1	2	0	5801
1419	0	5810	0	12	0	5822
1420	5	0	5873	0	0	5878
1421	5535	0	3	0	0	5538
1422	5648	1	12	0	0	5661
1423	0	16	0	5696	0	5712
1424	6031	1	12	0	0	6044
1425	1	6181	0	1	0	6183
1426	0	6031	0	5	0	6036
1427	6187	1	11	2	0	6201
1428	0	8	2	6306	0	6316
1429	6290	0	4	0	0	6294
1430	6611	0	5	0	0	6616
1431	2	7	1	6550	0	6560
1432	9	1	6552	0	0	6562
1433	6563	0	6	3	0	6572
1434	6471	0	25	0	0	6496
1435	0	10	0	6438	0	6448
1436	0	6253	0	2	0	6255
1437	1	8	3	6172	0	6184
1438	3	0	6198	1	0	6202
1439	2	0	6200	3	0	6205
1440	0	6148	0	2	0	6150
1441	2	21	2	6120	0	6145
1442	0	10	1	6115	0	6126
1443	1	0	6120	2	0	6123
1444	6165	1	6	1	0	6173
1445	6216	1	17	1	0	6235
1446	6362	3	9	0	0	6374
1447	6317	3	24	1	0	6345
1448	0	6363	1	2	0	6366
1449	0	6329	0	1	0	6330
1450	6328	0	5	2	0	6335
1451	2	14	0	6400	0	6416
1452	2	8	0	6431	0	6441
1453	0	6436	0	1	0	6437
1454	1	24	5	6325	0	6355
1455	0	8	0	7109	0	7117
1456	0	7155	0	3	0	7158
1457	7	0	7126	2	0	7135
1458	1	5	2	7218	0	7226
1459	7211	1	3	2	0	7217
1460	7172	0	35	2	0	7209
1461	4	0	7276	1	0	7281
1462	7	0	7315	1	0	7323
1463	5	0	7437	0	0	7442
1464	2	21	0	6703	0	6726
1465	2	0	6709	2	0	6713
1466	1	2	6780	1	0	6784
1467	1	14	0	6846	0	6861
1468	2	6760	2	20	0	6784
1469	5	3	6774	0	0	6782
1470	4	6725	0	4	0	6733
1471	6798	1	7	2	0	6808
1472	2	7011	1	1	0	7015
1473	0	7	1	6985	0	6993
1474	7072	0	8	0	0	7080
1475	0	13	1	7103	0	7117
1476	0	16	0	6938	0	6954
1477	1	0	6933	4	0	6938
1478	1	7101	0	6	0	7108
1479	1	6855	0	1	0	6857
1480	0	23	0	6754	0	6777
1481	1	9	1	6968	0	6979
1482	2	6	0	6941	0	6949
1483	2	1	6810	0	0	6813
1484	3	0	6848	3	0	6854
1485	6805	0	6	3	0	6814
1486	0	0	6854	3	0	6857
1487	2	0	7023	0	0	7025
1488	2	6814	0	3	0	6819
1489	1	10	1	6785	0	6797
1490	6	0	6952	1	0	6959
1491	0	31	3	7252	0	7286
1492	3	0	7461	0	0	7464
1493	1	12	0	7406	0	7419
1494	2	0	7471	0	0	7473
1495	0	13	2	7449	0	7464
1496	1	19	0	7625	0	7645
1497	2	8017	0	2	0	8021
1498	1	24	0	7999	0	8024
1499	2	8303	0	2	0	8307
1500	1	17	0	8204	0	8222
1501	0	8	0	8274	0	8282
1502	8331	1	5	1	0	8338
1503	4	6	1	8190	0	8201
1504	4	0	8063	1	0	8068
1505	1	12	1	8081	0	8095
1506	0	19	1	7793	0	7813
1507	3	0	7757	4	0	7764
1508	14	0	7667	2	0	7683
1509	0	33	0	7671	0	7704
1510	2	16	2	7701	0	7721
1511	3	1	7906	1	0	7911
1512	4	8123	1	2	0	8130
1513	1	8215	0	3	0	8219
1514	8282	0	7	1	0	8290
1515	0	15	2	8622	0	8639
1516	8589	0	8	1	0	8598
1517	8612	1	22	2	0	8637
1518	0	8714	0	3	0	8717
1519	8675	0	17	2	0	8694
1520	8548	0	12	0	0	8560
1521	0	0	8570	3	0	8573
1522	2	13	2	8560	0	8577
1523	6	0	8599	1	0	8606
1524	2	17	0	8462	0	8481
1525	2	0	8607	3	0	8612
1526	3	8652	2	5	0	8662
1527	1	8697	0	8	0	8706
1528	2	7	0	8652	0	8661
1529	8778	0	7	3	0	8788
1530	5	24	0	8834	0	8863
1531	0	19	1	8536	0	8556
1532	4	0	8505	3	0	8512
1533	1	0	8482	3	0	8486
1534	8	0	8549	1	0	8558
1535	2	29	0	8471	0	8502
1536	0	14	0	8373	0	8387
1537	2	8491	0	3	0	8496
1538	2	8383	2	2	0	8389
1539	8444	1	10	0	0	8455
1540	0	8401	0	54	0	8455
1541	7	0	8436	0	0	8443
1542	1	17	0	8542	0	8560
1543	5	0	8283	10	0	8298
1544	1	8479	0	4	0	8484
1545	3	14	1	8533	0	8551
1546	8433	1	9	3	0	8446
1547	1	0	8470	0	0	8471
1548	5	8650	0	5	0	8660
1549	10	0	8652	1	0	8663
1550	0	8647	0	3	0	8650
1551	0	12	0	8625	0	8637
1552	9178	0	10	0	0	9188
1553	9117	0	40	2	0	9159
1554	0	9106	0	1	0	9107
1555	9083	2	5	0	0	9090
1556	2	8	0	9030	0	9040
1557	8710	0	13	1	0	8724
1558	6	0	9073	1	0	9080
1559	4	0	9216	1	0	9221
1560	1	11	8	9252	0	9272
1561	0	5	2	8905	0	8912
1562	2	0	8910	0	0	8912
1563	1	8	2	9009	0	9020
1564	9013	0	4	0	0	9017
1565	9019	1	15	3	0	9038
1566	2	9229	0	1	0	9232
1567	0	8655	1	5	0	8661
1568	8740	1	12	2	0	8755
1569	1	13	0	8774	0	8788
1570	8692	0	14	3	0	8709
1571	3	8685	0	6	0	8694
1572	8386	0	12	1	0	8399
1573	8	0	8076	1	0	8085
1574	1	0	8227	3	0	8231
1575	3	104	2	7510	0	7619
1576	973	0	6646	0	0	7619
1577	0	20	2	7933	0	7955
1578	2	14	2	7859	0	7877
1579	3	0	7984	0	0	7987
1580	0	18	0	8229	0	8247
1581	0	22	2	8172	0	8196
1582	1	0	8054	2	0	8057
1583	2	0	8123	0	0	8125
1584	7993	1	13	6	0	8013
1585	2	0	8132	1	0	8135
1586	8030	1	23	1	0	8055
1587	7897	1	10	2	0	7910
1588	2	0	7744	1	0	7747
1589	7	0	7853	3	0	7863
1590	0	17	0	7847	0	7864
1591	2	3	0	7542	0	7547
1592	2	7528	0	3	0	7533
1593	1	7387	0	29	0	7417
1594	6	0	7435	0	0	7441
1595	7726	3	8	1	0	7738
1596	7631	1	12	2	0	7646
1597	4	0	7668	1	0	7673
1598	2	2	7901	0	0	7905
1599	2	22	0	7798	0	7822
1600	0	7553	0	1	0	7554
1601	1	17	0	7586	0	7604
1602	1	10	0	7614	0	7625
1603	7743	1	6	6	0	7756
1604	7836	1	13	0	0	7850
1605	1	12	1	7784	0	7798
1606	3	1	7674	0	0	7678
1607	7280	2	21	3	0	7306
1608	0	7210	1	5	0	7216
1609	7149	0	28	2	0	7179
1610	7254	0	10	1	0	7265
1611	2	7293	0	0	0	7295
1612	1	7184	0	1	0	7186
1613	1	31	1	7141	0	7174
1614	4	28	0	7404	0	7436
1615	3	7465	0	2	0	7470
1616	0	10	0	7509	0	7519
1617	4	8	0	7513	0	7525
1618	1	1	7406	0	0	7408
1619	7509	1	18	5	0	7533
1620	7437	0	21	0	0	7458
1621	7449	0	12	0	0	7461
1622	0	8	0	7417	0	7425
1623	7175	0	5	0	0	7180
1624	0	7118	0	1	0	7119
1625	2	17	2	7005	0	7026
1626	4	7069	0	2	0	7075
1627	0	6640	1	4	0	6645
1628	6646	0	11	0	0	6657
1629	6640	1	5	0	0	6646
1630	6460	1	33	1	0	6495
1631	6525	0	16	0	0	6541
1632	6483	0	29	0	0	6512
1633	2	0	6527	1	0	6530
1634	6004	0	21	1	0	6026
1635	1	0	6054	1	0	6056
1636	6029	1	21	0	0	6051
1637	6033	0	9	1	0	6043
1638	6003	0	8	1	0	6012
1639	2	0	5973	2	0	5977
1640	2	8	0	5947	0	5957
1641	0	5666	0	9	0	5675
1642	5620	1	30	1	0	5652
1643	5755	2	4	0	0	5761
1644	0	5756	0	4	0	5760
1645	5792	2	12	1	0	5807
1646	3	11	1	6127	0	6142
1647	1	6180	0	3	0	6184
1648	6085	0	5	2	0	6092
1649	6203	1	9	2	0	6215
1650	0	5	0	6193	0	6198
1651	6265	1	6	0	0	6272
1652	0	9	0	6276	0	6285
1653	1	7	1	5825	0	5834
1654	1	0	5924	1	0	5926
1655	1	13	0	5730	0	5744
1656	3	5	1	5625	0	5634
1657	4	0	5600	3	0	5607
1658	0	0	5455	2	0	5457
1659	2	11	1	5508	0	5522
1660	2	0	5495	0	0	5497
1661	5571	0	15	1	0	5587
1662	0	5710	0	2	0	5712
1663	0	11	0	5621	0	5632
1664	1	6	0	5607	0	5614
1665	0	9	0	5487	0	5496
1666	5550	0	5	0	0	5555
1667	5741	1	12	0	0	5754
1668	5830	0	7	0	0	5837
1669	0	6007	0	3	0	6010
1670	0	9	1	5754	0	5764
1671	2	0	0	5718	0	5720
1672	5795	0	5	0	0	5800
1673	5737	0	4	2	0	5743
1674	0	1	0	5585	0	5586
1675	2	0	5621	2	0	5625
1676	5584	0	10	4	0	5598
1677	5531	0	17	1	0	5549
1678	1	0	5548	2	0	5551
1679	5265	0	10	1	0	5276
1680	0	0	5266	1	0	5267
1681	5663	0	14	3	0	5680
1682	3	8	0	5774	0	5785
1683	0	5801	0	3	0	5804
1684	8	2	5808	0	0	5818
1685	5	6062	0	1	0	6068
1686	0	6022	0	6	0	6028
1687	5991	1	30	0	0	6022
1688	1	5	0	6044	0	6050
1689	0	2	0	6016	0	6018
1690	6017	3	3	1	0	6024
1691	1	9	0	5926	0	5936
1692	3	6	0	5891	0	5900
1693	0	2	0	5879	0	5881
1694	0	12	1	5647	0	5660
1695	2	0	5583	2	0	5587
1696	3	1	5600	1	0	5605
1697	0	5626	1	7	0	5634
1698	5686	0	11	0	0	5697
1699	1	7	3	5710	0	5721
1700	0	5677	0	0	0	5677
1701	0	16	0	5684	0	5700
1702	0	9	0	5915	0	5924
1703	0	17	1	5902	0	5920
1704	0	15	0	6134	0	6149
1705	3	10	0	6147	0	6160
1706	0	6106	0	2	0	6108
1707	0	12	0	6057	0	6069
1708	6	1	6098	1	0	6106
1709	0	6173	0	2	0	6175
1710	4	82	1	6127	0	6214
1711	3	6	2	6211	0	6222
1712	2	6347	0	5	0	6354
1713	0	6347	0	5	0	6352
1714	6424	0	12	2	0	6438
1715	2	6350	0	4	0	6356
1716	6324	2	14	1	0	6341
1717	6140	1	148	0	0	6289
1718	0	0	6349	0	0	6349
1719	3	10	0	6231	0	6244
1720	2	0	6046	1	0	6049
1721	1	5848	0	3	0	5852
1722	1	197	0	5614	0	5812
1723	2	10	0	5820	0	5832
1724	0	18	0	5808	0	5826
1725	0	8	0	5710	0	5718
1726	23	0	5712	0	0	5735
1727	3	7	1	5668	0	5679
1728	2	0	5572	0	0	5574
1729	3	0	5620	0	0	5623
1730	5395	0	11	2	0	5408
1731	5415	1	15	2	0	5433
1732	5426	5	11	1	0	5443
1733	1	5421	0	2	0	5424
1734	2	9	1	5316	0	5328
1735	6	0	5383	0	0	5389
1736	2	9	1	5392	0	5404
1737	0	0	5403	0	0	5403
1738	5204	1	16	2	0	5223
1739	5185	0	14	0	0	5199
1740	5193	4	20	0	0	5217
1741	0	0	5378	1	0	5379
1742	2	1	5327	2	0	5332
1743	1	5	1	5255	0	5262
1744	1	1	0	5220	0	5222
1745	1	6	0	5171	0	5178
1746	1	0	5345	0	0	5346
1747	2	0	5385	1	0	5388
1748	5423	0	5	1	0	5429
1749	0	9	1	5521	0	5531
1750	1	7	0	5330	0	5338
1751	5340	0	9	0	0	5349
1752	1	7	1	5358	0	5367
1753	5396	0	11	0	0	5407
1754	5372	0	21	1	0	5394
1755	4988	0	20	0	0	5008
1756	6	0	5009	0	0	5015
1757	2	5072	0	30	0	5104
1758	4978	0	13	0	0	4991
1759	1	11	0	4937	0	4949
1760	1	12	0	5204	0	5217
1761	1	4960	0	2	0	4963
1762	5003	1	15	0	0	5019
1763	5042	0	5	0	0	5047
1764	5014	3	11	0	0	5028
1765	0	4968	0	2	0	4970
1766	4884	0	7	0	0	4891
1767	4919	1	10	0	0	4930
1768	4912	0	7	0	0	4919
1769	0	4	1	5060	0	5065
1770	0	15	0	5038	0	5053
1771	0	0	5269	0	0	5269
1772	0	8	0	5323	0	5331
1773	0	10	1	5308	0	5319
1774	4	0	5228	1	0	5233
1775	5282	5	6	4	0	5297
1776	5261	0	11	2	0	5274
1777	0	11	0	5564	0	5575
1778	3	5426	0	4	0	5433
1779	0	5561	0	2	0	5563
1780	1	8	1	5299	0	5309
1781	5	0	5375	0	0	5380
1782	1	101	0	5377	0	5479
1783	3	0	5448	0	0	5451
1784	0	0	5431	0	0	5431
1785	1	4	1	5300	0	5306
1786	5272	0	13	0	0	5285
1787	5387	0	4	2	0	5393
1788	5	10	0	5349	0	5364
1789	2	15	0	5419	0	5436
1790	1	7	0	5385	0	5393
1791	1	2	0	5404	0	5407
1792	5524	0	1	3	0	5528
1793	5687	0	4	0	0	5691
1794	5615	1	24	0	0	5640
1795	2	0	5691	0	0	5693
1796	0	7	0	5804	0	5811
1797	2	4	0	5681	0	5687
1798	5752	0	11	3	0	5766
1799	2	5732	0	11	0	5745
1800	5767	0	7	2	0	5776
1801	5748	0	11	0	0	5759
1802	5703	0	38	1	0	5742
1803	5746	0	14	1	0	5761
1804	4	0	5722	1	0	5727
1805	4	0	5725	0	0	5729
1806	5791	0	17	0	0	5808
1807	5905	0	10	0	0	5915
1808	5932	3	27	1	0	5963
1809	5550	2	322	1	0	5875
1810	2	0	5969	0	0	5971
1811	0	5993	1	1	0	5995
1812	0	6	1	6005	0	6012
1813	6014	0	12	0	0	6026
1814	6073	0	6	2	0	6081
1815	6073	1	3	1	0	6078
1816	6118	0	17	2	0	6137
1817	6049	1	7	1	0	6058
1818	5894	0	15	0	0	5909
1819	1	0	5803	0	0	5804
1820	2	0	5864	2	0	5868
1821	0	13	0	5749	0	5762
1822	0	0	5595	0	0	5595
1823	1	5583	1	6	0	5591
1824	1	5499	1	5	0	5506
1825	2	4	1	5526	0	5533
1826	2	0	5532	0	0	5534
1827	1	0	5898	1	0	5900
1828	5887	0	10	3	0	5900
1829	5899	3	13	1	0	5916
1830	0	2	0	5902	0	5904
1831	5849	0	4	0	0	5853
1832	1	10	0	5817	0	5828
1833	3	6	0	5677	0	5686
1834	6	1	5677	1	0	5685
1835	1	0	5741	0	0	5742
1836	1	8	0	5480	0	5489
1837	3	0	5434	1	0	5438
1838	5410	0	9	3	0	5422
1839	5486	0	21	1	0	5508
1840	2	5461	0	4	0	5467
1841	5398	1	18	1	0	5418
1842	0	2	5461	0	0	5463
1843	5437	1	9	0	0	5447
1844	5801	0	18	0	0	5819
1845	5687	0	10	1	0	5698
1846	2	9	0	5842	0	5853
1847	0	5629	0	4	0	5633
1848	5572	0	9	0	0	5581
1849	5900	0	15	0	0	5915
1850	3	7	0	6626	0	6636
1851	6610	1	7	0	0	6618
1852	2	6485	0	1	0	6488
1853	0	4	0	6075	0	6079
1854	0	0	6131	4	0	6135
1855	6022	0	35	1	0	6058
1856	1	0	6168	0	0	6169
1857	1	4	0	6142	0	6147
1858	0	6054	0	4	0	6058
1859	0	6204	0	3	0	6207
1860	0	8	0	6408	0	6416
1861	0	6736	0	0	0	6736
1862	0	10	0	6836	0	6846
1863	2	5	0	6815	0	6822
1864	1	1	0	6788	0	6790
1865	6690	1	13	1	0	6705
1866	1	13	1	6709	0	6724
1867	2	0	6701	0	0	6703
1868	4	6693	1	4	0	6702
1869	6530	0	9	1	0	6540
1870	2	7	2	6281	0	6292
1871	3	21	0	6240	0	6264
1872	3	32	0	6216	0	6251
1873	1	0	6319	0	0	6320
1874	0	6434	0	3	0	6437
1875	6492	0	19	1	0	6512
1876	0	7	1	6677	0	6685
1877	0	6591	0	3	0	6594
1878	6531	0	13	0	0	6544
1879	0	1	6570	1	0	6572
1880	6813	1	49	0	0	6863
1881	3	0	6858	0	0	6861
1882	1	0	6890	4	0	6895
1883	0	6741	0	0	0	6741
1884	0	11	0	6686	0	6697
1885	2	2	6734	1	0	6739
1886	0	6677	0	3	0	6680
1887	4	48	0	6578	0	6630
1888	0	6667	0	11	0	6678
1889	4	0	6850	0	0	6854
1890	1	9	0	6854	0	6864
1891	1	0	6858	0	0	6859
1892	1	16	4	7097	0	7118
1893	2	13	0	7040	0	7055
1894	3	0	7019	2	0	7024
1895	0	9	0	7377	0	7386
1896	7295	0	67	0	0	7362
1897	0	7656	0	7	0	7663
1898	2	1	7509	0	0	7512
1899	7519	1	18	2	0	7540
1900	0	14	0	7589	0	7603
1901	0	7613	1	3	0	7617
1902	7942	0	5	0	0	7947
1903	7700	1	14	0	0	7715
1904	0	6	0	7739	0	7745
1905	2	17	2	7685	0	7706
1906	0	9	0	7729	0	7738
1907	4	12	0	7737	0	7753
1908	0	7655	0	2	0	7657
1909	1	8	0	7550	0	7559
1910	0	7613	0	1	0	7614
1911	3	7592	0	7	0	7602
1912	0	7625	0	7	0	7632
1913	2	1	7624	1	0	7628
1914	1	7597	0	2	0	7600
1915	7603	1	15	2	0	7621
1916	1	8133	0	6	0	8140
1917	2	10	0	8193	0	8205
1918	1	8133	0	3	0	8137
1919	1	9	0	8167	0	8177
1920	1	10	1	8165	0	8177
1921	2	0	8119	2	0	8123
1922	8148	0	18	4	0	8170
1923	8457	1	41	1	0	8500
1924	8576	0	16	1	0	8593
1925	0	8226	0	3	0	8229
1926	0	10	0	7424	0	7434
1927	3	0	7498	0	0	7501
1928	2	7731	0	7	0	7740
1929	5	17	1	7689	0	7712
1930	2	7775	0	1	0	7778
1931	7849	0	3	0	0	7852
1932	7747	0	10	1	0	7758
1933	7866	0	9	2	0	7877
1934	7933	1	17	1	0	7952
1935	0	14	0	7851	0	7865
1936	2	12	0	7574	0	7588
1937	0	7436	0	0	0	7436
1938	0	26	0	7322	0	7348
1939	1	0	7357	0	0	7358
1940	1	10	0	7324	0	7335
1941	1	0	7322	2	0	7325
1942	0	7801	0	4	0	7805
1943	2	1	7867	0	0	7870
1944	3	17	3	7886	0	7909
1945	6	0	8120	1	0	8127
1946	1	11	4	8190	0	8206
1947	1	22	3	8261	0	8287
1948	12	23	2	8304	0	8341
1949	1	2	1	8320	0	8324
1950	8253	0	14	1	0	8268
1951	0	8202	0	1	0	8203
1952	7992	3	21	1	0	8017
1953	2	0	8012	1	0	8015
1954	7931	0	14	2	0	7947
1955	7749	0	23	1	0	7773
1956	4	0	7738	0	0	7742
1957	3	0	7637	1	0	7641
1958	2	7835	1	3	0	7841
1959	1	7783	3	2	0	7789
1960	6	1	7855	1	0	7863
1961	0	7974	0	1	0	7975
1962	3	8	1	8019	0	8031
1963	8082	0	53	0	0	8135
1964	1	7	1	8232	0	8241
1965	8085	0	7	1	0	8093
1966	8086	0	16	2	0	8104
1967	2	8089	0	2	0	8093
1968	7947	0	16	0	0	7963
1969	8073	0	5	1	0	8079
1970	1	11	0	7658	0	7670
1971	7728	0	15	1	0	7744
1972	1	7772	0	0	0	7773
1973	1	8	0	7351	0	7360
1974	7352	0	10	2	0	7364
1975	2	0	7328	1	0	7331
1976	7210	1	21	3	0	7235
1977	2	6	0	7218	0	7226
1978	2	0	6902	0	0	6904
1979	3	0	7014	3	0	7020
1980	7014	0	4	0	0	7018
1981	7079	1	24	0	0	7104
1982	2	9	0	7177	0	7188
1983	0	19	1	7089	0	7109
1984	1	10	1	7176	0	7188
1985	0	7177	0	1	0	7178
1986	7195	1	8	1	0	7205
1987	1	7204	0	2	0	7207
1988	7037	0	21	0	0	7058
1989	0	0	7451	0	0	7451
1990	1	9	0	7472	0	7482
1991	7737	0	5	1	0	7743
1992	0	21	0	7229	0	7250
1993	4	10	0	7039	0	7053
1994	0	7161	0	2	0	7163
1995	7169	1	10	1	0	7181
1996	0	7475	0	0	0	7475
1997	4	7	0	7708	0	7719
1998	1	1	7661	1	0	7664
1999	7174	1	28	1	0	7204
2000	5	0	7255	1	0	7261
2001	7319	0	21	2	0	7342
2002	1	7260	0	9	0	7270
2003	1	13	2	6991	0	7007
2004	1	9338	0	3	0	9342
2005	9405	3	17	0	0	9425
2006	0	11	1	9718	0	9730
2007	4	15	2	9650	0	9671
2008	4	2	9864	3	0	9873
2009	14641	2	37	1	0	14681
2010	4	28	1	14908	0	14941
2011	1	0	16518	7	0	16526
2012	2	17137	1	3	0	17143
2013	0	6	2	17006	0	17014
2014	18422	0	6	4	0	18432
2015	1	12	0	18442	0	18455
2016	9	0	18907	2	0	18918
2017	19020	0	9	3	0	19032
2018	4	8	0	18661	0	18673
2019	6	1	20519	6	0	20532
2020	3	76	5	20474	0	20558
2021	4	60	1	20259	0	20324
2022	2	20321	0	12	0	20335
2023	20320	0	59	2	0	20381
2024	5	22002	0	8	0	22015
2025	21995	0	30	3	0	22028
2026	4	55	1	21989	0	22049
2027	0	22044	0	7	0	22051
2028	11	58	3	21964	0	22036
2029	12	0	22880	3	0	22895
2030	22737	6	76	5	0	22824
2031	3	54	5	23004	0	23066
2032	2	59	3	23609	0	23673
2033	6	47	2	23382	0	23437
2034	15	0	23790	19	0	23824
2035	15	1	24296	14	0	24326
2036	1	24526	0	22	0	24549
2037	3	46	2	25012	0	25063
2038	25579	4	26	5	0	25614
2039	0	25926	0	34	0	25960
2040	6	40	1	26203	0	26250
2041	26174	2	37	6	0	26219
2042	26246	3	56	5	0	26310
2043	2	26869	0	9	0	26880
2044	26492	5	26	9	0	26532
2045	28559	6	59	7	0	28631
2046	4	102	0	28580	0	28686
2047	2	28918	0	13	0	28933
2048	0	53	3	28768	0	28824
2049	29748	5	34	3	0	29790
2050	46	0	30138	3	0	30187
2051	7	73	3	30517	0	30600
2052	4	50	2	30424	0	30480
2053	14	0	31842	4	0	31860
2054	4	42	2	31954	0	32002
2055	33248	0	28	1	0	33277
2056	33348	1	82	3	0	33434
2057	2	66	0	33437	0	33505
2058	10	0	34824	5	0	34839
2059	23	2	34866	15	0	34906
2060	5	34937	2	25	0	34969
2061	2	35935	0	23	0	35960
2062	9	72	8	36032	0	36121
2063	41282	2	25	6	0	41315
2064	1	43813	0	16	0	43830
2065	44050	3	44	1	0	44098
2066	6	157	8	45623	0	45794
2067	2	19	2	45587	0	45610
2068	45588	4	29	3	0	45624
2069	1	45537	0	76	0	45614
2070	45357	5	83	27	0	45472
2071	20	2	45907	2	0	45931
2072	30	5	45655	18	0	45708
2073	12	74	4	45135	0	45225
2074	28	1	44914	10	0	44953
2075	29	0	45837	13	0	45879
2076	12	434	1	46416	0	46863
2077	17	1	46868	2	0	46888
2078	2	116	2	47263	0	47383
2079	9	143	0	47098	0	47250
2080	34	2	45454	4	0	45494
2081	9	94	1	45604	0	45708
2082	48	104	4	45482	0	45638
2083	2	45427	1	14	0	45444
2084	45127	4	111	4	0	45246
2085	29	0	40904	6	0	40939
2086	4	105	7	41484	0	41600
2087	1	125	4	39737	0	39867
2088	26	2	38973	8	0	39009
2089	39350	4	75	7	0	39436
2090	0	37749	0	7	0	37756
2091	8	142	6	37828	0	37984
2092	82	90	3	38120	0	38295
2093	1	37876	4	21	0	37902
2094	30	5	37734	5	0	37774
2095	0	36226	0	12	0	36238
2096	36094	2	47	7	0	36150
2097	7	1	36366	4	0	36378
2098	14	202	3	36734	0	36953
2099	23	2	37418	8	0	37451
2100	57	1	38577	17	0	38652
2101	6	38538	2	24	0	38570
2102	16	80	2	38405	0	38503
2103	38967	1	56	1	0	39025
2104	39694	2	50	2	0	39748
2105	2	39586	0	8	0	39596
2106	6	54	5	39380	0	39445
2107	39458	1	53	0	0	39512
2108	38259	3	459	5	0	38726
2109	2	39044	2	7	0	39055
2110	40557	6	43	6	0	40612
2111	10	144	6	40445	0	40605
2112	2	41081	0	6	0	41089
2113	7	269	3	40192	0	40471
2114	5	39	3	40366	0	40413
2115	16	58	9	40247	0	40330
2116	30	1	39822	10	0	39863
2117	44	11	39691	18	0	39764
2118	7	40264	0	40	0	40311
2119	40199	6	106	14	0	40325
2120	5	39662	0	16	0	39683
2121	4	55	3	39002	0	39064
2122	18	0	41743	2	0	41763
2123	1	118	18	41468	0	41605
2124	5	155	6	41374	0	41540
2125	6	206	1	40619	0	40832
2126	40403	3	57	2	0	40465
2127	5	142	1	40301	0	40449
2128	9	0	40482	0	0	40491
2129	38973	4	83	11	0	39071
2130	38839	7	84	3	0	38933
2131	37286	4	116	10	0	37416
2132	37099	4	44	4	0	37151
2133	38064	22	95	5	0	38186
2134	2	36756	0	2	0	36760
2135	7	77	4	36440	0	36528
2136	2	35945	1	11	0	35959
2137	35793	5	63	4	0	35865
2138	35949	1	61	4	0	36015
2139	31570	1	51	5	0	31627
2140	8	29193	0	10	0	29211
2141	1	28475	0	9	0	28485
2142	0	27487	1	257	0	27745
2143	26	1	28555	1	0	28583
2144	8	76	6	28971	0	29061
2145	11	28783	2	10	0	28806
2146	4	28642	0	7	0	28653
2147	2	598	1	28233	0	28834
2148	5	68	6	28929	0	29008
2149	24	0	28964	0	0	28988
2150	28827	3	50	11	0	28891
2151	3	50	6	29323	0	29382
2152	11	94	4	28462	0	28571
2153	21	0	28729	4	0	28754
2154	40	0	28789	6	0	28835
2155	3	27602	2	901	0	28508
2156	7	88	3	28517	0	28615
2157	6	68	5	28983	0	29062
2158	13	0	29134	2	0	29149
2159	28855	3	60	8	0	28926
2160	28942	4	61	4	0	29011
2161	5	0	28896	2	0	28903
2162	27946	2	134	12	0	28094
2163	11	1	28318	0	0	28330
2164	28061	4	64	8	0	28137
2165	28283	3	54	2	0	28342
2166	9	0	30445	0	0	30454
2167	0	78	2	30176	0	30256
2168	8	45	2	29996	0	30051
2169	4	21	16	30256	0	30297
2170	30120	1	37	5	0	30163
2171	30099	4	47	9	0	30159
2172	10	2	30160	1	0	30173
2173	7	1	30047	3	0	30058
2174	29306	1	41	14	0	29362
2175	25840	4	63	7	0	25914
2176	10	0	26521	1	0	26532
2177	15	1	28262	2	0	28280
2178	4	80	5	28081	0	28170
2179	24	1	27978	1	0	28004
2180	1	51	3	27556	0	27611
2181	26980	2	30	3	0	27015
2182	5	0	27167	0	0	27172
2183	26930	1	36	4	0	26971
2184	11	0	27976	3	0	27990
2185	2	127	2	26746	0	26877
2186	3	61	4	25388	0	25456
2187	9	105	2	26956	0	27072
2188	1	26491	0	2	0	26494
2189	14	46	3	26398	0	26461
2190	1	15	0	26612	0	26628
2191	26131	2	181	2	0	26316
2192	11	1	26210	4	0	26226
2193	24951	1	49	11	0	25012
2194	13	0	25107	2	0	25122
2195	24978	0	51	6	0	25035
2196	1	24540	2	16	0	24559
2197	12	0	24263	1	0	24276
2198	7	0	23507	3	0	23517
2199	2	47	3	23375	0	23427
2200	11	36	5	23345	0	23397
2201	20	0	23447	2	0	23469
2202	8	0	23350	4	0	23362
2203	9	0	23482	6	0	23497
2204	23042	1	24	16	0	23083
2205	22933	6	59	10	0	23008
2206	24279	2	55	4	0	24340
2207	2	47	7	24093	0	24149
2208	3	31	1	24855	0	24890
2209	5	0	24386	0	0	24391
2210	9	48	1	24688	0	24746
2211	4	8	1	24710	0	24723
2212	24717	1	20	4	0	24742
2213	24919	1	19	2	0	24941
2214	25081	1	62	4	0	25148
2215	1	20	0	25208	0	25229
2216	2	21	0	24761	0	24784
2217	1	32	2	25006	0	25041
2218	27194	2	24	0	0	27220
2219	8	69	0	27061	0	27138
2220	2	27122	0	35	0	27159
2221	16	98	7	26811	0	26932
2222	0	27181	0	16	0	27197
2223	27267	2	27	5	0	27301
2224	27956	4	45	8	0	28013
2225	4	28339	0	7	0	28350
2226	3	27579	0	8	0	27590
2227	5	72	0	26648	0	26725
2228	16	0	27150	0	0	27166
2229	8	53	0	28190	0	28251
2230	25	0	27972	12	0	28009
2231	6	29826	0	16	0	29848
2232	3	110	1	29798	0	29912
2233	8	248	4	29146	0	29406
2234	17	1	29279	0	0	29297
2235	8	88	2	29167	0	29265
2236	14	0	29159	2	0	29175
2237	28744	2	76	15	0	28837
2238	28892	4	135	2	0	29033
2239	28908	2	84	2	0	28996
2240	1	28	6	28880	0	28915
2241	2	44	0	28577	0	28623
2242	5	1	26769	7	0	26782
2243	2	43	1	26930	0	26976
2244	4	26755	1	42	0	26802
2245	32	1	26619	1	0	26653
2246	59	0	26746	8	0	26813
2247	6	91	3	26805	0	26905
2248	11	1	26608	4	0	26624
2249	15	2	26880	7	0	26904
2250	27233	2	60	12	0	27307
2251	0	26615	1	20	0	26636
2252	26563	4	46	6	0	26619
2253	25512	1	36	4	0	25553
2254	26589	1	80	1	0	26671
2255	3	43	3	26505	0	26554
2256	5	72	2	26491	0	26570
2257	14	2	26421	4	0	26441
2258	10	83	3	26177	0	26273
2259	4	25391	0	20	0	25415
2260	25512	3	37	12	0	25564
2261	6	25416	0	21	0	25443
2262	7	24634	0	12	0	24653
2263	7	68	1	23574	0	23650
2264	27	1	24491	0	0	24519
2265	5	88	3	24450	0	24546
2266	29	1	24390	1	0	24421
2267	4	24316	2	13	0	24335
2268	24714	1	49	4	0	24768
2269	24913	2	86	6	0	25007
2270	24675	2	53	5	0	24735
2271	4	0	25178	0	0	25182
2272	3	0	26507	3	0	26513
2273	27047	3	55	8	0	27113
2274	27006	3	70	4	0	27083
2275	28016	1	53	8	0	28078
2276	4	59	1	28640	0	28704
2277	2	23	0	29197	0	29222
2278	29364	2	25	5	0	29396
2279	29291	3	54	9	0	29357
2280	8	1	29307	3	0	29319
2281	6	1	29516	13	0	29536
2282	27907	4	58	9	0	27978
2283	32	0	27874	4	0	27910
2284	26942	2	50	6	0	27000
2285	17	0	28174	0	0	28191
2286	4	57	3	27883	0	27947
2287	16	0	28757	1	0	28774
2288	8	80	2	29472	0	29562
2289	5	69	4	29334	0	29412
2290	0	29214	0	10	0	29224
2291	29082	4	52	11	0	29149
2292	14	1	29454	4	0	29473
2293	29122	2	127	7	0	29258
2294	0	27674	0	23	0	27697
2295	26930	4	44	1	0	26979
2296	5	100	1	28163	0	28269
2297	7	66	1	28541	0	28615
2298	1	29041	1	16	0	29059
2299	1	86	4	28787	0	28878
2300	2	124	4	28736	0	28866
2301	2	26	1	29098	0	29127
2302	28997	5	38	7	0	29047
2303	28766	5	48	5	0	28824
2304	217	2	28350	2	0	28571
2305	3	27458	0	9	0	27470
2306	2	89	6	27085	0	27182
2307	5	39	4	26217	0	26265
2308	13	0	26446	2	0	26461
2309	1	40	1	26509	0	26551
2310	26355	2	28	0	0	26385
2311	26370	2	38	3	0	26413
2312	26436	1	26	3	0	26466
2313	1	15	0	26570	0	26586
2314	26536	1	24	2	0	26563
2315	26440	5	28	8	0	26481
2316	26821	0	31	1	0	26853
2317	2	13	5	26925	0	26945
2318	3	27	0	26734	0	26764
2319	4	23	7	26722	0	26756
2320	1	16	0	27196	0	27213
2321	2	62	1	27203	0	27268
2322	11	5	26950	14	0	26980
2323	13	0	27112	6	0	27131
2324	2	26809	0	23	0	26834
2325	4	60	2	26594	0	26660
2326	5	84	3	26660	0	26752
2327	4	68	2	26860	0	26934
2328	16	0	27537	5	0	27558
2329	10	63	3	27205	0	27281
2330	12	1	26929	1	0	26943
2331	9	338	1	26939	0	27287
2332	20	1	27010	5	0	27036
2333	6	28891	2	17	0	28916
2334	13	80	5	28830	0	28928
2335	48	1	29668	7	0	29724
2336	30860	1	48	21	0	30930
2337	3	32881	0	9	0	32893
2338	10	89	7	32280	0	32386
2339	2	32147	1	20	0	32170
2340	4	57	5	33154	0	33220
2341	34965	2	45	5	0	35017
2342	17	100	9	35092	0	35218
2343	2	35936	0	16	0	35954
2344	35776	3	48	9	0	35836
2345	8	57	4	36990	0	37059
2346	2	43	2	38540	0	38587
2347	38238	0	31	1	0	38270
2348	6	48	4	37532	0	37590
2349	11	64	5	36660	0	36740
2350	26	2	35677	11	0	35716
2351	15	1	35184	12	0	35212
2352	13	133	1	34778	0	34925
2353	24	0	33947	7	0	33978
2354	14	0	34402	11	0	34427
2355	33909	4	79	11	0	34003
2356	19	0	34551	2	0	34572
2357	4	35004	0	16	0	35024
2358	0	61	4	35344	0	35409
2359	35427	2	29	2	0	35460
2360	35319	8	33	8	0	35368
2361	35405	2	53	0	0	35460
2362	1	34946	0	5	0	34952
2363	4	57	1	34600	0	34662
2364	3	16	0	34572	0	34591
2365	34428	1	27	4	0	34460
2366	34141	4	66	4	0	34215
2367	34158	6	76	4	0	34244
2368	10	0	34368	36	0	34414
2369	8	34567	0	48	0	34623
2370	2	32515	1	13	0	32531
2371	4	110	3	32367	0	32484
2372	1	70	1	32450	0	32522
2373	3	0	32700	18	0	32721
2374	31674	2	37	7	0	31720
2375	31870	1	56	6	0	31933
2376	3	18	2	32000	0	32023
2377	2	39	3	31459	0	31503
2378	0	12	3	31691	0	31706
2379	31621	3	29	3	0	31656
2380	19	3	31768	4	0	31794
2381	14	0	32953	3	0	32970
2382	10	74	1	32437	0	32522
2383	14	0	32306	0	0	32320
2384	32937	0	64	10	0	33011
2385	33046	0	56	3	0	33105
2386	32987	10	191	6	0	33194
2387	1	33567	0	8	0	33576
2388	33498	1	33	2	0	33534
2389	4	64	13	33510	0	33591
2390	8	48	2	33472	0	33530
2391	5	42	3	33761	0	33811
2392	14	0	33515	4	0	33533
2393	9	208	4	33577	0	33798
2394	3	33681	3	24	0	33711
2395	33677	4	177	5	0	33863
2396	1	33360	0	24	0	33385
2397	184	1	33073	3	0	33261
2398	5	33190	2	17	0	33214
2399	33351	1	91	11	0	33454
2400	2	35622	0	19	0	35643
2401	12	133	4	35903	0	36052
2402	2	37024	0	12	0	37038
2403	37041	3	52	3	0	37099
2404	36444	4	65	5	0	36518
2405	36348	1	59	6	0	36414
2406	18	0	35640	1	0	35659
2407	43	0	35762	4	0	35809
2408	13	1	35936	5	0	35955
2409	33838	7	91	12	0	33948
2410	6	77	7	34139	0	34229
2411	6	83	2	32258	0	32349
2412	27	3	36209	2	0	36241
2413	1	78	2	34658	0	34739
2414	34721	2	36	7	0	34766
2415	3	33798	1	6	0	33808
2416	32547	3	49	14	0	32613
2417	14	0	31253	3	0	31270
2418	31377	1	65	6	0	31449
2419	31125	4	70	10	0	31209
2420	30713	1	99	4	0	30817
2421	14	0	29794	2	0	29810
2422	3	80	10	26796	0	26889
2423	13	0	27457	0	0	27470
2424	8	74	8	27209	0	27299
2425	14	1	27625	3	0	27643
2426	9	116	8	27485	0	27618
2427	5	18	1	27422	0	27446
2428	28030	2	30	1	0	28063
2429	27984	2	40	9	0	28035
2430	27745	1	83	0	0	27829
2431	8	42	3	27445	0	27498
2432	3	27203	0	12	0	27218
2433	3	26983	0	13	0	26999
2434	26709	5	68	3	0	26785
2435	14	1	26981	3	0	26999
2436	27154	1	59	6	0	27220
2437	6	2	27128	1	0	27137
2438	27588	4	94	1	0	27687
2439	27217	3	72	4	0	27296
2440	8	1	27362	3	0	27374
2441	28541	0	58	10	0	28609
2442	28718	2	75	1	0	28796
2443	28814	2	102	5	0	28923
2444	2	28394	0	11	0	28407
2445	4	75	4	28301	0	28384
2446	12	5	29476	4	0	29497
2447	28	6	29385	8	0	29427
2448	8	29944	3	165	0	30120
2449	2	31022	3	6	0	31033
2450	3	53	3	30742	0	30801
2451	32086	2	45	5	0	32138
2452	2	32317	0	4	0	32323
2453	14	68	4	31908	0	31994
2454	4	32169	1	11	0	32185
2455	31354	6	46	6	0	31412
2456	4	86	4	31194	0	31288
2457	28	1	31269	2	0	31300
2458	12	32029	3	18	0	32062
2459	1	32306	3	14	0	32324
2460	10	83	3	31689	0	31785
2461	0	32033	0	3	0	32036
2462	2	59	4	31866	0	31931
2463	32087	1	14	1	0	32103
2464	31963	2	70	2	0	32037
2465	31686	1	24	1	0	31712
2466	31466	5	156	3	0	31630
2467	4	2	31488	0	0	31494
2468	5	32489	37	11	0	32542
2469	11	32097	0	15	0	32123
2470	8	32040	0	19	0	32067
2471	4	32307	2	16	0	32329
2472	32488	4	36	13	0	32541
2473	32596	5	39	1	0	32641
2474	32152	4	31	0	0	32187
2475	32139	6	88	5	0	32238
2476	0	0	30473	2	0	30475
2477	29761	4	51	2	0	29818
2478	29021	1	41	4	0	29067
2479	29541	4	51	6	0	29602
2480	2	21	5	29372	0	29400
2481	0	46	2	29466	0	29514
2482	30464	0	8	1	0	30473
2483	3	72	2	30060	0	30137
2484	2	30086	0	4	0	30092
2485	5	92	5	29647	0	29749
2486	9	59	1	30349	0	30418
2487	2	27109	0	34	0	27145
2488	2	44	5	26825	0	26876
2489	1	8	4	27056	0	27069
2490	26978	1	44	6	0	27029
2491	5	0	26988	3	0	26996
2492	29087	2	87	10	0	29186
2493	25	0	29294	3	0	29322
2494	15	1	29042	3	0	29061
2495	20	1	29618	8	0	29647
2496	28932	1	71	13	0	29017
2497	12	0	29155	2	0	29169
2498	29629	5	72	12	0	29718
2499	29380	3	75	8	0	29466
2500	29489	3	67	6	0	29565
2501	1	31468	0	22	0	31491
2502	31203	3	72	4	0	31282
2503	0	32170	0	10	0	32180
2504	6	67	4	31345	0	31422
2505	13	62	1	32422	0	32498
2506	9	32340	6	20	0	32375
2507	6	32596	0	433	0	33035
2508	1	33197	0	18	0	33216
2509	33286	8	41	13	0	33348
2510	1	33136	0	13	0	33150
2511	32805	2	72	4	0	32883
2512	2	0	33138	2	0	33142
2513	32471	0	42	3	0	32516
2514	32336	4	109	7	0	32456
2515	5	0	34151	0	0	34156
2516	5	64	3	33357	0	33429
2517	5	0	33176	1	0	33182
2518	5	56	2	33433	0	33496
2519	2	42	0	33603	0	33647
2520	33555	1	51	5	0	33612
2521	33205	2	72	11	0	33290
2522	3	32108	0	17	0	32128
2523	30541	28	47	16	0	30632
2524	7	0	30932	2	0	30941
2525	29897	8	203	6	0	30114
2526	7	2	30306	2	0	30317
2527	17	0	29868	6	0	29891
2528	29573	2	41	10	0	29626
2529	29651	5	87	4	0	29747
2530	12	0	29917	0	0	29929
2531	3	46	3	29980	0	30032
2532	4	88	2	29606	0	29700
2533	7	0	29947	0	0	29954
2534	5	107	4	29464	0	29580
2535	2	28966	1	11	0	28980
2536	12	61	4	30489	0	30566
2537	9	90	4	30383	0	30486
2538	4	0	30352	7	0	30363
2539	30691	1	70	5	0	30767
2540	30773	1	74	1	0	30849
2541	30710	13	131	6	0	30860
2542	30387	17	96	7	0	30507
2543	0	31134	0	4	0	31138
2544	8	72	2	30730	0	30812
2545	57	1	31025	3	0	31086
2546	19	1	31150	2	0	31172
2547	13	63	3	31030	0	31109
2548	144	0	31118	3	0	31265
2549	32878	0	57	8	0	32943
2550	4	86	4	33334	0	33428
2551	11	106	6	33294	0	33417
2552	1	32	0	32992	0	33025
2553	32919	1	57	6	0	32983
2554	3	32659	0	18	0	32680
2555	32382	2	64	7	0	32455
2556	32680	3	67	7	0	32757
2557	13	36025	0	15	0	36053
2558	2	37506	1	9	0	37518
2559	37340	4	53	2	0	37399
2560	4	57	10	37280	0	37351
2561	0	39	1	37234	0	37274
2562	36531	7	96	8	0	36642
2563	6	0	36454	2	0	36462
2564	36496	6	82	6	0	36590
2565	36514	3	95	8	0	36620
2566	3	36616	1	14	0	36634
2567	33966	0	64	7	0	34037
2568	36839	2	75	11	0	36927
2569	11	36385	1	64	0	36461
2570	4	36420	1	9	0	36434
2571	3	88	2	36391	0	36484
2572	36439	0	71	2	0	36512
2573	2	36719	0	15	0	36736
2574	5	41	5	37093	0	37144
2575	37165	1	47	0	0	37213
2576	14	0	37235	0	0	37249
2577	7	50	3	34795	0	34855
2578	14	0	34677	5	0	34696
2579	33776	3	81	17	0	33877
2580	33745	5	92	0	0	33842
2581	9	0	32856	0	0	32865
2582	1	31955	1	17	0	31974
2583	2	65	2	31785	0	31854
2584	7	1	32561	0	0	32569
2585	3	40	1	33016	0	33060
2586	40	51	6	35681	0	35778
2587	6	0	35878	4	0	35888
2588	35674	6	68	5	0	35753
2589	35389	4	172	4	0	35569
2590	32	0	34926	3	0	34961
2591	3	33714	0	27	0	33744
2592	5	78	7	33426	0	33516
2593	3	34372	0	20	0	34395
2594	2	34172	0	22	0	34196
2595	34369	2	49	2	0	34422
2596	1	41	3	34612	0	34657
2597	11	48	8	34469	0	34536
2598	16	0	34646	3	0	34665
2599	15	2	34807	6	0	34830
2600	1	48	4	35695	0	35748
2601	12	82	3	35799	0	35896
2602	26	1	35148	2	0	35177
2603	127	1	36543	5	0	36676
2604	9	54	4	36899	0	36966
2605	37838	2	38	3	0	37881
2606	11	37181	2	949	0	38143
2607	39338	11	123	8	0	39480
2608	12	39328	1	52	0	39393
2609	2	39166	0	27	0	39195
2610	39863	5	83	6	0	39957
2611	30	0	39787	2	0	39819
2612	11	100	9	39566	0	39686
2613	4	107	7	39479	0	39597
2614	4	90	7	39490	0	39591
2615	25	1	41640	0	0	41666
2616	8	40	0	41831	0	41879
2617	41624	2	131	2	0	41759
2618	8	55	3	41624	0	41690
2619	5	19	0	41701	0	41725
2620	41220	5	60	1	0	41286
2621	40960	4	114	2	0	41080
2622	0	41098	1	10	0	41109
2623	26	4	40889	6	0	40925
2624	28	2	41674	12	0	41716
2625	90	0	41867	13	0	41970
2626	0	42104	2	23	0	42129
2627	11	123	3	42259	0	42396
2628	10	40	2	42469	0	42521
2629	42809	0	34	2	0	42845
2630	12	62	4	42920	0	42998
2631	24	0	42947	1	0	42972
2632	14	142	4	43133	0	43293
2633	8	52	4	39114	0	39178
2634	32	0	36631	16	0	36679
2635	3	36597	3	23	0	36626
2636	10	93	6	36061	0	36170
2637	10	36586	1	24	0	36621
2638	23	0	36488	6	0	36517
2639	36482	0	39	9	0	36530
2640	37747	0	64	6	0	37817
2641	38075	2	91	9	0	38177
2642	8	66	6	37950	0	38030
2643	7	35438	0	18	0	35463
2644	35441	4	71	2	0	35518
2645	35185	1	123	6	0	35315
2646	34580	4	81	8	0	34673
2647	5	4	34501	4	0	34514
2648	34596	4	94	9	0	34703
2649	5	34101	1	12	0	34119
2650	33765	3	104	5	0	33877
2651	1	33752	0	13	0	33766
2652	33512	3	128	20	0	33663
2653	5	0	36542	2	0	36549
2654	37090	1	60	15	0	37166
2655	37482	2	152	1	0	37637
2656	37878	4	70	2	0	37954
2657	37437	2	179	2	0	37620
2658	11	2	38384	7	0	38404
2659	2	80	2	38501	0	38585
2660	37610	3	51	7	0	37671
2661	2	37604	0	18	0	37624
2662	12	67	1	34623	0	34703
2663	23	0	34864	8	0	34895
2664	9	91	3	35098	0	35201
2665	14	0	34853	19	0	34886
2666	13	35807	3	16	0	35839
2667	14	35397	1	14	0	35426
2668	1	35610	1	17	0	35629
2669	14	73	7	35505	0	35599
2670	6	88	3	35547	0	35644
2671	23	1	35467	8	0	35499
2672	14	35646	4	20	0	35684
2673	36795	8	92	6	0	36901
2674	9	37543	1	26	0	37579
2675	4	36411	0	24	0	36439
2676	6	47	4	37006	0	37063
2677	37523	4	37	9	0	37573
2678	38502	0	77	13	0	38592
2679	2	45	3	37090	0	37140
2680	37110	4	43	8	0	37165
2681	4	57	5	36666	0	36732
2682	11	2	36142	5	0	36160
2683	35419	4	93	8	0	35524
2684	5	67	3	35617	0	35692
2685	22	0	35150	6	0	35178
2686	16	1	36047	9	0	36073
2687	5	131	0	36719	0	36855
2688	36837	1	40	4	0	36882
2689	36858	1	111	8	0	36978
2690	3	35045	2	11	0	35061
2691	35669	5	60	3	0	35737
2692	36412	3	44	8	0	36467
2693	36621	10	94	7	0	36732
2694	2	37618	0	15	0	37635
2695	36047	5	88	6	0	36146
2696	36296	1	132	4	0	36433
2697	4	34	2	36486	0	36526
2698	36610	3	51	1	0	36665
2699	6	34864	0	12	0	34882
2700	5	37662	1	17	0	37685
2701	7	107	6	37177	0	37297
2702	11	98	1	39218	0	39328
2703	4	39129	1	19	0	39153
2704	39136	3	106	6	0	39251
2705	2	39124	0	26	0	39152
2706	38847	7	121	6	0	38981
2707	4	41206	0	17	0	41227
2708	20	97	4	39980	0	40101
2709	6	41634	1	18	0	41659
2710	41839	4	75	5	0	41923
2711	42031	3	72	5	0	42111
2712	41882	9	138	6	0	42035
2713	22	1	42328	3	0	42354
2714	12	2	42426	14	0	42454
2715	3	42952	1	32	0	42988
2716	15	2	41758	3	0	41778
2717	23	1	41826	8	0	41858
2718	7	111	6	41699	0	41823
2719	43	2	41737	6	0	41788
2720	19	41581	0	46	0	41646
2721	41994	3	161	8	0	42166
2722	18	43359	2	27	0	43406
2723	12	43102	5	30	0	43149
2724	43498	21	79	13	0	43611
2725	43645	1	72	8	0	43726
2726	1	43049	1	15	0	43066
2727	42688	6	73	10	0	42777
2728	42671	5	49	2	0	42727
2729	39616	6	79	4	0	39705
2730	10	0	40378	0	0	40388
2731	10	1	39850	4	0	39865
2732	3	53	4	39481	0	39541
2733	0	23	4	39840	0	39867
2734	39350	2	61	0	0	39413
2735	3	39698	1	8	0	39710
2736	4	95	2	39426	0	39527
2737	5	68	0	39325	0	39398
2738	7	58	1	39273	0	39339
2739	6	58	1	38696	0	38761
2740	18	0	39111	4	0	39133
2741	26	1	39595	5	0	39627
2742	10	53	8	39817	0	39888
2743	12	0	39712	2	0	39726
2744	39019	6	119	5	0	39149
2745	12	102	2	39259	0	39375
2746	15	0	39284	5	0	39304
2747	40388	5	152	21	0	40566
2748	3	39689	1	17	0	39710
2749	39179	5	90	4	0	39278
2750	2	36343	2	18	0	36365
2751	7	126	3	36546	0	36682
2752	17	1	38968	0	0	38986
2753	13	86	7	39654	0	39760
2754	24	0	39943	1	0	39968
2755	40120	5	125	25	0	40275
2756	5	43	4	40180	0	40232
2757	39447	3	70	12	0	39532
2758	9	2	39430	2	0	39443
2759	38996	3	176	15	0	39190
2760	38358	3	154	3	0	38518
2761	16	1	38394	1	0	38412
2762	8	52	4	35687	0	35751
2763	26	0	35657	0	0	35683
2764	17	35354	1	27	0	35399
2765	36028	3	106	3	0	36140
2766	35892	0	102	29	0	36023
2767	14	1	36808	8	0	36831
2768	11	0	38946	5	0	38962
2769	8	101	8	38711	0	38828
2770	2	42	4	37818	0	37866
2771	42666	5	78	9	0	42758
2772	10	42921	3	27	0	42961
2773	43783	1	96	4	0	43884
2774	43713	6	106	9	0	43834
2775	9	0	43317	2	0	43328
2776	39497	9	182	9	0	39697
2777	11	1	40445	1	0	40458
2778	6	148	4	38667	0	38825
2779	24	0	38948	0	0	38972
2780	11	84	3	39164	0	39262
2781	14	0	39697	1	0	39712
2782	40076	3	116	8	0	40203
2783	38083	0	58	3	0	38144
2784	7	35	1	38014	0	38057
2785	36888	0	44	8	0	36940
2786	7	57	6	36570	0	36640
2787	1	36588	0	10	0	36599
2788	36183	3	168	7	0	36361
2789	2	37804	0	10	0	37816
2790	5	76	7	36779	0	36867
2791	6	69	6	38182	0	38263
2792	5	105	1	38288	0	38399
2793	2	76	0	37954	0	38032
2794	16	3	37955	4	0	37978
2795	37647	2	122	5	0	37776
2796	38089	1	103	2	0	38195
2797	4	38134	1	338	0	38477
2798	8	50	1	37169	0	37228
2799	14	59	5	37762	0	37840
2800	10	0	38105	2	0	38117
2801	38203	2	83	10	0	38298
2802	7	80	2	38273	0	38362
2803	20	1	38337	0	0	38358
2804	37998	3	126	8	0	38135
2805	37981	2	381	3	0	38367
2806	37390	6	527	17	0	37940
2807	11	2	38211	3	0	38227
2808	9	0	38971	6	0	38986
2809	38133	0	306	6	0	38445
2810	6	50	2	38952	0	39010
2811	8	101	3	38387	0	38499
2812	9	1	39004	5	0	39019
2813	40072	3	230	4	0	40309
2814	2	36	4	40452	0	40494
2815	40514	3	50	4	0	40571
2816	39942	6	74	9	0	40031
2817	38545	3	153	6	0	38707
2818	31	0	39884	2	0	39917
2819	5	28	1	40039	0	40073
2820	40608	1	75	7	0	40691
2821	6	40605	0	13	0	40624
2822	7	67	4	39563	0	39641
2823	5	37	3	39712	0	39757
2824	40572	1	26	2	0	40601
2825	40525	3	59	1	0	40588
2826	7	53	4	39544	0	39608
2827	15	0	39219	3	0	39237
2828	36075	5	175	7	0	36262
2829	5	1	36465	3	0	36474
2830	35751	0	209	13	0	35973
2831	35724	3	130	6	0	35863
2832	14	1	36584	2	0	36601
2833	5	101	2	35764	0	35872
2834	10	0	35757	4	0	35771
2835	3	36419	2	31	0	36455
2836	12	65	2	35891	0	35970
2837	6	36729	1	34	0	36770
2838	12	62	3	36588	0	36665
2839	44	3	39764	7	0	39818
2840	16	39859	4	24	0	39903
2841	7	38313	0	44	0	38364
2842	12	45	5	38017	0	38079
2843	38584	3	43	6	0	38636
2844	2	36	5	36850	0	36893
2845	36674	0	100	3	0	36777
2846	0	36964	0	12	0	36976
2847	32062	3	102	4	0	32171
2848	5	0	31806	3	0	31814
2849	6	64	7	31475	0	31552
2850	3	58	1	31030	0	31092
2851	19	0	30624	10	0	30653
2852	30171	2	97	7	0	30277
2853	31793	3	112	2	0	31910
2854	1	32154	0	15	0	32170
2855	8	40	1	31470	0	31519
2856	6	31749	1	21	0	31777
2857	29	2	31278	2	0	31311
2858	14	1	33686	7	0	33708
2859	3	62	3	34861	0	34929
2860	34661	0	94	6	0	34761
2861	7	34562	0	16	0	34585
2862	34186	0	101	8	0	34295
2863	13	1	35609	1	0	35624
2864	37698	2	91	9	0	37800
2865	36431	5	111	0	0	36547
2866	13	1	37226	2	0	37242
2867	4	39	5	36543	0	36591
2868	36717	3	155	1	0	36876
2869	36696	9	137	4	0	36846
2870	36701	8	64	6	0	36779
2871	7	24	4	37515	0	37550
2872	14	0	37747	5	0	37766
2873	36257	9	157	12	0	36435
2874	16	2	36682	1	0	36701
2875	0	49	2	36427	0	36478
2876	15	78	3	36306	0	36402
2877	3	36790	1	38	0	36832
2878	32	1	36892	4	0	36929
2879	14	37256	1	20	0	37291
2880	4	36293	3	9	0	36309
2881	14	63	5	35987	0	36069
2882	10	0	37002	1	0	37013
2883	7	70	0	37551	0	37628
2884	16	0	38053	0	0	38069
2885	5	62	5	40018	0	40090
2886	28	57	4	38997	0	39086
2887	20	0	38925	19	0	38964
2888	29	100	4	38435	0	38568
2889	22	0	37451	8	0	37481
2890	28	7	38075	7	0	38117
2891	3	37646	1	52	0	37702
2892	36987	20	91	27	0	37125
2893	10	4	36997	3	0	37014
2894	37341	2	112	17	0	37472
2895	2	95	4	37331	0	37432
2896	19	2	36692	4	0	36717
2897	1	36764	0	325	0	37090
2898	22	72	3	36696	0	36793
2899	20	0	37146	0	0	37166
2900	11	117	3	37506	0	37637
2901	2	38438	1	29	0	38470
2902	39149	0	76	4	0	39229
2903	4	38	2	38755	0	38799
2904	41699	2	30	2	0	41733
2905	41072	0	37	5	0	41114
2906	40960	2	44	1	0	41007
2907	42500	1	83	1	0	42585
2908	41729	6	55	8	0	41798
2909	2	42531	1	8	0	42542
2910	3	111	11	40932	0	41057
2911	3	71	2	41185	0	41261
2912	1	64	2	43079	0	43146
2913	15	1	42356	4	0	42376
2914	4	39430	2	22	0	39458
2915	39535	4	85	6	0	39630
2916	39806	4	87	7	0	39904
2917	8	40750	0	38	0	40796
2918	6	37162	0	3422	0	40590
2919	40371	5	64	9	0	40449
2920	10	0	42226	2	0	42238
2921	6	54	2	42591	0	42653
2922	42296	1	73	5	0	42375
2923	14	205	0	41852	0	42071
2924	2	42069	2	8	0	42081
2925	8	85	2	41703	0	41798
2926	14	1	42679	1	0	42695
2927	44094	5	112	18	0	44229
2928	44279	3	110	3	0	44395
2929	7	87	3	42318	0	42415
2930	0	30	0	42294	0	42324
2931	44340	2	54	4	0	44400
2932	4	42169	0	5	0	42178
2933	4	78	2	42004	0	42088
2934	2	47	6	42182	0	42237
2935	41480	4	37	2	0	41523
2936	10	42023	0	22	0	42055
2937	41803	7	360	13	0	42183
2938	7	41472	3	18	0	41500
2939	3	40645	1	26	0	40675
2940	39387	3	89	6	0	39485
2941	6	38391	0	34	0	38431
2942	11	40	3	37578	0	37632
2943	16	1	37769	4	0	37790
2944	33	1	37487	7	0	37528
2945	10	3	37805	13	0	37831
2946	4	38521	1	31	0	38557
2947	37879	4	105	4	0	37992
2948	0	33	7	37491	0	37531
2949	2	46	3	37283	0	37334
2950	9	0	38072	2	0	38083
2951	39483	2	94	8	0	39587
2952	5	52	4	42983	0	43044
2953	5	67	4	42168	0	42244
2954	3	32	6	42488	0	42529
2955	42229	8	45	5	0	42287
2956	6	0	42575	4	0	42585
2957	44183	3	155	0	0	44341
2958	7	59	3	43418	0	43487
2959	22	0	43015	7	0	43044
2960	40272	6	128	12	0	40418
2961	12	1	41073	1	0	41087
2962	8	105	2	41468	0	41583
2963	16	0	41050	5	0	41071
2964	21	1	41917	13	0	41952
2965	41730	2	349	6	0	42087
2966	5	1	42615	2	0	42623
2967	4	35	1	42908	0	42948
2968	42322	0	337	5	0	42664
2969	7	288	2	42154	0	42451
2970	26	0	41375	0	0	41401
2971	26	1	41982	10	0	42019
2972	14	42160	1	42	0	42217
2973	2	46	0	40487	0	40535
2974	42194	1	102	12	0	42309
2975	4	41466	0	26	0	41496
2976	41727	0	87	5	0	41819
2977	6	26	3	41084	0	41119
2978	40789	2	40	9	0	40840
2979	2	41785	1	35	0	41823
2980	3	45	6	38752	0	38806
2981	38845	1	47	1	0	38894
2982	4	38597	0	17	0	38618
2983	30	42	3	37042	0	37117
2984	4	41	2	38669	0	38716
2985	37812	0	5	0	0	37817
2986	7	61	4	37834	0	37906
2987	8	54	4	37748	0	37814
2988	6	59	2	35868	0	35935
2989	6	0	35997	2	0	36005
2990	36084	10	80	10	0	36184
2991	8	65	4	36423	0	36500
2992	16	2	36251	1	0	36270
2993	34401	7	102	12	0	34522
2994	8	0	34790	0	0	34798
2995	7	89	6	34776	0	34878
2996	2	33748	0	26	0	33776
2997	18	58	2	33720	0	33798
2998	13	1	33731	0	0	33745
2999	12	2	33933	4	0	33951
3000	10	144	3	33542	0	33699
3001	13	0	33617	4	0	33634
3002	30773	5	156	14	0	30948
3003	9	1	31234	0	0	31244
3004	5	101	4	31164	0	31274
3005	7	32	3	31048	0	31090
3006	8	39	1	30952	0	31000
3007	29614	4	16	4	0	29638
3008	29196	3	54	2	0	29255
3009	29769	2	30	2	0	29803
3010	8	32	3	29578	0	29621
3011	6	44	1	29393	0	29444
3012	15	0	28596	3	0	28614
3013	21	2	28847	0	0	28870
3014	4	28151	0	7	0	28162
3015	3	69	2	28426	0	28500
3016	17	200	1	28668	0	28886
3017	5	29222	1	7	0	29235
3018	29392	2	63	6	0	29463
3019	1	29788	1	8	0	29798
3020	29725	1	68	3	0	29797
3021	6	31	1	29216	0	29254
3022	29036	2	31	2	0	29071
3023	7	179	1	29141	0	29328
3024	12	1	29818	1	0	29832
3025	4	29	1	30724	0	30758
3026	29433	0	22	2	0	29457
3027	5	40	3	28313	0	28361
3028	4	47	1	24599	0	24651
3029	26	1	24619	4	0	24650
3030	5	61	0	27830	0	27896
3031	13	57	5	29761	0	29836
3032	2	29483	0	5	0	29490
3033	12	87	2	32334	0	32435
3034	2	51	0	32752	0	32805
3035	11	90	2	34911	0	35014
3036	4	35239	3	14	0	35260
3037	7	41	3	35255	0	35306
3038	35226	0	35	6	0	35267
3039	15	35026	0	49	0	35090
3040	9	34001	3	19	0	34032
3041	1	34078	0	31	0	34110
3042	16	238	9	33016	0	33279
3043	10	33839	0	22	0	33871
3044	0	33410	1	407	0	33818
3045	33647	3	100	7	0	33757
3046	20	1	33727	2	0	33750
3047	32069	2	1099	6	0	33176
3048	4	69	4	32726	0	32803
3049	19	1	32891	2	0	32913
3050	30901	3	112	12	0	31028
3051	22	0	31143	2	0	31167
3052	8	0	30790	9	0	30807
3053	30802	1	86	5	0	30894
3054	6	44	2	30800	0	30852
3055	7	1	29717	0	0	29725
3056	29732	3	131	15	0	29881
3057	29678	1	93	8	0	29780
3058	12	0	29907	2	0	29921
3059	29631	0	87	8	0	29726
3060	27943	2	80	4	0	28029
3061	12	0	27932	2	0	27946
3062	27615	3	60	9	0	27687
3063	27609	4	93	4	0	27710
3064	10	0	27514	3	0	27527
3065	7	1	27426	2	0	27436
3066	4	51	6	26808	0	26869
3067	7	1	26557	5	0	26570
3068	26340	2	73	2	0	26417
3069	5	47	6	26223	0	26281
3070	8	41	3	25957	0	26009
3071	11	0	26054	0	0	26065
3072	2	92	5	25713	0	25812
3073	6	1	25689	0	0	25696
3074	25502	2	137	15	0	25656
3075	25540	3	75	4	0	25622
3076	4	0	25687	0	0	25691
3077	25438	0	55	5	0	25498
3078	25336	1	71	5	0	25413
3079	5	0	25309	1	0	25315
3080	25044	0	41	1	0	25086
3081	24894	4	83	8	0	24989
3082	4	0	25039	2	0	25045
3083	24594	6	59	3	0	24662
3084	4	0	24749	0	0	24753
3085	5	96	5	24083	0	24189
3086	4	63	5	24002	0	24074
3087	0	29	5	23968	0	24002
3088	7	1	23673	1	0	23682
3089	23157	1	112	6	0	23276
3090	11	0	23632	3	0	23646
3091	9	23224	3	16	0	23252
3092	6	22780	2	12	0	22800
3093	22564	0	41	3	0	22608
3094	7	32	2	22473	0	22514
3095	3	21930	1	15	0	21949
3096	22039	1	40	1	0	22081
3097	22175	1	49	3	0	22228
3098	3	21884	0	2	0	21889
3099	4	11	1	21099	0	21115
3100	18	21553	0	1	0	21572
3101	20659	0	7	3	0	20669
3102	20917	0	7	2	0	20926
3103	2	7	1	20870	0	20880
3104	20691	1	5	7	0	20704
3105	5	12	0	20092	0	20109
3106	10	3	16994	0	0	17007
3107	14599	1	7	2	0	14609
3108	3	0	14979	0	0	14982
3109	2	10	0	10196	0	10208
3110	9550	0	4	0	0	9554
3111	0	14	0	7021	0	7035
3112	4	0	6372	0	0	6376
3113	2	1	6900	2	0	6905
3114	0	7	0	6694	0	6701
3115	5907	0	6	0	0	5913
3116	1	5612	1	0	0	5614
3117	0	14	1	5431	0	5446
3118	1	0	5596	1	0	5598
3119	5596	0	8	3	0	5607
3120	5594	0	13	3	0	5610
3121	1	0	5630	1	0	5632
3122	5299	0	9	0	0	5308
3123	0	6	1	5500	0	5507
3124	0	0	5498	0	0	5498
3125	5469	1	5	1	0	5476
3126	1	11	0	5602	0	5614
3127	2	5	0	5462	0	5469
3128	5506	1	6	2	0	5515
3129	2	5491	0	3	0	5496
3130	0	5423	0	0	0	5423
3131	5408	1	4	6	0	5419
3132	5496	0	6	0	0	5502
3133	0	0	5558	0	0	5558
3134	6	0	5562	2	0	5570
3135	1	14	0	5606	0	5621
3136	5576	0	0	0	0	5576
3137	5523	0	3	2	0	5528
3138	5730	0	12	0	0	5742
3139	1	5816	0	1	0	5818
3140	0	5832	0	0	0	5832
3141	3	11	0	5722	0	5736
3142	1	9	1	5801	0	5812
3143	0	13	0	5817	0	5830
3144	1	0	5790	0	0	5791
3145	0	0	5774	1	0	5775
3146	5712	0	13	2	0	5727
3147	5738	0	14	0	0	5752
3148	1	6	2	5633	0	5642
3149	0	7	0	5686	0	5693
3150	2	15	3	5668	0	5688
3151	12	0	5662	0	0	5674
3152	5	0	5613	1	0	5619
3153	2	25	0	5658	0	5685
3154	2	0	5621	0	0	5623
3155	1	5609	1	4	0	5615
3156	1	5688	0	2	0	5691
3157	5777	0	6	3	0	5786
3158	0	5816	0	2	0	5818
3159	0	9	0	5813	0	5822
3160	0	12	0	5842	0	5854
3161	0	5885	0	1	0	5886
3162	3	15	4	5856	0	5878
3163	2	0	5867	1	0	5870
3164	0	5909	0	7	0	5916
3165	4	20	0	5882	0	5906
3166	3	0	5919	0	0	5922
3167	0	5876	0	2	0	5878
3168	0	16	1	5895	0	5912
3169	0	6022	0	4	0	6026
3170	2	17	0	6034	0	6053
3171	2	17	1	6015	0	6035
3172	0	5808	0	1	0	5809
3173	5792	0	13	0	0	5805
3174	5817	0	15	0	0	5832
3175	0	5503	1	1	0	5505
3176	2	5245	0	1	0	5248
3177	1	14	1	5221	0	5237
3178	1	0	5338	1	0	5340
3179	5313	0	9	3	0	5325
3180	5318	1	8	0	0	5327
3181	1	0	5343	0	0	5344
3182	5223	0	5	5	0	5233
3183	5032	0	7	1	0	5040
3184	0	0	4714	0	0	4714
3185	4642	0	9	1	0	4652
3186	6	0	4705	1	0	4712
3187	0	4838	0	4	0	4842
3188	4871	0	13	0	0	4884
3189	4323	0	6	1	0	4330
3190	1	0	4453	0	0	4454
3191	4697	1	5	1	0	4704
3192	4667	0	13	1	0	4681
3193	1	0	4726	0	0	4727
3194	4581	0	9	1	0	4591
3195	4589	0	4	0	0	4593
3196	1	0	4610	0	0	4611
3197	4758	0	27	3	0	4788
3198	1	8	0	4741	0	4750
3199	0	7	0	4598	0	4605
3200	4	0	4757	1	0	4762
3201	4	0	4880	0	0	4884
3202	1	15	1	4824	0	4841
3203	0	7	0	4808	0	4815
3204	4736	0	2	1	0	4739
3205	1	0	4909	0	0	4910
3206	4952	0	10	0	0	4962
3207	0	13	0	4975	0	4988
3208	0	0	4876	0	0	4876
3209	4734	0	10	0	0	4744
3210	1	5	1	4734	0	4741
3211	2	0	4756	0	0	4758
3212	4842	0	3	0	0	4845
3213	2	15	1	4881	0	4899
3214	4691	0	7	1	0	4699
3215	0	0	4627	0	0	4627
3216	3	9	1	4597	0	4610
3217	1	4604	0	4	0	4609
3218	4656	1	5	1	0	4663
3219	4793	0	8	0	0	4801
3220	0	4771	0	3	0	4774
3221	4721	0	10	3	0	4734
3222	4722	0	27	0	0	4749
3223	4709	0	9	0	0	4718
3224	0	4828	0	0	0	4828
3225	0	8	0	4748	0	4756
3226	6	0	4768	0	0	4774
3227	2	22	0	4771	0	4795
3228	9	9	0	5014	0	5032
3229	4	0	5000	4	0	5008
3230	2	0	5096	0	0	5098
3231	1	13	0	5121	0	5135
3232	1	5025	1	0	0	5027
3233	5027	0	13	1	0	5041
3234	4951	0	5	0	0	4956
3235	0	5015	0	3	0	5018
3236	5004	0	8	1	0	5013
3237	4983	0	3	3	0	4989
3238	1	0	4986	0	0	4987
3239	4945	0	9	2	0	4956
3240	1	4953	1	4	0	4959
3241	27	0	4869	0	0	4896
3242	3	0	5134	4	0	5141
3243	1	5196	0	5	0	5202
3244	5180	0	5	1	0	5186
3245	2	0	5135	0	0	5137
3246	1	13	1	5156	0	5171
3247	0	0	5217	0	0	5217
3248	5218	1	14	7	0	5240
3249	0	0	5217	0	0	5217
3250	2	0	5103	2	0	5107
3251	5100	0	6	0	0	5106
3252	1	5212	0	2	0	5215
3253	5158	0	10	2	0	5170
3254	5143	0	7	0	0	5150
3255	2	15	0	5357	0	5374
3256	0	5351	0	2	0	5353
3257	5299	0	10	1	0	5310
3258	4	0	5425	0	0	5429
3259	5440	0	7	1	0	5448
3260	1	5634	0	7	0	5642
3261	5449	3	5	0	0	5457
3262	5845	0	3	2	0	5850
3263	1	6006	0	1	0	6008
3264	0	12	2	6096	0	6110
3265	6105	0	7	1	0	6113
3266	1	5974	0	4	0	5979
3267	1	7	1	5781	0	5790
3268	5873	0	5	2	0	5880
3269	0	3	0	5850	0	5853
3270	1	5	2	5876	0	5884
3271	1	5804	0	7	0	5812
3272	5750	0	3	0	0	5753
3273	5763	0	6	1	0	5770
3274	5770	1	5	0	0	5776
3275	0	5678	0	1	0	5679
3276	5590	0	7	0	0	5597
3277	5716	0	9	0	0	5725
3278	0	7	0	5960	0	5967
3279	0	10	1	5963	0	5974
3280	2	0	6041	0	0	6043
3281	0	12	1	5851	0	5864
3282	3	15	0	5790	0	5808
3283	4	0	5761	4	0	5769
3284	5580	1	24	6	0	5611
3285	4	0	5613	1	0	5618
3286	4	1	5615	1	0	5621
3287	0	18	1	5560	0	5579
3288	0	9	1	5506	0	5516
3289	0	5769	0	2	0	5771
3290	5785	0	11	0	0	5796
3291	5764	0	9	0	0	5773
3292	2	5691	0	3	0	5696
3293	1	5646	0	3	0	5650
3294	1	24	2	5535	0	5562
3295	7	5678	0	2	0	5687
3296	5771	1	3	0	0	5775
3297	6057	0	15	0	0	6072
3298	1	8	0	6025	0	6034
3299	0	8	0	6078	0	6086
3300	5904	1	5	1	0	5911
3301	0	0	5915	1	0	5916
3302	5849	1	16	0	0	5866
3303	0	0	5946	0	0	5946
3304	5768	0	8	1	0	5777
3305	0	14	2	5770	0	5786
3306	1	0	5666	0	0	5667
3307	3	0	5987	2	0	5992
3308	6274	3	14	2	0	6293
3309	6493	1	12	0	0	6506
3310	1	6441	0	1	0	6443
3311	2	16	0	6353	0	6371
3312	0	6	1	6429	0	6436
3313	6390	1	18	1	0	6410
3314	2	6625	2	3	0	6632
3315	6673	0	10	2	0	6685
3316	1	6661	0	1	0	6663
3317	1	6432	0	5	0	6438
3318	6326	0	5	2	0	6333
3319	3	0	6361	1	0	6365
3320	1	13	0	6314	0	6328
3321	0	11	1	6343	0	6355
3322	2	0	6556	0	0	6558
3323	1	23	0	6528	0	6552
3324	2	20	0	6501	0	6523
3325	0	6516	0	0	0	6516
3326	6416	2	10	1	0	6429
3327	10	0	6528	0	0	6538
3328	6425	1	9	4	0	6439
3329	0	6800	0	3	0	6803
3330	1	10	0	6723	0	6734
3331	6784	1	11	0	0	6796
3332	1	14	0	6766	0	6781
3333	0	18	0	6828	0	6846
3334	2	0	6737	1	0	6740
3335	6684	13	17	8	0	6722
3336	6490	1	14	0	0	6505
3337	0	0	6550	0	0	6550
3338	2	12	1	6079	0	6094
3339	3	0	6036	0	0	6039
3340	5901	0	51	1	0	5953
3341	5954	0	12	3	0	5969
3342	0	11	0	5986	0	5997
3343	5895	0	9	3	0	5907
3344	1	0	6155	0	0	6156
3345	1	12	3	6083	0	6099
3346	1	10	2	6050	0	6063
3347	0	9	1	6045	0	6055
3348	1	3	0	5877	0	5881
3349	5840	1	3	1	0	5845
3350	4	0	5862	0	0	5866
3351	5	12	0	5816	0	5833
3352	2	0	5814	0	0	5816
3353	1	0	5552	1	0	5554
3354	0	5	1	5295	0	5301
3355	1	4	1	5432	0	5438
3356	5694	0	3	0	0	5697
3357	1	6	0	5696	0	5703
3358	1	3	0	5745	0	5749
3359	3	5	0	5732	0	5740
3360	5749	0	6	0	0	5755
3361	5711	0	8	0	0	5719
3362	5666	2	6	0	0	5674
3363	5780	1	20	0	0	5801
3364	0	5992	0	0	0	5992
3365	0	9	1	5666	0	5676
3366	0	7	0	5760	0	5767
3367	5748	1	4	1	0	5754
3368	0	5613	0	2	0	5615
3369	1	33	1	5576	0	5611
3370	2	0	5666	0	0	5668
3371	5647	0	30	3	0	5680
3372	3	5846	0	1	0	5850
3373	5652	0	12	0	0	5664
3374	5799	0	12	4	0	5815
3375	0	14	1	5890	0	5905
3376	1	0	6079	0	0	6080
3377	1	10	0	6049	0	6060
3378	6013	0	8	3	0	6024
3379	2	5	0	6003	0	6010
3380	5863	0	7	2	0	5872
3381	1	6125	0	2	0	6128
3382	5933	0	9	0	0	5942
3383	1	17	2	5800	0	5820
3384	0	0	0	5613	0	5613
3385	5430	0	9	0	0	5439
3386	5439	1	3	0	0	5443
3387	5427	0	3	2	0	5432
3388	5543	0	2	1	0	5546
3389	5680	0	7	1	0	5688
3390	0	2	0	5474	0	5476
3391	8	0	5460	0	0	5468
3392	0	5380	1	3	0	5384
3393	5356	1	18	0	0	5375
3394	2	0	5387	1	0	5390
3395	5522	0	7	0	0	5529
3396	1	5661	0	1	0	5663
3397	5589	0	7	0	0	5596
3398	0	12	0	5557	0	5569
3399	0	11	0	5518	0	5529
3400	3	0	5613	1	0	5617
3401	1	21	0	5649	0	5671
3402	7	0	5642	1	0	5650
3403	2	0	5535	0	0	5537
3404	5523	0	10	2	0	5535
3405	5059	0	14	5	0	5078
3406	1	0	5072	0	0	5073
3407	4978	0	16	1	0	4995
3408	5012	0	10	0	0	5022
3409	2	0	5024	0	0	5026
3410	0	5006	0	0	0	5006
3411	0	4	0	5004	0	5008
3412	5008	0	1	0	0	5009
3413	4981	0	8	0	0	4989
3414	4990	0	5	0	0	4995
3415	4815	0	14	0	0	4829
3416	4784	0	37	0	0	4821
3417	0	0	4888	0	0	4888
3418	0	0	5204	4	0	5208
3419	0	1	0	5243	0	5244
3420	4896	0	13	0	0	4909
3421	4882	0	7	0	0	4889
3422	5177	1	14	1	0	5193
3423	5217	7	12	2	0	5238
3424	1	5232	0	2	0	5235
3425	0	5244	1	6	0	5251
3426	5254	0	5	0	0	5259
3427	5236	0	11	0	0	5247
3428	0	5238	0	2	0	5240
3429	5233	0	13	0	0	5246
3430	3	0	5348	0	0	5351
3431	3	10	2	5550	0	5565
3432	5	0	5322	1	0	5328
3433	1	0	5413	0	0	5414
3434	1	15	1	5624	0	5641
3435	0	13	0	5715	0	5728
3436	5	0	5768	0	0	5773
3437	0	14	1	5740	0	5755
3438	0	3	0	5734	0	5737
3439	5681	0	8	1	0	5690
3440	5544	0	6	1	0	5551
3441	1	4	1	5517	0	5523
3442	3	0	5423	0	0	5426
3443	0	5390	0	5	0	5395
3444	5342	0	14	2	0	5358
3445	1	0	5458	0	0	5459
3446	0	5361	0	1	0	5362
3447	4	5171	0	1	0	5176
3448	5225	0	10	2	0	5237
3449	5484	0	7	0	0	5491
3450	0	4	1	5399	0	5404
3451	4	0	5314	1	0	5319
3452	0	11	10	5105	0	5126
3453	0	9	0	5094	0	5103
3454	0	5	0	5116	0	5121
3455	5196	3	9	1	0	5209
3456	0	5040	0	2	0	5042
3457	0	5004	1	3	0	5008
3458	3	11	0	4921	0	4935
3459	0	1	0	5031	0	5032
3460	5063	0	4	2	0	5069
3461	5201	0	4	0	0	5205
3462	5285	0	7	1	0	5293
3463	0	5345	0	4	0	5349
3464	5316	1	3	1	0	5321
3465	0	4	0	5187	0	5191
3466	5	0	5132	0	0	5137
3467	3	0	5184	0	0	5187
3468	5173	1	11	3	0	5188
3469	0	0	5228	1	0	5229
3470	5	0	5197	3	0	5205
3471	5043	0	21	0	0	5064
3472	1	0	4974	0	0	4975
3473	4	0	5536	1	0	5541
3474	3	5	0	5380	0	5388
3475	4	0	5390	0	0	5394
3476	0	11	0	5704	0	5715
3477	2	19	0	5704	0	5725
3478	1	0	5710	1	0	5712
3479	0	5711	0	4	0	5715
3480	5686	0	6	2	0	5694
3481	3	1	5655	1	0	5660
3482	2	0	5547	0	0	5549
3483	5458	0	15	3	0	5476
3484	3	0	5695	1	0	5699
3485	1	6033	0	4	0	6038
3486	0	6197	0	1	0	6198
3487	2	12	0	6196	0	6210
3488	8	4	0	6248	0	6260
3489	6477	0	5	0	0	6482
3490	6511	2	6	1	0	6520
3491	6523	0	9	1	0	6533
3492	0	1	0	6508	0	6509
3493	6080	0	4	0	0	6084
3494	6022	0	6	2	0	6030
3495	3	0	6173	1	0	6177
3496	5	0	6408	1	0	6414
3497	2	6302	0	1	0	6305
3498	0	4	2	6179	0	6185
3499	6281	2	5	1	0	6289
3500	4	6279	0	2	0	6285
3501	1	7	2	6450	0	6460
3502	6539	3	10	0	0	6552
3503	6515	1	10	1	0	6527
3504	1	6475	0	1	0	6477
3505	6081	2	13	1	0	6097
3506	6074	2	8	0	0	6084
3507	1	4	1	6121	0	6127
3508	6	0	6078	1	0	6085
3509	2	5963	0	5	0	5970
3510	1	5645	0	4	0	5650
3511	5693	1	10	2	0	5706
3512	2	7	2	5659	0	5670
3513	2	0	5620	1	0	5623
3514	1	5629	0	2	0	5632
3515	5597	0	7	1	0	5605
3516	5666	0	15	2	0	5683
3517	0	0	5671	0	0	5671
3518	0	3	0	5806	0	5809
3519	0	16	0	5738	0	5754
3520	1	0	5706	0	0	5707
3521	5671	0	9	3	0	5683
3522	5678	0	14	1	0	5693
3523	2	10	1	5759	0	5772
3524	0	5549	0	1	0	5550
3525	1	7	1	5396	0	5405
3526	3	0	5531	0	0	5534
3527	5567	1	16	1	0	5585
3528	1	5	0	5918	0	5924
3529	2	0	5946	0	0	5948
3530	5943	0	9	3	0	5955
3531	0	15	0	5967	0	5982
3532	1	3	0	5864	0	5868
3533	5939	1	1	0	0	5941
3534	0	5978	0	0	0	5978
3535	5863	1	15	1	0	5880
3536	0	13	0	5872	0	5885
3537	5695	0	8	3	0	5706
3538	0	0	5932	1	0	5933
3539	1	6146	0	6	0	6153
3540	2	17	3	6080	0	6102
3541	6184	0	8	0	0	6192
3542	0	6442	0	0	0	6442
3543	3	7	0	6392	0	6402
3544	6377	1	3	0	0	6381
3545	6352	1	8	2	0	6363
3546	1	2	0	6323	0	6326
3547	0	0	5947	0	0	5947
3548	2	0	5894	1	0	5897
3549	5729	1	15	0	0	5745
3550	1	5735	0	1	0	5737
3551	0	5394	0	2	0	5396
3552	5638	2	8	2	0	5650
3553	0	5961	0	2	0	5963
3554	0	22	0	5935	0	5957
3555	0	6	0	5956	0	5962
3556	5961	1	3	1	0	5966
3557	5951	0	7	1	0	5959
3558	5938	0	12	1	0	5951
3559	1	0	5989	0	0	5990
3560	1	9	1	5650	0	5661
3561	3	0	5515	0	0	5518
3562	1	0	5406	4	0	5411
3563	1	0	5431	3	0	5435
3564	1	11	1	5498	0	5511
3565	12	0	5279	0	0	5291
3566	1	0	5358	0	0	5359
3567	2	8	0	5389	0	5399
3568	5351	0	14	2	0	5367
3569	3	0	5432	0	0	5435
3570	3	9	0	5615	0	5627
3571	0	11	1	5375	0	5387
3572	4	0	5312	0	0	5316
3573	1	14	1	5252	0	5268
3574	3	0	5360	0	0	5363
3575	0	11	0	5297	0	5308
3576	0	11	0	5203	0	5214
3577	0	8	0	5176	0	5184
3578	1	1	0	5108	0	5110
3579	5111	1	1	2	0	5115
3580	5096	1	13	0	0	5110
3581	1	0	5120	0	0	5121
3582	0	5039	0	3	0	5042
3583	2	4	4983	2	0	4991
3584	4	0	5003	0	0	5007
3585	5257	0	11	2	0	5270
3586	0	5252	0	0	0	5252
3587	6021	0	10	1	0	6032
3588	0	6101	0	2	0	6103
3589	6087	0	11	0	0	6098
3590	6224	0	9	0	0	6233
3591	1	2	0	6194	0	6197
3592	0	6134	0	4	0	6138
3593	2	12	0	6095	0	6109
3594	0	10	0	6118	0	6128
3595	1	1	6301	2	0	6305
3596	0	6314	0	6	0	6320
3597	1	6	0	6293	0	6300
3598	6303	0	12	1	0	6316
3599	6196	0	8	0	0	6204
3600	6241	2	35	1	0	6279
3601	1	6160	0	3	0	6164
3602	6062	1	22	0	0	6085
3603	0	5805	0	2	0	5807
3604	0	6	1	5514	0	5521
3605	2	0	5874	0	0	5876
3606	3	10	1	5851	0	5865
3607	1	5992	0	1	0	5994
3608	2	17	0	5960	0	5979
3609	1	7	2	5934	0	5944
3610	0	5870	0	6	0	5876
3611	5880	0	11	0	0	5891
3612	1	1	0	5869	0	5871
3613	2	0	5832	1	0	5835
3614	0	15	0	5243	0	5258
3615	0	11	2	5184	0	5197
3616	1	0	5131	1	0	5133
3617	3	23	0	5134	0	5160
3618	1	4776	0	6	0	4783
3619	2	0	4748	0	0	4750
3620	3	0	4787	0	0	4790
3621	0	4782	0	3	0	4785
3622	3	4880	0	5	0	4888
3623	0	4913	0	2	0	4915
3624	5061	2	3	3	0	5069
3625	5109	0	5	0	0	5114
3626	5101	0	5	0	0	5106
3627	1	4	0	5063	0	5068
3628	0	0	4833	0	0	4833
3629	1	7	0	4616	0	4624
3630	0	6	0	4667	0	4673
3631	4671	0	10	1	0	4682
3632	4662	1	18	2	0	4683
3633	0	4699	0	0	0	4699
3634	4652	1	7	0	0	4660
3635	4638	0	4	0	0	4642
3636	4554	1	13	1	0	4569
3637	1	0	4601	1	0	4603
3638	1	0	4854	2	0	4857
3639	1	12	1	5256	0	5270
3640	0	0	5247	0	0	5247
3641	5329	0	18	5	0	5352
3642	5254	0	21	2	0	5277
3643	2	0	5265	2	0	5269
3644	5272	0	12	2	0	5286
3645	0	5262	1	2	0	5265
3646	5063	0	12	1	0	5076
3647	1	8	0	5070	0	5079
3648	0	8	0	5062	0	5070
3649	0	4963	0	1	0	4964
3650	4936	2	10	2	0	4950
3651	5007	0	6	0	0	5013
3652	1	5150	0	0	0	5151
3653	0	23	0	5109	0	5132
3654	2	11	0	5697	0	5710
3655	0	5749	0	0	0	5749
3656	1	7	1	5738	0	5747
3657	1	3	0	5799	0	5803
3658	5784	1	6	0	0	5791
3659	5761	1	10	0	0	5772
3660	1	0	5706	0	0	5707
3661	5405	0	13	0	0	5418
3662	6	0	5438	0	0	5444
3663	1	9	2	4788	0	4800
3664	2	0	4724	0	0	4726
3665	1	4615	0	3	0	4619
3666	0	11	2	4581	0	4594
3667	1	5	0	5196	0	5202
3668	5390	0	1	1	0	5392
3669	2	8	0	5464	0	5474
3670	4	0	5435	0	0	5439
3671	5317	1	24	0	0	5342
3672	5367	0	6	0	0	5373
3673	5340	1	11	1	0	5353
3674	5366	0	4	2	0	5372
3675	2	6	0	5378	0	5386
3676	0	3	0	5318	0	5321
3677	2	7	0	5502	0	5511
3678	2	3	1	5514	0	5520
3679	5976	0	2	3	0	5981
3680	5977	2	10	0	0	5989
3681	2	5	0	5664	0	5671
3682	1	5665	0	6	0	5672
3683	5509	9	6	4	0	5528
3684	0	0	5571	0	0	5571
3685	2	5556	0	6	0	5564
3686	5705	0	10	1	0	5716
3687	0	5732	1	5	0	5738
3688	13	0	5706	0	0	5719
3689	5783	0	11	3	0	5797
3690	5761	1	10	0	0	5772
3691	3	0	5841	0	0	5844
3692	1	15	1	6592	0	6609
3693	0	11	0	6499	0	6510
3694	0	6551	0	1	0	6552
3695	1	8	0	6565	0	6574
3696	6635	0	17	2	0	6654
3697	0	6678	1	1	0	6680
3698	1	6	1	6521	0	6529
3699	1	14	1	6507	0	6523
3700	3	1	6335	0	0	6339
3701	2	6299	1	1	0	6303
3702	6409	1	11	0	0	6421
3703	0	6450	4	4	0	6458
3704	2	6364	0	2	0	6368
3705	6620	1	16	1	0	6638
3706	1	1	0	6609	0	6611
3707	0	9	1	6616	0	6626
3708	6746	0	7	0	0	6753
3709	1	7	1	6726	0	6735
3710	0	4	1	6673	0	6678
3711	6773	0	12	0	0	6785
3712	4	5	1	6501	0	6511
3713	1	6370	0	1	0	6372
3714	5845	0	17	1	0	5863
3715	1	0	5871	0	0	5872
3716	0	6054	2	2	0	6058
3717	1	9	5	5917	0	5932
3718	2	0	5943	1	0	5946
3719	0	0	6087	0	0	6087
3720	1	0	0	6078	0	6079
3721	6050	0	1	0	0	6051
3722	2	8	0	5992	0	6002
3723	0	6	0	6015	0	6021
3724	0	10	1	5978	0	5989
3725	0	3	0	5981	0	5984
3726	2	5	7	6043	0	6057
3727	4	0	5991	1	0	5996
3728	2	0	5918	2	0	5922
3729	2	8	0	5833	0	5843
3730	6	0	5201	1	0	5208
3731	0	5175	0	4	0	5179
3732	2	6	0	5160	0	5168
3733	7	0	5251	2	0	5260
3734	5459	1	4	0	0	5464
3735	1	5581	0	1	0	5583
3736	1	5582	0	3	0	5586
3737	1	5534	0	1	0	5536
3738	0	8	0	5527	0	5535
3739	5557	0	17	0	0	5574
3740	0	5	0	5595	0	5600
3741	5690	0	4	1	0	5695
3742	0	5683	0	3	0	5686
3743	5043	1	12	1	0	5057
3744	0	11	1	4982	0	4994
3745	1	6	0	4863	0	4870
3746	0	5255	0	1	0	5256
3747	0	7	1	5127	0	5135
3748	1	8	1	5095	0	5105
3749	0	3	0	5114	0	5117
3750	5062	0	3	0	0	5065
3751	5032	0	13	0	0	5045
3752	1	0	5078	0	0	5079
3753	4862	0	18	0	0	4880
3754	1	0	4947	0	0	4948
3755	0	6	0	4434	0	4440
3756	1	7	0	4488	0	4496
3757	0	9	1	4499	0	4509
3758	0	0	4903	1	0	4904
3759	2	14	0	4933	0	4949
3760	7	0	4926	1	0	4934
3761	0	5	3	4944	0	4952
3762	4829	1	6	0	0	4836
3763	1	0	4829	7	0	4837
3764	4884	2	6	0	0	4892
3765	1	6	0	4860	0	4867
3766	4866	0	4	0	0	4870
3767	0	4729	0	7	0	4736
3768	3	2	0	4026	0	4031
3769	2	0	4069	0	0	4071
3770	0	9	0	4010	0	4019
3771	2	2	1	4082	0	4087
3772	1	4002	0	1	0	4004
3773	7	0	3977	3	0	3987
3774	2	4038	0	3	0	4043
3775	4068	0	14	1	0	4083
3776	1	4050	0	3	0	4054
3777	4035	0	4	0	0	4039
3778	4152	2	6	1	0	4161
3779	4058	1	3	0	0	4062
3780	4	8	0	4102	0	4114
3781	1	0	3854	2	0	3857
3782	0	8	1	3895	0	3904
3783	0	3866	1	1	0	3868
3784	2	34	0	3830	0	3866
3785	3944	0	3	1	0	3948
3786	0	3951	0	0	0	3951
3787	0	4	1	3786	0	3791
3788	0	2	1	3800	0	3803
3789	3681	0	3	1	0	3685
3790	4	0	3666	0	0	3670
3791	0	3598	0	4	0	3602
3792	0	3	0	3515	0	3518
3793	4	0	3577	0	0	3581
3794	0	6	1	3525	0	3532
3795	0	3601	0	0	0	3601
3796	2	14	1	3593	0	3610
3797	1	5	1	3645	0	3652
3798	0	5	0	3644	0	3649
3799	4	0	3623	0	0	3627
3800	3679	1	12	2	0	3694
3801	1	3	1	3697	0	3702
3802	3643	0	2	0	0	3645
3803	3634	0	3	1	0	3638
3804	3585	0	4	1	0	3590
3805	3596	0	8	2	0	3606
3806	3609	2	5	1	0	3617
3807	0	7	0	3631	0	3638
3808	0	3538	0	1	0	3539
3809	4	5	1	3441	0	3451
3810	0	3334	0	1	0	3335
3811	0	1	2	3322	0	3325
3812	3465	1	5	0	0	3471
3813	0	1	0	3440	0	3441
3814	1	0	3401	0	0	3402
3815	3538	0	12	0	0	3550
3816	0	3607	0	3	0	3610
3817	3552	0	4	3	0	3559
3818	3578	0	5	0	0	3583
3819	3550	0	9	1	0	3560
3820	0	3124	0	0	0	3124
3821	1	7	0	3097	0	3105
3822	0	4	0	3151	0	3155
3823	2	0	3166	0	0	3168
3824	0	11	0	3147	0	3158
3825	3	19	0	3148	0	3170
3826	0	10	0	3224	0	3234
3827	2	3260	0	0	0	3262
3828	3295	2	11	0	0	3308
3829	3280	0	3	0	0	3283
3830	3	0	3251	0	0	3254
3831	0	3245	0	2	0	3247
3832	1	20	0	3155	0	3176
3833	0	10	0	3244	0	3254
3834	0	13	0	2865	0	2878
3835	1	4	0	2834	0	2839
3836	1	4	0	3187	0	3192
3837	1	0	3173	0	0	3174
3838	0	0	3187	2	0	3189
3839	3176	0	19	1	0	3196
3840	3134	0	12	0	0	3146
3841	3145	0	10	0	0	3155
3842	0	5	0	3140	0	3145
3843	3	0	3132	0	0	3135
3844	3197	0	5	1	0	3203
3845	3152	1	10	2	0	3165
3846	1	0	3171	0	0	3172
3847	3041	0	11	1	0	3053
3848	3	0	3126	0	0	3129
3849	0	12	1	3223	0	3236
3850	5	0	3192	0	0	3197
3851	3224	0	12	0	0	3236
3852	3170	1	15	0	0	3186
3853	3170	0	10	3	0	3183
3854	3016	0	27	0	0	3043
3855	0	0	3027	0	0	3027
3856	0	3120	0	3	0	3123
3857	3049	0	2	1	0	3052
3858	3043	0	6	1	0	3050
3859	0	0	2961	0	0	2961
3860	1	3	1	3103	0	3108
3861	0	4	2	3079	0	3085
3862	5	0	3092	0	0	3097
3863	3094	0	8	1	0	3103
3864	3172	0	11	0	0	3183
3865	1	3160	0	3	0	3164
3866	3125	0	3	0	0	3128
3867	3129	0	7	0	0	3136
3868	3141	0	8	1	0	3150
3869	3063	0	15	0	0	3078
3870	2	0	3075	0	0	3077
3871	3139	0	8	1	0	3148
3872	0	7	0	3148	0	3155
3873	0	3223	0	0	0	3223
3874	2	0	3223	0	0	3225
3875	0	3196	0	2	0	3198
3876	3	13	0	3194	0	3210
3877	19	0	3202	0	0	3221
3878	3167	0	5	0	0	3172
3879	0	0	3216	0	0	3216
3880	3273	0	6	0	0	3279
3881	0	6	1	3307	0	3314
3882	2	7	2	3298	0	3309
3883	2	3235	0	0	0	3237
3884	0	3227	0	4	0	3231
3885	1	4	0	3250	0	3255
3886	3242	0	6	0	0	3248
3887	3261	3	4	1	0	3269
3888	3127	0	19	1	0	3147
3889	1	0	3260	0	0	3261
3890	3100	0	9	0	0	3109
3891	2	0	3100	0	0	3102
3892	6	0	3228	0	0	3234
3893	3343	0	19	1	0	3363
3894	3464	0	15	1	0	3480
3895	0	0	3630	0	0	3630
3896	2	50	0	3605	0	3657
3897	0	3	0	3634	0	3637
3898	3594	1	5	0	0	3600
3899	3574	1	12	3	0	3590
3900	0	0	3637	0	0	3637
3901	4	3727	0	3	0	3734
3902	0	3698	0	0	0	3698
3903	4613	0	7	1	0	4621
3904	0	14	0	4628	0	4642
3905	8	4	2	4745	0	4759
3906	0	3	0	4812	0	4815
3907	4816	0	2	1	0	4819
3908	0	5	0	4807	0	4812
3909	4761	0	5	0	0	4766
3910	4862	0	12	1	0	4875
3911	0	5025	0	1	0	5026
3912	0	8	1	4623	0	4632
3913	0	0	4687	0	0	4687
3914	4688	0	12	0	0	4700
3915	4934	0	10	0	0	4944
3916	4946	0	15	0	0	4961
3917	0	0	5017	0	0	5017
3918	1	8	2	5060	0	5071
3919	4986	0	10	0	0	4996
3920	4986	0	8	0	0	4994
3921	5212	3	9	2	0	5226
3922	2	5394	0	0	0	5396
3923	0	5348	0	0	0	5348
3924	2	7	2	5238	0	5249
3925	2	7	0	5239	0	5248
3926	1	5446	0	8	0	5455
3927	5406	0	18	3	0	5427
3928	1	0	5550	0	0	5551
3929	0	19	0	5568	0	5587
3930	0	9	0	5446	0	5455
3931	4	1	5527	0	0	5532
3932	5576	0	13	2	0	5591
3933	5577	0	28	0	0	5605
3934	0	5585	0	2	0	5587
3935	5439	1	15	0	0	5455
3936	2	0	5699	0	0	5701
3937	5656	0	14	1	0	5671
3938	2	0	5713	0	0	5715
3939	5774	0	14	2	0	5790
3940	5811	0	5	1	0	5817
3941	5817	0	25	1	0	5843
3942	5854	8	18	1	0	5881
3943	0	5886	0	2	0	5888
3944	5844	0	13	1	0	5858
3945	5697	0	17	1	0	5715
3946	2	0	5774	0	0	5776
3947	5878	0	6	0	0	5884
3948	0	2	1	5908	0	5911
3949	1	0	5806	1	0	5808
3950	5768	1	5	3	0	5777
3951	1	11	0	5839	0	5851
3952	6068	0	7	0	0	6075
3953	6029	1	7	4	0	6041
3954	0	0	6074	1	0	6075
3955	6052	0	8	2	0	6062
3956	6041	2	12	0	0	6055
3957	6090	1	17	1	0	6109
3958	6330	0	5	1	0	6336
3959	1	13	0	6692	0	6706
3960	1	6728	0	3	0	6732
3961	6749	1	12	2	0	6764
3962	6747	0	16	0	0	6763
3963	6716	1	41	2	0	6760
3964	1	0	6769	0	0	6770
3965	1	6851	0	1	0	6853
3966	3	22	1	6761	0	6787
3967	3	17	0	6677	0	6697
3968	6	0	6872	1	0	6879
3969	0	7	0	6784	0	6791
3970	3	0	6728	0	0	6731
3971	1	23	0	6877	0	6901
3972	1	7	0	6854	0	6862
3973	3	0	6848	1	0	6852
3974	6846	0	14	1	0	6861
3975	6790	0	30	2	0	6822
3976	1	0	6780	1	0	6782
3977	6764	0	5	1	0	6770
3978	6963	2	21	1	0	6987
3979	0	0	6069	0	0	6069
3980	2	9	0	6081	0	6092
3981	0	6	0	6015	0	6021
3982	6073	0	7	1	0	6081
3983	0	6453	1	4	0	6458
3984	6443	2	18	0	0	6463
3985	6475	0	12	0	0	6487
3986	0	6353	0	1	0	6354
3987	6256	1	22	2	0	6281
3988	6448	0	6	1	0	6455
3989	0	6425	0	4	0	6429
3990	1	10	1	6321	0	6333
3991	0	6324	0	2	0	6326
3992	0	19	1	6342	0	6362
3993	4	0	6429	0	0	6433
3994	2	0	6610	1	0	6613
3995	6672	0	6	0	0	6678
3996	6644	2	30	2	0	6678
3997	1	0	6449	0	0	6450
3998	6448	0	14	2	0	6464
3999	6436	0	9	2	0	6447
4000	6535	1	13	1	0	6550
4001	0	6369	0	5	0	6374
4002	0	7	2	6348	0	6357
4003	6394	0	4	1	0	6399
4004	6205	5	40	0	0	6250
4005	4	0	6306	0	0	6310
4006	8	19	0	6337	0	6364
4007	0	9	1	6206	0	6216
4008	2	6262	0	2	0	6266
4009	0	6192	0	0	0	6192
4010	1	12	3	6174	0	6190
4011	0	5981	0	2	0	5983
4012	6002	0	4	1	0	6007
4013	0	6038	0	5	0	6043
4014	5943	0	15	1	0	5959
4015	2	0	5989	0	0	5991
4016	6010	0	6	0	0	6016
4017	5985	1	10	0	0	5996
4018	5929	0	15	2	0	5946
4019	6050	0	13	0	0	6063
4020	0	6047	0	0	0	6047
4021	0	6	1	5972	0	5979
4022	0	10	0	5935	0	5945
4023	3	0	5908	0	0	5911
4024	1	9	0	5878	0	5888
4025	0	3	0	5876	0	5879
4026	6160	0	6	0	0	6166
4027	0	6148	0	3	0	6151
4028	1	4	1	5920	0	5926
4029	1	10	0	5906	0	5917
4030	0	1	0	5895	0	5896
4031	6241	0	10	0	0	6251
4032	0	6	1	6228	0	6235
4033	6111	0	3	1	0	6115
4034	1	7	0	5918	0	5926
4035	3	4	0	5418	0	5425
4036	1	0	5382	2	0	5385
4037	5369	3	27	0	0	5399
4038	1	5562	0	1	0	5564
4039	5561	1	8	1	0	5571
4040	0	7	1	5317	0	5325
4041	1	1	1	5301	0	5304
4042	5312	0	5	1	0	5318
4043	5327	0	7	0	0	5334
4044	0	10	0	5281	0	5291
4045	2	0	5234	1	0	5237
4046	2	0	5136	3	0	5141
4047	0	5166	0	5	0	5171
4048	5779	0	13	1	0	5793
4049	5949	0	13	0	0	5962
4050	0	11	0	6084	0	6095
4051	0	6106	0	3	0	6109
4052	4	17	0	6071	0	6092
4053	3	21	0	6070	0	6094
4054	0	5859	0	1	0	5860
4055	5862	1	9	1	0	5873
4056	0	4	0	5902	0	5906
4057	1	5862	0	2	0	5865
4058	2	5742	0	1	0	5745
4059	5374	0	6	4	0	5384
4060	2	0	5442	0	0	5444
4061	5513	1	12	0	0	5526
4062	0	10	0	5531	0	5541
4063	1	8	1	5446	0	5456
4064	1	5143	0	1	0	5145
4065	0	22	3	5024	0	5049
4066	6	1	5063	2	0	5072
4067	0	5094	0	5	0	5099
4068	1	5037	0	6	0	5044
4069	4928	0	4	2	0	4934
4070	0	5021	0	1	0	5022
4071	0	21	1	4888	0	4910
4072	0	4932	0	1	0	4933
4073	2	37	1	4785	0	4825
4074	0	3	1	4893	0	4897
4075	0	0	4939	0	0	4939
4076	0	14	1	4847	0	4862
4077	1	3	0	4862	0	4866
4078	4821	0	5	2	0	4828
4079	2	0	4831	1	0	4834
4080	0	6	1	4910	0	4917
4081	3	1	4853	0	0	4857
4082	4887	0	6	2	0	4895
4083	2	4908	0	1	0	4911
4084	4851	0	40	0	0	4891
4085	1	12	1	4881	0	4895
4086	3	21	1	4900	0	4925
4087	3	0	4905	1	0	4909
4088	4909	1	16	1	0	4927
4089	1	4955	0	1	0	4957
4090	4946	0	9	1	0	4956
4091	3	13	0	4883	0	4899
4092	0	4853	0	2	0	4855
4093	4980	1	7	1	0	4989
4094	1	5137	0	3	0	5141
4095	1	15	0	5165	0	5181
4096	1	7	0	5218	0	5226
4097	0	7	0	5209	0	5216
4098	0	5274	0	1	0	5275
4099	0	12	0	5270	0	5282
4100	0	5	0	5258	0	5263
4101	5286	0	1	1	0	5288
4102	5063	1	5	0	0	5069
4103	4987	1	12	0	0	5000
4104	1	0	5026	1	0	5028
4105	5036	1	6	1	0	5044
4106	5164	0	11	0	0	5175
4107	4791	0	13	1	0	4805
4108	0	0	4842	0	0	4842
4109	4861	1	12	0	0	4874
4110	0	4	0	4858	0	4862
4111	3	0	4970	1	0	4974
4112	1	4865	1	0	0	4867
4113	2	11	0	5042	0	5055
4114	1	6331	0	2	0	6334
4115	0	6563	0	0	0	6563
4116	7315	0	11	4	0	7330
4117	0	7	0	7398	0	7405
4118	7514	0	6	0	0	7520
4119	0	6	2	7564	0	7572
4120	7613	1	5	0	0	7619
4121	3	9	0	7588	0	7600
4122	7235	1	3	0	0	7239
4123	5	0	7316	0	0	7321
4124	1	16	1	6800	0	6818
4125	8	1	6699	0	0	6708
4126	3	1	6629	2	0	6635
4127	6	1	6682	0	0	6689
4128	0	11	1	6683	0	6695
4129	2	0	6639	1	0	6642
4130	6737	1	10	1	0	6749
4131	1	13	0	6745	0	6759
4132	3	0	6715	0	0	6718
4133	3	34	1	6752	0	6790
4134	0	17	0	6684	0	6701
4135	7	0	7146	1	0	7154
4136	1	28	0	7078	0	7107
4137	0	11	0	7093	0	7104
4138	0	7109	0	2	0	7111
4139	7053	2	6	1	0	7062
4140	7009	0	14	1	0	7024
4141	0	0	7053	1	0	7054
4142	6940	1	8	0	0	6949
4143	1	0	7008	0	0	7009
4144	9	2	6933	2	0	6946
4145	1	0	7208	1	0	7210
4146	1	6	0	7118	0	7125
4147	5	0	7316	0	0	7321
4148	1	18	1	7203	0	7223
4149	1	13	0	7203	0	7217
4150	0	16	0	7172	0	7188
4151	1	19	0	7152	0	7172
4152	7128	0	13	0	0	7141
4153	7127	1	14	1	0	7143
4154	0	7162	0	0	0	7162
4155	3	4	1	7031	0	7039
4156	4	0	7149	4	0	7157
4157	0	7141	0	2	0	7143
4158	2	18	0	7188	0	7208
4159	5	0	7289	2	0	7296
4160	0	15	2	7364	0	7381
4161	7	0	8037	3	0	8047
4162	0	0	8189	2	0	8191
4163	3	35	1	8162	0	8201
4164	0	25	1	8254	0	8280
4165	8202	0	11	0	0	8213
4166	0	5	0	8713	0	8718
4167	8697	0	6	2	0	8705
4168	1	8753	0	5	0	8759
4169	0	9073	0	5	0	9078
4170	1	7	1	8964	0	8973
4171	9126	0	9	1	0	9136
4172	0	9470	0	6	0	9476
4173	2	4	1	9487	0	9494
4174	9472	1	6	1	0	9480
4175	9482	1	12	2	0	9497
4176	9455	1	17	0	0	9473
4177	9625	2	31	1	0	9659
4178	9528	0	28	2	0	9558
4179	2	0	9596	0	0	9598
4180	7	0	9634	2	0	9643
4181	0	9599	0	3	0	9602
4182	1	10	0	9548	0	9559
4183	7	0	9528	2	0	9537
4184	20	0	9566	2	0	9588
4185	1	15	1	9602	0	9619
4186	3	3	9508	7	0	9521
4187	8	0	9453	0	0	9461
4188	0	9220	1	4	0	9225
4189	9188	0	13	1	0	9202
4190	0	7364	0	3	0	7367
4191	0	5	3	7331	0	7339
4192	7680	0	11	0	0	7691
4193	0	7542	0	4	0	7546
4194	1	10	0	7622	0	7633
4195	3	0	7599	2	0	7604
4196	7669	0	6	5	0	7680
4197	7653	3	13	0	0	7669
4198	7682	3	10	1	0	7696
4199	0	16	0	7506	0	7522
4200	8	1	7508	0	0	7517
4201	1	7260	0	0	0	7261
4202	0	14	0	7543	0	7557
4203	7540	0	33	3	0	7576
4204	1	0	7572	2	0	7575
4205	1	7497	0	18	0	7516
4206	2	1	7521	0	0	7524
4207	7634	0	14	4	0	7652
4208	7617	0	11	1	0	7629
4209	7545	1	29	0	0	7575
4210	2	0	7635	2	0	7639
4211	0	7706	0	1	0	7707
4212	0	10	2	7859	0	7871
4213	4	26	0	7882	0	7912
4214	0	9	0	7929	0	7938
4215	2	0	7879	4	0	7885
4216	7878	1	15	0	0	7894
4217	2	0	7929	0	0	7931
4218	7907	1	16	1	0	7925
4219	7808	0	14	1	0	7823
4220	8198	0	15	0	0	8213
4221	7933	7	25	0	0	7965
4222	1	0	8009	0	0	8010
4223	0	11	0	7850	0	7861
4224	10	0	7806	0	0	7816
4225	4	7843	0	4	0	7851
4226	3	7848	1	3	0	7855
4227	7880	0	13	3	0	7896
4228	7986	0	8	7	0	8001
4229	0	7943	0	2	0	7945
4230	7955	0	7	0	0	7962
4231	2	1	8042	0	0	8045
4232	7970	2	14	2	0	7988
4233	9	8419	1	2	0	8431
4234	8552	1	16	1	0	8570
4235	8707	0	12	1	0	8720
4236	3	2	0	9222	0	9227
4237	0	4	0	8573	0	8577
4238	8756	1	3	4	0	8764
4239	3	9	0	8776	0	8788
4240	8694	1	6	0	0	8701
4241	1	5	0	8808	0	8814
4242	8251	2	5	1	0	8259
4243	8220	0	26	7	0	8253
4244	0	8341	0	5	0	8346
4245	0	7885	0	1	0	7886
4246	7795	0	4	1	0	7800
4247	1	7386	0	1	0	7388
4248	2	10	0	7240	0	7252
4249	0	6	0	7279	0	7285
4250	7302	0	1	0	0	7303
4251	2	6779	0	654	0	7435
4252	0	7410	0	3	0	7413
4253	4	7395	0	4	0	7403
4254	11	1	7283	3	0	7298
4255	7	0	7286	5	0	7298
4256	4	0	7311	0	0	7315
4257	6	20	0	7272	0	7298
4258	5	7221	0	1	0	7227
4259	7217	1	8	0	0	7226
4260	2	0	7341	0	0	7343
4261	2	0	7661	1	0	7664
4262	3	0	7909	1	0	7913
4263	0	18	0	7940	0	7958
4264	1	9	0	7865	0	7875
4265	2	1	0	8059	0	8062
4266	7888	0	5	1	0	7894
4267	7926	1	11	0	0	7938
4268	7748	1	12	0	0	7761
4269	1	12	0	7828	0	7841
4270	1	0	7772	0	0	7773
4271	3	0	8078	0	0	8081
4272	3	17	0	8159	0	8179
4273	0	10	0	8179	0	8189
4274	8303	0	5	1	0	8309
4275	2	8314	2	2	0	8320
4276	8486	0	14	2	0	8502
4277	1	8932	0	5	0	8938
4278	2	30	0	8567	0	8599
4279	4	1	9012	0	0	9017
4280	1	8	0	9067	0	9076
4281	9023	1	6	0	0	9030
4282	1	1	9013	0	0	9015
4283	8819	2	11	2	0	8834
4284	2	0	8858	2	0	8862
4285	3	0	8744	2	0	8749
4286	8177	2	9	4	0	8192
4287	0	0	8486	0	0	8486
4288	12	0	8305	3	0	8320
4289	0	8344	0	8	0	8352
4290	8366	0	12	0	0	8378
4291	8365	1	24	1	0	8391
4292	8386	0	17	2	0	8405
4293	0	0	8375	1	0	8376
4294	8343	0	12	1	0	8356
4295	2	8372	0	1	0	8375
4296	7881	0	10	2	0	7893
4297	2	0	8005	0	0	8007
4298	0	8	5	8021	0	8034
4299	9	0	8151	1	0	8161
4300	1	8214	0	0	0	8215
4301	1	16	2	8121	0	8140
4302	2	2	0	8139	0	8143
4303	8192	0	1	1	0	8194
4304	8090	0	8	6	0	8104
4305	8076	0	10	0	0	8086
4306	7995	1	7	0	0	8003
4307	7696	2	18	0	0	7716
4308	2	0	7879	2	0	7883
4309	1	11	0	7339	0	7351
4310	1	0	7353	1	0	7355
4311	0	6	0	7260	0	7266
4312	6749	0	2	0	0	6751
4313	6663	1	28	1	0	6693
4314	6435	0	2	0	0	6437
4315	6374	0	12	0	0	6386
4316	1	0	6376	0	0	6377
4317	0	17	1	6163	0	6181
4318	4	0	6277	1	0	6282
4319	0	6129	1	0	0	6130
4320	0	6139	0	2	0	6141
4321	1	19	0	6155	0	6175
4322	1	6	1	6166	0	6174
4323	3	14	0	6173	0	6190
4324	0	10	0	6229	0	6239
4325	6490	2	8	0	0	6500
4326	0	6472	0	2	0	6474
4327	6325	1	20	1	0	6347
4328	1	13	0	6406	0	6420
4329	1	28	0	6265	0	6294
4330	1	6489	0	3	0	6493
4331	1	15	0	6501	0	6517
4332	6769	1	9	0	0	6779
4333	1	6768	0	3	0	6772
4334	0	6533	0	1	0	6534
4335	6640	0	3	2	0	6645
4336	1	23	2	6603	0	6629
4337	0	7135	0	5	0	7140
4338	0	10	1	7128	0	7139
4339	7169	1	1	0	0	7171
4340	2	10	0	7217	0	7229
4341	0	11	0	7058	0	7069
4342	7145	0	4	0	0	7149
4343	1	26	0	7339	0	7366
4344	0	7369	0	0	0	7369
4345	5	28	2	7060	0	7095
4346	0	6958	0	5	0	6963
4347	3	12	0	6885	0	6900
4348	6920	0	2	0	0	6922
4349	6930	0	5	0	0	6935
4350	2	18	1	6799	0	6820
4351	0	0	6782	1	0	6783
4352	6486	0	12	0	0	6498
4353	2	0	6093	1	0	6096
4354	6138	0	11	3	0	6152
4355	5646	1	6	1	0	5654
4356	2	0	5676	0	0	5678
4357	2	5814	1	7	0	5824
4358	5959	0	30	2	0	5991
4359	5992	1	6	3	0	6002
4360	0	0	5980	0	0	5980
4361	5960	0	8	2	0	5970
4362	6050	0	10	0	0	6060
4363	5774	0	11	0	0	5785
4364	1	1	1	5840	0	5843
4365	0	10	0	5915	0	5925
4366	0	5933	0	0	0	5933
4367	2	9	0	5919	0	5930
4368	1	6	1	5952	0	5960
4369	4	0	5929	1	0	5934
4370	4	0	5984	2	0	5990
4371	5956	0	17	1	0	5974
4372	5978	0	80	2	0	6060
4373	0	5773	0	0	0	5773
4374	0	10	0	5725	0	5735
4375	1	0	5853	0	0	5854
4376	1	36	0	5806	0	5843
4377	2	14	0	5886	0	5902
4378	3	8	1	5926	0	5938
4379	0	6000	0	1	0	6001
4380	2	16	1	6013	0	6032
4381	0	20	0	6026	0	6046
4382	1	0	5988	0	0	5989
4383	0	0	6050	2	0	6052
4384	5785	0	12	1	0	5798
4385	5824	0	8	0	0	5832
4386	1	5	0	5767	0	5773
4387	0	2	0	5775	0	5777
4388	1	14	0	5757	0	5772
4389	1	0	5743	2	0	5746
4390	1	5722	1	5	0	5729
4391	1	0	5770	0	0	5771
4392	5985	0	21	1	0	6007
4393	1	0	6013	0	0	6014
4394	5971	1	11	1	0	5984
4395	5937	0	15	3	0	5955
4396	6743	0	15	0	0	6758
4397	1	5	0	6800	0	6806
4398	4	0	6795	0	0	6799
4399	0	6743	0	3	0	6746
4400	0	15	0	6711	0	6726
4401	1	19	0	6806	0	6826
4402	7	1	6775	0	0	6783
4403	3	6620	0	3	0	6626
4404	6694	1	30	3	0	6728
4405	1	6441	0	1	0	6443
4406	7032	1	3	2	0	7038
4407	2	14	1	7276	0	7293
4408	8	0	7027	1	0	7036
4409	4	7050	0	18	0	7072
4410	7018	1	17	0	0	7036
4411	3	0	6998	0	0	7001
4412	7885	0	8	1	0	7894
4413	7269	4	8	1	0	7282
4414	467	0	6781	0	0	7248
4415	7067	0	53	1	0	7121
4416	7023	1	11	1	0	7036
4417	7018	14	11	1	0	7044
4418	0	6818	0	7	0	6825
4419	6850	2	33	3	0	6888
4420	0	6736	1	1	0	6738
4421	11	0	6688	2	0	6701
4422	3	6581	0	2	0	6586
4423	6713	0	4	1	0	6718
4424	6940	2	2	0	0	6944
4425	7069	1	8	0	0	7078
4426	0	3	0	7275	0	7278
4427	1	2	1	7266	0	7270
4428	7678	0	1	0	0	7679
4429	7704	0	6	0	0	7710
4430	0	14	0	7723	0	7737
4431	6	1	7765	0	0	7772
4432	6	7692	0	6	0	7704
4433	1	7564	0	3	0	7568
4434	3	11	2	7426	0	7442
4435	4	0	7484	0	0	7488
4436	1	21	0	7569	0	7591
4437	1	7479	0	0	0	7480
4438	3	18	0	7439	0	7460
4439	3	0	7528	1	0	7532
4440	0	16	14	7525	0	7555
4441	20	0	7541	1	0	7562
4442	1	18	2	7641	0	7662
4443	2	0	7575	2	0	7579
4444	3	0	7751	1	0	7755
4445	7839	0	12	3	0	7854
4446	7863	2	14	1	0	7880
4447	7921	3	15	0	0	7939
4448	1	7935	0	2	0	7938
4449	1	5	0	7866	0	7872
4450	7820	1	7	0	0	7828
4451	7699	0	12	2	0	7713
4452	7707	1	15	0	0	7723
4453	6	0	7662	0	0	7668
4454	6	7809	0	3	0	7818
4455	2	7773	0	4	0	7779
4456	7748	1	22	2	0	7773
4457	0	20	1	7785	0	7806
4458	7969	0	7	2	0	7978
4459	2	0	8120	0	0	8122
4460	0	18	0	8240	0	8258
4461	2	19	3	8181	0	8205
4462	2	28	1	8117	0	8148
4463	3	8668	1	3	0	8675
4464	8765	0	8	1	0	8774
4465	9004	0	18	0	0	9022
4466	1	9084	0	2	0	9087
4467	1	7	1	8882	0	8891
4468	8915	0	6	2	0	8923
4469	0	10	0	8889	0	8899
4470	8878	0	14	0	0	8892
4471	0	8751	1	6	0	8758
4472	7819	2	13	0	0	7834
4473	5	0	8399	1	0	8405
4474	0	8180	0	3	0	8183
4475	5	0	8246	0	0	8251
4476	1	5	2	8381	0	8389
4477	8295	0	4	0	0	8299
4478	8415	0	8	2	0	8425
4479	9269	0	5	3	0	9277
4480	0	12	0	9293	0	9305
4481	9323	0	1	2	0	9326
4482	2	4	0	8608	0	8614
4483	8431	1	2	1	0	8435
4484	8355	0	9	3	0	8367
4485	3	0	8416	1	0	8420
4486	4	0	8381	1	0	8386
4487	1	0	8533	4	0	8538
4488	0	3	0	7556	0	7559
4489	7623	1	5	3	0	7632
4490	3	6	1	7646	0	7656
4491	1	3	0	7660	0	7664
4492	7675	1	2	3	0	7681
4493	7895	0	1	1	0	7897
4494	7754	3	2	2	0	7761
4495	8298	1	2	0	0	8301
4496	0	2	0	8158	0	8160
4497	8357	2	12	2	0	8373
4498	1	8430	0	2	0	8433
4499	8431	1	26	3	0	8461
4500	8194	0	15	1	0	8210
4501	1	0	8123	0	0	8124
4502	7854	0	23	1	0	7878
4503	1	0	8056	0	0	8057
4504	8	0	7630	1	0	7639
4505	4	0	7650	2	0	7656
4506	1	17	0	7706	0	7724
4507	12	0	7721	0	0	7733
4508	1	17	0	7816	0	7834
4509	4	0	7855	0	0	7859
4510	2	0	8120	3	0	8125
4511	0	15	2	8120	0	8137
4512	0	17	1	8136	0	8154
4513	2	0	8222	3	0	8227
4514	8167	1	5	3	0	8176
4515	0	13	0	8121	0	8134
4516	0	5	0	8217	0	8222
4517	8183	0	10	0	0	8193
4518	0	11	1	8123	0	8135
4519	4	0	7892	0	0	7896
4520	2	3	8105	0	0	8110
4521	2	13	0	8055	0	8070
4522	3	0	7923	4	0	7930
4523	0	7945	0	2	0	7947
4524	2	7	0	7945	0	7954
4525	8049	1	16	0	0	8066
4526	1	0	8103	0	0	8104
4527	8090	0	8	1	0	8099
4528	0	13	2	8158	0	8173
4529	1	13	0	8008	0	8022
4530	2	24	0	8006	0	8032
4531	1	6	0	8058	0	8065
4532	8077	1	5	1	0	8084
4533	0	7921	0	12	0	7933
4534	1	16	0	7864	0	7881
4535	1	9	0	7824	0	7834
4536	2	11	2	7767	0	7782
4537	0	3	2	7833	0	7838
4538	7765	0	2	0	0	7767
4539	0	7306	1	6	0	7313
4540	7349	0	14	0	0	7363
4541	1	7310	1	0	0	7312
4542	1	7149	0	15	0	7165
4543	7218	0	13	5	0	7236
4544	3	0	7354	1	0	7358
4545	0	9	0	7611	0	7620
4546	7616	0	3	0	0	7619
4547	7712	1	19	3	0	7735
4548	7742	2	19	0	0	7763
4549	7296	3	19	1	0	7319
4550	0	7475	0	1	0	7476
4551	7356	1	16	0	0	7373
4552	7898	0	11	0	0	7909
4553	0	7080	2	0	0	7082
4554	3	19	1	7127	0	7150
4555	5	0	7202	1	0	7208
4556	2	12	1	7200	0	7215
4557	7140	0	6	0	0	7146
4558	1	0	7152	3	0	7156
4559	5	7104	0	4	0	7113
4560	3	0	7134	0	0	7137
4561	3	18	0	7092	0	7113
4562	2	6893	0	3	0	6898
4563	6946	1	6	0	0	6953
4564	1	7266	0	1	0	7268
4565	2	7	2	7227	0	7238
4566	1	5	0	7396	0	7402
4567	7447	0	11	2	0	7460
4568	3	8	1	7500	0	7512
4569	2	7281	0	4	0	7287
4570	7289	1	7	2	0	7299
4571	6799	1	7	2	0	6809
4572	0	6686	0	5	0	6691
4573	6542	0	15	1	0	6558
4574	0	6795	0	4	0	6799
4575	6710	1	19	3	0	6733
4576	1	6851	0	4	0	6856
4577	1	9	0	6779	0	6789
4578	2	1	0	6807	0	6810
4579	6730	0	5	0	0	6735
4580	6689	0	12	1	0	6702
4581	1	6576	0	3	0	6580
4582	3	0	6537	1	0	6541
4583	6574	2	13	0	0	6589
4584	3	39	1	6571	0	6614
4585	0	6314	0	5	0	6319
4586	0	8	0	6257	0	6265
4587	6597	0	6	0	0	6603
4588	6436	0	6	0	0	6442
4589	7466	2	7	0	0	7475
4590	1	6	0	7458	0	7465
4591	2	2	7439	0	0	7443
4592	7417	0	23	2	0	7442
4593	7399	0	36	1	0	7436
4594	7426	5	24	3	0	7458
4595	0	7458	0	3	0	7461
4596	2	14	1	7373	0	7390
4597	1	7548	0	1	0	7550
4598	0	20	0	7515	0	7535
4599	0	14	0	7548	0	7562
4600	2	0	7608	2	0	7612
4601	1	7	0	7739	0	7747
4602	0	10	1	7778	0	7789
4603	7750	0	8	1	0	7759
4604	0	7722	0	2	0	7724
4605	7583	1	6	0	0	7590
4606	7582	0	19	2	0	7603
4607	2	10	0	7577	0	7589
4608	4	1	7614	2	0	7621
4609	0	7612	0	3	0	7615
4610	1	7591	0	7	0	7599
4611	7648	1	19	1	0	7669
4612	0	7704	0	9	0	7713
4613	1	16	1	7651	0	7669
4614	1	18	0	7807	0	7826
4615	3	0	7782	0	0	7785
4616	4	0	7922	0	0	7926
4617	2	7689	0	4	0	7695
4618	0	4	0	7559	0	7563
4619	8167	0	9	1	0	8177
4620	0	17	0	8023	0	8040
4621	0	0	8168	0	0	8168
4622	1	18	0	8184	0	8203
4623	8056	2	8	0	0	8066
4624	8055	2	14	1	0	8072
4625	1	7811	0	1	0	7813
4626	7758	0	22	0	0	7780
4627	0	7664	0	4	0	7668
4628	7237	0	11	0	0	7248
4629	1	24	0	7191	0	7216
4630	5	0	7015	1	0	7021
4631	1	2	7074	0	0	7077
4632	1	7043	0	10	0	7054
4633	1	9	2	6960	0	6972
4634	0	2	1	7115	0	7118
4635	7147	0	3	1	0	7151
4636	7134	0	1	2	0	7137
4637	7038	1	3	0	0	7042
4638	0	6	2	7051	0	7059
4639	0	7	0	6968	0	6975
4640	0	9	0	6825	0	6834
4641	0	0	6841	2	0	6843
4642	0	1	6709	2	0	6712
4643	7101	0	15	1	0	7117
4644	6989	0	31	1	0	7021
4645	3	0	7019	0	0	7022
4646	7092	1	19	1	0	7113
4647	7070	0	16	0	0	7086
4648	0	0	7085	0	0	7085
4649	1	6586	0	15	0	6602
4650	0	14	0	6869	0	6883
4651	3	0	6932	3	0	6938
4652	2	7592	0	3	0	7597
4653	0	19	1	7515	0	7535
4654	0	7705	0	8	0	7713
4655	7	1	7682	0	0	7690
4656	5	0	9239	1	0	9245
4657	0	8	0	9375	0	9383
4658	9510	1	14	1	0	9526
4659	4	5	1	9372	0	9382
4660	9286	0	11	2	0	9299
4661	2	16	0	9367	0	9385
4662	6	0	9350	1	0	9357
4663	8967	0	19	3	0	8989
4664	0	1	9003	0	0	9004
4665	8031	1	35	2	0	8069
4666	6	9	0	8011	0	8026
4667	0	8148	0	3	0	8151
4668	3	19	0	8085	0	8107
4669	2	8048	0	2	0	8052
4670	2	24	0	7980	0	8006
4671	1	8000	1	5	0	8007
4672	8010	0	8	0	0	8018
4673	7913	0	8	1	0	7922
4674	7857	0	35	1	0	7893
4675	2	0	7966	2	0	7970
4676	2	23	0	7872	0	7897
4677	3	0	7768	5	0	7776
4678	2	7746	0	10	0	7758
4679	0	7752	0	9	0	7761
4680	7768	0	25	1	0	7794
4681	7	1	7805	3	0	7816
4682	0	7773	0	5	0	7778
4683	0	11	0	7792	0	7803
4684	7734	1	10	2	0	7747
4685	0	7624	0	4	0	7628
4686	7582	0	19	0	0	7601
4687	3	0	7652	0	0	7655
4688	5	17	0	7695	0	7717
4689	2	14	0	7740	0	7756
4690	2	15	2	7630	0	7649
4691	0	6874	0	1	0	6875
4692	3	7	0	6903	0	6913
4693	1	0	6935	0	0	6936
4694	1	17	1	7031	0	7050
4695	1	17	0	7113	0	7131
4696	1	13	0	7153	0	7167
4697	1	7000	1	4	0	7006
4698	0	21	0	6989	0	7010
4699	5	10	0	6982	0	6997
4700	2	6962	0	2	0	6966
4701	7061	0	31	0	0	7092
4702	1	7139	0	2	0	7142
4703	2	7054	0	14	0	7070
4704	0	10	0	6968	0	6978
4705	2	0	6981	1	0	6984
4706	7003	0	25	3	0	7031
4707	1	9	0	7071	0	7081
4708	3	0	7066	0	0	7069
4709	0	7413	0	4	0	7417
4710	0	6	3	7319	0	7328
4711	2	0	7425	0	0	7427
4712	1	12	0	7463	0	7476
4713	1	4	0	7472	0	7477
4714	7430	0	10	0	0	7440
4715	2	7410	0	4	0	7416
4716	7163	0	27	2	0	7192
4717	3	0	7307	1	0	7311
4718	1	6969	0	5	0	6975
4719	2	1	7598	0	0	7601
4720	1	7	1	7522	0	7531
4721	7501	0	10	0	0	7511
4722	0	8	1	7485	0	7494
4723	7451	0	10	0	0	7461
4724	7583	1	25	2	0	7611
4725	0	8	0	7625	0	7633
4726	2	0	7336	1	0	7339
4727	0	0	7436	2	0	7438
4728	0	68	0	7356	0	7424
4729	1	7	1	7466	0	7475
4730	7405	1	8	3	0	7417
4731	0	4	0	7554	0	7558
4732	0	5947	0	0	0	5947
4733	4	3	0	5864	0	5871
4734	1	4	0	5990	0	5995
4735	5905	1	8	2	0	5916
4736	0	5891	0	1	0	5892
4737	0	13	0	5793	0	5806
4738	1	14	0	5798	0	5813
4739	0	6205	0	2	0	6207
4740	1	11	0	5988	0	6000
4741	3	22	0	5965	0	5990
4742	1	5849	0	6	0	5856
4743	2	12	0	5870	0	5884
4744	4	29	0	6483	0	6516
4745	0	6475	0	0	0	6475
4746	0	13	0	6463	0	6476
4747	6469	0	8	0	0	6477
4748	6464	1	16	0	0	6481
4749	6523	4	5	1	0	6533
4750	6525	2	14	1	0	6542
4751	0	6521	0	6	0	6527
4752	6374	0	30	0	0	6404
4753	2	6680	0	2	0	6684
4754	1	6801	2	7	0	6811
4755	0	12	0	6791	0	6803
4756	10	0	6844	0	0	6854
4757	7178	2	21	2	0	7203
4758	7095	7	22	0	0	7124
4759	0	2	7140	0	0	7142
4760	7162	0	20	0	0	7182
4761	7416	0	15	1	0	7432
4762	1	7379	0	2	0	7382
4763	7582	0	11	0	0	7593
4764	0	17	2	7546	0	7565
4765	0	7	0	7506	0	7513
4766	0	3	0	7533	0	7536
4767	0	6	0	7638	0	7644
4768	8132	1	3	0	0	8136
4769	0	9	0	8100	0	8109
4770	0	7	1	7999	0	8007
4771	0	0	7867	4	0	7871
4772	7701	0	13	1	0	7715
4773	7758	0	14	0	0	7772
4774	7790	1	27	1	0	7819
4775	0	7865	0	3	0	7868
4776	3	7814	0	3	0	7820
4777	7725	0	40	0	0	7765
4778	4	21	1	8137	0	8163
4779	0	8200	0	3	0	8203
4780	4	10	0	8081	0	8095
4781	0	8255	0	2	0	8257
4782	8232	2	13	3	0	8250
4783	0	7935	1	2	0	7938
4784	0	11	0	7808	0	7819
4785	2	13	0	7785	0	7800
4786	4	0	7816	1	0	7821
4787	1	7711	0	4	0	7716
4788	1	7	0	7921	0	7929
4789	2	0	7914	0	0	7916
4790	33	0	7829	1	0	7863
4791	1	19	0	8225	0	8245
4792	2	30	0	8216	0	8248
4793	3	8085	2	1	0	8091
4794	0	7637	0	2	0	7639
4795	0	9	0	7775	0	7784
4796	7835	0	14	2	0	7851
4797	0	6	1	7954	0	7961
4798	8138	1	7	0	0	8146
4799	8130	0	7	1	0	8138
4800	7935	1	11	0	0	7947
4801	0	0	7939	0	0	7939
4802	8328	0	2	1	0	8331
4803	0	4	2	7778	0	7784
4804	0	7	0	7580	0	7587
4805	3	1	7502	2	0	7508
4806	3	0	7784	4	0	7791
4807	6	8	1	7678	0	7693
4808	4	7698	0	3	0	7705
4809	2	7648	0	3	0	7653
4810	4	14	0	7935	0	7953
4811	8349	0	10	2	0	8361
4812	2	17	0	8322	0	8341
4813	2	17	3	8294	0	8316
4814	0	8378	0	1	0	8379
4815	5	5	1	7915	0	7926
4816	7	1	7939	2	0	7949
4817	5	0	7986	1	0	7992
4818	8222	4	26	0	0	8252
4819	1	8129	1	8	0	8139
4820	7593	0	10	1	0	7604
4821	7838	1	9	1	0	7849
4822	0	16	0	7785	0	7801
4823	3	7976	0	4	0	7983
4824	0	15	1	8058	0	8074
4825	8142	1	8	1	0	8152
4826	5	8039	0	0	0	8044
4827	8109	1	15	1	0	8126
4828	1	8177	0	3	0	8181
4829	8005	0	13	0	0	8018
4830	8033	0	30	0	0	8063
4831	0	8010	0	3	0	8013
4832	1	7	2	7641	0	7651
4833	7679	0	12	2	0	7693
4834	4	0	7655	1	0	7660
4835	6	0	8009	2	0	8017
4836	1	19	2	8069	0	8091
4837	7901	0	15	2	0	7918
4838	1	5	0	7874	0	7880
4839	7594	1	18	1	0	7614
4840	1	0	7644	0	0	7645
4841	7696	0	3	3	0	7702
4842	7690	0	2	0	0	7692
4843	1	13	0	7536	0	7550
4844	2	17	0	7025	0	7044
4845	1	12	0	7499	0	7512
4846	0	7575	0	0	0	7575
4847	0	12	0	7566	0	7578
4848	1	4	0	7640	0	7645
4849	7596	1	7	0	0	7604
4850	7567	0	11	3	0	7581
4851	0	0	7528	0	0	7528
4852	7515	0	31	1	0	7547
4853	1	0	7592	0	0	7593
4854	7028	1	33	3	0	7065
4855	0	0	7202	2	0	7204
4856	11	0	7452	0	0	7463
4857	2	32	0	7388	0	7422
4858	3	0	7507	0	0	7510
4859	7513	0	8	0	0	7521
4860	1	8	0	7517	0	7526
4861	7507	0	13	1	0	7521
4862	8024	0	11	2	0	8037
4863	8014	1	10	0	0	8025
4864	7862	2	27	1	0	7892
4865	0	0	8131	1	0	8132
4866	0	9	1	7818	0	7828
4867	2	1	8071	0	0	8074
4868	0	3	3	8053	0	8059
4869	8500	0	9	1	0	8510
4870	1	2	1	8370	0	8374
4871	8352	0	2	1	0	8355
4872	2	12	0	8529	0	8543
4873	1	7	1	8468	0	8477
4874	8327	0	11	1	0	8339
4875	1	8361	0	1	0	8363
4876	8158	1	15	2	0	8176
4877	1	8774	0	1	0	8776
4878	0	6	0	8440	0	8446
4879	8487	2	17	2	0	8508
4880	0	0	8531	0	0	8531
4881	3	13	0	8457	0	8473
4882	8244	1	9	0	0	8254
4883	8218	1	15	1	0	8235
4884	2	9	0	8641	0	8652
4885	2	8660	0	3	0	8665
4886	0	8006	0	2	0	8008
4887	1	16	2	8029	0	8048
4888	8188	0	8	1	0	8197
4889	1	8360	0	3	0	8364
4890	0	8329	0	8	0	8337
4891	8409	0	33	4	0	8446
4892	1	8433	0	8	0	8442
4893	8244	1	10	4	0	8259
4894	0	20	0	8356	0	8376
4895	1	7	2	8304	0	8314
4896	0	8146	0	7	0	8153
4897	0	8672	0	7	0	8679
4898	8719	0	11	1	0	8731
4899	0	8801	0	2	0	8803
4900	0	8687	0	5	0	8692
4901	2	7	0	8644	0	8653
4902	8601	0	24	0	0	8625
4903	4	0	8623	1	0	8628
4904	8603	0	17	0	0	8620
4905	2	4	0	8578	0	8584
4906	1	0	8337	0	0	8338
4907	4	0	8366	0	0	8370
4908	1	14	0	8720	0	8735
4909	2	2	8674	1	0	8679
4910	8650	0	23	0	0	8673
4911	8300	1	39	1	0	8341
4912	1	0	8461	0	0	8462
4913	0	13	0	8443	0	8456
4914	0	12	0	8597	0	8609
4915	8629	1	8	0	0	8638
4916	0	8	2	8497	0	8507
4917	0	8619	0	17	0	8636
4918	8684	0	31	0	0	8715
4919	3	8882	0	4	0	8889
4920	1	8417	0	3	0	8421
4921	5	18	0	8290	0	8313
4922	0	5	0	8329	0	8334
4923	1	12	0	8361	0	8374
4924	2	0	8305	0	0	8307
4925	8629	1	23	1	0	8654
4926	0	8659	0	2	0	8661
4927	8436	1	71	2	0	8510
4928	8528	5	14	0	0	8547
4929	1	11	2	8832	0	8846
4930	0	8637	0	2	0	8639
4931	2	7	1	8613	0	8623
4932	1	9	1	8654	0	8665
4933	8662	0	4	2	0	8668
4934	8510	3	21	2	0	8536
4935	4	0	8543	1	0	8548
4936	8554	1	16	0	0	8571
4937	1	8565	0	2	0	8568
4938	7962	2	15	2	0	7981
4939	0	7784	0	2	0	7786
4940	2	11	2	7697	0	7712
4941	5	22	0	7690	0	7717
4942	0	7513	0	2	0	7515
4943	2	14	0	7499	0	7515
4944	0	16	0	7871	0	7887
4945	1	34	0	7442	0	7477
4946	0	7239	0	2	0	7241
4947	1	25	0	7128	0	7154
4948	0	4	1	7089	0	7094
4949	1	6	0	7117	0	7124
4950	1	0	7073	1	0	7075
4951	6936	1	33	2	0	6972
4952	1	0	7032	0	0	7033
4953	6439	0	20	3	0	6462
4954	2	0	6488	0	0	6490
4955	6788	0	21	4	0	6813
4956	6850	0	5	0	0	6855
4957	0	0	6874	0	0	6874
4958	0	3	0	6891	0	6894
4959	2	0	6824	1	0	6827
4960	6405	3	18	3	0	6429
4961	4	0	6417	4	0	6425
4962	6	0	6443	1	0	6450
4963	6800	0	14	1	0	6815
4964	0	6916	1	3	0	6920
4965	0	9	0	6715	0	6724
4966	7002	0	4	2	0	7008
4967	0	7	5	6913	0	6925
4968	0	5	0	6928	0	6933
4969	6917	1	8	1	0	6927
4970	6780	1	13	0	0	6794
4971	3	0	6795	1	0	6799
4972	1	0	6821	0	0	6822
4973	1	10	1	6191	0	6203
4974	2	0	6306	0	0	6308
4975	0	7	6	6130	0	6143
4976	0	9	0	6194	0	6203
4977	0	3	0	6236	0	6239
4978	6218	1	10	0	0	6229
4979	1	6127	0	0	0	6128
4980	6154	1	11	0	0	6166
4981	6151	0	9	2	0	6162
4982	0	6114	0	1	0	6115
4983	5508	0	178	0	0	5686
4984	0	0	5792	0	0	5792
4985	1	9	1	5837	0	5848
4986	5888	0	11	1	0	5900
4987	4	0	5816	0	0	5820
4988	5748	0	19	1	0	5768
4989	1	5902	0	2	0	5905
4990	5778	2	14	1	0	5795
4991	5914	0	16	3	0	5933
4992	0	5960	0	2	0	5962
4993	5788	0	14	1	0	5803
4994	0	15	0	5849	0	5864
4995	1	5	0	5657	0	5663
4996	5681	0	0	0	0	5681
4997	5645	0	17	1	0	5663
4998	0	5640	0	2	0	5642
4999	0	6370	0	2	0	6372
5000	0	10	1	6025	0	6036
5001	0	6074	0	7	0	6081
5002	0	6067	1	4	0	6072
5003	6087	0	15	0	0	6102
5004	1	5777	0	9	0	5787
5005	5783	0	15	0	0	5798
5006	0	5746	0	3	0	5749
5007	6	0	5670	1	0	5677
5008	1	5648	0	1	0	5650
5009	5736	0	3	1	0	5740
5010	5570	0	154	0	0	5724
5011	0	0	5792	0	0	5792
5012	1	61	0	5754	0	5816
5013	1	7	0	5664	0	5672
5014	4	0	5667	0	0	5671
5015	3	9	0	5878	0	5890
5016	4	0	5811	0	0	5815
5017	1	0	5816	0	0	5817
5018	5865	0	5	2	0	5872
5019	4	5784	0	9	0	5797
5020	5428	0	12	1	0	5441
5021	1	9	0	5503	0	5513
5022	6	0	5508	1	0	5515
5023	2	11	0	5637	0	5650
5024	3	5717	0	1	0	5721
5025	5673	1	38	2	0	5714
5026	5717	0	1	2	0	5720
5027	1	4	1	5705	0	5711
5028	1	0	5699	0	0	5700
5029	5861	2	11	0	0	5874
5030	1	5570	0	6	0	5577
5031	5388	1	11	1	0	5401
5032	1	2	0	5324	0	5327
5033	5343	0	3	1	0	5347
5034	1	8	0	5459	0	5468
5035	1	0	5400	0	0	5401
5036	2	2	5380	3	0	5387
5037	5310	1	11	3	0	5325
5038	1	5231	0	1	0	5233
5039	5102	0	12	1	0	5115
5040	4854	0	6	1	0	4861
5041	0	4710	0	2	0	4712
5042	4582	1	5	2	0	4590
5043	3	0	4588	0	0	4591
5044	2	14	2	4660	0	4678
5045	0	6	0	4643	0	4649
5046	0	2	2	4677	0	4681
5047	5	0	4572	0	0	4577
5048	1	0	4714	0	0	4715
5049	2	7	0	4824	0	4833
5050	4	4628	1	22	0	4655
5051	2	4584	0	1	0	4587
5052	4561	0	10	0	0	4571
5053	4634	0	6	0	0	4640
5054	0	4632	0	1	0	4633
5055	0	2	0	4717	0	4719
5056	0	3	0	4663	0	4666
5057	4544	0	8	0	0	4552
5058	2	7	0	4501	0	4510
5059	0	17	0	4530	0	4547
5060	0	4	0	4724	0	4728
5061	2	0	4674	0	0	4676
5062	1	0	4560	1	0	4562
5063	4565	0	6	0	0	4571
5064	0	4	0	4676	0	4680
5065	4	0	4464	1	0	4469
5066	3	0	4457	1	0	4461
5067	4429	0	13	1	0	4443
5068	1	0	4453	1	0	4455
5069	2	4594	0	4	0	4600
5070	1	4	1	4461	0	4467
5071	3	0	4454	1	0	4458
5072	4761	1	23	0	0	4785
5073	0	5	0	4812	0	4817
5074	2	0	4805	0	0	4807
5075	1	12	0	4438	0	4451
5076	0	5	0	4490	0	4495
5077	4601	0	6	0	0	4607
5078	1	4559	0	1	0	4561
5079	2	8	0	4569	0	4579
5080	4590	0	1	0	0	4591
5081	4605	1	0	0	0	4606
5082	4591	0	6	0	0	4597
5083	4630	0	2	0	0	4632
5084	0	4	0	4610	0	4614
5085	4547	0	2	0	0	4549
5086	4581	0	6	0	0	4587
5087	4493	0	7	0	0	4500
5088	4667	1	11	0	0	4679
5089	0	5007	0	1	0	5008
5090	0	4752	0	2	0	4754
5091	5	6	1	4685	0	4697
5092	0	4732	0	1	0	4733
5093	4707	0	12	1	0	4720
5094	0	0	0	4711	0	4711
5095	4649	0	2	0	0	4651
5096	4672	0	9	0	0	4681
5097	1	8	0	4573	0	4582
5098	2	4	1	4333	0	4340
5099	0	4375	0	1	0	4376
5100	4248	1	9	0	0	4258
5101	0	4288	0	1	0	4289
5102	4250	0	19	0	0	4269
5103	1	5	0	4207	0	4213
5104	6	0	4222	0	0	4228
5105	4055	0	5	0	0	4060
5106	4046	0	7	0	0	4053
5107	1	0	4019	0	0	4020
5108	1	0	4020	0	0	4021
5109	1	4	0	4005	0	4010
5110	3851	0	8	0	0	3859
5111	3847	2	3	2	0	3854
5112	3828	0	2	0	0	3830
5113	3837	0	8	1	0	3846
5114	1	3842	0	1	0	3844
5115	3626	0	7	0	0	3633
5116	0	6	1	3548	0	3555
5117	0	12	1	3367	0	3380
5118	0	9	2	3378	0	3389
5119	0	3	0	3427	0	3430
5120	3450	0	1	0	0	3451
5121	1	13	0	3420	0	3434
5122	0	0	3412	0	0	3412
5123	0	10	0	3248	0	3258
5124	0	10	1	3116	0	3127
5125	1	7	0	3107	0	3115
5126	0	1	0	3121	0	3122
5127	3128	0	1	1	0	3130
5128	3	3072	1	0	0	3076
5129	0	3020	0	4	0	3024
5130	0	0	0	2987	0	2987
5131	2892	1	0	0	0	2893
5132	2890	0	7	0	0	2897
5133	1	2	0	2880	0	2883
5134	0	0	2870	0	0	2870
5135	2862	0	8	1	0	2871
5136	0	3	0	2540	0	2543
5137	3	0	2528	0	0	2531
5138	2499	0	20	0	0	2519
5139	0	2511	0	1	0	2512
5140	2362	0	7	1	0	2370
5141	0	2359	0	1	0	2360
5142	1	10	0	2129	0	2140
5143	0	2161	0	0	0	2161
5144	1	14	0	1982	0	1997
5145	1996	0	3	0	0	1999
5146	0	2002	0	1	0	2003
5147	0	0	1910	0	0	1910
5148	1	7	0	1681	0	1689
5149	0	0	1647	0	0	1647
5150	0	2	0	1207	0	1209
5151	0	0	9	1136	0	1145
5152	0	0	1082	0	0	1082
5153	960	0	5	0	0	965
5154	1	0	950	0	0	951
5155	0	0	930	0	0	930
5156	0	814	0	0	0	814
5157	0	0	0	737	0	737
5158	0	0	0	701	0	701
5159	0	1	0	705	0	706
5160	0	0	0	706	0	706
5161	0	0	698	0	0	698
5162	616	0	1	0	0	617
5163	0	0	613	0	0	613
5164	0	0	0	432	0	432
5165	101	1	0	0	0	102
5166	0	92	0	0	0	92
5167	0	1	0	8	0	9
5168	9	0	0	0	0	9
5169	0	8	0	0	0	8
5170	0	8	0	0	0	8
5171	8	0	0	0	0	8
5172	0	8	0	0	0	8
5173	8	0	0	0	0	8
5174	0	8	0	0	0	8
5175	8	0	0	0	0	8
5176	8	0	0	0	0	8
5177	0	8	0	0	0	8
5178	0	0	0	8	0	8
5179	0	0	8	0	0	8
5180	8	0	0	0	0	8
5181	0	0	0	9	0	9
5182	0	8	0	0	0	8
5183	0	8	0	0	0	8
5184	0	0	0	8	0	8
5185	8	0	0	0	0	8
5186	0	0	8	0	0	8
5187	0	0	0	8	0	8
5188	0	0	0	8	0	8
5189	0	0	0	9	0	9
5190	0	0	0	9	0	9
5191	0	9	0	0	0	9
5192	0	0	0	9	0	9
5193	0	0	9	0	0	9
5194	0	0	9	0	0	9
5195	0	0	9	0	0	9
5196	0	0	0	9	0	9
5197	8	0	0	0	0	8
5198	0	0	7	0	0	7
5199	0	0	7	0	0	7
5200	0	0	0	7	0	7
5201	7	0	0	0	0	7
5202	0	7	0	0	0	7
5203	7	0	0	0	0	7
5204	0	0	0	7	0	7
5205	0	0	7	0	0	7
5206	0	0	0	7	0	7
5207	0	6	0	0	0	6
5208	5	0	0	0	0	5
5209	0	0	5	0	0	5
5210	0	3	0	0	0	3
5211	3	0	0	0	0	3
5212	0	0	0	3	0	3
5213	0	0	0	3	0	3
5214	3	0	0	0	0	3
5215	3	0	0	0	0	3
5216	3	0	0	0	0	3
5217	0	0	0	2	0	2
5218	0	2	0	0	0	2
5219	2	0	0	0	0	2
5220	0	2	0	0	0	2
5221	2	0	0	0	0	2
5222	0	2	0	0	0	2
5223	0	0	0	2	0	2
5224	2	0	0	0	0	2
5225	2	0	0	0	0	2
5226	2	0	0	0	0	2
5227	2	0	0	0	0	2
5228	2	0	0	0	0	2
5229	0	0	3	0	0	3
5230	0	0	0	3	0	3
5231	0	0	3	0	0	3
5232	0	0	3	0	0	3
5233	3	0	0	0	0	3
5234	3	0	0	0	0	3
5235	3	0	0	0	0	3
5236	0	0	0	3	0	3
5237	3	0	0	0	0	3
5238	0	3	0	0	0	3
5239	0	3	0	0	0	3
5240	0	3	0	0	0	3
5241	3	0	0	0	0	3
5242	0	3	0	0	0	3
5243	3	0	0	0	0	3
5244	3	0	0	0	0	3
5245	0	0	3	0	0	3
5246	0	0	0	4	0	4
5247	0	0	0	4	0	4
5248	4	0	0	0	0	4
5249	4	0	0	0	0	4
5250	0	0	0	4	0	4
5251	0	0	4	0	0	4
5252	0	0	4	0	0	4
5253	0	0	0	4	0	4
5254	0	0	0	4	0	4
5255	0	0	0	4	0	4
5256	5	0	0	0	0	5
5257	4	0	0	0	0	4
5258	0	4	0	0	0	4
5259	0	0	0	4	0	4
5260	0	0	0	4	0	4
5261	0	4	0	0	0	4
5262	0	0	0	4	0	4
5263	4	0	0	0	0	4
5264	0	0	0	4	0	4
5265	0	0	0	3	0	3
5266	3	0	0	0	0	3
5267	3	0	0	0	0	3
5268	3	0	0	0	0	3
5269	0	0	0	3	0	3
5270	0	0	3	0	0	3
5271	0	0	3	0	0	3
5272	0	0	3	0	0	3
5273	0	3	0	0	0	3
5274	3	0	0	0	0	3
5275	0	0	3	0	0	3
5276	3	0	0	0	0	3
5277	0	0	0	3	0	3
5278	3	0	0	0	0	3
5279	3	0	0	0	0	3
5280	0	3	0	0	0	3
5281	3	0	0	0	0	3
5282	5	0	0	0	0	5
5283	0	5	0	0	0	5
5284	0	0	0	5	0	5
5285	0	0	5	0	0	5
5286	0	0	0	5	0	5
5287	0	0	0	5	0	5
5288	5	0	0	0	0	5
5289	0	0	0	6	0	6
5290	0	6	0	0	0	6
5291	0	0	0	6	0	6
5292	0	0	0	6	0	6
5293	0	0	5	1	0	6
5294	0	6	0	0	0	6
5295	0	6	0	0	0	6
5296	6	0	0	0	0	6
5297	0	6	0	0	0	6
5298	0	0	0	6	0	6
5299	2	0	5	0	0	7
5300	0	8	0	0	0	8
5301	8	0	0	0	0	8
5302	0	0	0	9	0	9
5303	0	0	0	9	0	9
5304	0	0	9	0	0	9
5305	0	0	0	8	0	8
5306	0	0	0	8	0	8
5307	8	0	0	0	0	8
5308	8	0	0	0	0	8
5309	0	8	0	0	0	8
5310	8	0	0	0	0	8
5311	0	8	0	0	0	8
5312	0	0	0	8	0	8
5313	0	8	0	0	0	8
5314	0	8	0	0	0	8
5315	8	0	0	0	0	8
5316	8	0	0	0	0	8
5317	0	7	0	0	0	7
5318	8	0	0	0	0	8
5319	8	0	0	0	0	8
5320	8	0	0	0	0	8
5321	0	0	0	8	0	8
5322	7	0	0	0	0	7
5323	0	0	7	0	0	7
5324	7	0	0	0	0	7
5325	0	0	6	0	0	6
5326	0	0	0	7	0	7
5327	0	0	0	7	0	7
5328	0	0	7	0	0	7
5329	7	0	0	0	0	7
5330	7	0	0	0	0	7
5331	0	0	7	0	0	7
5332	0	0	0	6	0	6
5333	0	0	0	6	0	6
5334	0	0	0	6	0	6
5335	6	0	0	0	0	6
5336	6	0	0	0	0	6
5337	0	0	0	6	0	6
5338	0	6	0	0	0	6
5339	0	6	0	0	0	6
5340	6	0	0	0	0	6
5341	0	6	0	0	0	6
5342	0	6	0	0	0	6
5343	0	0	0	6	0	6
5344	0	0	6	0	0	6
5345	0	6	0	0	0	6
5346	0	0	0	6	0	6
5347	0	6	0	0	0	6
5348	0	0	0	6	0	6
5349	6	0	0	0	0	6
5350	0	6	0	0	0	6
5351	7	0	0	0	0	7
5352	6	0	0	0	0	6
5353	0	0	7	0	0	7
5354	8	0	0	0	0	8
5355	0	0	0	8	0	8
5356	0	0	8	0	0	8
5357	0	6	0	0	0	6
5358	0	0	0	6	0	6
5359	0	0	0	6	0	6
5360	6	0	0	0	0	6
5361	0	0	0	6	0	6
5362	0	0	0	6	0	6
5363	6	0	0	0	0	6
5364	0	6	0	0	0	6
5365	5	0	0	0	0	5
5366	0	0	5	0	0	5
5367	6	0	0	0	0	6
5368	0	0	6	0	0	6
5369	0	6	0	0	0	6
5370	5	0	0	0	0	5
5371	6	0	0	0	0	6
5372	0	0	5	0	0	5
5373	0	0	6	0	0	6
5374	0	0	6	0	0	6
5375	0	4	0	0	0	4
5376	0	0	0	4	0	4
5377	0	0	4	0	0	4
5378	0	0	5	0	0	5
5379	0	0	0	5	0	5
5380	0	0	5	0	0	5
5381	5	0	0	0	0	5
5382	5	0	0	0	0	5
5383	0	0	5	0	0	5
5384	0	5	0	0	0	5
5385	0	0	0	5	0	5
5386	0	0	5	0	0	5
5387	0	5	0	0	0	5
5388	0	0	0	6	0	6
5389	6	0	0	0	0	6
5390	6	0	0	0	0	6
5391	0	6	0	0	0	6
5392	0	0	0	6	0	6
5393	0	0	0	6	0	6
5394	0	0	0	6	0	6
5395	0	0	0	6	0	6
5396	0	0	6	0	0	6
5397	0	0	0	6	0	6
5398	1	0	5	0	0	6
5399	0	6	0	0	0	6
5400	6	0	0	0	0	6
5401	0	6	0	0	0	6
5402	0	0	0	6	0	6
5403	0	0	0	6	0	6
5404	6	0	0	0	0	6
5405	0	0	0	7	0	7
5406	0	7	0	0	0	7
5407	0	0	0	7	0	7
5408	0	0	0	7	0	7
5409	7	0	0	0	0	7
5410	0	0	7	0	0	7
5411	0	7	0	0	0	7
5412	0	7	0	0	0	7
5413	0	0	0	7	0	7
5414	7	0	0	0	0	7
5415	0	7	0	0	0	7
5416	0	0	0	7	0	7
5417	0	0	8	0	0	8
5418	0	0	0	8	0	8
5419	8	0	0	0	0	8
5420	8	0	0	0	0	8
5421	0	0	0	8	0	8
5422	8	0	0	0	0	8
5423	8	0	0	0	0	8
5424	0	0	9	0	0	9
5425	9	0	0	0	0	9
5426	0	10	0	0	0	10
5427	9	0	0	0	0	9
5428	0	0	9	0	0	9
5429	0	0	0	9	0	9
5430	8	0	0	0	0	8
5431	0	0	8	0	0	8
5432	0	0	8	0	0	8
5433	0	0	0	8	0	8
5434	0	0	8	0	0	8
5435	8	0	0	0	0	8
5436	0	0	8	0	0	8
5437	0	0	0	8	0	8
5438	0	0	0	8	0	8
5439	8	0	0	0	0	8
5440	0	0	7	0	0	7
5441	0	0	7	0	0	7
5442	0	0	0	7	0	7
5443	0	0	7	0	0	7
5444	7	0	0	0	0	7
5445	0	0	0	7	0	7
5446	0	0	7	0	0	7
5447	0	0	0	7	0	7
5448	0	0	0	6	0	6
5449	6	0	0	0	0	6
5450	0	0	6	0	0	6
5451	6	0	0	0	0	6
5452	0	0	6	0	0	6
5453	5	0	0	0	0	5
5454	5	0	0	0	0	5
5455	6	0	0	0	0	6
5456	0	6	0	0	0	6
5457	6	0	0	0	0	6
5458	7	0	0	0	0	7
5459	0	0	0	7	0	7
5460	0	0	7	0	0	7
5461	7	0	0	0	0	7
5462	0	0	7	0	0	7
5463	0	0	0	7	0	7
5464	0	0	0	6	0	6
5465	5	0	0	1	0	6
5466	0	6	0	0	0	6
5467	0	0	0	6	0	6
5468	0	0	0	6	0	6
5469	0	0	6	0	0	6
5470	0	0	0	6	0	6
5471	0	0	0	6	0	6
5472	0	0	0	6	0	6
5473	0	6	0	0	0	6
5474	6	0	0	0	0	6
5475	6	0	0	0	0	6
5476	0	6	0	0	0	6
5477	6	0	0	0	0	6
5478	0	0	0	6	0	6
5479	0	0	6	0	0	6
5480	0	5	0	0	0	5
5481	0	5	0	0	0	5
5482	5	0	0	0	0	5
5483	5	0	0	0	0	5
5484	0	0	0	5	0	5
5485	0	0	0	5	0	5
5486	0	0	0	5	0	5
5487	5	0	0	0	0	5
5488	0	0	5	0	0	5
5489	5	0	0	0	0	5
5490	0	0	0	5	0	5
5491	0	0	0	5	0	5
5492	0	4	0	0	0	4
5493	0	0	0	4	0	4
5494	0	0	0	4	0	4
5495	0	0	5	0	0	5
5496	0	5	0	0	0	5
5497	4	0	0	0	0	4
5498	5	0	0	0	0	5
5499	5	0	0	0	0	5
5500	4	0	0	0	0	4
5501	0	0	4	0	0	4
5502	3	0	0	0	0	3
5503	0	0	3	0	0	3
5504	0	0	0	4	0	4
5505	0	4	0	0	0	4
5506	0	0	0	4	0	4
5507	0	1	0	3	0	4
5508	0	0	4	0	0	4
5509	4	0	0	0	0	4
5510	4	0	0	0	0	4
5511	0	3	0	0	0	3
5512	0	0	4	0	0	4
5513	0	0	0	4	0	4
5514	0	0	4	0	0	4
5515	0	0	4	0	0	4
5516	0	0	0	4	0	4
5517	0	0	4	0	0	4
5518	0	0	0	5	0	5
5519	0	0	5	0	0	5
5520	0	0	0	5	0	5
5521	5	0	0	0	0	5
5522	5	0	0	0	0	5
5523	6	0	0	0	0	6
5524	6	0	0	0	0	6
5525	0	6	0	0	0	6
5526	0	0	0	6	0	6
5527	0	0	0	6	0	6
5528	0	0	6	0	0	6
5529	0	0	0	6	0	6
5530	0	0	6	0	0	6
5531	0	0	5	0	0	5
5532	5	0	0	0	0	5
5533	0	5	0	0	0	5
5534	4	0	0	0	0	4
5535	5	0	0	0	0	5
5536	0	5	0	0	0	5
5537	5	0	0	0	0	5
5538	0	0	5	0	0	5
5539	0	5	0	0	0	5
5540	5	0	0	0	0	5
5541	0	0	4	0	0	4
5542	4	0	0	0	0	4
5543	0	5	0	0	0	5
5544	6	0	0	0	0	6
5545	9	0	0	0	0	9
5546	0	10	0	0	0	10
5547	0	9	0	0	0	9
5548	0	10	0	0	0	10
5549	0	0	0	10	0	10
5550	0	0	0	10	0	10
5551	10	0	0	0	0	10
5552	10	0	0	0	0	10
5553	0	0	10	0	0	10
5554	0	0	10	0	0	10
5555	0	0	10	0	0	10
5556	0	0	0	10	0	10
5557	0	0	10	0	0	10
5558	0	0	0	10	0	10
5559	10	0	0	0	0	10
5560	0	0	10	0	0	10
5561	11	0	0	0	0	11
5562	11	0	0	0	0	11
5563	0	0	11	0	0	11
5564	0	11	0	0	0	11
5565	0	0	0	12	0	12
5566	0	0	13	0	0	13
5567	1	0	0	12	0	13
5568	0	0	0	13	0	13
5569	12	0	0	0	0	12
5570	0	0	0	13	0	13
5571	0	0	11	0	0	11
5572	0	0	0	12	0	12
5573	12	0	0	0	0	12
5574	0	12	0	0	0	12
5575	12	0	0	0	0	12
5576	0	0	0	12	0	12
5577	0	0	11	0	0	11
5578	0	0	12	0	0	12
5579	0	0	10	0	0	10
5580	0	12	0	0	0	12
5581	12	0	0	0	0	12
5582	0	12	0	0	0	12
5583	12	0	0	0	0	12
5584	0	12	0	0	0	12
5585	0	0	0	12	0	12
5586	0	0	0	12	0	12
5587	0	0	0	12	0	12
5588	0	12	0	0	0	12
5589	0	0	0	12	0	12
5590	0	0	0	12	0	12
5591	12	0	0	0	0	12
5592	0	0	0	12	0	12
5593	0	0	11	0	0	11
5594	11	0	0	0	0	11
5595	11	0	0	0	0	11
5596	0	11	0	0	0	11
5597	11	0	0	0	0	11
5598	12	0	0	0	0	12
5599	0	0	0	11	0	11
5600	0	0	0	11	0	11
5601	0	0	0	11	0	11
5602	11	0	0	0	0	11
5603	11	0	0	0	0	11
5604	0	0	11	0	0	11
5605	10	0	0	0	0	10
5606	11	0	0	0	0	11
5607	11	0	0	0	0	11
5608	0	0	10	0	0	10
5609	0	0	11	0	0	11
5610	0	0	0	11	0	11
5611	0	0	11	0	0	11
5612	0	0	0	11	0	11
5613	0	0	0	11	0	11
5614	0	11	0	0	0	11
5615	11	0	0	0	0	11
5616	0	0	11	0	0	11
5617	11	0	0	0	0	11
5618	0	0	0	11	0	11
5619	11	0	0	0	0	11
5620	0	8	0	0	0	8
5621	0	6	0	0	0	6
5622	0	0	0	6	0	6
5623	0	0	0	5	0	5
5624	0	0	5	0	0	5
5625	0	0	0	6	0	6
5626	6	0	0	0	0	6
5627	0	6	0	0	0	6
5628	0	0	6	0	0	6
5629	0	0	0	6	0	6
5630	0	0	5	0	0	5
5631	0	0	0	7	0	7
5632	0	0	7	0	0	7
5633	0	0	9	0	0	9
5634	0	0	0	9	0	9
5635	8	0	0	0	0	8
5636	8	0	0	0	0	8
5637	8	0	0	0	0	8
5638	0	7	0	0	0	7
5639	7	0	0	0	0	7
5640	7	0	0	0	0	7
5641	0	0	7	0	0	7
5642	0	7	0	0	0	7
5643	0	0	0	7	0	7
5644	7	0	0	0	0	7
5645	0	7	0	0	0	7
5646	7	0	0	0	0	7
5647	7	0	0	0	0	7
5648	7	0	0	0	0	7
5649	7	0	0	0	0	7
5650	0	0	0	6	0	6
5651	7	0	0	0	0	7
5652	0	0	0	7	0	7
5653	0	7	0	0	0	7
5654	0	0	0	7	0	7
5655	7	0	0	0	0	7
5656	0	0	7	0	0	7
5657	0	0	0	8	0	8
5658	8	0	0	0	0	8
5659	0	8	0	0	0	8
5660	8	0	0	0	0	8
5661	8	0	0	0	0	8
5662	0	8	0	0	0	8
5663	8	0	0	0	0	8
5664	0	0	8	0	0	8
5665	0	0	8	0	0	8
5666	8	0	0	0	0	8
5667	0	0	7	0	0	7
5668	0	0	0	8	0	8
5669	0	8	0	0	0	8
5670	8	0	0	0	0	8
5671	0	8	0	0	0	8
5672	0	8	0	0	0	8
5673	0	0	0	8	0	8
5674	0	0	0	8	0	8
5675	0	0	0	8	0	8
5676	0	0	0	8	0	8
5677	0	0	8	0	0	8
5678	0	0	0	8	0	8
5679	0	0	0	8	0	8
5680	8	0	0	0	0	8
5681	0	0	0	8	0	8
5682	0	0	8	0	0	8
5683	9	0	0	0	0	9
5684	0	0	0	9	0	9
5685	0	0	9	0	0	9
5686	0	0	0	9	0	9
5687	0	8	0	0	0	8
5688	8	0	0	0	0	8
5689	0	0	7	0	0	7
5690	0	8	0	0	0	8
5691	8	0	0	0	0	8
5692	0	8	0	0	0	8
5693	0	8	0	0	0	8
5694	8	0	0	0	0	8
5695	0	8	0	0	0	8
5696	0	8	0	0	0	8
5697	0	0	0	8	0	8
5698	0	0	8	0	0	8
5699	0	8	0	0	0	8
5700	0	0	0	8	0	8
5701	0	8	0	0	0	8
5702	8	0	0	0	0	8
5703	0	0	8	0	0	8
5704	0	0	0	9	0	9
5705	9	0	0	0	0	9
5706	0	0	0	8	0	8
5707	0	0	8	0	0	8
5708	8	0	0	0	0	8
5709	6	0	0	0	0	6
5710	0	6	0	0	0	6
5711	0	0	0	6	0	6
5712	0	0	0	6	0	6
5713	6	0	0	0	0	6
5714	6	0	0	0	0	6
5715	0	0	6	0	0	6
5716	0	6	0	0	0	6
5717	5	0	0	0	0	5
5718	0	0	0	5	0	5
5719	0	0	5	0	0	5
5720	0	0	5	0	0	5
5721	0	0	0	5	0	5
5722	5	0	0	0	0	5
5723	0	5	0	0	0	5
5724	5	0	0	0	0	5
5725	0	0	0	5	0	5
5726	0	0	0	5	0	5
5727	0	0	0	7	0	7
5728	7	0	0	0	0	7
5729	0	6	0	0	0	6
5730	0	0	0	6	0	6
5731	0	0	0	6	0	6
5732	0	0	6	0	0	6
5733	0	0	0	5	0	5
5734	0	0	5	0	0	5
5735	0	5	0	0	0	5
5736	0	0	0	5	0	5
5737	6	0	0	0	0	6
5738	0	0	6	0	0	6
5739	0	0	0	6	0	6
5740	0	0	6	0	0	6
5741	6	0	0	0	0	6
5742	0	0	6	0	0	6
5743	0	0	0	7	0	7
5744	7	0	0	0	0	7
5745	0	7	0	0	0	7
5746	8	0	0	0	0	8
5747	0	8	0	0	0	8
5748	0	0	0	7	0	7
5749	0	0	7	0	0	7
5750	0	0	7	0	0	7
5751	0	0	0	7	0	7
5752	7	0	0	0	0	7
5753	6	0	1	0	0	7
5754	0	0	0	7	0	7
5755	0	0	0	7	0	7
5756	7	0	0	0	0	7
5757	0	7	0	0	0	7
5758	0	7	0	0	0	7
5759	6	0	0	0	0	6
5760	0	0	6	0	0	6
5761	0	0	0	6	0	6
5762	0	0	6	0	0	6
5763	0	0	0	6	0	6
5764	0	0	6	0	0	6
5765	0	0	6	0	0	6
5766	0	0	0	6	0	6
5767	0	5	0	0	0	5
5768	6	0	0	0	0	6
5769	0	10	0	0	0	10
5770	0	0	0	10	0	10
5771	10	0	0	0	0	10
5772	0	0	0	10	0	10
5773	10	0	0	0	0	10
5774	10	0	0	0	0	10
5775	10	0	0	0	0	10
5776	0	10	0	0	0	10
5777	10	0	0	0	0	10
5778	0	0	0	9	0	9
5779	10	0	0	0	0	10
5780	0	0	0	10	0	10
5781	10	0	0	0	0	10
5782	9	0	0	0	0	9
5783	0	10	0	0	0	10
5784	0	0	0	11	0	11
5785	0	0	0	11	0	11
5786	0	10	0	0	0	10
5787	0	0	0	11	0	11
5788	11	0	0	0	0	11
5789	11	0	0	0	0	11
5790	11	0	0	0	0	11
5791	0	0	11	0	0	11
5792	12	0	0	0	0	12
5793	11	0	1	0	0	12
5794	12	0	0	0	0	12
5795	0	12	0	0	0	12
5796	0	0	0	12	0	12
5797	0	0	0	12	0	12
5798	0	0	0	11	0	11
5799	0	0	12	0	0	12
5800	0	0	0	12	0	12
5801	12	0	0	0	0	12
5802	0	0	0	12	0	12
5803	0	0	0	10	0	10
5804	0	0	10	0	0	10
5805	0	10	0	0	0	10
5806	10	0	0	0	0	10
5807	0	0	0	10	0	10
5808	10	0	0	0	0	10
5809	0	0	10	0	0	10
5810	12	0	0	0	0	12
5811	0	12	0	0	0	12
5812	0	0	12	0	0	12
5813	0	0	11	0	0	11
5814	0	0	0	11	0	11
5815	0	0	11	0	0	11
5816	0	11	0	0	0	11
5817	0	0	0	11	0	11
5818	0	0	0	10	0	10
5819	0	0	0	10	0	10
5820	10	0	0	0	0	10
5821	0	10	0	0	0	10
5822	0	0	0	9	0	9
5823	0	0	0	9	0	9
5824	9	0	0	0	0	9
5825	0	12	0	0	0	12
5826	11	0	0	0	0	11
5827	12	0	0	0	0	12
5828	12	0	0	0	0	12
5829	0	0	12	0	0	12
5830	0	0	0	12	0	12
5831	0	12	0	0	0	12
5832	0	12	0	0	0	12
5833	0	0	0	12	0	12
5834	0	12	0	0	0	12
5835	12	0	0	0	0	12
5836	0	0	12	0	0	12
5837	12	0	0	0	0	12
5838	12	0	0	0	0	12
5839	0	0	0	12	0	12
5840	12	0	0	0	0	12
5841	0	12	0	0	0	12
5842	12	0	0	0	0	12
5843	12	0	0	0	0	12
5844	12	0	0	0	0	12
5845	0	0	8	0	0	8
5846	0	0	8	0	0	8
5847	0	0	0	8	0	8
5848	0	8	0	0	0	8
5849	0	8	0	0	0	8
5850	0	0	0	8	0	8
5851	9	0	0	0	0	9
5852	0	0	0	9	0	9
5853	0	0	0	8	0	8
5854	9	0	0	0	0	9
5855	0	8	0	0	0	8
5856	0	0	8	0	0	8
5857	0	0	8	0	0	8
5858	8	0	0	0	0	8
5859	0	0	0	7	0	7
5860	0	0	7	0	0	7
5861	0	0	0	7	0	7
5862	0	0	0	7	0	7
5863	0	0	0	7	0	7
5864	0	0	0	7	0	7
5865	0	7	0	0	0	7
5866	0	0	0	6	0	6
5867	6	0	0	0	0	6
5868	0	6	0	0	0	6
5869	6	0	0	0	0	6
5870	6	0	0	0	0	6
5871	6	0	0	0	0	6
5872	0	0	6	0	0	6
5873	6	0	0	0	0	6
5874	6	0	0	0	0	6
5875	5	0	0	0	0	5
5876	6	0	0	0	0	6
5877	0	6	0	0	0	6
5878	6	0	0	0	0	6
5879	0	0	6	0	0	6
5880	0	0	0	7	0	7
5881	0	0	0	7	0	7
5882	7	0	0	0	0	7
5883	0	7	0	0	0	7
5884	7	0	0	0	0	7
5885	0	7	0	0	0	7
5886	5	0	0	0	0	5
5887	5	0	0	0	0	5
5888	0	6	0	0	0	6
5889	5	0	0	0	0	5
5890	6	0	0	0	0	6
5891	0	6	0	0	0	6
5892	0	6	0	0	0	6
5893	6	0	0	0	0	6
5894	0	0	0	7	0	7
5895	7	0	0	0	0	7
5896	7	0	0	0	0	7
5897	7	0	0	0	0	7
5898	8	0	0	0	0	8
5899	0	8	0	0	0	8
5900	0	8	0	0	0	8
5901	5	0	0	0	0	5
5902	0	0	5	0	0	5
5903	0	0	0	5	0	5
5904	0	0	0	5	0	5
5905	5	0	0	0	0	5
5906	0	5	0	0	0	5
5907	0	0	0	5	0	5
5908	0	0	0	6	0	6
5909	6	0	0	0	0	6
5910	0	0	0	6	0	6
5911	6	0	0	0	0	6
5912	8	0	0	0	0	8
5913	8	0	0	0	0	8
5914	0	0	0	8	0	8
5915	0	0	0	8	0	8
5916	0	0	8	0	0	8
5917	0	0	8	0	0	8
5918	8	0	0	0	0	8
5919	0	0	0	8	0	8
5920	0	0	8	0	0	8
5921	0	0	9	0	0	9
5922	0	0	0	9	0	9
5923	0	0	9	0	0	9
5924	0	0	0	9	0	9
5925	0	0	0	9	0	9
5926	0	0	9	0	0	9
5927	0	0	0	8	0	8
5928	0	0	0	8	0	8
5929	0	0	0	8	0	8
5930	0	0	8	0	0	8
5931	0	0	0	8	0	8
5932	8	0	0	0	0	8
5933	0	8	0	0	0	8
5934	8	0	0	0	0	8
5935	0	0	8	0	0	8
5936	8	0	0	0	0	8
5937	8	0	0	0	0	8
5938	8	0	0	0	0	8
5939	0	0	0	8	0	8
5940	0	0	0	8	0	8
5941	0	0	8	0	0	8
5942	8	0	0	0	0	8
5943	0	8	0	0	0	8
5944	0	8	0	0	0	8
5945	0	8	0	0	0	8
5946	0	0	0	8	0	8
5947	9	0	0	0	0	9
5948	8	0	0	0	0	8
5949	0	0	9	0	0	9
5950	0	0	0	9	0	9
5951	0	0	0	9	0	9
5952	0	0	8	0	0	8
5953	0	0	8	0	0	8
5954	8	0	0	0	0	8
5955	0	8	0	0	0	8
5956	8	0	0	0	0	8
5957	8	0	0	0	0	8
5958	0	0	0	8	0	8
5959	0	0	0	8	0	8
5960	8	0	0	0	0	8
5961	0	0	0	8	0	8
5962	0	0	0	8	0	8
5963	7	0	0	0	0	7
5964	0	0	0	7	0	7
5965	7	0	0	0	0	7
5966	7	0	0	0	0	7
5967	0	0	7	0	0	7
5968	7	0	0	0	0	7
5969	7	0	0	0	0	7
5970	6	0	0	0	0	6
5971	0	0	6	0	0	6
5972	6	0	0	0	0	6
5973	0	6	0	0	0	6
5974	5	0	0	0	0	5
5975	6	0	0	0	0	6
5976	0	0	0	6	0	6
5977	0	0	0	6	0	6
5978	0	6	0	0	0	6
5979	0	0	0	10	0	10
5980	0	0	0	10	0	10
5981	64	0	0	0	0	64
5982	0	0	0	71	0	71
5983	0	0	0	74	0	74
5984	0	0	0	209	0	209
5985	0	208	0	1	0	209
5986	213	0	0	0	0	213
5987	0	235	0	0	0	235
5988	244	0	0	0	0	244
5989	0	0	378	0	0	378
5990	379	0	0	0	0	379
5991	0	0	481	0	0	481
5992	0	477	0	0	0	477
5993	510	0	0	0	0	510
5994	570	1	0	0	0	571
5995	0	654	0	0	0	654
5996	0	923	0	0	0	923
5997	970	0	2	0	0	972
5998	979	0	1	0	0	980
5999	0	2	0	989	0	991
6000	1	2	0	985	0	988
6001	1	0	990	0	0	991
6002	1377	0	4	1	0	1382
6003	0	10	0	1410	0	1420
6004	0	1427	0	0	0	1427
6005	0	5	0	1423	0	1428
6006	0	6	0	1426	0	1432
6007	1	0	1701	1	0	1703
6008	1	1	0	1724	0	1726
6009	1721	0	4	0	0	1725
6010	0	1714	0	2	0	1716
6011	0	1714	0	2	0	1716
6012	1803	0	4	0	0	1807
6013	1884	0	4	2	0	1890
6014	1900	1	1	0	0	1902
6015	0	1911	0	0	0	1911
6016	0	1915	0	0	0	1915
6017	1969	0	3	0	0	1972
6018	2111	1	0	0	0	2112
6019	0	2124	0	3	0	2127
6020	0	2122	0	0	0	2122
6021	2147	0	2	0	0	2149
6022	0	2	0	2185	0	2187
6023	2287	0	5	0	0	2292
6024	1	11	0	2285	0	2297
6025	0	2313	0	0	0	2313
6026	0	2316	1	0	0	2317
6027	2332	0	0	0	0	2332
6028	2341	0	3	0	0	2344
6029	2359	0	2	0	0	2361
6030	0	2373	0	2	0	2375
6031	1	1	2382	1	0	2385
6032	0	2372	0	1	0	2373
6033	2389	1	3	1	0	2394
6034	2401	1	3	0	0	2405
6035	1	0	2414	0	0	2415
6036	0	2461	0	2	0	2463
6037	2	1	0	2425	0	2428
6038	1	2	0	2452	0	2455
6039	0	2471	0	2	0	2473
6040	0	0	2470	1	0	2471
6041	2440	1	6	0	0	2447
6042	0	2	0	2474	0	2476
6043	2495	0	1	0	0	2496
6044	2583	0	1	0	0	2584
6045	0	0	0	2695	0	2695
6046	1	5	0	2671	0	2677
6047	0	12	0	2683	0	2695
6048	0	1	0	2700	0	2701
6049	2732	0	1	0	0	2733
6050	2699	0	8	2	0	2709
6051	0	0	2867	0	0	2867
6052	0	9	0	2842	0	2851
6053	0	7	0	2841	0	2848
6054	2	6	2	2865	0	2875
6055	1	0	3130	0	0	3131
6056	1	5	2	3155	0	3163
6057	3115	2	2	1	0	3120
6058	0	12	0	3132	0	3144
6059	0	0	3149	0	0	3149
6060	0	7	0	3125	0	3132
6061	1	0	3126	0	0	3127
6062	3116	2	3	1	0	3122
6063	0	0	1	3129	0	3130
6064	3135	0	3	0	0	3138
6065	3138	0	3	0	0	3141
6066	0	4	0	3256	0	3260
6067	3147	0	7	1	0	3155
6068	2	8	0	3083	0	3093
6069	2	3079	1	0	0	3082
6070	3072	0	3	0	0	3075
6071	3053	0	1	0	0	3054
6072	2783	1	5	0	0	2789
6073	0	0	0	2751	0	2751
6074	0	3	0	2752	0	2755
6075	1	7	0	2749	0	2757
6076	0	0	2756	1	0	2757
6077	0	2356	0	0	0	2356
6078	1	13	1	2340	0	2355
6079	4	0	2355	1	0	2360
6080	2346	0	0	0	0	2346
6081	0	5	2	2411	0	2418
6082	2	0	2505	0	0	2507
6083	2463	2	2	1	0	2468
6084	1	5	0	2475	0	2481
6085	2	2	0	2471	0	2475
6086	1	1	0	2492	0	2494
6087	2491	0	1	2	0	2494
6088	2425	0	2	0	0	2427
6089	2309	0	45	0	0	2354
6090	0	2404	0	1	0	2405
6091	0	2398	0	4	0	2402
6092	2432	1	4	1	0	2438
6093	1	0	2483	0	0	2484
6094	1	3	0	2450	0	2454
6095	0	0	0	2457	0	2457
6096	2470	0	7	2	0	2479
6097	2475	1	2	1	0	2479
6098	0	2348	0	0	0	2348
6099	0	2	0	2338	0	2340
6100	1	0	2735	0	0	2736
6101	3	0	2805	0	0	2808
6102	0	2	0	2878	0	2880
6103	0	6	0	2897	0	2903
6104	2912	0	2	0	0	2914
6105	0	6	0	3068	0	3074
6106	3046	0	2	0	0	3048
6107	3037	0	4	0	0	3041
6108	1	0	3036	0	0	3037
6109	3203	0	6	0	0	3209
6110	3189	0	7	0	0	3196
6111	3235	2	21	0	0	3258
6112	1	3212	0	0	0	3213
6113	0	3195	0	0	0	3195
6114	0	2	0	3242	0	3244
6115	2	0	3287	0	0	3289
6116	0	3562	0	0	0	3562
6117	0	22	0	3549	0	3571
6118	0	11	0	3585	0	3596
6119	1	3556	0	0	0	3557
6120	3566	0	11	2	0	3579
6121	3480	0	15	0	0	3495
6122	0	0	3501	0	0	3501
6123	3456	1	15	2	0	3474
6124	0	0	3500	0	0	3500
6125	3430	1	4	2	0	3437
6126	1	0	3561	0	0	3562
6127	0	3490	0	1	0	3491
6128	0	11	0	3484	0	3495
6129	0	1	0	3592	0	3593
6130	3684	0	1	1	0	3686
6131	3479	0	6	0	0	3485
6132	3490	0	7	0	0	3497
6133	0	0	3503	0	0	3503
6134	1	12	0	3501	0	3514
6135	7	1	0	3465	0	3473
6136	3423	0	1	1	0	3425
6137	0	3447	0	4	0	3451
6138	3464	0	5	0	0	3469
6139	0	4	0	3451	0	3455
6140	0	9	0	3417	0	3426
6141	0	8	0	3304	0	3312
6142	1	7	0	3313	0	3321
6143	2	5	0	3319	0	3326
6144	0	3334	0	0	0	3334
6145	1	3311	0	2	0	3314
6146	0	3307	0	1	0	3308
6147	2	14	2	3293	0	3311
6148	2	0	3490	0	0	3492
6149	3514	0	2	1	0	3517
6150	0	3739	0	1	0	3740
6151	0	6	0	3719	0	3725
6152	0	5	0	3744	0	3749
6153	3785	0	2	0	0	3787
6154	3795	0	5	1	0	3801
6155	3915	0	9	0	0	3924
6156	0	4	0	3973	0	3977
6157	1	0	3919	0	0	3920
6158	1	0	3976	1	0	3978
6159	1	9	0	3791	0	3801
6160	2	0	3770	2	0	3774
6161	3978	0	14	2	0	3994
6162	0	4	0	4054	0	4058
6163	2	0	4074	0	0	4076
6164	2	10	0	4080	0	4092
6165	2	0	4055	1	0	4058
6166	0	0	4062	1	0	4063
6167	3	2	0	4012	0	4017
6168	3	0	4043	0	0	4046
6169	1	0	4023	0	0	4024
6170	0	4037	0	3	0	4040
6171	1	5	1	4023	0	4030
6172	4034	0	0	3	0	4037
6173	0	7	1	4029	0	4037
6174	0	12	0	4079	0	4091
6175	0	0	4193	3	0	4196
6176	4091	1	4	1	0	4097
6177	1	4	1	4169	0	4175
6178	1	1	1	4206	0	4209
6179	4223	0	7	1	0	4231
6180	0	3	0	4196	0	4199
6181	4106	0	3	0	0	4109
6182	4103	0	1	1	0	4105
6183	4319	0	6	0	0	4325
6184	0	4390	0	1	0	4391
6185	4193	0	5	2	0	4200
6186	0	4476	0	1	0	4477
6187	1	6	0	4413	0	4420
6188	4461	0	4	0	0	4465
6189	0	4453	0	0	0	4453
6190	4394	0	35	1	0	4430
6191	0	4338	0	0	0	4338
6192	4262	0	8	0	0	4270
6193	0	4331	0	1	0	4332
6194	15	3806	0	440	0	4261
6195	0	4327	0	1	0	4328
6196	0	13	0	4287	0	4300
6197	0	4676	0	0	0	4676
6198	1	18	0	4695	0	4714
6199	0	10	2	4705	0	4717
6200	0	10	0	4700	0	4710
6201	0	4	0	4745	0	4749
6202	4843	0	1	3	0	4847
6203	4806	0	6	9	0	4821
6204	2	0	4837	0	0	4839
6205	4886	0	5	2	0	4893
6206	4777	0	17	0	0	4794
6207	4679	0	9	0	0	4688
6208	0	0	4671	0	0	4671
6209	1	1	4771	2	0	4775
6210	4871	0	7	2	0	4880
6211	1	0	4946	0	0	4947
6212	0	4973	0	2	0	4975
6213	1	6	0	4994	0	5001
6214	5076	0	4	2	0	5082
6215	5144	0	5	0	0	5149
6216	5149	0	21	1	0	5171
6217	0	2	0	5325	0	5327
6218	1	4	0	5237	0	5242
6219	3	0	5230	0	0	5233
6220	1	17	0	5448	0	5466
6221	1	7	0	5734	0	5742
6222	6052	1	6	0	0	6059
6223	0	5903	0	3	0	5906
6224	5903	0	6	2	0	5911
6225	1	8	0	5919	0	5928
6226	5731	0	1	1	0	5733
6227	6053	0	12	0	0	6065
6228	6155	1	9	0	0	6165
6229	0	6175	1	2	0	6178
6230	1	6147	0	1	0	6149
6231	0	4	0	6106	0	6110
6232	6167	0	5	0	0	6172
6233	0	18	3	6202	0	6223
6234	0	16	0	6070	0	6086
6235	0	0	6152	0	0	6152
6236	1	19	6	5989	0	6015
6237	0	8	0	5937	0	5945
6238	3	9	0	5899	0	5911
6239	2	0	5809	1	0	5812
6240	3	0	5923	5	0	5931
6241	1	5947	0	6	0	5954
6242	5982	0	58	0	0	6040
6243	0	14	3	6099	0	6116
6244	4	0	6079	0	0	6083
6245	3	10	0	6045	0	6058
6246	2	11	0	6081	0	6094
6247	6102	0	13	0	0	6115
6248	6111	1	9	0	0	6121
6249	2	6101	0	2	0	6105
6250	6049	0	4	1	0	6054
6251	5972	0	11	0	0	5983
6252	1	5	1	5679	0	5686
6253	10	0	5539	1	0	5550
6254	0	5504	0	3	0	5507
6255	5499	0	17	0	0	5516
6256	5540	2	12	2	0	5556
6257	1	5365	0	1	0	5367
6258	0	27	1	5645	0	5673
6259	5851	1	1	0	0	5853
6260	5791	0	4	0	0	5795
6261	1	2	0	5796	0	5799
6262	5487	0	17	1	0	5505
6263	5469	3	7	2	0	5481
6264	5447	1	5	0	0	5453
6265	3	0	5487	1	0	5491
6266	0	5478	0	3	0	5481
6267	1	5290	0	0	0	5291
6268	5392	1	16	0	0	5409
6269	0	5546	0	3	0	5549
6270	5	1	5811	1	0	5818
6271	0	6	0	5733	0	5739
6272	5698	1	1	1	0	5701
6273	0	3	0	5396	0	5399
6274	5395	0	0	2	0	5397
6275	5380	0	4	2	0	5386
6276	5728	3	6	0	0	5737
6277	1	5904	0	1	0	5906
6278	0	5728	0	0	0	5728
6279	5560	0	4	0	0	5564
6280	5562	2	3	0	0	5567
6281	5598	1	18	0	0	5617
6282	0	6	2	5829	0	5837
6283	5913	0	5	0	0	5918
6284	0	5939	0	1	0	5940
6285	1	5733	0	4	0	5738
6286	1	8	2	5639	0	5650
6287	5	0	6062	1	0	6068
6288	1	0	6875	1	0	6877
6289	0	28	0	6867	0	6895
6290	3	0	6890	1	0	6894
6291	1	3	0	6820	0	6824
6292	6842	0	4	0	0	6846
6293	2	24	0	6770	0	6796
6294	6799	0	2	0	0	6801
6295	0	6833	0	4	0	6837
6296	3	0	6568	0	0	6571
6297	1	19	1	6253	0	6274
6298	2	18	0	6007	0	6027
6299	2	0	6209	1	0	6212
6300	1	24	0	6454	0	6479
6301	0	6241	0	1	0	6242
6302	4	16	0	6180	0	6200
6303	0	5	0	6227	0	6232
6304	0	7	0	6237	0	6244
6305	3	0	6158	1	0	6162
6306	2	0	6290	3	0	6295
6307	6174	0	6	4	0	6184
6308	3	0	6208	1	0	6212
6309	1	6216	0	1	0	6218
6310	6249	0	10	2	0	6261
6311	0	6241	0	7	0	6248
6312	6227	0	2	1	0	6230
6313	6228	0	13	0	0	6241
6314	6267	1	22	0	0	6290
6315	6289	0	18	0	0	6307
6316	0	6141	0	2	0	6143
6317	1	6085	0	3	0	6089
6318	6047	1	13	1	0	6062
6319	1	0	6080	0	0	6081
6320	2	6	0	5984	0	5992
6321	0	5	0	5964	0	5969
6322	2	0	5888	3	0	5893
6323	5904	0	9	4	0	5917
6324	5927	0	4	0	0	5931
6325	6082	1	4	1	0	6088
6326	0	6241	0	0	0	6241
6327	6230	0	5	0	0	6235
6328	2	12	0	6195	0	6209
6329	2	6117	0	2	0	6121
6330	6104	2	10	0	0	6116
6331	6145	1	7	1	0	6154
6332	6139	0	11	1	0	6151
6333	0	10	0	6076	0	6086
6334	0	5	1	5753	0	5759
6335	1	5657	0	2	0	5660
6336	1	0	5666	0	0	5667
6337	0	17	1	5748	0	5766
6338	2	5	0	5776	0	5783
6339	0	4	0	5799	0	5803
6340	2	0	5855	0	0	5857
6341	6065	0	13	3	0	6081
6342	1	14	1	6094	0	6110
6343	1	0	6250	0	0	6251
6344	0	12	0	6188	0	6200
6345	6106	0	6	1	0	6113
6346	1	5842	0	2	0	5845
6347	1	19	0	5809	0	5829
6348	2	0	5826	0	0	5828
6349	5910	0	13	0	0	5923
6350	5948	0	10	0	0	5958
6351	1	0	6046	0	0	6047
6352	2	28	0	5749	0	5779
6353	1	5586	0	2	0	5589
6354	5486	0	9	0	0	5495
6355	4	0	5509	0	0	5513
6356	5463	1	8	2	0	5474
6357	0	0	5446	0	0	5446
6358	1	0	5347	1	0	5349
6359	5438	1	6	1	0	5446
6360	0	5262	1	2	0	5265
6361	1	0	5255	0	0	5256
6362	0	4974	0	8	0	4982
6363	6	1	4966	0	0	4973
6364	0	4320	0	2	0	4322
6365	4323	1	5	1	0	4330
6366	2	0	4461	1	0	4464
6367	1	0	4592	0	0	4593
6368	0	0	4641	0	0	4641
6369	4701	0	9	5	0	4715
6370	4753	0	6	0	0	4759
6371	1	9	1	4731	0	4742
6372	6	0	4924	0	0	4930
6373	3	0	4933	1	0	4937
6374	4925	1	3	2	0	4931
6375	1	3	0	4581	0	4585
6376	4628	0	4	0	0	4632
6377	4560	0	14	2	0	4576
6378	2	66	0	4638	0	4706
6379	1	4711	0	2	0	4714
6380	1	6	2	4631	0	4640
6381	0	2	0	4663	0	4665
6382	1	0	4665	0	0	4666
6383	4	4653	0	4	0	4661
6384	1	4650	0	0	0	4651
6385	2	11	0	4625	0	4638
6386	1	0	4645	0	0	4646
6387	0	4708	0	0	0	4708
6388	2	0	4729	1	0	4732
6389	4713	2	4	2	0	4721
6390	4655	0	3	1	0	4659
6391	1	0	4823	0	0	4824
6392	5040	0	5	0	0	5045
6393	2	11	0	5147	0	5160
6394	1	5109	0	2	0	5112
6395	0	5	0	5122	0	5127
6396	5139	0	4	1	0	5144
6397	5152	1	5	2	0	5160
6398	5157	1	9	0	0	5167
6399	5159	2	21	1	0	5183
6400	0	5230	1	0	0	5231
6401	0	4944	0	0	0	4944
6402	4854	0	3	0	0	4857
6403	1	0	4916	0	0	4917
6404	0	7	0	4923	0	4930
6405	0	5001	0	0	0	5001
6406	2	18	1	4957	0	4978
6407	1	5260	0	0	0	5261
6408	0	5	0	5336	0	5341
6409	1	0	5387	0	0	5388
6410	5454	1	8	2	0	5465
6411	5398	0	17	1	0	5416
6412	1	0	5378	1	0	5380
6413	5464	0	4	3	0	5471
6414	5390	0	31	0	0	5421
6415	1	0	5563	0	0	5564
6416	2	4	1	5401	0	5408
6417	5244	0	7	1	0	5252
6418	1	1	5324	0	0	5326
6419	2	17	0	5830	0	5849
6420	3	0	5832	1	0	5836
6421	4	0	5808	2	0	5814
6422	5765	0	12	1	0	5778
6423	5833	0	25	1	0	5859
6424	5713	0	10	1	0	5724
6425	6064	0	3	0	0	6067
6426	0	12	0	5942	0	5954
6427	2	5870	0	3	0	5875
6428	1	5874	0	2	0	5877
6429	2	16	1	5862	0	5881
6430	6022	0	3	0	0	6025
6431	1	5983	0	2	0	5986
6432	0	5911	0	2	0	5913
6433	6006	0	6	1	0	6013
6434	0	6	0	5857	0	5863
6435	5925	0	3	0	0	5928
6436	0	6021	0	1	0	6022
6437	5881	0	22	1	0	5904
6438	0	0	5932	0	0	5932
6439	6171	0	6	2	0	6179
6440	6181	0	8	0	0	6189
6441	6153	0	17	2	0	6172
6442	0	1	5932	0	0	5933
6443	5908	0	33	1	0	5942
6444	1	5822	0	1	0	5824
6445	3	0	5826	0	0	5829
6446	0	15	1	5860	0	5876
6447	1	27	1	5769	0	5798
6448	0	5683	0	2	0	5685
6449	3	15	0	5693	0	5711
6450	1	3	3	5720	0	5727
6451	1	0	5746	0	0	5747
6452	5533	0	15	2	0	5550
6453	2	0	5646	1	0	5649
6454	0	11	1	5599	0	5611
6455	3	0	5601	0	0	5604
6456	2	13	1	5597	0	5613
6457	5438	0	3	0	0	5441
6458	5431	2	2	1	0	5436
6459	0	13	0	5452	0	5465
6460	1	0	5514	0	0	5515
6461	1	8	0	5438	0	5447
6462	0	0	5332	2	0	5334
6463	5395	1	9	5	0	5410
6464	5378	0	11	0	0	5389
6465	5346	2	27	0	0	5375
6466	5349	14	10	2	0	5375
6467	0	5124	0	1	0	5125
6468	0	13	0	5059	0	5072
6469	5099	1	6	0	0	5106
6470	1	5079	0	3	0	5083
6471	4	5059	0	2	0	5065
6472	2	0	5080	0	0	5082
6473	5150	0	13	0	0	5163
6474	5126	2	48	0	0	5176
6475	0	0	5316	0	0	5316
6476	0	5	2	5294	0	5301
6477	0	2	0	5508	0	5510
6478	1	0	5642	0	0	5643
6479	0	4	0	5702	0	5706
6480	5659	2	11	1	0	5673
6481	7	0	5596	0	0	5603
6482	1	0	5550	0	0	5551
6483	5284	0	15	1	0	5300
6484	0	0	5251	0	0	5251
6485	5389	0	60	2	0	5451
6486	2	5560	0	1	0	5563
6487	5467	1	8	0	0	5476
6488	1	12	0	5488	0	5501
6489	0	8	1	5476	0	5485
6490	5589	1	6	0	0	5596
6491	0	17	1	5499	0	5517
6492	5812	0	4	1	0	5817
6493	0	5729	0	0	0	5729
6494	1	2	1	5115	0	5119
6495	1	4	0	5017	0	5022
6496	4906	2	3	1	0	4912
6497	4965	0	15	0	0	4980
6498	4985	0	7	2	0	4994
6499	0	4905	0	1	0	4906
6500	0	4694	0	1	0	4695
6501	4466	1	6	2	0	4475
6502	3	0	4579	1	0	4583
6503	0	4980	0	2	0	4982
6504	5043	0	5	1	0	5049
6505	5054	1	2	0	0	5057
6506	4954	1	0	0	0	4955
6507	1	0	0	5005	0	5006
6508	5060	0	3	3	0	5066
6509	4989	0	10	2	0	5001
6510	4	7	0	4983	0	4994
6511	4685	0	6	0	0	4691
6512	0	0	4716	0	0	4716
6513	0	6	0	4575	0	4581
6514	0	4	1	4690	0	4695
6515	1	1	0	4731	0	4733
6516	4778	0	0	0	0	4778
6517	4851	1	1	0	0	4853
6518	4922	0	4	0	0	4926
6519	4877	1	5	1	0	4884
6520	4886	1	2	2	0	4891
6521	1	2	1	4885	0	4889
6522	0	13	0	4860	0	4873
6523	4917	1	0	0	0	4918
6524	0	4878	0	4	0	4882
6525	4852	2	9	2	0	4865
6526	16	0	4885	0	0	4901
6527	5101	0	12	1	0	5114
6528	5086	0	11	0	0	5097
6529	0	0	5026	0	0	5026
6530	4885	0	12	0	0	4897
6531	0	0	4945	2	0	4947
6532	0	0	5199	0	0	5199
6533	1	8	0	5242	0	5251
6534	1	7	0	5271	0	5279
6535	7	0	5184	0	0	5191
6536	4	0	5180	2	0	5186
6537	3	5522	0	7	0	5532
6538	1	5546	0	4	0	5551
6539	5587	0	9	1	0	5597
6540	2	5569	0	1	0	5572
6541	5618	1	14	0	0	5633
6542	1	5565	0	3	0	5569
6543	5460	0	16	0	0	5476
6544	3	0	5769	1	0	5773
6545	5977	0	4	0	0	5981
6546	1	14	1	6068	0	6084
6547	0	6092	0	0	0	6092
6548	0	13	1	6049	0	6063
6549	6077	0	3	0	0	6080
6550	6044	0	9	3	0	6056
6551	0	7	2	5947	0	5956
6552	7	0	5880	1	0	5888
6553	4	0	5657	1	0	5662
6554	1	5528	1	2	0	5532
6555	0	13	0	5444	0	5457
6556	5	0	5486	0	0	5491
6557	0	5532	1	3	0	5536
6558	2	15	3	5510	0	5530
6559	0	8	0	5741	0	5749
6560	5836	0	12	0	0	5848
6561	0	11	0	5560	0	5571
6562	0	0	5426	0	0	5426
6563	3	12	0	5393	0	5408
6564	5376	0	7	1	0	5384
6565	2	1	5363	0	0	5366
6566	5251	0	12	0	0	5263
6567	1	5093	1	0	0	5095
6568	4944	0	5	0	0	4949
6569	5386	0	6	0	0	5392
6570	2	13	1	5389	0	5405
6571	0	7	0	5383	0	5390
6572	0	5458	0	1	0	5459
6573	0	5	0	5422	0	5427
6574	5428	0	1	1	0	5430
6575	0	0	5500	1	0	5501
6576	0	9	0	5493	0	5502
6577	1	5361	0	0	0	5362
6578	2	11	2	4933	0	4948
6579	0	2	0	4974	0	4976
6580	4949	0	5	0	0	4954
6581	0	5039	0	0	0	5039
6582	0	5	0	5219	0	5224
6583	5327	0	5	0	0	5332
6584	2	16	2	5552	0	5572
6585	0	5	0	5645	0	5650
6586	5626	0	4	0	0	5630
6587	5623	0	12	0	0	5635
6588	1	1	5578	0	0	5580
6589	5540	1	17	2	0	5560
6590	5343	0	5	1	0	5349
6591	5400	0	18	1	0	5419
6592	1	5564	0	3	0	5568
6593	1	5482	0	0	0	5483
6594	2	13	0	5421	0	5436
6595	5519	0	7	0	0	5526
6596	5601	0	11	0	0	5612
6597	0	6	0	5628	0	5634
6598	0	0	5887	0	0	5887
6599	5821	0	7	1	0	5829
6600	5776	0	5	0	0	5781
6601	1	0	0	5717	0	5718
6602	1	3	0	5832	0	5836
6603	6271	0	6	1	0	6278
6604	0	7	0	6253	0	6260
6605	2	6315	0	1	0	6318
6606	0	9	0	6385	0	6394
6607	6146	1	3	2	0	6152
6608	2	0	6208	0	0	6210
6609	6397	0	16	1	0	6414
6610	1	0	6691	1	0	6693
6611	0	7	0	6833	0	6840
6612	6462	0	5	0	0	6467
6613	1	13	0	6440	0	6454
6614	0	2	0	6547	0	6549
6615	6509	1	11	2	0	6523
6616	0	0	6478	0	0	6478
6617	6	0	6564	1	0	6571
6618	3	17	1	6412	0	6433
6619	0	7	0	6332	0	6339
6620	0	10	0	6133	0	6143
6621	2	0	6106	2	0	6110
6622	6003	1	7	2	0	6013
6623	6011	1	5	0	0	6017
6624	5972	2	19	0	0	5993
6625	5996	2	19	0	0	6017
6626	0	6143	0	1	0	6144
6627	2	6041	0	4	0	6047
6628	0	6059	0	3	0	6062
6629	0	10	0	6075	0	6085
6630	1	30	0	6072	0	6103
6631	3	0	6085	0	0	6088
6632	2	5975	0	1	0	5978
6633	0	8	0	6002	0	6010
6634	6094	0	7	1	0	6102
6635	0	5889	0	0	0	5889
6636	0	16	0	5761	0	5777
6637	0	5835	0	2	0	5837
6638	5820	0	9	0	0	5829
6639	1	11	4	5884	0	5900
6640	2	0	5839	1	0	5842
6641	3	0	5900	1	0	5904
6642	2	8	0	5963	0	5973
6643	0	8	0	5838	0	5846
6644	1	7	0	5918	0	5926
6645	5470	0	12	0	0	5482
6646	1	0	5453	0	0	5454
6647	0	5448	0	8	0	5456
6648	0	13	0	5388	0	5401
6649	14	0	5455	1	0	5470
6650	1	5537	0	2	0	5540
6651	2	12	0	5615	0	5629
6652	222	0	5642	1	0	5865
6653	1	7	0	5870	0	5878
6654	0	5	0	5983	0	5988
6655	6030	1	1	0	0	6032
6656	6235	1	6	0	0	6242
6657	0	12	0	6122	0	6134
6658	5920	0	7	1	0	5928
6659	0	0	5770	3	0	5773
6660	3	8	0	5409	0	5420
6661	5	0	5364	1	0	5370
6662	2	104	0	5320	0	5426
6663	1	5465	0	9	0	5475
6664	3	5673	0	3	0	5679
6665	1	5667	0	2	0	5670
6666	0	21	2	5836	0	5859
6667	0	14	0	5858	0	5872
6668	3	1	5691	1	0	5696
6669	9	0	5678	1	0	5688
6670	1	0	5733	2	0	5736
6671	5649	1	18	1	0	5669
6672	0	3	0	5595	0	5598
6673	5467	0	2	3	0	5472
6674	0	5328	0	4	0	5332
6675	0	9	0	6001	0	6010
6676	6153	0	5	0	0	6158
6677	2	7	0	6127	0	6136
6678	5947	0	8	0	0	5955
6679	7	0	5620	0	0	5627
6680	0	5557	0	1	0	5558
6681	0	6	0	5574	0	5580
6682	5513	0	4	0	0	5517
6683	5232	0	4	0	0	5236
6684	1	2	0	5167	0	5170
6685	2	4	0	5073	0	5079
6686	5048	0	0	0	0	5048
6687	2	17	0	5010	0	5029
6688	3	0	5017	0	0	5020
6689	1	4997	0	1	0	4999
6690	0	8	0	4898	0	4906
6691	5016	0	5	0	0	5021
6692	4970	0	7	2	0	4979
6693	1	0	4998	1	0	5000
6694	1	4992	0	6	0	4999
6695	0	4967	1	13	0	4981
6696	0	21	1	4925	0	4947
6697	1	12	1	5075	0	5089
6698	0	5	1	5288	0	5294
6699	1	8	0	5301	0	5310
6700	0	5209	0	9	0	5218
6701	6	12	0	5158	0	5176
6702	0	10	0	5168	0	5178
6703	5130	0	19	1	0	5150
6704	5181	0	20	0	0	5201
6705	0	5368	0	0	0	5368
6706	5318	0	5	2	0	5325
6707	5312	0	1	3	0	5316
6708	5285	0	11	0	0	5296
6709	0	0	5382	2	0	5384
6710	0	9	0	5463	0	5472
6711	1	7	1	5475	0	5484
6712	3	0	5507	0	0	5510
6713	2	29	0	5522	0	5553
6714	2	13	0	5581	0	5596
6715	5515	0	16	0	0	5531
6716	0	1	5548	0	0	5549
6717	0	8	0	5549	0	5557
6718	5514	0	7	1	0	5522
6719	1	5505	0	2	0	5508
6720	5398	0	30	1	0	5429
6721	5507	0	12	1	0	5520
6722	1	5607	0	0	0	5608
6723	3	2	0	5654	0	5659
6724	5742	0	12	0	0	5754
6725	1	5407	0	5	0	5413
6726	0	7	0	5611	0	5618
6727	5634	0	5	1	0	5640
6728	5426	1	10	0	0	5437
6729	0	5464	0	0	0	5464
6730	5337	0	7	1	0	5345
6731	0	5	0	5638	0	5643
6732	5349	0	1	0	0	5350
6733	2	0	5470	0	0	5472
6734	0	7	1	5462	0	5470
6735	1	5	0	5434	0	5440
6736	5428	0	14	0	0	5442
6737	2	5340	0	1	0	5343
6738	5319	2	14	0	0	5335
6739	2	5288	0	2	0	5292
6740	5	0	5010	0	0	5015
6741	1	0	5429	1	0	5431
6742	1	15	1	5238	0	5255
6743	1	0	5307	0	0	5308
6744	0	19	2	5323	0	5344
6745	0	9	0	5252	0	5261
6746	0	4	1	5261	0	5266
6747	5226	0	1	0	0	5227
6748	5177	0	13	4	0	5194
6749	5180	2	6	0	0	5188
6750	1	5025	0	2	0	5028
6751	0	4212	0	3	0	4215
6752	2	0	4325	1	0	4328
6753	1	9	0	4343	0	4353
6754	1	0	4310	0	0	4311
6755	1	11	0	4287	0	4299
6756	1	9	1	4275	0	4286
6757	2	9	0	4243	0	4254
6758	1	0	4392	0	0	4393
6759	0	4	1	4473	0	4478
6760	4472	0	2	1	0	4475
6761	0	4397	0	1	0	4398
6762	0	0	0	4201	0	4201
6763	4279	0	13	0	0	4292
6764	4347	0	5	0	0	4352
6765	0	8	0	4597	0	4605
6766	0	4	1	4615	0	4620
6767	4465	0	1	0	0	4466
6768	0	4	2	4406	0	4412
6769	4364	0	9	1	0	4374
6770	1	7	0	4351	0	4359
6771	1	0	4366	0	0	4367
6772	0	4595	1	2	0	4598
6773	0	4521	0	0	0	4521
6774	0	5	0	4301	0	4306
6775	0	9	2	4312	0	4323
6776	4410	0	0	0	0	4410
6777	1	7	4	4555	0	4567
6778	0	15	0	4527	0	4542
6779	0	9	0	4627	0	4636
6780	0	4635	1	1	0	4637
6781	3	12	0	4408	0	4423
6782	0	7	0	4536	0	4543
6783	0	6	0	4533	0	4539
6784	4845	0	3	0	0	4848
6785	0	4834	0	0	0	4834
6786	2	20	0	4650	0	4672
6787	0	7	0	4937	0	4944
6788	0	9	1	4914	0	4924
6789	4919	0	4	1	0	4924
6790	6	11	0	4899	0	4916
6791	1	11	0	4951	0	4963
6792	0	0	4941	1	0	4942
6793	1	5225	0	3	0	5229
6794	3	21	0	5317	0	5341
6795	5344	0	4	1	0	5349
6796	1	5310	0	2	0	5313
6797	5441	1	8	3	0	5453
6798	5523	0	11	0	0	5534
6799	0	12	1	5553	0	5566
6800	3	10	0	5493	0	5506
6801	1	0	5498	4	0	5503
6802	1	13	1	5352	0	5367
6803	1	0	5326	0	0	5327
6804	2	2	0	5908	0	5912
6805	5881	0	16	2	0	5899
6806	0	5787	0	0	0	5787
6807	0	28	0	5625	0	5653
6808	0	53	0	5611	0	5664
6809	2	23	1	5525	0	5551
6810	3	2	0	5576	0	5581
6811	5578	0	4	1	0	5583
6812	0	5559	0	1	0	5560
6813	2	14	0	5552	0	5568
6814	5503	0	12	0	0	5515
6815	5	1	5435	1	0	5442
6816	5494	0	17	1	0	5512
6817	5127	0	10	6	0	5143
6818	0	0	5253	1	0	5254
6819	1	2	0	5148	0	5151
6820	5145	0	7	0	0	5152
6821	0	5204	0	1	0	5205
6822	5181	0	12	0	0	5193
6823	5159	0	7	3	0	5169
6824	5143	0	4	0	0	5147
6825	1	11	0	5239	0	5251
6826	0	9	0	5303	0	5312
6827	0	5163	0	0	0	5163
6828	0	3	0	5138	0	5141
6829	5141	0	12	0	0	5153
6830	0	0	5206	0	0	5206
6831	5203	0	8	1	0	5212
6832	5233	1	8	0	0	5242
6833	0	2	1	5313	0	5316
6834	0	1	3	5095	0	5099
6835	5091	0	5	1	0	5097
6836	5061	1	5	0	0	5067
6837	5030	0	7	0	0	5037
6838	0	0	5057	0	0	5057
6839	0	5262	0	0	0	5262
6840	5247	0	9	0	0	5256
6841	1	9	1	5009	0	5020
6842	0	5019	0	2	0	5021
6843	0	17	1	4990	0	5008
6844	5067	0	3	0	0	5070
6845	1	5	0	5045	0	5051
6846	0	0	5075	0	0	5075
6847	2	4964	1	3	0	4970
6848	1	4800	0	8	0	4809
6849	5	0	4834	0	0	4839
6850	4843	0	7	0	0	4850
6851	2	4768	0	1	0	4771
6852	0	5	0	4785	0	4790
6853	4769	0	8	1	0	4778
6854	1	4776	0	4	0	4781
6855	0	5	0	4729	0	4734
6856	4848	0	7	2	0	4857
6857	4	4	1	4874	0	4883
6858	4725	0	6	0	0	4731
6859	2	0	4744	1	0	4747
6860	1	4372	1	2	0	4376
6861	4356	0	14	1	0	4371
6862	4358	0	2	0	0	4360
6863	4023	0	12	0	0	4035
6864	0	0	4129	0	0	4129
6865	4243	0	1	1	0	4245
6866	4266	0	7	0	0	4273
6867	1	1	0	4235	0	4237
6868	4093	1	8	1	0	4103
6869	1	4113	0	0	0	4114
6870	1	6	0	4023	0	4030
6871	2	0	4131	0	0	4133
6872	0	10	0	4110	0	4120
6873	2	3	0	4061	0	4066
6874	3919	0	6	1	0	3926
6875	3809	0	10	2	0	3821
6876	3	0	3821	0	0	3824
6877	3812	1	16	3	0	3832
6878	0	0	3860	0	0	3860
6879	0	9	1	3296	0	3306
6880	1	0	3269	2	0	3272
6881	1	4	1	3581	0	3587
6882	0	3522	1	3	0	3526
6883	5	0	3515	0	0	3520
6884	6	0	3527	0	0	3533
6885	0	1	0	3547	0	3548
6886	3514	0	1	0	0	3515
6887	3497	0	2	1	0	3500
6888	3539	0	2	2	0	3543
6889	2	7	1	3527	0	3537
6890	0	8	2	3502	0	3512
6891	0	1	3	3486	0	3490
6892	0	3	1	3497	0	3501
6893	0	0	3562	0	0	3562
6894	0	11	0	3481	0	3492
6895	0	3482	0	3	0	3485
6896	1	5	0	3488	0	3494
6897	3427	0	5	0	0	3432
6898	0	0	3439	1	0	3440
6899	3425	0	14	0	0	3439
6900	2	0	3456	0	0	3458
6901	1	1	3407	0	0	3409
6902	1	3429	1	3	0	3434
6903	0	15	0	3407	0	3422
6904	1	1	0	3461	0	3463
6905	0	3398	0	3	0	3401
6906	3439	0	8	0	0	3447
6907	0	1	0	3485	0	3486
6908	0	7	0	3472	0	3479
6909	0	4	0	3407	0	3411
6910	3375	0	6	0	0	3381
6911	3377	1	1	0	0	3379
6912	0	1	0	3418	0	3419
6913	0	1	0	3388	0	3389
6914	3411	0	1	0	0	3412
6915	0	6	0	3146	0	3152
6916	1	3	1	3138	0	3143
6917	0	4	0	3160	0	3164
6918	1	0	3140	2	0	3143
6919	3171	0	2	0	0	3173
6920	3136	0	4	0	0	3140
6921	4	0	3151	0	0	3155
6922	0	7	0	3190	0	3197
6923	0	3115	0	3	0	3118
6924	3175	0	6	0	0	3181
6925	1	3151	0	0	0	3152
6926	0	3043	0	0	0	3043
6927	1	8	0	3040	0	3049
6928	3051	0	0	1	0	3052
6929	3075	1	2	0	0	3078
6930	3	5	1	2992	0	3001
6931	0	3	0	2986	0	2989
6932	2	5	0	2980	0	2987
6933	0	3	0	2971	0	2974
6934	2	2	0	2960	0	2964
6935	0	2909	0	3	0	2912
6936	0	4	1	2912	0	2917
6937	2910	0	2	0	0	2912
6938	2877	0	9	0	0	2886
6939	2897	0	5	0	0	2902
6940	0	2838	0	0	0	2838
6941	2	6	0	2688	0	2696
6942	0	0	2863	0	0	2863
6943	2921	0	36	0	0	2957
6944	1	0	0	2966	0	2967
6945	2740	0	2	0	0	2742
6946	2685	0	0	0	0	2685
6947	2924	1	2	0	0	2927
6948	0	2	0	2957	0	2959
6949	2906	1	5	0	0	2912
6950	0	2	0	2924	0	2926
6951	1	5	0	2845	0	2851
6952	2884	0	0	0	0	2884
6953	1	1	0	2896	0	2898
6954	2890	0	0	0	0	2890
6955	2921	0	0	0	0	2921
6956	0	24	0	2588	0	2612
6957	7	0	0	2564	0	2571
6958	0	3	2	2559	0	2564
6959	0	0	2666	0	0	2666
6960	0	0	2764	0	0	2764
6961	1	3	2	2735	0	2741
6962	0	3	0	2728	0	2731
6963	0	2	0	2802	0	2804
6964	0	14	3	2817	0	2834
6965	1	1	0	2842	0	2844
6966	2906	0	7	0	0	2913
6967	0	3093	0	0	0	3093
6968	0	4	0	3060	0	3064
6969	3186	0	5	0	0	3191
6970	0	12	0	3184	0	3196
6971	1	1	0	3201	0	3203
6972	3195	0	1	1	0	3197
6973	3183	0	3	0	0	3186
6974	1	0	3332	0	0	3333
6975	0	4	0	3621	0	3625
6976	0	0	3582	0	0	3582
6977	1	6	4	3516	0	3527
6978	1	3	0	3495	0	3499
6979	1	6	0	3519	0	3526
6980	1	0	3572	1	0	3574
6981	0	3754	0	10	0	3764
6982	2	3776	0	2	0	3780
6983	2	2	0	3769	0	3773
6984	3839	0	4	1	0	3844
6985	0	0	3886	0	0	3886
6986	0	0	4077	0	0	4077
6987	1	6	0	4107	0	4114
6988	3	4	0	4323	0	4330
6989	0	4552	0	1	0	4553
6990	0	18	2	4562	0	4582
6991	1	5	0	4752	0	4758
6992	1	4	0	4818	0	4823
6993	4946	0	1	3	0	4950
6994	4945	0	3	1	0	4949
6995	2	17	0	4897	0	4916
6996	0	5190	0	1	0	5191
6997	1	3	3	5120	0	5127
6998	5191	0	4	1	0	5196
6999	0	5175	1	1	0	5177
7000	0	12	1	5124	0	5137
7001	0	5174	0	3	0	5177
7002	5199	0	8	1	0	5208
7003	5222	0	15	1	0	5238
7004	0	5260	1	0	0	5261
7005	0	5251	0	5	0	5256
7006	3	0	5248	3	0	5254
7007	1	5166	0	4	0	5171
7008	1	16	0	5142	0	5159
7009	2	0	5457	3	0	5462
7010	0	5489	0	3	0	5492
7011	0	14	1	5479	0	5494
7012	1	8	1	5471	0	5481
7013	1	2	0	5517	0	5520
7014	5515	3	16	0	0	5534
7015	0	0	5551	1	0	5552
7016	0	0	5672	3	0	5675
7017	0	98	2	5536	0	5636
7018	2	0	5504	1	0	5507
7019	1	15	1	5448	0	5465
7020	1	7	1	5465	0	5474
7021	2	4	0	5458	0	5464
7022	2	13	1	5560	0	5576
7023	5225	0	3	0	0	5228
7024	5203	0	11	1	0	5215
7025	0	9	0	5189	0	5198
7026	0	0	5280	0	0	5280
7027	3	25	0	5192	0	5220
7028	1	5264	0	1	0	5266
7029	0	5	0	5280	0	5285
7030	5420	1	10	1	0	5432
7031	5424	0	16	2	0	5442
7032	0	4	0	5501	0	5505
7033	2	10	1	5486	0	5499
7034	0	4	0	5521	0	5525
7035	5299	2	12	1	0	5314
7036	0	0	5291	1	0	5292
7037	0	0	5327	1	0	5328
7038	0	5724	0	3	0	5727
7039	5685	0	13	0	0	5698
7040	1	8	0	5656	0	5665
7041	1	0	5749	1	0	5751
7042	0	5885	1	4	0	5890
7043	0	5838	0	3	0	5841
7044	0	15	0	5870	0	5885
7045	1	15	1	5864	0	5881
7046	1	5985	0	2	0	5988
7047	0	8	0	6149	0	6157
7048	1	5	0	6941	0	6947
7049	6938	0	17	2	0	6957
7050	1	6861	0	1	0	6863
7051	1	14	0	6529	0	6544
7052	6	0	6690	0	0	6696
7053	0	5	0	6744	0	6749
7054	6769	0	7	0	0	6776
7055	1	6791	0	6	0	6798
7056	0	6	0	6614	0	6620
7057	3	0	6879	2	0	6884
7058	6	0	7028	1	0	7035
7059	2	26	0	7102	0	7130
7060	0	19	0	7068	0	7087
7061	6956	1	13	1	0	6971
7062	0	6857	0	4	0	6861
7063	6831	0	14	0	0	6845
7064	9	0	6621	1	0	6631
7065	6501	1	15	2	0	6519
7066	0	0	6518	3	0	6521
7067	6339	0	14	3	0	6356
7068	6286	2	41	1	0	6330
7069	2	0	6199	1	0	6202
7070	4	1	6284	1	0	6290
7071	1	6205	0	5	0	6211
7072	0	16	0	6187	0	6203
7073	6240	1	7	0	0	6248
7074	2	12	0	6122	0	6136
7075	0	7	0	6156	0	6163
7076	0	6	1	6161	0	6168
7077	0	0	6109	0	0	6109
7078	6214	3	10	2	0	6229
7079	6267	1	17	0	0	6285
7080	1	6300	0	2	0	6303
7081	5	16	0	6201	0	6222
7082	0	6464	0	0	0	6464
7083	3	3	0	6467	0	6473
7084	6493	0	9	1	0	6503
7085	0	6218	0	0	0	6218
7086	0	24	0	6279	0	6303
7087	6411	1	11	0	0	6423
7088	6544	0	17	2	0	6563
7089	0	8	1	6594	0	6603
7090	3	0	6579	0	0	6582
7091	1	14	1	6435	0	6451
7092	2	6381	1	7	0	6391
7093	6391	1	14	2	0	6408
7094	0	6562	0	15	0	6577
7095	2	4	1	6577	0	6584
7096	6663	4	4	1	0	6672
7097	9	16	2	6788	0	6815
7098	0	11	1	6730	0	6742
7099	4	0	6702	0	0	6706
7100	2	6768	0	3	0	6773
7101	6743	1	8	0	0	6752
7102	6733	0	10	0	0	6743
7103	1	6657	1	1	0	6660
7104	0	6687	1	5	0	6693
7105	2	7	0	6659	0	6668
7106	6902	0	6	3	0	6911
7107	0	6854	0	2	0	6856
7108	1	12	0	6802	0	6815
7109	6	0	6920	0	0	6926
7110	0	5	0	6918	0	6923
7111	7074	0	7	0	0	7081
7112	1	7035	0	5	0	7041
7113	3	8	1	6617	0	6629
7114	80	0	6628	0	0	6708
7115	6	0	7474	6	0	7486
7116	0	9	0	7606	0	7615
7117	2	11	0	7448	0	7461
7118	1	6996	0	8	0	7005
7119	12	19	0	6931	0	6962
7120	7003	0	7	1	0	7011
7121	0	9	0	6994	0	7003
7122	7059	0	6	0	0	7065
7123	0	6878	0	1	0	6879
7124	0	6021	0	1	0	6022
7125	0	13	0	6021	0	6034
7126	4	6	0	6020	0	6030
7127	3	0	6030	0	0	6033
7128	0	12	0	5902	0	5914
7129	5793	2	7	0	0	5802
7130	2	0	5845	0	0	5847
7131	0	30	2	5583	0	5615
7132	1	0	5599	0	0	5600
7133	2	17	7	5206	0	5232
7134	2	23	0	5130	0	5155
7135	0	13	0	5150	0	5163
7136	4	0	5210	0	0	5214
7137	1	18	0	5234	0	5253
7138	0	5212	0	2	0	5214
7139	0	8	1	4931	0	4940
7140	1	2	1	4983	0	4987
7141	4887	2	7	0	0	4896
7142	0	0	4912	1	0	4913
7143	2	8	0	4905	0	4915
7144	1	0	4915	0	0	4916
7145	0	0	4839	1	0	4840
7146	0	14	0	4757	0	4771
7147	0	43	1	4718	0	4762
7148	1	3	0	4760	0	4764
7149	4703	1	2	2	0	4708
7150	2	0	4718	0	0	4720
7151	4682	0	3	1	0	4686
7152	0	16	1	4688	0	4705
7153	1	5	0	4536	0	4542
7154	0	4557	0	1	0	4558
7155	1	15	0	4565	0	4581
7156	0	5	1	4640	0	4646
7157	1	1	0	4657	0	4659
7158	4415	1	3	0	0	4419
7159	4	1	4401	0	0	4406
7160	4371	0	14	2	0	4387
7161	0	4454	0	2	0	4456
7162	4361	3	6	1	0	4371
7163	1	4279	0	1	0	4281
7164	0	4085	0	0	0	4085
7165	1	20	0	4074	0	4095
7166	4106	0	3	0	0	4109
7167	7	13	0	4123	0	4143
7168	2	4112	0	2	0	4116
7169	1	4061	0	2	0	4064
7170	0	11	0	3848	0	3859
7171	1	14	0	3845	0	3860
7172	0	3817	0	1	0	3818
7173	0	19	0	3716	0	3735
7174	2	4	0	3727	0	3733
7175	0	3	0	3713	0	3716
7176	3641	0	4	0	0	3645
7177	0	0	3648	0	0	3648
7178	3661	0	6	1	0	3668
7179	3654	0	9	0	0	3663
7180	3463	1	4	1	0	3469
7181	0	3614	0	0	0	3614
7182	0	11	0	3360	0	3371
7183	3416	0	1	1	0	3418
7184	0	7	0	3422	0	3429
7185	3334	1	1	1	0	3337
7186	1	3444	0	0	0	3445
7187	3215	0	5	0	0	3220
7188	3240	0	5	1	0	3246
7189	3269	1	6	1	0	3277
7190	0	2	0	2649	0	2651
7191	0	2	0	2443	0	2445
7192	2340	0	0	1	0	2341
7193	0	2367	0	0	0	2367
7194	0	2348	0	2	0	2350
7195	2332	2	0	0	0	2334
7196	0	6	0	2303	0	2309
7197	1	3	0	2284	0	2288
7198	0	7	0	2175	0	2182
7199	0	2117	0	0	0	2117
7200	2111	0	3	0	0	2114
7201	1	10	0	2094	0	2105
7202	0	2103	0	1	0	2104
7203	0	5	0	2127	0	2132
7204	0	0	0	2145	0	2145
7205	0	2	0	2226	0	2228
7206	0	1	0	2171	0	2172
7207	2177	0	3	0	0	2180
7208	2150	0	2	0	0	2152
7209	2148	1	6	1	0	2156
7210	0	2	0	2195	0	2197
7211	3	0	2181	0	0	2184
7212	1	0	2182	0	0	2183
7213	0	0	2161	3	0	2164
7214	2179	0	3	2	0	2184
7215	1	6	0	2237	0	2244
7216	0	3	0	2324	0	2327
7217	1	2	0	2334	0	2337
7218	2341	0	2	0	0	2343
7219	2340	0	1	1	0	2342
7220	0	2269	0	1	0	2270
7221	0	2	0	2202	0	2204
7222	3	0	2280	1	0	2284
7223	0	2292	0	1	0	2293
7224	2	12	0	2271	0	2285
7225	1	9	1	2269	0	2280
7226	0	3	0	2392	0	2395
7227	0	5	2	2400	0	2407
7228	0	0	2406	1	0	2407
7229	1	0	2397	0	0	2398
7230	0	2249	0	1	0	2250
7231	0	6	1	2217	0	2224
7232	0	0	0	2280	0	2280
7233	2269	0	5	1	0	2275
7234	0	0	2364	0	0	2364
7235	0	7	0	2388	0	2395
7236	0	4	0	2405	0	2409
7237	1	0	2329	0	0	2330
7238	0	2252	0	0	0	2252
7239	2244	1	5	1	0	2251
7240	2	0	2278	0	0	2280
7241	2224	2	0	0	0	2226
7242	0	0	2277	0	0	2277
7243	0	6	0	2230	0	2236
7244	1	0	2259	0	0	2260
7245	2	0	2295	0	0	2297
7246	0	2	0	2310	0	2312
7247	0	0	0	2290	0	2290
7248	0	0	0	2225	0	2225
7249	1	1	0	2185	0	2187
7250	0	4	0	2188	0	2192
7251	0	0	2189	1	0	2190
7252	1	0	2067	125	0	2193
7253	0	2199	0	3	0	2202
7254	2137	0	18	0	0	2155
7255	0	1	0	2190	0	2191
7256	2241	0	2	0	0	2243
7257	0	2	0	2061	0	2063
7258	2100	1	1	0	0	2102
7259	0	6	0	2064	0	2070
7260	0	2	0	2084	0	2086
7261	0	2064	0	0	0	2064
7262	1	13	0	1964	0	1978
7263	0	3	0	2034	0	2037
7264	0	7	0	2018	0	2025
7265	0	4	0	2064	0	2068
7266	0	2052	0	3	0	2055
7267	2028	0	2	0	0	2030
7268	0	2060	0	2	0	2062
7269	0	3	0	2056	0	2059
7270	2085	1	3	0	0	2089
7271	2	0	2080	0	0	2082
7272	1	2	2166	0	0	2169
7273	0	3	1	2178	0	2182
7274	0	3	0	2203	0	2206
7275	0	1	1	2215	0	2217
7276	0	1	0	2246	0	2247
7277	0	2	0	2299	0	2301
7278	0	2267	0	0	0	2267
7279	0	8	0	2277	0	2285
7280	2433	0	1	0	0	2434
7281	0	9	0	2359	0	2368
7282	1	0	2421	0	0	2422
7283	0	3	0	2478	0	2481
7284	2493	0	2	0	0	2495
7285	0	2555	0	1	0	2556
7286	0	3	0	2516	0	2519
7287	2	5	0	2552	0	2559
7288	1	1	2444	15	0	2461
7289	2	0	2460	1	0	2463
7290	2351	0	79	0	0	2430
7291	0	1	0	2409	0	2410
7292	0	3	1	2330	0	2334
7293	1	0	2392	1	0	2394
7294	381	1	2034	1	0	2417
7295	0	2463	0	0	0	2463
7296	0	6	0	2453	0	2459
7297	2	0	2457	0	0	2459
7298	0	2451	0	5	0	2456
7299	2524	0	21	0	0	2545
7300	2603	0	4	0	0	2607
7301	1	6	0	2674	0	2681
7302	0	2562	0	0	0	2562
7303	2570	0	0	2	0	2572
7304	0	6	0	2547	0	2553
7305	1	0	2514	1	0	2516
7306	1	2607	0	1	0	2609
7307	2606	0	2	0	0	2608
7308	2573	0	6	0	0	2579
7309	0	5	0	2580	0	2585
7310	0	2	0	2510	0	2512
7311	3	0	2533	0	0	2536
7312	0	7	0	2556	0	2563
7313	2	1	0	2539	0	2542
7314	0	18	0	2529	0	2547
7315	0	9	0	2538	0	2547
7316	1	4	1	2514	0	2520
7317	1	2482	0	0	0	2483
7318	2447	0	13	0	0	2460
7319	0	0	2480	0	0	2480
7320	1	2442	0	0	0	2443
7321	1	2	0	2414	0	2417
7322	2465	0	1	0	0	2466
7323	1	10	0	2463	0	2474
7324	2	6	0	2458	0	2466
7325	0	23	1	2531	0	2555
7326	0	8	0	2549	0	2557
7327	1	1	2539	1	0	2542
7328	1	2508	0	0	0	2509
7329	2459	0	9	0	0	2468
7330	10	0	2537	0	0	2547
7331	1	4	0	2521	0	2526
7332	2583	0	1	1	0	2585
7333	0	2586	0	0	0	2586
7334	2543	0	1	0	0	2544
7335	0	7	0	2604	0	2611
7336	0	2	0	2633	0	2635
7337	1	0	0	2704	0	2705
7338	0	1	0	2741	0	2742
7339	2694	0	2	0	0	2696
7340	0	2	0	2680	0	2682
7341	0	3	1	2660	0	2664
7342	2612	0	0	1	0	2613
7343	0	0	2629	0	0	2629
7344	1	0	0	2688	0	2689
7345	2678	0	0	0	0	2678
7346	2664	0	4	0	0	2668
7347	0	1	0	2944	0	2945
7348	0	11	0	2849	0	2860
7349	0	2869	0	0	0	2869
7350	0	3	1	2823	0	2827
7351	1	4	0	2845	0	2850
7352	0	0	2881	1	0	2882
7353	4	0	2848	0	0	2852
7354	1	2903	0	0	0	2904
7355	1	11	0	2839	0	2851
7356	0	4	0	2714	0	2718
7357	2736	0	0	1	0	2737
7358	1	11	0	2661	0	2673
7359	12	0	2621	0	0	2633
7360	1	12	0	2593	0	2606
7361	5	0	2574	1	0	2580
7362	0	0	2688	0	0	2688
7363	0	5	1	2659	0	2665
7364	0	4	0	2949	0	2953
7365	2932	0	4	0	0	2936
7366	3065	0	2	0	0	3067
7367	1	3	0	3147	0	3151
7368	3237	0	2	0	0	3239
7369	3161	0	3	4	0	3168
7370	0	3	0	3130	0	3133
7371	0	1	0	3050	0	3051
7372	3058	0	1	0	0	3059
7373	3183	0	1	0	0	3184
7374	2	2	0	3258	0	3262
7375	0	3167	0	1	0	3168
7376	0	10	1	3141	0	3152
7377	0	11	0	3106	0	3117
7378	0	0	3193	0	0	3193
7379	1	2	0	3268	0	3271
7380	3259	0	8	2	0	3269
7381	0	3253	0	2	0	3255
7382	3158	0	12	0	0	3170
7383	3176	1	4	1	0	3182
7384	3224	1	9	0	0	3234
7385	0	4	1	3226	0	3231
7386	0	0	3201	1	0	3202
7387	2	0	3146	5	0	3153
7388	0	3143	0	2	0	3145
7389	0	3136	0	2	0	3138
7390	0	3180	0	2	0	3182
7391	1	3192	0	0	0	3193
7392	1	2	3246	0	0	3249
7393	3245	0	5	0	0	3250
7394	0	10	1	3293	0	3304
7395	0	3	0	3371	0	3374
7396	0	12	0	3369	0	3381
7397	0	3362	0	0	0	3362
7398	3334	1	17	0	0	3352
7399	0	0	3377	0	0	3377
7400	2	3332	0	7	0	3341
7401	0	1	1	3297	0	3299
7402	3295	1	10	0	0	3306
7403	0	4	1	3344	0	3349
7404	2	0	3485	1	0	3488
7405	4	0	3542	0	0	3546
7406	0	5	1	3534	0	3540
7407	0	9	1	3530	0	3540
7408	3415	1	2	0	0	3418
7409	0	0	3451	2	0	3453
7410	3465	0	5	0	0	3470
7411	3445	0	10	0	0	3455
7412	0	12	1	3391	0	3404
7413	1	0	3403	1	0	3405
7414	0	6	0	3386	0	3392
7415	3373	0	9	0	0	3382
7416	0	3325	0	1	0	3326
7417	3313	0	5	0	0	3318
7418	1	9	0	3271	0	3281
7419	0	3254	0	0	0	3254
7420	0	8	0	3318	0	3326
7421	0	2	0	3405	0	3407
7422	0	3186	0	6	0	3192
7423	0	4	0	3141	0	3145
7424	0	5	0	3153	0	3158
7425	0	10	0	3134	0	3144
7426	0	0	3146	0	0	3146
7427	2	3060	0	4	0	3066
7428	3099	0	3	0	0	3102
7429	0	6	1	3115	0	3122
7430	0	3073	0	1	0	3074
7431	3393	0	2	0	0	3395
7432	0	6	0	3468	0	3474
7433	0	7	0	3436	0	3443
7434	0	1	0	3491	0	3492
7435	0	1	0	3471	0	3472
7436	3508	1	3	0	0	3512
7437	7	2	0	3353	0	3362
7438	2	3	0	3234	0	3239
7439	3515	0	5	0	0	3520
7440	0	3	0	3227	0	3230
7441	19	0	3324	0	0	3343
7442	0	2	0	3269	0	3271
7443	3206	0	33	0	0	3239
7444	0	7	1	3157	0	3165
7445	1	0	3147	0	0	3148
7446	0	0	3239	2	0	3241
7447	3236	0	0	1	0	3237
7448	3259	1	14	2	0	3276
7449	3159	1	4	0	0	3164
7450	3083	1	30	1	0	3115
7451	1	0	3277	0	0	3278
7452	0	6	1	3296	0	3303
7453	0	2	0	3286	0	3288
7454	3207	0	1	1	0	3209
7455	0	5	0	3173	0	3178
7456	0	0	3206	0	0	3206
7457	0	9	0	3205	0	3214
7458	1	0	3211	0	0	3212
7459	0	3209	0	1	0	3210
7460	3182	2	2	0	0	3186
7461	1	5	0	3205	0	3211
7462	1	0	3386	0	0	3387
7463	1	4	0	3556	0	3561
7464	0	5	0	3545	0	3550
7465	1	0	3594	0	0	3595
7466	1	8	0	3737	0	3746
7467	3689	0	10	3	0	3702
7468	2	0	3670	0	0	3672
7469	3720	1	11	1	0	3733
7470	0	3779	0	2	0	3781
7471	1	0	3673	0	0	3674
7472	26	0	3857	0	0	3883
7473	0	13	0	3906	0	3919
7474	0	9	1	3908	0	3918
7475	0	0	3907	0	0	3907
7476	0	2	0	4043	0	4045
7477	4059	0	10	1	0	4070
7478	4047	0	4	2	0	4053
7479	1	6	0	4010	0	4017
7480	1	9	0	3877	0	3887
7481	1	3792	0	2	0	3795
7482	3805	0	7	1	0	3813
7483	1	8	1	4032	0	4042
7484	0	4029	0	1	0	4030
7485	4093	0	8	3	0	4104
7486	4142	0	5	0	0	4147
7487	0	4104	0	3	0	4107
7488	0	3	0	4115	0	4118
7489	1	6	0	4138	0	4145
7490	2	0	4274	0	0	4276
7491	2	2	0	4282	0	4286
7492	4270	0	1	0	0	4271
7493	0	11	0	4365	0	4376
7494	21	0	4299	0	0	4320
7495	4422	1	8	1	0	4432
7496	10	354	0	3988	0	4352
7497	1	1	4360	1	0	4363
7498	0	10	0	4390	0	4400
7499	1	0	4437	0	0	4438
7500	1	6	0	4438	0	4445
7501	0	6	0	4439	0	4445
7502	4470	0	9	1	0	4480
7503	1	4534	0	6	0	4541
7504	4506	1	8	0	0	4515
7505	4467	0	4	0	0	4471
7506	4508	2	6	3	0	4519
7507	0	4265	0	0	0	4265
7508	4	0	4242	0	0	4246
7509	0	4	1	4417	0	4422
7510	4401	0	5	0	0	4406
7511	4398	0	13	1	0	4412
7512	0	4	1	4375	0	4380
7513	4320	0	1	0	0	4321
7514	1	0	4342	0	0	4343
7515	4127	0	19	1	0	4147
7516	1	1	4204	0	0	4206
7517	1	4095	0	3	0	4099
7518	4130	0	12	0	0	4142
7519	4103	0	22	0	0	4125
7520	0	4087	0	5	0	4092
7521	4090	0	5	1	0	4096
7522	3985	0	12	3	0	4000
7523	0	0	3991	0	0	3991
7524	3916	0	13	0	0	3929
7525	0	0	3947	0	0	3947
7526	0	7	2	3939	0	3948
7527	0	3779	1	4	0	3784
7528	1	0	3791	0	0	3792
7529	3762	0	7	2	0	3771
7530	3822	1	6	1	0	3830
7531	0	3	1	3793	0	3797
7532	2	0	3832	0	0	3834
7533	2	4	0	3862	0	3868
7534	3832	0	4	2	0	3838
7535	0	3826	0	3	0	3829
7536	3880	0	10	4	0	3894
7537	3897	1	19	1	0	3918
7538	0	3658	0	3	0	3661
7539	0	1	0	3582	0	3583
7540	3609	0	1	0	0	3610
7541	0	6	0	3481	0	3487
7542	1	7	0	3595	0	3603
7543	6	0	3619	0	0	3625
7544	2	7	0	3600	0	3609
7545	3	2	0	3575	0	3580
7546	3509	0	3	1	0	3513
7547	3476	0	6	0	0	3482
7548	0	2	1	3314	0	3317
7549	3	0	3263	0	0	3266
7550	2	0	3491	0	0	3493
7551	0	6	0	3368	0	3374
7552	3	0	3377	0	0	3380
7553	0	4	0	3528	0	3532
7554	0	4	0	3526	0	3530
7555	3500	0	5	1	0	3506
7556	3	0	3486	0	0	3489
7557	3444	2	9	0	0	3455
7558	3399	0	9	1	0	3409
7559	1	0	3142	0	0	3143
7560	2	0	3243	0	0	3245
7561	1	7	0	3229	0	3237
7562	1	3153	0	0	0	3154
7563	0	3257	0	0	0	3257
7564	0	12	0	3286	0	3298
7565	0	9	0	3305	0	3314
7566	0	5	0	3217	0	3222
7567	0	4	0	3214	0	3218
7568	3369	1	0	0	0	3370
7569	0	11	1	3274	0	3286
7570	8	0	3363	0	0	3371
7571	0	9	0	3224	0	3233
7572	1	3151	0	2	0	3154
7573	1	5	0	3122	0	3128
7574	3248	1	3	0	0	3252
7575	2	3	0	3223	0	3228
7576	1	1	3227	0	0	3229
7577	1	3256	1	2	0	3260
7578	0	4	0	3229	0	3233
7579	3281	1	3	0	0	3285
7580	3262	0	5	2	0	3269
7581	0	6	1	3261	0	3268
7582	1	0	3191	1	0	3193
7583	1	0	3163	0	0	3164
7584	2993	0	6	3	0	3002
7585	2	0	3035	0	0	3037
7586	0	0	3092	1	0	3093
7587	0	6	0	3286	0	3292
7588	3255	0	8	0	0	3263
7589	3266	1	2	1	0	3270
7590	3228	0	11	1	0	3240
7591	2	0	3253	0	0	3255
7592	1	0	3226	0	0	3227
7593	0	3211	0	1	0	3212
7594	0	7	0	3208	0	3215
7595	0	2	0	3244	0	3246
7596	0	6	1	3232	0	3239
7597	0	7	0	3245	0	3252
7598	0	0	3236	0	0	3236
7599	0	3221	0	1	0	3222
7600	3194	0	9	0	0	3203
7601	3207	1	10	1	0	3219
7602	3203	1	6	0	0	3210
7603	0	3257	0	0	0	3257
7604	0	3	0	3263	0	3266
7605	3326	0	3	0	0	3329
7606	0	3261	0	3	0	3264
7607	3268	1	12	0	0	3281
7608	0	3295	0	2	0	3297
7609	3273	0	8	0	0	3281
7610	3340	0	11	0	0	3351
7611	0	6	0	3352	0	3358
7612	0	3	0	3314	0	3317
7613	2	0	3244	0	0	3246
7614	0	0	3259	0	0	3259
7615	3355	0	4	2	0	3361
7616	3309	0	6	1	0	3316
7617	0	3	1	3267	0	3271
7618	0	3	1	3145	0	3149
7619	0	0	3318	0	0	3318
7620	2	5	0	3316	0	3323
7621	1	0	3325	0	0	3326
7622	0	8	0	3321	0	3329
7623	0	3	0	3330	0	3333
7624	3328	0	8	4	0	3340
7625	3459	2	6	0	0	3467
7626	0	12	0	3293	0	3305
7627	0	6	0	3317	0	3323
7628	0	0	3370	0	0	3370
7629	0	1	0	3216	0	3217
7630	2	0	3324	0	0	3326
7631	3299	0	12	2	0	3313
7632	0	4	0	3337	0	3341
7633	3361	0	6	1	0	3368
7634	1	3375	0	1	0	3377
7635	3534	0	8	2	0	3544
7636	0	6	0	3529	0	3535
7637	0	1	0	3490	0	3491
7638	0	3381	0	0	0	3381
7639	1	5	0	3268	0	3274
7640	0	0	3386	0	0	3386
7641	1	3	0	3482	0	3486
7642	2	0	3449	1	0	3452
7643	0	3385	0	1	0	3386
7644	0	6	0	3236	0	3242
7645	1	0	3335	0	0	3336
7646	1	0	3521	1	0	3523
7647	0	15	1	3517	0	3533
7648	3505	1	4	1	0	3511
7649	0	0	3566	1	0	3567
7650	0	10	0	3459	0	3469
7651	3472	0	4	0	0	3476
7652	0	3499	0	1	0	3500
7653	3649	0	8	0	0	3657
7654	0	3	1	3654	0	3658
7655	0	5	1	3607	0	3613
7656	1	4	1	3925	0	3931
7657	3953	1	3	0	0	3957
7658	0	6	0	3980	0	3986
7659	0	3	0	4020	0	4023
7660	3941	1	4	0	0	3946
7661	0	0	3959	0	0	3959
7662	0	8	1	3744	0	3753
7663	2	0	3745	0	0	3747
7664	3756	0	9	0	0	3765
7665	0	11	1	3790	0	3802
7666	1	0	3792	0	0	3793
7667	3851	0	6	2	0	3859
7668	3876	2	7	1	0	3886
7669	1	0	3886	0	0	3887
7670	0	7	2	3934	0	3943
7671	0	7	1	3901	0	3909
7672	1	0	3944	0	0	3945
7673	0	4027	0	5	0	4032
7674	5	0	4024	0	0	4029
7675	4017	0	12	0	0	4029
7676	1	0	4029	0	0	4030
7677	4151	0	18	1	0	4170
7678	0	0	4216	0	0	4216
7679	4176	1	7	0	0	4184
7680	0	4192	0	3	0	4195
7681	2	6	1	4170	0	4179
7682	0	13	1	4281	0	4295
7683	1	0	4295	1	0	4297
7684	1	5	0	4332	0	4338
7685	0	4253	0	0	0	4253
7686	4249	0	15	1	0	4265
7687	0	4286	0	1	0	4287
7688	0	1	0	4316	0	4317
7689	4312	0	3	1	0	4316
7690	0	4276	0	3	0	4279
7691	4124	0	6	2	0	4132
7692	0	0	4261	0	0	4261
7693	1	4	0	4286	0	4291
7694	0	5	0	4281	0	4286
7695	1	2	0	4101	0	4104
7696	4054	0	1	0	0	4055
7697	4062	0	1	2	0	4065
7698	4068	0	7	0	0	4075
7699	4030	0	11	0	0	4041
7700	1	0	4058	0	0	4059
7701	3937	0	18	1	0	3956
7702	1	3945	0	1	0	3947
7703	1	3940	0	2	0	3943
7704	3977	0	4	0	0	3981
7705	3969	0	1	0	0	3970
7706	1	0	0	3890	0	3891
7707	3971	0	1	0	0	3972
7708	3962	0	5	0	0	3967
7709	3956	0	4	0	0	3960
7710	1	6	1	3910	0	3918
7711	1	3734	2	2	0	3739
7712	0	3867	0	1	0	3868
7713	1	4	1	3851	0	3857
7714	3858	3	6	0	0	3867
7715	0	3759	0	0	0	3759
7716	0	6	0	3635	0	3641
7717	0	0	3662	0	0	3662
7718	3649	0	8	4	0	3661
7719	1	3645	0	3	0	3649
7720	0	3544	0	2	0	3546
7721	3450	2	7	3	0	3462
7722	0	0	3656	0	0	3656
7723	0	4	0	3682	0	3686
7724	1	3695	0	1	0	3697
7725	0	10	1	3731	0	3742
7726	0	5	0	3787	0	3792
7727	0	3578	0	0	0	3578
7728	1	3	0	3562	0	3566
7729	0	2	1	3566	0	3569
7730	3590	0	4	2	0	3596
7731	0	3492	0	0	0	3492
7732	3186	0	15	0	0	3201
7733	0	3	1	3176	0	3180
7734	0	3104	0	2	0	3106
7735	0	0	3151	0	0	3151
7736	1	3	0	3207	0	3211
7737	1	4	0	3129	0	3134
7738	0	0	3135	0	0	3135
7739	3133	0	11	1	0	3145
7740	1	4	0	3217	0	3222
7741	3169	1	4	1	0	3175
7742	0	0	3371	0	0	3371
7743	0	5	0	3332	0	3337
7744	0	0	3273	0	0	3273
7745	0	8	0	3221	0	3229
7746	0	3	1	3232	0	3236
7747	3248	0	12	1	0	3261
7748	0	3205	0	1	0	3206
7749	3102	0	10	0	0	3112
7750	97	0	3100	0	0	3197
7751	1	1	0	3074	0	3076
7752	2	0	3076	4	0	3082
7753	3061	0	11	3	0	3075
7754	3041	0	11	2	0	3054
7755	1	0	3092	1	0	3094
7756	3057	0	4	0	0	3061
7757	3057	0	5	1	0	3063
7758	0	3	0	2971	0	2974
7759	2	0	2831	0	0	2833
7760	2	0	2851	1	0	2854
7761	5	8	0	2835	0	2848
7762	0	3	0	2835	0	2838
7763	2	2809	1	0	0	2812
7764	1	2899	1	1	0	2902
7765	2929	0	5	0	0	2934
7766	0	5	0	2906	0	2911
7767	0	2815	0	0	0	2815
7768	0	2848	0	1	0	2849
7769	2820	0	0	0	0	2820
7770	0	30	1	2863	0	2894
7771	0	2897	0	0	0	2897
7772	1	10	0	2897	0	2908
7773	0	3	1	2872	0	2876
7774	0	2	0	2954	0	2956
7775	3046	0	1	0	0	3047
7776	0	2999	1	2	0	3002
7777	0	1	0	2915	0	2916
7778	0	6	0	2896	0	2902
7779	0	2	0	2851	0	2853
7780	2	0	2905	0	0	2907
7781	2930	0	9	1	0	2940
7782	0	2	1	3029	0	3032
7783	2959	0	2	0	0	2961
7784	3055	0	1	0	0	3056
7785	3014	0	9	1	0	3024
7786	0	0	3017	1	0	3018
7787	0	2968	0	2	0	2970
7788	0	2	0	2859	0	2861
7789	3	0	2871	0	0	2874
7790	1	0	2926	1	0	2928
7791	4	7	1	3087	0	3099
7792	0	3077	0	2	0	3079
7793	3080	0	5	0	0	3085
7794	3063	0	17	0	0	3080
7795	3066	0	4	0	0	3070
7796	3060	1	7	0	0	3068
7797	0	0	3103	0	0	3103
7798	2904	0	9	1	0	2914
7799	0	2879	0	0	0	2879
7800	2	6	0	2823	0	2831
7801	0	0	0	2850	0	2850
7802	2829	1	7	0	0	2837
7803	0	3	1	2831	0	2835
7804	1	0	2834	0	0	2835
7805	2909	2	8	2	0	2921
7806	2876	0	3	0	0	2879
7807	2844	0	11	2	0	2857
7808	0	0	2849	0	0	2849
7809	3035	0	14	0	0	3049
7810	2	2956	0	2	0	2960
7811	2908	0	4	1	0	2913
7812	1	2	1	2895	0	2899
7813	1	5	1	3039	0	3046
7814	1	3009	0	0	0	3010
7815	0	3	1	3005	0	3009
7816	1	2875	0	2	0	2878
7817	0	6	0	2818	0	2824
7818	0	2865	0	0	0	2865
7819	3	4	0	2821	0	2828
7820	1	2875	0	0	0	2876
7821	3	4	2	2898	0	2907
7822	0	2911	0	5	0	2916
7823	2895	0	2	0	0	2897
7824	1	3	0	2895	0	2899
7825	0	1	0	2875	0	2876
7826	1	2	1	2826	0	2830
7827	0	3	0	2784	0	2787
7828	0	0	2744	0	0	2744
7829	0	2	0	2750	0	2752
7830	3	3	1	2727	0	2734
7831	2785	0	1	0	0	2786
7832	2816	0	3	3	0	2822
7833	1	2821	0	1	0	2823
7834	0	10	1	2794	0	2805
7835	0	0	0	2902	0	2902
7836	2845	0	3	1	0	2849
7837	0	0	2854	0	0	2854
7838	2851	0	13	0	0	2864
7839	0	2848	0	2	0	2850
7840	2685	0	10	0	0	2695
7841	2755	1	10	0	0	2766
7842	0	2799	0	1	0	2800
7843	0	2767	0	0	0	2767
7844	1	6	0	2745	0	2752
7845	0	0	2744	0	0	2744
7846	2708	0	7	0	0	2715
7847	1	0	2750	0	0	2751
7848	2681	1	32	1	0	2715
7849	1	0	2788	0	0	2789
7850	0	2736	0	0	0	2736
7851	1	6	0	2655	0	2662
7852	2687	0	4	0	0	2691
7853	2685	0	5	0	0	2690
7854	0	4	0	2687	0	2691
7855	2639	0	8	0	0	2647
7856	2579	0	2	0	0	2581
7857	1	2685	0	5	0	2691
7858	2600	0	6	0	0	2606
7859	0	2612	0	2	0	2614
7860	0	5	0	2510	0	2515
7861	2510	0	4	1	0	2515
7862	2529	0	4	0	0	2533
7863	2504	0	2	1	0	2507
7864	0	0	2543	0	0	2543
7865	0	0	2524	3	0	2527
7866	0	13	0	2329	0	2342
7867	1	4	0	2339	0	2344
7868	1	2318	0	0	0	2319
7869	2322	0	2	1	0	2325
7870	0	11	0	2329	0	2340
7871	0	3	0	2342	0	2345
7872	2	0	2356	1	0	2359
7873	2	2543	0	0	0	2545
7874	1	2597	0	0	0	2598
7875	2	3	0	2574	0	2579
7876	2621	0	2	0	0	2623
7877	0	6	0	2590	0	2596
7878	2	5	0	2562	0	2569
7879	2553	1	2	1	0	2557
7880	2658	0	2	0	0	2660
7881	0	5	0	2574	0	2579
7882	0	0	2604	0	0	2604
7883	1	3	0	2446	0	2450
7884	0	2	0	2458	0	2460
7885	2447	0	2	1	0	2450
7886	1	6	0	2533	0	2540
7887	2546	0	2	0	0	2548
7888	2	0	2560	0	0	2562
7889	0	3	3	2383	0	2389
7890	0	2	0	2359	0	2361
7891	0	6	0	2332	0	2338
7892	2	2	0	2373	0	2377
7893	1	3	0	2374	0	2378
7894	0	0	2338	1	0	2339
7895	2310	1	4	2	0	2317
7896	0	1	2	2304	0	2307
7897	1	1	2232	0	0	2234
7898	0	0	2471	1	0	2472
7899	0	4	0	2614	0	2618
7900	2627	0	0	0	0	2627
7901	2614	0	5	2	0	2621
7902	2718	0	3	0	0	2721
7903	1	2	0	2707	0	2710
7904	0	2763	0	4	0	2767
7905	2785	0	5	0	0	2790
7906	2806	0	5	0	0	2811
7907	2752	1	8	0	0	2761
7908	2819	0	9	0	0	2828
7909	0	20	0	2822	0	2842
7910	0	0	2915	1	0	2916
7911	0	7	0	2801	0	2808
7912	0	0	2824	1	0	2825
7913	2822	1	6	0	0	2829
7914	2826	1	18	0	0	2845
7915	0	0	2839	0	0	2839
7916	2847	0	26	1	0	2874
7917	2785	0	17	0	0	2802
7918	1	5	0	2849	0	2855
7919	0	2799	0	0	0	2799
7920	2863	3	5	0	0	2871
7921	0	7	0	2839	0	2846
7922	0	2814	0	0	0	2814
7923	0	5	0	2819	0	2824
7924	3	0	2818	1	0	2822
7925	0	2800	0	5	0	2805
7926	2820	0	7	0	0	2827
7927	2861	0	7	0	0	2868
7928	2879	1	4	0	0	2884
7929	2908	0	10	0	0	2918
7930	1	1	0	2912	0	2914
7931	0	2910	0	2	0	2912
7932	2859	0	7	1	0	2867
7933	1	0	2761	0	0	2762
7934	0	2800	0	3	0	2803
7935	0	0	2805	0	0	2805
7936	5	7	0	2908	0	2920
7937	0	2931	0	0	0	2931
7938	2	4	0	2912	0	2918
7939	2	0	3094	0	0	3096
7940	0	3	10	3098	0	3111
7941	0	4	0	3129	0	3133
7942	0	4	0	3142	0	3146
7943	3164	0	3	3	0	3170
7944	1	3151	0	0	0	3152
7945	0	4	0	3212	0	3216
7946	3212	0	8	0	0	3220
7947	0	3169	0	0	0	3169
7948	2914	0	11	0	0	2925
7949	1	0	2937	1	0	2939
7950	2	7	0	2804	0	2813
7951	0	2815	0	0	0	2815
7952	2794	0	3	0	0	2797
7953	2	0	2882	0	0	2884
7954	1	2795	0	1	0	2797
7955	1	2	0	2786	0	2789
7956	2	2	0	2775	0	2779
7957	2786	0	6	1	0	2793
7958	1	5	1	2736	0	2743
7959	101	0	2714	0	0	2815
7960	2	6	0	2822	0	2830
7961	1	0	2812	0	0	2813
7962	1	7	0	2700	0	2708
7963	0	2674	0	0	0	2674
7964	2740	1	9	0	0	2750
7965	2788	0	6	0	0	2794
7966	2	2853	0	1	0	2856
7967	1	2898	0	1	0	2900
7968	0	0	0	2841	0	2841
7969	2861	0	3	0	0	2864
7970	0	2	0	2877	0	2879
7971	2870	0	5	1	0	2876
7972	0	2924	0	1	0	2925
7973	0	3	0	2689	0	2692
7974	1	0	2749	0	0	2750
7975	0	2	0	2663	0	2665
7976	0	1	0	2674	0	2675
7977	2692	0	0	0	0	2692
7978	0	2562	0	2	0	2564
7979	0	1	0	2772	0	2773
7980	2751	0	7	0	0	2758
7981	59	0	2664	0	0	2723
7982	2726	2	3	0	0	2731
7983	0	5	0	2648	0	2653
7984	0	2600	0	0	0	2600
7985	2580	0	6	1	0	2587
7986	0	0	2550	0	0	2550
7987	1	0	2564	1	0	2566
7988	0	2613	1	1	0	2615
7989	2592	0	9	0	0	2601
7990	0	3	0	2659	0	2662
7991	1	3	0	2675	0	2679
7992	2783	0	2	0	0	2785
7993	0	0	3326	0	0	3326
7994	2	4	1	3360	0	3367
7995	4	0	3768	1	0	3773
7996	2	0	0	3700	0	3702
7997	0	3687	0	0	0	3687
7998	0	6	0	3768	0	3774
7999	0	0	3852	0	0	3852
8000	4170	0	1	0	0	4171
8001	3	3	0	4193	0	4199
8002	4	0	4810	0	0	4814
8003	1	14	1	4751	0	4767
8004	16	5	0	4994	0	5015
8005	3	0	5121	2	0	5126
8006	14	0	5167	3	0	5184
8007	3	12	1	5190	0	5206
8008	3	0	5168	1	0	5172
8009	5072	1	75	4	0	5152
8010	0	7	0	5207	0	5214
8011	5077	0	5	1	0	5083
8012	2	1	5481	0	0	5484
8013	0	10	0	5409	0	5419
8014	2	0	5364	3	0	5369
8015	0	5279	1	3	0	5283
8016	2	0	5293	0	0	5295
8017	3	0	5302	2	0	5307
8018	5292	0	4	2	0	5298
8019	5287	0	12	3	0	5302
8020	0	1	5322	0	0	5323
8021	1	13	0	5309	0	5323
8022	0	16	0	5291	0	5307
8023	7	0	5251	2	0	5260
8024	0	5307	0	2	0	5309
8025	5300	0	20	2	0	5322
8026	0	0	5505	1	0	5506
8027	0	9	2	5504	0	5515
8028	0	2	1	5534	0	5537
8029	5523	0	5	0	0	5528
8030	5503	0	16	2	0	5521
8031	5515	0	20	0	0	5535
8032	5562	2	8	0	0	5572
8033	1	6	0	5703	0	5710
8034	1	0	5841	0	0	5842
8035	1	17	0	5678	0	5696
8036	1	26	5	5656	0	5688
8037	1	16	1	5659	0	5677
8038	2	0	5685	1	0	5688
8039	5824	0	12	1	0	5837
8040	3	8	0	5821	0	5832
8041	0	0	5895	1	0	5896
8042	0	5893	1	1	0	5895
8043	0	7	0	5860	0	5867
8044	3	6	0	5902	0	5911
8045	5874	0	11	1	0	5886
8046	0	6310	0	10	0	6320
8047	3	0	6391	0	0	6394
8048	1	10	1	6387	0	6399
8049	2	17	1	6370	0	6390
8050	6316	0	7	0	0	6323
8051	6304	0	15	1	0	6320
8052	0	12	0	6324	0	6336
8053	6339	1	11	0	0	6351
8054	1	6346	0	3	0	6350
8055	5	0	6148	1	0	6154
8056	0	30	6	6107	0	6143
8057	3	25	2	6165	0	6195
8058	0	14	0	6302	0	6316
8059	2	14	0	6319	0	6335
8060	1	6339	0	2	0	6342
8061	6343	0	17	2	0	6362
8062	3	17	0	6294	0	6314
8063	0	6372	0	4	0	6376
8064	6414	0	9	2	0	6425
8065	6686	0	45	0	0	6731
8066	2	6656	0	3	0	6661
8067	0	19	0	6610	0	6629
8068	1	13	0	6633	0	6647
8069	1	18	0	6108	0	6127
8070	0	13	0	6708	0	6721
8071	6309	0	6	2	0	6317
8072	6321	0	5	2	0	6328
8073	1	6280	0	3	0	6284
8074	4	0	6258	0	0	6262
8075	0	10	0	6297	0	6307
8076	6134	0	4	1	0	6139
8077	1	5500	0	2	0	5503
8078	0	5480	0	6	0	5486
8079	5481	2	11	3	0	5497
8080	5209	0	12	1	0	5222
8081	1	8	0	5226	0	5235
8082	1	1	5204	0	0	5206
8083	2	0	5531	1	0	5534
8084	5568	1	17	2	0	5588
8085	5554	1	17	5	0	5577
8086	5532	0	10	1	0	5543
8087	5578	0	15	0	0	5593
8088	5281	1	4	1	0	5287
8089	0	5353	0	2	0	5355
8090	3	18	1	5294	0	5316
8091	1	5407	0	2	0	5410
8092	5415	0	10	0	0	5425
8093	5432	0	28	0	0	5460
8094	5418	0	13	1	0	5432
8095	5433	0	11	0	0	5444
8096	0	5582	0	72	0	5654
8097	5591	1	5	0	0	5597
8098	0	5605	0	1	0	5606
8099	3	5	2	5532	0	5542
8100	5652	1	6	0	0	5659
8101	2	0	5693	0	0	5695
8102	2	16	0	5476	0	5494
8103	0	13	0	5468	0	5481
8104	7	0	5445	0	0	5452
8105	2	5421	0	12	0	5435
8106	5505	0	8	0	0	5513
8107	5483	0	8	2	0	5493
8108	0	5361	0	3	0	5364
8109	0	13	0	5406	0	5419
8110	7	1	5442	1	0	5451
8111	0	5479	0	3	0	5482
8112	5493	1	13	0	0	5507
8113	2	0	5488	0	0	5490
8114	5514	0	5	1	0	5520
8115	5443	1	7	2	0	5453
8116	4	0	5412	0	0	5416
8117	0	5640	0	4	0	5644
8118	0	11	0	5617	0	5628
8119	3	0	5628	1	0	5632
8120	5666	0	14	1	0	5681
8121	5708	0	8	0	0	5716
8122	1	5259	0	1	0	5261
8123	0	17	1	5224	0	5242
8124	1	7	0	5274	0	5282
8125	7	0	5307	0	0	5314
8126	2	5338	1	3	0	5344
8127	5323	0	25	2	0	5350
8128	5396	0	7	0	0	5403
8129	5355	1	11	1	0	5368
8130	0	0	5565	0	0	5565
8131	5547	0	11	0	0	5558
8132	5548	4	12	1	0	5565
8133	0	7	0	5477	0	5484
8134	0	0	5418	0	0	5418
8135	1	7	0	5368	0	5376
8136	4	0	5556	0	0	5560
8137	1	13	0	6254	0	6268
8138	1	6396	0	0	0	6397
8139	0	6093	0	1	0	6094
8140	1	15	0	6097	0	6113
8141	0	9	0	6122	0	6131
8142	6054	0	16	1	0	6071
8143	2	0	6268	1	0	6271
8144	6261	1	10	0	0	6272
8145	0	6223	0	2	0	6225
8146	5513	0	19	1	0	5533
8147	5587	0	5	1	0	5593
8148	0	4	0	5669	0	5673
8149	0	0	6074	0	0	6074
8150	1	16	0	6031	0	6048
8151	1	6004	1	0	0	6006
8152	1	17	2	5846	0	5866
8153	1	7	1	5870	0	5879
8154	5961	2	10	1	0	5974
8155	3	9	0	5969	0	5981
8156	0	5896	0	1	0	5897
8157	1	11	0	5776	0	5788
8158	5847	1	1	0	0	5849
8159	1	5878	0	0	0	5879
8160	0	23	1	5745	0	5769
8161	2	5	0	5762	0	5769
8162	0	9	0	5749	0	5758
8163	0	5	0	5825	0	5830
8164	5736	0	3	0	0	5739
8165	1	13	0	5688	0	5702
8166	0	10	1	5686	0	5697
8167	0	6	1	5636	0	5643
8168	0	5594	1	3	0	5598
8169	5547	2	6	5	0	5560
8170	0	0	5536	0	0	5536
8171	0	5458	0	2	0	5460
8172	5369	1	10	0	0	5380
8173	1	0	5388	1	0	5390
8174	0	5304	0	0	0	5304
8175	3	20	2	5190	0	5215
8176	0	5375	0	1	0	5376
8177	6	0	5371	0	0	5377
8178	4	0	5428	8	0	5440
8179	2	5411	0	3	0	5416
8180	5387	0	12	1	0	5400
8181	5334	2	11	3	0	5350
8182	2	0	5386	1	0	5389
8183	1	0	5677	2	0	5680
8184	3	0	5645	0	0	5648
8185	0	8	2	5488	0	5498
8186	0	12	1	5430	0	5443
8187	0	12	0	5416	0	5428
8188	6	0	5449	0	0	5455
8189	0	9	0	5505	0	5514
8190	0	7	2	5466	0	5475
8191	3	0	5348	1	0	5352
8192	5094	0	8	0	0	5102
8193	0	10	0	5125	0	5135
8194	0	27	0	5107	0	5134
8195	0	5126	1	5	0	5132
8196	5024	1	7	2	0	5034
8197	15	0	5135	1	0	5151
8198	5201	0	8	3	0	5212
8199	0	17	1	5273	0	5291
8200	0	0	5275	0	0	5275
8201	0	2	0	5200	0	5202
8202	5145	0	7	2	0	5154
8203	2	0	5138	0	0	5140
8204	5281	0	3	6	0	5290
8205	5481	0	9	2	0	5492
8206	5134	0	214	0	0	5348
8207	0	5578	0	1	0	5579
8208	0	9	0	5563	0	5572
8209	5561	1	6	0	0	5568
8210	5549	3	8	0	0	5560
8211	5536	0	12	0	0	5548
8212	1	0	5356	0	0	5357
8213	5183	0	7	1	0	5191
8214	0	11	0	5120	0	5131
8215	2	0	5188	0	0	5190
8216	2	24	0	5139	0	5165
8217	1	22	0	5236	0	5259
8218	3	0	5295	0	0	5298
8219	1	8	1	5120	0	5130
8220	0	9	1	5094	0	5104
8221	6	0	5087	1	0	5094
8222	5071	0	6	3	0	5080
8223	5299	0	6	0	0	5305
8224	0	13	0	5375	0	5388
8225	5	0	5433	0	0	5438
8226	4	12	0	5488	0	5504
8227	1	5364	1	0	0	5366
8228	1	20	0	5399	0	5420
8229	2	3	0	5433	0	5438
8230	5377	0	3	0	0	5380
8231	5371	0	14	2	0	5387
8232	5351	0	11	0	0	5362
8233	1	10	1	5398	0	5410
8234	1	20	0	5054	0	5075
8235	3	1	5010	0	0	5014
8236	1	18	0	5083	0	5102
8237	0	5049	0	5	0	5054
8238	5119	0	7	1	0	5127
8239	2	5097	0	5	0	5104
8240	5159	0	7	1	0	5167
8241	0	33	0	5093	0	5126
8242	0	5263	0	0	0	5263
8243	5279	0	9	0	0	5288
8244	5416	0	4	0	0	5420
8245	0	15	0	5399	0	5414
8246	0	5374	0	2	0	5376
8247	0	16	0	5348	0	5364
8248	0	2	5406	0	0	5408
8249	5637	0	9	1	0	5647
8250	0	5729	0	2	0	5731
8251	5801	0	6	0	0	5807
8252	0	6	0	5733	0	5739
8253	5694	0	5	1	0	5700
8254	1	1	5697	0	0	5699
8255	5708	0	11	1	0	5720
8256	5750	1	8	0	0	5759
8257	3	0	5762	1	0	5766
8258	0	13	3	5656	0	5672
8259	0	5	0	5528	0	5533
8260	5560	0	10	0	0	5570
8261	0	5510	0	0	0	5510
8262	2	22	0	5470	0	5494
8263	3	1	5534	1	0	5539
8264	2	0	5534	1	0	5537
8265	1	5635	0	2	0	5638
8266	4	1	5623	1	0	5629
8267	5632	0	11	7	0	5650
8268	0	5	3	5707	0	5715
8269	5704	1	2	0	0	5707
8270	4	0	5848	0	0	5852
8271	3	11	0	5975	0	5989
8272	1	12	0	5954	0	5967
8273	0	0	6079	1	0	6080
8274	1	10	0	6264	0	6275
8275	6319	0	4	0	0	6323
8276	6295	0	7	0	0	6302
8277	1	4	0	6320	0	6325
8278	6368	0	6	1	0	6375
8279	6813	0	6	2	0	6821
8280	1	7150	0	2	0	7153
8281	3	11	0	7046	0	7060
8282	7035	1	2	0	0	7038
8283	1	19	0	6739	0	6759
8284	6950	0	6	0	0	6956
8285	2	11	0	6954	0	6967
8286	5	1	6927	2	0	6935
8287	0	6983	1	2	0	6986
8288	1	17	0	6766	0	6784
8289	0	6786	0	5	0	6791
8290	7008	1	6	2	0	7017
8291	2	7560	1	7	0	7570
8292	1	7487	0	5	0	7493
8293	0	16	0	7397	0	7413
8294	7443	0	2	2	0	7447
8295	0	9	0	7535	0	7544
8296	7515	0	9	0	0	7524
8297	7540	0	10	1	0	7551
8298	0	7530	0	4	0	7534
8299	7141	2	30	1	0	7174
8300	7022	1	10	0	0	7033
8301	6523	0	13	0	0	6536
8302	0	0	6767	1	0	6768
8303	0	13	1	6780	0	6794
8304	0	11	0	6735	0	6746
8305	0	1	6755	2	0	6758
8306	6734	0	11	3	0	6748
8307	6815	0	17	1	0	6833
8308	6835	1	11	0	0	6847
8309	6972	2	13	1	0	6988
8310	0	7079	0	1	0	7080
8311	7013	1	9	0	0	7023
8312	0	30	0	6988	0	7018
8313	2	0	6959	1	0	6962
8314	7074	0	6	3	0	7083
8315	1	7058	0	2	0	7061
8316	7004	0	15	2	0	7021
8317	1	7175	0	1	0	7177
8318	2	7098	0	3	0	7103
8319	0	7066	0	2	0	7068
8320	0	7140	0	4	0	7144
8321	5	0	7165	1	0	7171
8322	1	39	3	7119	0	7162
8323	3	0	7076	2	0	7081
8324	7231	0	11	4	0	7246
8325	1	7308	0	1	0	7310
8326	1	7257	0	1	0	7259
8327	0	33	3	7180	0	7216
8328	1	39	1	7202	0	7243
8329	2	0	7207	0	0	7209
8330	9	2	7272	2	0	7285
8331	0	14	0	7733	0	7747
8332	4	0	7618	1	0	7623
8333	1	7595	0	4	0	7600
8334	0	10	0	7591	0	7601
8335	2	20	0	7694	0	7716
8336	7	0	7959	1	0	7967
8337	1	14	0	8033	0	8048
8338	8208	0	12	0	0	8220
8339	1	21	1	8110	0	8133
8340	1	19	0	8345	0	8365
8341	13	0	8306	10	0	8329
8342	8459	0	16	2	0	8477
8343	0	8410	1	2	0	8413
8344	1	26	0	8280	0	8307
8345	6	0	8381	2	0	8389
8346	0	6	0	8483	0	8489
8347	8396	0	7	0	0	8403
8348	5	0	8289	0	0	8294
8349	0	22	1	8003	0	8026
8350	3	0	7732	8	0	7743
8351	0	7792	0	3	0	7795
8352	7	0	7798	0	0	7805
8353	0	7825	0	8	0	7833
8354	3	1	7817	0	0	7821
8355	1	20	0	7731	0	7752
8356	2	7271	0	3	0	7276
8357	7734	0	10	0	0	7744
8358	0	35	1	7709	0	7745
8359	7893	0	12	1	0	7906
8360	1	18	0	7806	0	7825
8361	0	11	1	7786	0	7798
8362	7625	0	8	0	0	7633
8363	7608	1	8	0	0	7617
8364	0	8	1	7439	0	7448
8365	10	0	7338	0	0	7348
8366	0	6510	0	2	0	6512
8367	6	0	6477	0	0	6483
8368	0	6508	0	3	0	6511
8369	6487	0	7	0	0	6494
8370	1	1	6539	1	0	6542
8371	4	0	6473	3	0	6480
8372	1	7	1	6533	0	6542
8373	6490	0	11	1	0	6502
8374	4	0	6516	0	0	6520
8375	0	6548	0	6	0	6554
8376	6547	0	11	0	0	6558
8377	6688	0	28	0	0	6716
8378	6505	2	18	1	0	6526
8379	6704	0	13	2	0	6719
8380	6712	1	29	0	0	6742
8381	0	0	6797	1	0	6798
8382	1	35	1	6895	0	6932
8383	5	6837	1	5	0	6848
8384	7005	1	27	2	0	7035
8385	0	6793	0	3	0	6796
8386	6806	0	13	1	0	6820
8387	6969	1	8	1	0	6979
8388	1	6961	0	3	0	6965
8389	7004	0	11	1	0	7016
8390	0	11	0	6964	0	6975
8391	0	12	0	6892	0	6904
8392	6	0	7168	1	0	7175
8393	1	6950	0	9	0	6960
8394	1	22	1	7060	0	7084
8395	1	10	0	7121	0	7132
8396	0	19	0	6987	0	7006
8397	1	0	7245	1	0	7247
8398	7338	0	4	2	0	7344
8399	0	3	0	7389	0	7392
8400	7336	1	34	0	0	7371
8401	3	19	1	7060	0	7083
8402	9	0	6968	0	0	6977
8403	5	0	7076	0	0	7081
8404	7004	1	16	4	0	7025
8405	7202	0	21	3	0	7226
8406	0	6815	0	3	0	6818
8407	2	0	6945	0	0	6947
8408	0	10	0	6947	0	6957
8409	0	5	1	6875	0	6881
8410	6902	0	9	0	0	6911
8411	6772	0	4	1	0	6777
8412	6478	1	13	3	0	6495
8413	0	0	6576	1	0	6577
8414	6678	0	8	1	0	6687
8415	0	30	0	6696	0	6726
8416	2	18	2	6349	0	6371
8417	2	23	0	6270	0	6295
8418	1	6259	0	1	0	6261
8419	6303	0	10	1	0	6314
8420	0	17	0	6375	0	6392
8421	6	0	6336	0	0	6342
8422	5	20	2	6243	0	6270
8423	0	6328	0	2	0	6330
8424	6329	1	9	0	0	6339
8425	0	25	0	6350	0	6375
8426	3	23	0	6494	0	6520
8427	1	0	6624	2	0	6627
8428	5	15	1	6695	0	6716
8429	2	6419	0	0	0	6421
8430	3	11	2	6340	0	6356
8431	4	0	6395	0	0	6399
8432	6413	0	2	1	0	6416
8433	5963	0	19	0	0	5982
8434	1	6636	0	2	0	6639
8435	6518	0	9	2	0	6529
8436	6416	2	14	3	0	6435
8437	0	6522	0	5	0	6527
8438	0	4	0	6491	0	6495
8439	6556	0	5	0	0	6561
8440	0	6542	0	5	0	6547
8441	1	0	6534	0	0	6535
8442	6550	2	1	0	0	6553
8443	6491	1	14	2	0	6508
8444	6709	0	14	1	0	6724
8445	7089	12	15	0	0	7116
8446	0	7483	0	2	0	7485
8447	7531	2	11	0	0	7544
8448	7687	0	9	0	0	7696
8449	7740	1	15	1	0	7757
8450	0	12	0	7694	0	7706
8451	8022	2	10	0	0	8034
8452	1	8059	0	2	0	8062
8453	3	1	7908	0	0	7912
8454	0	14	1	8021	0	8036
8455	7739	0	10	0	0	7749
8456	3	0	7830	0	0	7833
8457	2	21	0	7653	0	7676
8458	2	0	7584	2	0	7588
8459	1	7557	0	4	0	7562
8460	2	24	1	7394	0	7421
8461	6	0	7693	1	0	7700
8462	0	7797	2	5	0	7804
8463	0	8	0	7804	0	7812
8464	7883	0	6	1	0	7890
8465	7746	1	1	3	0	7751
8466	7741	0	20	0	0	7761
8467	8040	0	13	1	0	8054
8468	7718	0	32	0	0	7750
8469	1	0	7833	0	0	7834
8470	7567	0	14	1	0	7582
8471	7579	0	15	0	0	7594
8472	0	9	0	7779	0	7788
8473	7545	0	5	1	0	7551
8474	8032	0	10	1	0	8043
8475	0	8117	1	0	0	8118
8476	4	20	0	7954	0	7978
8477	0	7	0	7974	0	7981
8478	7917	0	7	0	0	7924
8479	1	8146	0	1	0	8148
8480	0	8058	0	1	0	8059
8481	1	28	1	7922	0	7952
8482	0	12	0	7982	0	7994
8483	1	19	0	7871	0	7891
8484	0	4	2	7917	0	7923
8485	8196	0	1	1	0	8198
8486	8171	0	14	1	0	8186
8487	2	0	8217	0	0	8219
8488	0	14	0	7958	0	7972
8489	1	15	0	7777	0	7793
8490	5	0	7843	1	0	7849
8491	7860	0	15	5	0	7880
8492	0	7818	0	5	0	7823
8493	8093	0	18	1	0	8112
8494	0	22	0	7889	0	7911
8495	6	0	8107	0	0	8113
8496	1	26	1	8039	0	8067
8497	1	0	7877	0	0	7878
8498	1	8025	0	4	0	8030
8499	7923	2	16	1	0	7942
8500	7952	0	21	1	0	7974
8501	1	8183	0	2	0	8186
8502	0	8	0	8189	0	8197
8503	8447	1	6	2	0	8456
8504	2	8316	0	5	0	8323
8505	1	6	0	8162	0	8169
8506	8160	0	12	0	0	8172
8507	4	0	8137	0	0	8141
8508	8164	0	20	3	0	8187
8509	3	8149	0	3	0	8155
8510	7346	5	14	1	0	7366
8511	7362	0	22	3	0	7387
8512	3	0	7698	1	0	7702
8513	1	23	2	7817	0	7843
8514	0	16	0	7869	0	7885
8515	5	0	7947	0	0	7952
8516	1	17	1	8056	0	8075
8517	3	6	1	8084	0	8094
8518	8067	0	16	0	0	8083
8519	8106	0	9	1	0	8116
8520	0	10	2	7966	0	7978
8521	2	0	7583	1	0	7586
8522	1	20	0	7432	0	7453
8523	1	19	2	7355	0	7377
8524	2	1	7225	0	0	7228
8525	1	11	0	7318	0	7330
8526	7305	0	12	0	0	7317
8527	7086	0	16	2	0	7104
8528	0	7202	0	10	0	7212
8529	7239	1	25	1	0	7266
8530	7275	0	18	0	0	7293
8531	0	7146	0	2	0	7148
8532	7152	1	17	1	0	7171
8533	7158	1	3	0	0	7162
8534	7372	2	15	0	0	7389
8535	1	0	7451	0	0	7452
8536	7437	0	12	1	0	7450
8537	0	7	0	7295	0	7302
8538	7057	2	6	2	0	7067
8539	3	1	7191	0	0	7195
8540	1	7356	0	5	0	7362
8541	7650	0	12	1	0	7663
8542	1	7793	0	1	0	7795
8543	1	22	0	7535	0	7558
8544	1	2	2	7560	0	7565
8545	7468	1	7	0	0	7476
8546	7435	0	9	1	0	7445
8547	3	0	7483	0	0	7486
8548	5	1	7265	3	0	7274
8549	4	0	7275	3	0	7282
8550	1	4	1	6865	0	6871
8551	4	0	6781	0	0	6785
8552	6	0	6917	0	0	6923
8553	0	4	0	7042	0	7046
8554	7025	0	7	0	0	7032
8555	6829	0	11	0	0	6840
8556	6782	0	9	1	0	6792
8557	6800	1	6	1	0	6808
8558	3	4	0	6864	0	6871
8559	1	11	1	6799	0	6812
8560	3	0	6953	0	0	6956
8561	0	17	0	6847	0	6864
8562	1	4	1	6850	0	6856
8563	7023	0	9	1	0	7033
8564	7238	1	4	0	0	7243
8565	0	6	1	7338	0	7345
8566	7165	0	3	2	0	7170
8567	7150	1	4	4	0	7159
8568	1	5	0	7146	0	7152
8569	0	6	0	7174	0	7180
8570	3	0	7420	1	0	7424
8571	1	0	7200	2	0	7203
8572	0	10	0	7267	0	7277
8573	0	9	0	7225	0	7234
8574	1	0	7153	0	0	7154
8575	7628	0	15	1	0	7644
8576	7605	0	24	1	0	7630
8577	0	0	7139	2	0	7141
8578	1	7123	0	1	0	7125
8579	6874	0	12	1	0	6887
8580	2	0	6951	0	0	6953
8581	3	13	0	7015	0	7031
8582	0	4	0	7092	0	7096
8583	7111	0	8	0	0	7119
8584	7537	0	15	1	0	7553
8585	1	9	0	7641	0	7651
8586	1	10	1	7704	0	7716
8587	7607	0	5	1	0	7613
8588	7532	0	2	0	0	7534
8589	7356	3	15	0	0	7374
8590	0	0	7365	0	0	7365
8591	0	18	1	7213	0	7232
8592	0	8	0	7270	0	7278
8593	7298	1	8	0	0	7307
8594	2	7287	0	1	0	7290
8595	7272	0	7	2	0	7281
8596	0	7268	0	0	0	7268
8597	2	27	4	7003	0	7036
8598	1	12	1	6980	0	6994
8599	3	0	6998	0	0	7001
8600	0	18	1	6935	0	6954
8601	2	0	6956	0	0	6958
8602	1	19	0	6944	0	6964
8603	0	14	0	6875	0	6889
8604	5	6789	0	6	0	6800
8605	2	6633	0	3	0	6638
8606	0	35	0	6634	0	6669
8607	1	20	1	6661	0	6683
8608	1	9	1	6623	0	6634
8609	1	7	0	6647	0	6655
8610	0	13	0	6399	0	6412
8611	4	0	6337	0	0	6341
8612	2	20	0	6453	0	6475
8613	1	8	0	6253	0	6262
8614	5	0	6219	0	0	6224
8615	0	5511	0	1	0	5512
8616	1	16	1	5616	0	5634
8617	16	0	5773	0	0	5789
8618	0	5793	1	1	0	5795
8619	0	5	0	5868	0	5873
8620	5971	0	6	2	0	5979
8621	1	7	0	6222	0	6230
8622	0	3	0	6261	0	6264
8623	1	8	0	6208	0	6217
8624	0	5	0	6201	0	6206
8625	0	6224	0	0	0	6224
8626	0	3	0	6220	0	6223
8627	6464	0	7	2	0	6473
8628	0	6	0	6557	0	6563
8629	2	6	3	6459	0	6470
8630	0	3	1	6771	0	6775
8631	7065	0	5	0	0	7070
8632	7089	0	2	0	0	7091
8633	0	5	1	7102	0	7108
8634	6980	0	6	0	0	6986
8635	7021	0	24	0	0	7045
8636	1	7040	0	1	0	7042
8637	7034	0	13	1	0	7048
8638	2	7059	0	0	0	7061
8639	2	6774	0	0	0	6776
8640	0	6	0	6680	0	6686
8641	2	0	7291	0	0	7293
8642	1	16	2	7331	0	7350
8643	1	11	1	7314	0	7327
8644	0	7317	0	3	0	7320
8645	7088	0	8	0	0	7096
8646	0	20	0	7052	0	7072
8647	2	1	7034	1	0	7038
8648	6	15	0	7060	0	7081
8649	1	7018	0	2	0	7021
8650	6610	2	20	3	0	6635
8651	1	16	1	7048	0	7066
8652	7	0	7236	0	0	7243
8653	1	64	0	7287	0	7352
8654	0	7326	0	2	0	7328
8655	2	20	0	7220	0	7242
8656	7265	1	5	0	0	7271
8657	7412	0	32	2	0	7446
8658	7389	2	15	3	0	7409
8659	0	7633	0	4	0	7637
8660	7247	1	24	2	0	7274
8661	1	7	0	7216	0	7224
8662	7251	0	7	0	0	7258
8663	0	7086	1	2	0	7089
8664	3	22	1	7001	0	7027
8665	2	0	7026	2	0	7030
8666	7039	1	11	0	0	7051
8667	0	7180	0	4	0	7184
8668	0	20	0	7057	0	7077
8669	0	16	0	7187	0	7203
8670	0	8	1	7141	0	7150
8671	3	13	0	7147	0	7163
8672	0	7046	0	3	0	7049
8673	7071	0	17	0	0	7088
8674	7063	3	16	1	0	7083
8675	2	0	7104	0	0	7106
8676	1	6	1	7022	0	7030
8677	0	0	7009	1	0	7010
8678	7022	1	23	6	0	7052
8679	7119	0	6	2	0	7127
8680	7100	0	22	0	0	7122
8681	3	16	0	7169	0	7188
8682	0	7232	0	0	0	7232
8683	7379	1	14	1	0	7395
8684	0	10	1	7447	0	7458
8685	7408	0	13	2	0	7423
8686	4	0	7527	0	0	7531
8687	4	0	7492	3	0	7499
8688	7821	1	29	1	0	7852
8689	1	21	0	7857	0	7879
8690	7838	0	3	1	0	7842
8691	1	7793	0	3	0	7797
8692	7665	0	19	1	0	7685
8693	7663	0	16	0	0	7679
8694	2	1	7806	2	0	7811
8695	4	1	8094	4	0	8103
8696	0	8062	0	0	0	8062
8697	1	10	0	7790	0	7801
8698	8083	1	7	3	0	8094
8699	1	16	0	8088	0	8105
8700	0	6	0	8131	0	8137
8701	8	0	8018	1	0	8027
8702	7890	1	44	5	0	7940
8703	3	7	0	7736	0	7746
8704	13	0	7555	2	0	7570
8705	0	0	7592	2	0	7594
8706	0	20	0	7361	0	7381
8707	6	2	7036	1	0	7045
8708	3	6	7726	2	0	7737
8709	2	13	1	7711	0	7727
8710	3	0	7667	2	0	7672
8711	0	10	0	7673	0	7683
8712	0	7375	0	2	0	7377
8713	7450	6	20	1	0	7477
8714	0	7411	0	0	0	7411
8715	1	37	0	7314	0	7352
8716	0	6797	0	4	0	6801
8717	6	0	6807	0	0	6813
8718	2	13	1	6967	0	6983
8719	3	0	6937	2	0	6942
8720	7239	1	19	0	0	7259
8721	0	7180	0	1	0	7181
8722	7451	3	7	1	0	7462
8723	2	10	0	7430	0	7442
8724	7551	0	16	0	0	7567
8725	2	0	7604	0	0	7606
8726	2	7895	0	5	0	7902
8727	7934	0	32	0	0	7966
8728	1	28	0	7806	0	7835
8729	0	7805	0	2	0	7807
8730	4	10	0	7800	0	7814
8731	7942	0	11	2	0	7955
8732	0	7923	0	1	0	7924
8733	7701	0	8	1	0	7710
8734	0	2	7767	1	0	7770
8735	7592	0	15	3	0	7610
8736	2	11	0	7676	0	7689
8737	7645	0	15	0	0	7660
8738	1	7777	0	3	0	7781
8739	0	11	0	7672	0	7683
8740	1	9	0	7654	0	7664
8741	1	0	7621	0	0	7622
8742	4	22	4	7566	0	7596
8743	1	10	0	7435	0	7446
8744	1	21	0	7517	0	7539
8745	1	4	0	7424	0	7429
8746	3	0	7437	4	0	7444
8747	1	7492	0	9	0	7502
8748	4	12	1	7529	0	7546
8749	7544	0	37	0	0	7581
8750	7635	0	6	1	0	7642
8751	1	7668	0	2	0	7671
8752	7673	0	12	0	0	7685
8753	7717	0	14	1	0	7732
8754	7607	2	33	1	0	7643
8755	3	7570	0	2	0	7575
8756	7509	0	14	0	0	7523
8757	1	11	1	7458	0	7471
8758	5	0	7386	1	0	7392
8759	1	7159	0	5	0	7165
8760	2	9	1	7085	0	7097
8761	2	0	7270	0	0	7272
8762	7237	0	9	1	0	7247
8763	1	5	1	7219	0	7226
8764	2	21	4	6808	0	6835
8765	2	17	1	6984	0	7004
8766	1	8	2	7153	0	7164
8767	1	0	7158	1	0	7160
8768	7259	0	20	0	0	7279
8769	2	6959	1	4	0	6966
8770	6981	0	17	0	0	6998
8771	0	6803	0	9	0	6812
8772	6727	1	12	0	0	6740
8773	1	13	0	7029	0	7043
8774	7	0	7202	0	0	7209
8775	6	0	7375	1	0	7382
8776	1	22	1	7324	0	7348
8777	2	14	0	7282	0	7298
8778	0	5	0	7282	0	7287
8779	7300	1	11	7	0	7319
8780	3	0	7308	0	0	7311
8781	5	7188	0	32	0	7225
8782	3	7143	0	7	0	7153
8783	6510	0	16	3	0	6529
8784	7	0	6551	0	0	6558
8785	2	6645	0	1	0	6648
8786	5	0	6695	0	0	6700
8787	0	10	0	6747	0	6757
8788	3	0	6715	1	0	6719
8789	0	0	6958	0	0	6958
8790	1	4	2	6950	0	6957
8791	5	0	6905	2	0	6912
8792	1	1	6984	1	0	6987
8793	1	7	0	7250	0	7258
8794	7245	0	9	2	0	7256
8795	0	0	7302	1	0	7303
8796	1	6	0	7136	0	7143
8797	2	7	0	7056	0	7065
8798	6836	0	7	2	0	6845
8799	1	11	0	6882	0	6894
8800	6800	0	8	0	0	6808
8801	0	6572	0	2	0	6574
8802	1	3	0	5963	0	5967
8803	5905	2	15	0	0	5922
8804	5898	0	8	2	0	5908
8805	0	8	1	5966	0	5975
8806	2	0	6016	0	0	6018
8807	5813	1	22	2	0	5838
8808	2	5817	1	1	0	5821
8809	5966	0	11	0	0	5977
8810	5877	0	20	0	0	5897
8811	5920	1	20	1	0	5942
8812	0	0	5829	0	0	5829
8813	0	5831	0	7	0	5838
8814	1	11	0	6059	0	6071
8815	0	17	0	6041	0	6058
8816	10	0	6056	2	0	6068
8817	0	6213	1	3	0	6217
8818	1	6204	0	3	0	6208
8819	1	6320	1	0	0	6322
8820	6275	1	15	2	0	6293
8821	1	7	2	6299	0	6309
8822	0	11	1	6228	0	6240
8823	2	0	6281	2	0	6285
8824	6343	2	10	0	0	6355
8825	1	5	0	6789	0	6795
8826	1	11	0	6697	0	6709
8827	7	0	6636	0	0	6643
8828	0	6651	0	2	0	6653
8829	0	17	0	6645	0	6662
8830	6	0	6644	1	0	6651
8831	3	6646	0	7	0	6656
8832	6649	1	25	1	0	6676
8833	0	0	6878	1	0	6879
8834	1	6	2	6818	0	6827
8835	1	6901	0	2	0	6904
8836	6929	1	9	4	0	6943
8837	1	7	0	7069	0	7077
8838	7145	0	7	1	0	7153
8839	7098	1	17	2	0	7118
8840	0	7292	0	4	0	7296
8841	7162	0	16	1	0	7179
8842	6910	1	30	1	0	6942
8843	0	0	6957	1	0	6958
8844	6809	2	26	1	0	6838
8845	0	0	6928	2	0	6930
8846	6731	2	47	1	0	6781
8847	6748	1	20	2	0	6771
8848	6	0	6793	0	0	6799
8849	2	9	2	6538	0	6551
8850	0	0	6240	1	0	6241
8851	1	0	6087	1	0	6089
8852	0	0	6236	2	0	6238
8853	1	10	5	6246	0	6262
8854	1	11	3	6169	0	6184
8855	2	12	2	6018	0	6034
8856	0	10	0	6133	0	6143
8857	1	0	6147	0	0	6148
8858	2	4	0	6288	0	6294
8859	1	6162	0	7	0	6170
8860	2	0	6165	1	0	6168
8861	5	14	1	6302	0	6322
8862	3	0	6206	4	0	6213
8863	0	6161	0	3	0	6164
8864	0	5941	0	1	0	5942
8865	3	6	0	5946	0	5955
8866	3	1	5970	0	0	5974
8867	5	0	6021	1	0	6027
8868	0	9	2	5969	0	5980
8869	2	11	0	5642	0	5655
8870	1	19	0	5470	0	5490
8871	2	0	5425	3	0	5430
8872	0	5750	1	0	0	5751
8873	0	5726	0	3	0	5729
8874	4	16	0	5855	0	5875
8875	5	0	5790	9	0	5804
8876	4	0	5925	2	0	5931
8877	4	5852	0	11	0	5867
8878	5935	1	11	3	0	5950
8879	1	6116	0	2	0	6119
8880	0	0	6078	0	0	6078
8881	6503	0	24	1	0	6528
8882	1	1	0	6871	0	6873
8883	6932	1	4	0	0	6937
8884	4	6	0	7241	0	7251
8885	0	4	1	7017	0	7022
8886	7070	1	10	0	0	7081
8887	0	6970	0	5	0	6975
8888	17	0	6906	0	0	6923
8889	6	6771	0	2	0	6779
8890	6510	0	8	0	0	6518
8891	0	6730	0	6	0	6736
8892	6757	0	8	0	0	6765
8893	7040	0	21	0	0	7061
8894	0	7036	0	6	0	7042
8895	1	5	0	6960	0	6966
8896	6976	0	14	1	0	6991
8897	6964	0	15	0	0	6979
8898	2	7	0	6949	0	6958
8899	12	0	6856	0	0	6868
8900	2	0	7204	0	0	7206
8901	2	13	1	7019	0	7035
8902	0	0	6991	0	0	6991
8903	6975	2	46	3	0	7026
8904	0	7100	0	10	0	7110
8905	0	10	1	7083	0	7094
8906	1	10	84	7102	0	7197
8907	2	18	0	7191	0	7211
8908	3	14	0	7210	0	7227
8909	0	38	2	6998	0	7038
8910	4	1	7025	1	0	7031
8911	0	7242	1	6	0	7249
8912	7261	1	25	0	0	7287
8913	0	15	0	7039	0	7054
8914	1	8	0	7011	0	7020
8915	1	14	2	7046	0	7063
8916	0	7000	0	1	0	7001
8917	2	6	4	6973	0	6985
8918	0	7	0	7081	0	7088
8919	7102	0	8	2	0	7112
8920	1	7063	0	7	0	7071
8921	0	6827	0	236	0	7063
8922	2	13	0	6985	0	7000
8923	6885	1	17	2	0	6905
8924	5	0	7010	1	0	7016
8925	6939	2	41	0	0	6982
8926	3	0	7005	0	0	7008
8927	1	15	3	7011	0	7030
8928	2	6	0	7030	0	7038
8929	0	19	2	7014	0	7035
8930	0	9	0	7120	0	7129
8931	2	5	2	7159	0	7168
8932	7115	1	5	1	0	7122
8933	10	0	7132	0	0	7142
8934	0	8	0	7004	0	7012
8935	1	2	6937	1	0	6941
8936	2	6930	0	8	0	6940
8937	6814	0	14	5	0	6833
8938	2	1	7033	0	0	7036
8939	1	12	0	7147	0	7160
8940	0	8	0	7219	0	7227
8941	5	0	7237	1	0	7243
8942	2	1	7236	1	0	7240
8943	1	7	1	7292	0	7301
8944	7266	0	22	0	0	7288
8945	7247	1	22	3	0	7273
8946	1	7379	0	9	0	7389
8947	7164	0	16	1	0	7181
8948	2	47	2	7082	0	7133
8949	0	7195	0	2	0	7197
8950	1	7	1	7054	0	7063
8951	2	0	7324	0	0	7326
8952	2	16	0	7380	0	7398
8953	0	5	2	7453	0	7460
8954	7467	0	9	3	0	7479
8955	0	7149	0	12	0	7161
8956	7041	1	24	2	0	7068
8957	0	6466	0	6	0	6472
8958	6176	0	19	1	0	6196
8959	0	6278	0	3	0	6281
8960	0	6120	0	9	0	6129
8961	6188	1	5	7	0	6201
8962	0	16	0	6075	0	6091
8963	3	6063	0	3	0	6069
8964	6101	1	6	2	0	6110
8965	6108	0	9	0	0	6117
8966	6252	2	12	1	0	6267
8967	6046	0	19	1	0	6066
8968	1	5974	1	0	0	5976
8969	1	4	0	5809	0	5814
8970	10	2	0	5797	0	5809
8971	6214	0	8	3	0	6225
8972	0	3	0	6265	0	6268
8973	6458	0	16	0	0	6474
8974	3	0	6791	2	0	6796
8975	6396	0	10	3	0	6409
8976	2	0	7290	0	0	7292
8977	0	5	0	7284	0	7289
8978	7367	0	6	1	0	7374
8979	3	7380	0	5	0	7388
8980	7734	1	13	2	0	7750
8981	0	7854	0	1	0	7855
8982	0	10	1	7729	0	7740
8983	1	0	8105	1	0	8107
8984	8146	0	6	0	0	8152
8985	1	8785	0	4	0	8790
8986	2	25	0	8442	0	8469
8987	1	10	2	8863	0	8876
8988	1	10	0	9001	0	9012
8989	13	0	8924	2	0	8939
8990	2	9403	0	5	0	9410
8991	9427	1	18	1	0	9447
8992	9734	0	29	5	0	9768
8993	1	9769	0	7	0	9777
8994	9759	1	15	0	0	9775
8995	1	23	1	9798	0	9823
8996	0	9786	0	1	0	9787
8997	9808	3	70	1	0	9882
8998	3	0	9996	1	0	10000
8999	0	10100	0	11	0	10111
9000	3	24	1	10079	0	10107
9001	0	38	0	10040	0	10078
9002	8	0	10314	0	0	10322
9003	1	51	0	10340	0	10392
9004	3	0	10375	1	0	10379
9005	0	50	2	10444	0	10496
9006	1	12	0	10401	0	10414
9007	0	22	0	10484	0	10506
9008	3	17	1	10547	0	10568
9009	0	0	10411	5	0	10416
9010	5	0	10938	2	0	10945
9011	3	10795	0	7	0	10805
9012	3	14	0	10753	0	10770
9013	9	0	10858	2	0	10869
9014	2	10760	0	12	0	10774
9015	2	29	5	10738	0	10774
9016	3	0	10849	1	0	10853
9017	10822	0	13	0	0	10835
9018	10938	0	24	1	0	10963
9019	3	24	2	11057	0	11086
9020	6	0	11173	0	0	11179
9021	0	7	1	11172	0	11180
9022	10962	0	9	0	0	10971
9023	0	10866	0	6	0	10872
9024	10828	0	19	0	0	10847
9025	10752	0	12	0	0	10764
9026	2	14	0	10791	0	10807
9027	0	24	0	10600	0	10624
9028	0	16	3	10571	0	10590
9029	3	16	0	10573	0	10592
9030	0	10	0	10565	0	10575
9031	10536	0	4	2	0	10542
9032	10504	1	8	0	0	10513
9033	10448	1	27	0	0	10476
9034	2	1	10468	0	0	10471
9035	10216	1	23	6	0	10246
9036	3	10	0	10215	0	10228
9037	5	0	10190	1	0	10196
9038	1	10516	0	8	0	10525
9039	2	45	2	10403	0	10452
9040	4	20	0	10508	0	10532
9041	0	10276	0	5	0	10281
9042	5	13	0	10402	0	10420
9043	8	0	10688	0	0	10696
9044	10	0	10689	4	0	10703
9045	2	23	0	10848	0	10873
9046	10844	0	12	2	0	10858
9047	10763	0	24	3	0	10790
9048	10	0	10972	1	0	10983
9049	2	10718	0	18	0	10738
9050	1	10716	0	1	0	10718
9051	10460	0	17	7	0	10484
9052	12	0	10243	1	0	10256
9053	1	12	0	10623	0	10636
9054	11393	3	11	1	0	11408
9055	2	11598	0	9	0	11609
9056	1	11249	0	6	0	11256
9057	11954	2	18	3	0	11977
9058	3	6	0	12032	0	12041
9059	11829	0	13	2	0	11844
9060	0	8	0	11996	0	12004
9061	3	25	2	11419	0	11449
9062	4	0	11887	2	0	11893
9063	1	43	1	12292	0	12337
9064	3	14	2	12298	0	12317
9065	12380	1	9	0	0	12390
9066	0	16	1	11934	0	11951
9067	5	0	11871	2	0	11878
9068	11904	1	30	5	0	11940
9069	1	17	3	12050	0	12071
9070	11945	2	147	3	0	12097
9071	2	12415	0	4	0	12421
9072	2	12172	1	3	0	12178
9073	12946	1	12	1	0	12960
9074	13184	0	17	0	0	13201
9075	1	13	1	13204	0	13219
9076	2	2	14766	0	0	14770
9077	3	25	1	15391	0	15420
9078	15327	0	14	2	0	15343
9079	0	15579	0	7	0	15586
9080	1	32	0	15434	0	15467
9081	15164	369	62	2	0	15597
9082	2	0	15573	1	0	15576
9083	15429	2	42	8	0	15481
9084	15451	0	29	1	0	15481
9085	6	1	15096	1	0	15104
9086	7	1	15511	1	0	15520
9087	1	45	4	15517	0	15567
9088	3	22	1	15443	0	15469
9089	0	16354	0	12	0	16366
9090	7	42	2	16420	0	16471
9091	8	0	16469	2	0	16479
9092	0	34	2	16455	0	16491
9093	4	19	0	16419	0	16442
9094	3	0	16346	1	0	16350
9095	0	16729	0	7	0	16736
9096	4	30	1	16740	0	16775
9097	1	76	2	16811	0	16890
9098	16884	1	9	5	0	16899
9099	2	36	0	16875	0	16913
9100	11	0	16887	0	0	16898
9101	17598	1	53	8	0	17660
9102	17639	2	27	2	0	17670
9103	17474	3	49	2	0	17528
9104	1	0	17795	0	0	17796
9105	1	27	0	17799	0	17827
9106	0	20	1	17799	0	17820
9107	0	14	0	17841	0	17855
9108	17882	1	27	3	0	17913
9109	1	17970	0	11	0	17982
9110	17	0	17903	0	0	17920
9111	6	17960	1	12	0	17979
9112	5	18093	1	16	0	18115
9113	2	18077	0	8	0	18087
9114	4	108	1	18000	0	18113
9115	9	0	18381	2	0	18392
9116	18416	0	32	4	0	18452
9117	2	18338	1	11	0	18352
9118	18285	2	50	4	0	18341
9119	2	18217	0	7	0	18226
9120	18028	1	30	3	0	18062
9121	1	18489	3	8	0	18501
9122	13	0	18492	0	0	18505
9123	10	31	8	18384	0	18433
9124	2	6	1	17914	0	17923
9125	17903	0	27	2	0	17932
9126	7	26	0	17799	0	17832
9127	23	0	17917	1	0	17941
9128	4	109	2	16953	0	17068
9129	10	0	17009	5	0	17024
9130	4	16367	0	1	0	16372
9131	3	52	1	16121	0	16177
9132	3	15503	2	8	0	15516
9133	15572	1	16	0	0	15589
9134	1	36	2	15536	0	15575
9135	13	0	15376	0	0	15389
9136	3	0	15159	3	0	15165
9137	15069	1	40	2	0	15112
9138	5	29	4	14613	0	14651
9139	6	2	13925	3	0	13936
9140	7	2	14135	6	0	14150
9141	2	14142	0	9	0	14153
9142	4	74	3	13918	0	13999
9143	5	14124	0	3	0	14132
9144	7	26	1	14073	0	14107
9145	14309	0	5	1	0	14315
9146	2	49	2	14443	0	14496
9147	0	10	0	14045	0	14055
9148	14126	0	6	1	0	14133
9149	1	17	1	13161	0	13180
9150	3	16	1	12904	0	12924
9151	1	11659	0	2	0	11662
9152	10974	0	10	0	0	10984
9153	11019	1	8	0	0	11028
9154	5	34	0	10718	0	10757
9155	2	22	0	10494	0	10518
9156	3	23	1	11585	0	11612
9157	1	11586	0	2	0	11589
9158	3	11571	0	9	0	11583
9159	3	13	0	11614	0	11630
9160	11605	1	16	0	0	11622
9161	11608	1	16	4	0	11629
9162	0	11529	1	3	0	11533
9163	11461	2	25	1	0	11489
9164	1	11565	1	2	0	11569
9165	0	10417	0	5	0	10422
9166	1	32	2	10313	0	10348
9167	10879	0	12	0	0	10891
9168	3	11083	0	5	0	11091
9169	2	11093	1	4	0	11100
9170	1	44	0	11044	0	11089
9171	4	31	1	10574	0	10610
9172	2	5	10568	2	0	10577
9173	10459	2	15	2	0	10478
9174	10428	0	36	0	0	10464
9175	3	0	10582	0	0	10585
9176	3	0	10009	10	0	10022
9177	2	17	1	9843	0	9863
9178	0	24	0	9654	0	9678
9179	0	10228	1	1	0	10230
9180	4	25	0	10166	0	10195
9181	3	0	10329	0	0	10332
9182	2	15	1	10621	0	10639
9183	0	14	0	10688	0	10702
9184	10576	0	22	4	0	10602
9185	1	0	10547	0	0	10548
9186	10450	0	15	3	0	10468
9187	3	0	10456	1	0	10460
9188	1	19	1	10326	0	10347
9189	16	1	10358	0	0	10375
9190	10	1	10514	5	0	10530
9191	1	15	0	10677	0	10693
9192	10637	1	10	0	0	10648
9193	10626	1	22	1	0	10650
9194	1	10551	0	8	0	10560
9195	10644	0	14	0	0	10658
9196	10704	1	16	4	0	10725
9197	1	10240	0	9	0	10250
9198	1	25	1	10212	0	10239
9199	1	7	2	10520	0	10530
9200	1	17	0	10566	0	10584
9201	3	20	2	10539	0	10564
9202	3	0	10563	1	0	10567
9203	10652	0	5	1	0	10658
9204	1	29	0	10659	0	10689
9205	2	18	0	10928	0	10948
9206	4	10513	0	4	0	10521
9207	3	31	1	10405	0	10440
9208	1	0	10641	1	0	10643
9209	10554	4	33	1	0	10592
9210	2	0	10854	2	0	10858
9211	1	9	0	11448	0	11458
9212	11692	2	3	2	0	11699
9213	1	11702	0	1	0	11704
9214	0	19	0	11615	0	11634
9215	9	0	11604	6	0	11619
9216	1	13	1	11805	0	11820
9217	11667	0	18	0	0	11685
9218	3	0	11660	2	0	11665
9219	3	0	11237	4	0	11244
9220	4	11100	1	5	0	11110
9221	11033	1	18	3	0	11055
9222	2	11462	0	6	0	11470
9223	9	1	11377	0	0	11387
9224	16	0	11302	2	0	11320
9225	3	11341	1	8	0	11353
9226	11405	2	9	0	0	11416
9227	1	11624	0	3	0	11628
9228	4	42	1	11545	0	11592
9229	1	23	0	11618	0	11642
9230	11	0	11692	0	0	11703
9231	4	37	1	11622	0	11664
9232	4	0	10595	1	0	10600
9233	10539	1	29	5	0	10574
9234	10569	0	12	0	0	10581
9235	10539	0	34	4	0	10577
9236	1	0	10678	1	0	10680
9237	10677	0	17	3	0	10697
9238	2	32	1	10480	0	10515
9239	0	10458	0	2	0	10460
9240	10398	0	34	2	0	10434
9241	1	0	10446	0	0	10447
9242	10464	1	21	0	0	10486
9243	9998	6	22	0	0	10026
9244	3	0	9860	0	0	9863
9245	1	9837	0	4	0	9842
9246	4	12	0	9948	0	9964
9247	12	0	10024	0	0	10036
9248	9	0	10363	2	0	10374
9249	1	23	2	10571	0	10597
9250	2	2	10651	0	0	10655
9251	3	31	3	10501	0	10538
9252	5	36	0	10327	0	10368
9253	8	31	1	10402	0	10442
9254	3	3	10715	2	0	10723
9255	4	34	2	10362	0	10402
9256	6	1	10539	1	0	10547
9257	1	17	0	10547	0	10565
9258	10942	1	10	2	0	10955
9259	4	26	1	10834	0	10865
9260	0	10846	0	3	0	10849
9261	5	17	1	10939	0	10962
9262	11149	1	4	1	0	11155
9263	0	10924	0	1	0	10925
9264	1	14	1	10777	0	10793
9265	10709	1	11	2	0	10723
9266	2	0	11032	1	0	11035
9267	1	21	0	10864	0	10886
9268	6	0	10874	0	0	10880
9269	3	1	11310	2	0	11316
9270	1	11	0	11206	0	11218
9271	11082	0	15	3	0	11100
9272	2	0	11116	0	0	11118
9273	10828	0	131	3	0	10962
9274	1	37	0	10864	0	10902
9275	4	0	10521	0	0	10525
9276	7	1	10586	2	0	10596
9277	9	0	11149	5	0	11163
9278	0	24	0	11029	0	11053
9279	11242	0	7	0	0	11249
9280	1	11291	1	4	0	11297
9281	4	21	2	11095	0	11122
9282	1	11	1	11321	0	11334
9283	11320	1	11	0	0	11332
9284	11318	0	12	1	0	11331
9285	1	11051	0	5	0	11057
9286	10736	0	19	5	0	10760
9287	11011	2	17	1	0	11031
9288	1	18	1	10718	0	10738
9289	8	0	10914	1	0	10923
9290	10867	0	19	0	0	10886
9291	2	10	0	10846	0	10858
9292	0	7	0	10885	0	10892
9293	10783	0	4	2	0	10789
9294	3	25	0	11356	0	11384
9295	2	8	0	11474	0	11484
9296	11457	0	4	2	0	11463
9297	0	11395	0	9	0	11404
9298	10691	0	27	5	0	10723
9299	4	1	10897	1	0	10903
9300	10882	1	15	1	0	10899
9301	2	15	0	11011	0	11028
9302	0	11038	0	1	0	11039
9303	5	41	1	10727	0	10774
9304	2	15	2	10805	0	10824
9305	0	10	0	11177	0	11187
9306	11173	0	7	4	0	11184
9307	0	11115	1	16	0	11132
9308	1	10972	0	1	0	10974
9309	10806	1	103	6	0	10916
9310	17	0	10915	0	0	10932
9311	4	0	11089	1	0	11094
9312	10757	2	26	3	0	10788
9313	4	0	10988	0	0	10992
9314	2	16	10	10856	0	10884
9315	3	36	1	11349	0	11389
9316	0	23	1	11413	0	11437
9317	3	5	1	11399	0	11408
9318	0	11338	0	4	0	11342
9319	3	18	1	11244	0	11266
9320	2	0	11388	1	0	11391
9321	5	36	2	11436	0	11479
9322	3	0	11513	0	0	11516
9323	4	1	12018	2	0	12025
9324	0	33	1	11575	0	11609
9325	40	0	11497	3	0	11540
9326	1	14	0	11755	0	11770
9327	11615	0	10	0	0	11625
9328	6	0	11578	2	0	11586
9329	11404	1	18	4	0	11427
9330	2	19	0	11253	0	11274
9331	8	0	10875	0	0	10883
9332	3	10617	0	3	0	10623
9333	1	61	0	10431	0	10493
9334	5	0	10772	0	0	10777
9335	1	14	0	11545	0	11560
9336	11707	0	12	0	0	11719
9337	11600	1	12	1	0	11614
9338	11481	0	6	3	0	11490
9339	2	9	1	11508	0	11520
9340	1	6	0	11424	0	11431
9341	2	3	0	11272	0	11277
9342	11058	0	9	1	0	11068
9343	0	10768	0	1	0	10769
9344	2	11	0	10555	0	10568
9345	1	13	1	10668	0	10683
9346	11033	0	7	2	0	11042
9347	1	11492	0	3	0	11496
9348	1	17	2	11444	0	11464
9349	11906	1	7	0	0	11914
9350	11911	3	8	3	0	11925
9351	0	8	1	12086	0	12095
9352	12178	1	4	0	0	12183
9353	1	19	1	12039	0	12060
9354	4	0	12436	0	0	12440
9355	0	33	8	12184	0	12225
9356	1	28	1	11950	0	11980
9357	0	10	0	12026	0	12036
9358	11899	1	21	1	0	11922
9359	0	11806	0	6	0	11812
9360	11857	1	26	1	0	11885
9361	1	12319	0	6	0	12326
9362	1	11926	0	4	0	11931
9363	11837	2	10	6	0	11855
9364	0	11429	0	0	0	11429
9365	0	10	0	11440	0	11450
9366	11831	0	8	0	0	11839
9367	11834	0	14	1	0	11849
9368	1	11	0	11875	0	11887
9369	2	42	1	11801	0	11846
9370	0	11244	0	3	0	11247
9371	11097	1	16	1	0	11115
9372	11556	0	8	4	0	11568
9373	3	11614	0	5	0	11622
9374	0	11606	1	8	0	11615
9375	0	15	3	11525	0	11543
9376	11579	1	6	1	0	11587
9377	3	17	2	11463	0	11485
9378	4	41	1	11769	0	11815
9379	5	2	11780	1	0	11788
9380	4	1	11788	1	0	11794
9381	0	29	0	11524	0	11553
9382	5	0	11782	2	0	11789
9383	2	11821	0	1	0	11824
9384	0	22	1	11794	0	11817
9385	2	39	0	11968	0	12009
9386	0	15	0	11987	0	12002
9387	11	0	12014	7	0	12032
9388	6	0	12172	2	0	12180
9389	12016	0	33	3	0	12052
9390	2	11868	1	7	0	11878
9391	11516	0	22	1	0	11539
9392	2	24	0	11877	0	11903
9393	11981	0	9	2	0	11992
9394	4	19	0	11889	0	11912
9395	0	11815	0	2	0	11817
9396	11510	3	34	4	0	11551
9397	8	1	11676	3	0	11688
9398	0	11650	0	22	0	11672
9399	11853	1	22	1	0	11877
9400	2	17	2	11989	0	12010
9401	0	13009	0	3	0	13012
9402	1	24	0	12996	0	13021
9403	13405	2	12	1	0	13420
9404	2	21	0	13556	0	13579
9405	13473	0	13	0	0	13486
9406	4	2	13488	1	0	13495
9407	2	31	0	13250	0	13283
9408	12771	1	11	2	0	12785
9409	6	0	12789	1	0	12796
9410	1	11675	0	7	0	11683
9411	2	45	3	11810	0	11860
9412	10	1	11771	1	0	11783
9413	3	0	11903	2	0	11908
9414	4	22	4	12010	0	12040
9415	6	0	11967	0	0	11973
9416	3	0	12410	0	0	12413
9417	3	46	0	12468	0	12517
9418	12494	0	18	2	0	12514
9419	2	82	1	12668	0	12753
9420	4	23	2	12670	0	12699
9421	4	0	12682	3	0	12689
9422	4	61	1	13219	0	13285
9423	12758	6	19	1	0	12784
9424	14	0	12770	1	0	12785
9425	0	12352	0	12	0	12364
9426	1	29	0	12382	0	12412
9427	12479	2	11	3	0	12495
9428	18	19	0	12391	0	12428
9429	0	11812	0	6	0	11818
9430	13	0	11922	1	0	11936
9431	1	13	0	12021	0	12035
9432	11905	0	12	0	0	11917
9433	6	0	12132	0	0	12138
9434	0	29	0	12901	0	12930
9435	12930	0	16	0	0	12946
9436	12812	1	14	2	0	12829
9437	0	12302	0	6	0	12308
9438	12223	3	20	2	0	12248
9439	3	30	2	12349	0	12384
9440	11	0	12216	3	0	12230
9441	2	12004	0	9	0	12015
9442	2	11930	0	2	0	11934
9443	7	22	0	11865	0	11894
9444	1	13	0	12244	0	12258
9445	31	0	12400	4	0	12435
9446	2	12532	1	9	0	12544
9447	2	12326	0	3	0	12331
9448	2	28	0	12264	0	12294
9449	12262	1	14	7	0	12284
9450	0	12134	0	1	0	12135
9451	1	7	0	12510	0	12518
9452	12851	1	11	1	0	12864
9453	2	34	2	12802	0	12840
9454	2	13	1	12489	0	12505
9455	1	19	2	12514	0	12536
9456	0	6	0	12575	0	12581
9457	12501	0	6	1	0	12508
9458	2	24	0	12405	0	12431
9459	3	0	12375	1	0	12379
9460	12010	0	45	3	0	12058
9461	8	0	12043	0	0	12051
9462	8	0	12505	1	0	12514
9463	1	33	3	12508	0	12545
9464	3	24	3	12526	0	12556
9465	1	23	2	13009	0	13035
9466	12972	0	17	2	0	12991
9467	3	1	13014	0	0	13018
9468	12795	1	131	1	0	12928
9469	12795	1	27	4	0	12827
9470	2	0	12777	1	0	12780
9471	12034	0	37	5	0	12076
9472	5	0	12322	2	0	12329
9473	2	12097	0	5	0	12104
9474	0	22	4	12056	0	12082
9475	5	21	1	12586	0	12613
9476	4	36	1	12575	0	12616
9477	3	13	0	11599	0	11615
9478	6	0	11669	2	0	11677
9479	3	0	11375	1	0	11379
9480	1	39	0	11274	0	11314
9481	8	0	11343	1	0	11352
9482	11243	2	34	5	0	11284
9483	11193	1	254	0	0	11448
9484	0	9	0	11470	0	11479
9485	11466	0	16	1	0	11483
9486	0	11548	0	5	0	11553
9487	11204	0	18	1	0	11223
9488	5	0	11800	1	0	11806
9489	2	38	2	12054	0	12096
9490	5	11869	0	22	0	11896
9491	11966	0	21	2	0	11989
9492	1	37	0	11453	0	11491
9493	5	0	11543	0	0	11548
9494	3	12	0	11821	0	11836
9495	11514	2	26	6	0	11548
9496	4	0	11561	0	0	11565
9497	0	21	0	10917	0	10938
9498	2	19	2	10867	0	10890
9499	3	0	10830	1	0	10834
9500	3	10731	0	205	0	10939
9501	2	11089	1	4	0	11096
9502	1	35	4	11033	0	11073
9503	2	11	1	11039	0	11053
9504	1	2	0	11056	0	11059
9505	11072	2	2	5	0	11081
9506	11530	0	13	1	0	11544
9507	1	5	0	11497	0	11503
9508	11428	1	6	2	0	11437
9509	0	11170	0	0	0	11170
9510	1	30	0	10434	0	10465
9511	1	66	0	10815	0	10882
9512	2	16	0	10945	0	10963
9513	11041	0	5	1	0	11047
9514	0	10970	0	3	0	10973
9515	2	14	0	10780	0	10796
9516	11186	1	12	2	0	11201
9517	2	24	0	11138	0	11164
9518	3	16	0	11502	0	11521
9519	4	11737	1	4	0	11746
9520	1	11070	0	2	0	11073
9521	0	31	2	11041	0	11074
9522	3	8	0	11225	0	11236
9523	11242	1	6	0	0	11249
9524	4	32	1	11280	0	11317
9525	2	1	11513	0	0	11516
9526	4	31	0	11243	0	11278
9527	1	10736	0	6	0	10743
9528	10685	2	24	2	0	10713
9529	2	36	0	10702	0	10740
9530	4	21	2	10981	0	11008
9531	0	11056	0	2	0	11058
9532	11019	4	32	1	0	11056
9533	0	11145	0	2	0	11147
9534	3	59	1	10869	0	10932
9535	6	0	11158	4	0	11168
9536	5	23	1	11420	0	11449
9537	11466	1	11	4	0	11482
9538	0	11082	0	8	0	11090
9539	6	8	2	10698	0	10714
9540	0	10890	0	12	0	10902
9541	3	13	1	10536	0	10553
9542	3	0	11019	1	0	11023
9543	0	28	2	11037	0	11067
9544	1	30	1	10795	0	10827
9545	0	22	0	11009	0	11031
9546	10890	1	5	1	0	10897
9547	10968	2	23	3	0	10996
9548	0	10988	0	1	0	10989
9549	10758	3	27	8	0	10796
9550	1	10790	0	7	0	10798
9551	0	10218	1	8	0	10227
9552	10191	1	19	2	0	10213
9553	1	0	10328	0	0	10329
9554	4	21	16	8864	0	8905
9555	2	24	1	10246	0	10273
9556	30	13	1	10289	0	10333
9557	10249	1	21	1	0	10272
9558	0	10143	1	6	0	10150
9559	4	46	0	10054	0	10104
9560	2	10221	0	4	0	10227
9561	10026	2	14	1	0	10043
9562	2	20	2	10361	0	10385
9563	3	32	0	10331	0	10366
9564	0	9856	1	2	0	9859
9565	6	36	1	9690	0	9733
9566	0	10	2	9798	0	9810
9567	9749	0	7	1	0	9757
9568	1	9977	0	3	0	9981
9569	2	9812	0	9	0	9823
9570	6	15	0	9791	0	9812
9571	9	0	9554	1	0	9564
9572	13	2	10163	3	0	10181
9573	2	43	3	10234	0	10282
9574	8	0	10314	1	0	10323
9575	0	28	2	10173	0	10203
9576	0	31	0	10059	0	10090
9577	1	11	0	9927	0	9939
9578	10134	1	6	2	0	10143
9579	0	25	1	10143	0	10169
9580	2	35	2	10120	0	10159
9581	1	9906	0	5	0	9912
9582	3	26	0	9379	0	9408
9583	3	1	9929	1	0	9934
9584	2	19	2	9950	0	9973
9585	0	8	0	10287	0	10295
9586	10317	1	3	2	0	10323
9587	1	12	0	9978	0	9991
9588	2	9	0	9897	0	9908
9589	0	3	1	10216	0	10220
9590	10332	0	7	0	0	10339
9591	0	10316	0	2	0	10318
9592	1	35	0	9848	0	9884
9593	1	55	0	9809	0	9865
9594	6	0	9642	2	0	9650
9595	2	9	2	9529	0	9542
9596	9541	0	13	1	0	9555
9597	1	9481	0	5	0	9487
9598	2	21	3	9825	0	9851
9599	3	24	0	9893	0	9920
9600	5	0	9848	1	0	9854
9601	9726	0	24	2	0	9752
9602	0	9919	0	2	0	9921
9603	9779	0	18	0	0	9797
9604	2	26	0	9732	0	9760
9605	2	31	0	9685	0	9718
9606	3	10	0	9600	0	9613
9607	2	9	0	9543	0	9554
9608	9538	0	2	2	0	9542
9609	1	32	0	9409	0	9442
9610	1	9151	0	2	0	9154
9611	2	27	2	8877	0	8908
9612	0	5	0	9215	0	9220
9613	9312	0	23	1	0	9336
9614	0	9474	0	2	0	9476
9615	2	19	1	9360	0	9382
9616	9373	1	24	2	0	9400
9617	9282	1	5	2	0	9290
9618	1	40	3	9018	0	9062
9619	6	1	9005	0	0	9012
9620	9179	0	24	3	0	9206
9621	3	20	1	9063	0	9087
9622	1	1	9117	0	0	9119
9623	0	29	1	9135	0	9165
9624	1	22	0	9480	0	9503
9625	1	17	2	9685	0	9705
9626	0	9576	0	0	0	9576
9627	0	101	1	9455	0	9557
9628	0	18	3	9586	0	9607
9629	2	24	0	9650	0	9676
9630	0	6	0	9668	0	9674
9631	2	4	1	9698	0	9705
9632	0	7	0	9780	0	9787
9633	9665	1	14	0	0	9680
9634	4	0	9776	1	0	9781
9635	5	9961	0	3	0	9969
9636	9954	2	26	2	0	9984
9637	0	9838	0	8	0	9846
9638	10148	1	39	0	0	10188
9639	1	18	0	10324	0	10343
9640	10447	1	13	0	0	10461
9641	2	18	0	10450	0	10470
9642	3	24	0	10385	0	10412
9643	2	10384	0	3	0	10389
9644	10050	1	26	0	0	10077
9645	3	0	10307	1	0	10311
9646	0	9	1	10228	0	10238
9647	8	0	10126	0	0	10134
9648	0	0	9548	2	0	9550
9649	9409	0	28	3	0	9440
9650	0	9	2	9595	0	9606
9651	3	0	9572	0	0	9575
9652	4	0	10260	1	0	10265
9653	0	25	1	10371	0	10397
9654	2	8	1	10174	0	10185
9655	10189	0	14	1	0	10204
9656	2	27	0	10199	0	10228
9657	4	0	10340	1	0	10345
9658	0	33	0	10420	0	10453
9659	3	25	1	9866	0	9895
9660	0	9843	0	3	0	9846
9661	9442	0	23	6	0	9471
9662	0	9661	0	51	0	9712
9663	9716	1	22	1	0	9740
9664	2	9952	1	2	0	9957
9665	0	10134	0	2	0	10136
9666	1	42	0	9980	0	10023
9667	4	21	1	10023	0	10049
9668	0	9	1	10068	0	10078
9669	10021	1	16	0	0	10038
9670	3	1	9891	0	0	9895
9671	3	10	0	9984	0	9997
9672	9930	1	14	0	0	9945
9673	2	9895	0	5	0	9902
9674	0	9269	1	2	0	9272
9675	2	16	1	9451	0	9470
9676	0	18	0	9667	0	9685
9677	1	22	0	9723	0	9746
9678	0	9657	0	0	0	9657
9679	2	21	1	9576	0	9600
9680	8	0	9741	2	0	9751
9681	4	0	9823	2	0	9829
9682	9675	2	33	1	0	9711
9683	0	5	0	9845	0	9850
9684	9625	1	7	1	0	9634
9685	9771	1	19	2	0	9793
9686	1	9903	0	2	0	9906
9687	9885	0	50	1	0	9936
9688	9749	0	11	0	0	9760
9689	1	14	1	9511	0	9527
9690	2	5	0	9414	0	9421
9691	6	0	9673	1	0	9680
9692	0	9739	0	7	0	9746
9693	4	27	0	10044	0	10075
9694	3	6	0	10019	0	10028
9695	10186	0	11	5	0	10202
9696	1	14	1	10274	0	10290
9697	10306	0	8	0	0	10314
9698	3	26	1	10273	0	10303
9699	1	10180	0	0	0	10181
9700	9759	0	11	0	0	9770
9701	1	16	0	9563	0	9580
9702	1	27	0	9568	0	9596
9703	1	20	2	9672	0	9695
9704	2	0	9889	0	0	9891
9705	0	7	1	9856	0	9864
9706	9836	0	13	1	0	9850
9707	2	32	0	9745	0	9779
9708	1	17	0	9612	0	9630
9709	5	12	0	9587	0	9604
9710	3	9818	0	5	0	9826
9711	0	9798	0	6	0	9804
9712	9799	1	42	6	0	9848
9713	3	9422	0	8	0	9433
9714	9148	2	20	1	0	9171
9715	9126	0	22	2	0	9150
9716	8914	2	25	1	0	8942
9717	3	0	9206	4	0	9213
9718	0	9420	2	6	0	9428
9719	9285	0	20	0	0	9305
9720	3	12	0	9533	0	9548
9721	0	31	2	9363	0	9396
9722	2	28	0	9456	0	9486
9723	1	9656	0	7	0	9664
9724	0	5	0	9591	0	9596
9725	9590	0	9	2	0	9601
9726	1	13	0	9471	0	9485
9727	2	19	2	9507	0	9530
9728	5	0	9048	3	0	9056
9729	1	0	9152	1	0	9154
9730	3	23	1	9210	0	9237
9731	4	20	2	9136	0	9162
9732	0	9178	0	4	0	9182
9733	1	64	0	9008	0	9073
9734	2	11	0	9164	0	9177
9735	0	16	1	9239	0	9256
9736	9206	3	21	2	0	9232
9737	4	0	9386	0	0	9390
9738	0	5	0	9370	0	9375
9739	9336	0	7	0	0	9343
9740	8824	1	10	2	0	8837
9741	1	12	0	8514	0	8527
9742	0	8	0	8845	0	8853
9743	9152	0	19	1	0	9172
9744	1	9334	0	0	0	9335
9745	0	9337	0	2	0	9339
9746	2	18	1	9217	0	9238
9747	9342	0	18	1	0	9361
9748	9292	2	28	0	0	9322
9749	9234	3	32	2	0	9271
9750	3	0	9285	0	0	9288
9751	8988	1	20	1	0	9010
9752	3	0	8858	0	0	8861
9753	8754	1	38	3	0	8796
9754	0	8911	0	10	0	8921
9755	5	1	9076	0	0	9082
9756	2	15	3	8880	0	8900
9757	3	1	8863	0	0	8867
9758	2	7	0	8896	0	8905
9759	8757	0	12	1	0	8770
9760	3	0	8914	0	0	8917
9761	1	9	1	8830	0	8841
9762	0	8939	1	1	0	8941
9763	0	16	1	8879	0	8896
9764	3	21	2	8829	0	8855
9765	2	5	0	8928	0	8935
9766	9339	1	12	1	0	9353
9767	9012	1	15	0	0	9028
9768	3	3	0	8940	0	8946
9769	7	0	8583	0	0	8590
9770	9	0	8621	3	0	8633
9771	1	21	0	8188	0	8210
9772	9	0	8113	1	0	8123
9773	2	31	8	8180	0	8221
9774	0	23	0	8151	0	8174
9775	2	8	0	8042	0	8052
9776	3	8424	0	3	0	8430
9777	0	8577	1	1	0	8579
9778	0	37	0	8604	0	8641
9779	2	29	2	8502	0	8535
9780	5	12	0	8345	0	8362
9781	8248	0	11	1	0	8260
9782	6	0	8257	0	0	8263
9783	1	10	0	8770	0	8781
9784	8752	0	9	0	0	8761
9785	1	8591	0	5	0	8597
9786	6	36	0	8214	0	8256
9787	3	12	1	8466	0	8482
9788	1	19	0	8826	0	8846
9789	1	13	0	9082	0	9096
9790	4	0	9075	0	0	9079
9791	9050	1	51	1	0	9103
9792	9058	0	40	2	0	9100
9793	1	0	8889	0	0	8890
9794	8665	0	29	2	0	8696
9795	8626	0	38	0	0	8664
9796	1	0	8470	0	0	8471
9797	0	8694	2	5	0	8701
9798	1	15	0	8695	0	8711
9799	4	0	8700	1	0	8705
9800	1	8676	1	7	0	8685
9801	9	2	8690	0	0	8701
9802	2	8581	0	2	0	8585
9803	1	9	1	8367	0	8378
9804	6	1	8474	0	0	8481
9805	3	11	0	9059	0	9073
9806	9	0	9030	0	0	9039
9807	1	10185	0	1	0	10187
9808	10493	2	32	3	0	10530
9809	2	10573	3	5	0	10583
9810	3	10812	1	1	0	10817
9811	0	48	2	10750	0	10800
9812	2	19	1	10868	0	10890
9813	1	16	1	10434	0	10452
9814	4	18	1	10457	0	10480
9815	5	14	1	10650	0	10670
9816	4	0	10677	1	0	10682
9817	4	32	0	10854	0	10890
9818	1	8	0	10482	0	10491
9819	10173	1	11	2	0	10187
9820	9921	2	19	0	0	9942
9821	10089	0	10	1	0	10100
9822	1	7	1	10283	0	10292
9823	10290	0	3	1	0	10294
9824	10346	2	7	1	0	10356
9825	10312	1	30	0	0	10343
9826	3	0	10358	0	0	10361
9827	10958	1	18	0	0	10977
9828	10652	0	101	4	0	10757
9829	10788	3	23	2	0	10816
9830	0	17	0	10476	0	10493
9831	5	0	10459	0	0	10464
9832	17	13	1	10428	0	10459
9833	10884	1	17	2	0	10904
9834	2	9	0	10916	0	10927
9835	0	10734	0	2	0	10736
9836	3	14	0	10961	0	10978
9837	11017	0	7	0	0	11024
9838	10762	0	15	1	0	10778
9839	10738	3	37	0	0	10778
9840	3	0	10781	1	0	10785
9841	1	11	0	10753	0	10765
9842	2	9	3	10384	0	10398
9843	26	0	10637	0	0	10663
9844	2	10694	0	11	0	10707
9845	8	0	10770	0	0	10778
9846	1	14	1	10748	0	10764
9847	10659	0	19	0	0	10678
9848	6	0	10893	0	0	10899
9849	1	16	1	10751	0	10769
9850	11	0	10754	0	0	10765
9851	10740	0	29	4	0	10773
9852	1	18	1	10294	0	10314
9853	6	0	10225	0	0	10231
9854	4	14	1	10251	0	10270
9855	4	0	10363	1	0	10368
9856	1	10612	0	6	0	10619
9857	0	15	0	10282	0	10297
9858	10355	0	14	1	0	10370
9859	2	15	0	10215	0	10232
9860	2	7	1	10420	0	10430
9861	10399	1	13	1	0	10414
9862	2	10330	0	3	0	10335
9863	1	10314	0	2	0	10317
9864	9	23	0	9829	0	9861
9865	0	9824	0	1	0	9825
9866	1	4	0	9719	0	9724
9867	0	6	0	9743	0	9749
9868	9811	1	20	0	0	9832
9869	2	9831	0	5	0	9838
9870	33	1	9742	0	0	9776
9871	8	9884	0	19	0	9911
9872	9666	1	17	1	0	9685
9873	10379	1	22	3	0	10405
9874	0	7	2	10406	0	10415
9875	10613	1	15	2	0	10631
9876	0	5	1	10643	0	10649
9877	10771	1	16	1	0	10789
9878	10790	5	14	2	0	10811
9879	2	5	0	10857	0	10864
9880	10091	2	5	0	0	10098
9881	2	0	10124	1	0	10127
9882	8546	2	29	2	0	8579
9883	1	5	1	8652	0	8659
9884	8505	1	10	2	0	8518
9885	0	8429	0	2	0	8431
9886	1	29	1	8035	0	8066
9887	0	9	0	8053	0	8062
9888	8011	1	4	0	0	8016
9889	2	0	8085	0	0	8087
9890	1	8049	0	2	0	8052
9891	0	21	0	7778	0	7799
9892	2	8365	0	0	0	8367
9893	0	43	1	8055	0	8099
9894	2	13	0	8127	0	8142
9895	0	5	0	8153	0	8158
9896	8208	0	4	2	0	8214
9897	2	2	2	8131	0	8137
9898	7973	0	10	0	0	7983
9899	7954	1	5	2	0	7962
9900	0	1	0	7887	0	7888
9901	7358	0	4	1	0	7363
9902	7220	1	17	0	0	7238
9903	3	0	7624	0	0	7627
9904	1	2	0	7595	0	7598
9905	7647	0	15	5	0	7667
9906	2	7796	0	6	0	7804
9907	7914	0	12	1	0	7927
9908	8024	0	19	0	0	8043
9909	4	0	10119	1	0	10124
9910	1	3	0	10294	0	10298
9911	10416	0	2	0	0	10418
9912	3	25	0	10514	0	10542
9913	1	11	4	10478	0	10494
9914	0	11	0	10497	0	10508
9915	0	6	1	10801	0	10808
9916	10697	1	5	1	0	10704
9917	1	0	10852	0	0	10853
9918	3	15	0	10510	0	10528
9919	2	1	10359	1	0	10363
9920	1	0	11001	0	0	11002
9921	10956	0	19	2	0	10977
9922	6	0	11390	1	0	11397
9923	0	11261	0	2	0	11263
9924	11485	0	10	0	0	11495
9925	11525	0	16	0	0	11541
9926	0	22	0	11581	0	11603
9927	11	1	13677	3	0	13692
9928	10	0	13864	2	0	13876
9929	13820	0	34	3	0	13857
9930	3	46	2	13886	0	13937
9931	13854	0	21	3	0	13878
9932	1	14252	0	17	0	14270
9933	14192	0	45	3	0	14240
9934	14728	3	34	0	0	14765
9935	0	14744	0	6	0	14750
9936	1	18	2	14843	0	14864
9937	15022	0	13	0	0	15035
9938	11	0	15097	0	0	15108
9939	0	15747	0	7	0	15754
9940	2	35	1	15816	0	15854
9941	16017	0	42	2	0	16061
9942	2	16292	0	6	0	16300
9943	16184	0	24	3	0	16211
9944	1	0	16335	1	0	16337
9945	16208	0	57	29	0	16294
9946	2	0	16447	1	0	16450
9947	16189	2	48	1	0	16240
9948	16106	1	44	7	0	16158
9949	4	0	15517	7	0	15528
9950	0	15170	0	5	0	15175
9951	3	49	0	15182	0	15234
9952	13	0	15646	3	0	15662
9953	0	15581	0	21	0	15602
9954	3	37	3	15879	0	15922
9955	1	27	1	15941	0	15970
9956	6	0	16050	2	0	16058
9957	2	43	1	16174	0	16220
9958	3	23	1	15994	0	16021
9959	4	0	15855	1	0	15860
9960	6	17	0	16130	0	16153
9961	2	16200	1	4	0	16207
9962	16484	1	28	3	0	16516
9963	8	28	2	16741	0	16779
9964	0	16714	0	3	0	16717
9965	7	44	4	16714	0	16769
9966	0	17010	1	11	0	17022
9967	20	3	16965	1	0	16989
9968	0	16622	0	11	0	16633
9969	16656	0	19	1	0	16676
9970	16637	5	19	1	0	16662
9971	16634	2	39	6	0	16681
9972	15	0	16790	4	0	16809
9973	13	1	16760	8	0	16782
9974	0	16916	0	4	0	16920
9975	7	73	0	16548	0	16628
9976	2	17310	1	7	0	17320
9977	7	50	1	17087	0	17145
9978	1	17438	1	2	0	17442
9979	17424	2	20	4	0	17450
9980	17457	1	35	0	0	17493
9981	1	30	2	17431	0	17464
9982	3	0	17324	5	0	17332
9983	17192	1	55	3	0	17251
9984	0	15124	0	5	0	15129
9985	2	44	1	14954	0	15001
9986	4	46	3	15030	0	15083
9987	0	14876	0	7	0	14883
9988	14835	0	31	2	0	14868
9989	5	1	14906	1	0	14913
9990	1	29	2	15185	0	15217
9991	15305	0	14	0	0	15319
9992	15348	0	38	5	0	15391
9993	0	15415	0	6	0	15421
9994	8	26	1	15115	0	15150
9995	1	14710	0	0	0	14711
9996	14480	1	30	0	0	14511
9997	10	0	14731	0	0	14741
9998	12	0	14677	2	0	14691
9999	1	50	0	14734	0	14785
10000	2	30	1	14487	0	14520
10001	0	12292	0	3	0	12295
10002	1	29	4	12207	0	12241
10003	11	0	12259	0	0	12270
10004	12322	0	25	2	0	12349
10005	0	45	2	12325	0	12372
10006	10	0	12969	0	0	12979
10007	1	26	2	12974	0	13003
10008	2	21	2	12505	0	12530
10009	0	12078	0	1	0	12079
10010	0	139	0	11968	0	12107
10011	3	25	0	12341	0	12369
10012	1	30	0	12133	0	12164
10013	12039	1	17	2	0	12059
10014	1	11243	0	8	0	11252
10015	0	11010	1	22	0	11033
10016	11455	2	21	3	0	11481
10017	11203	0	18	0	0	11221
10018	2	11314	0	6	0	11322
10019	1	11030	1	11	0	11043
10020	10950	0	8	1	0	10959
10021	2	11390	0	2	0	11394
10022	0	11447	0	3	0	11450
10023	11971	1	15	2	0	11989
10024	1	11874	0	21	0	11896
10025	11795	0	14	0	0	11809
10026	11840	0	15	1	0	11856
10027	11732	3	23	1	0	11759
10028	2	12400	0	2	0	12404
10029	0	12412	0	4	0	12416
10030	3	32	0	12398	0	12433
10031	0	12757	0	1	0	12758
10032	6	17	1	12711	0	12735
10033	13587	0	13	1	0	13601
10034	6	21	0	13517	0	13544
10035	1	13700	1	2	0	13704
10036	13534	2	13	0	0	13549
10037	0	13753	0	12	0	13765
10038	1	14346	1	0	0	14348
10039	16	53	4	13946	0	14019
10040	0	14216	0	8	0	14224
10041	14091	3	14	2	0	14110
10042	10	0	14037	1	0	14048
10043	0	14574	1	10	0	14585
10044	2	25	0	14489	0	14516
10045	3	0	14980	0	0	14983
10046	0	31	5	14848	0	14884
10047	0	60	4	14859	0	14923
10048	4	52	1	14843	0	14900
10049	1	47	0	14874	0	14922
10050	6	1	14743	2	0	14752
10051	0	14390	0	9	0	14399
10052	14237	1	30	5	0	14273
10053	5	0	14362	2	0	14369
10054	13788	5	33	9	0	13835
10055	1	0	14239	0	0	14240
10056	2	33	2	14491	0	14528
10057	4	0	14595	1	0	14600
10058	5	0	15652	1	0	15658
10059	2	30	1	15740	0	15773
10060	4	33	2	15460	0	15499
10061	3	28	0	15510	0	15541
10062	0	9	1	15802	0	15812
10063	15447	0	14	1	0	15462
10064	6	0	15489	0	0	15495
10065	15671	0	44	1	0	15716
10066	15642	0	34	1	0	15677
10067	15194	2	35	4	0	15235
10068	15117	2	44	0	0	15163
10069	14957	1	18	1	0	14977
10070	4	16	7	15010	0	15037
10071	20	1	14944	1	0	14966
10072	8	3	14975	1	0	14987
10073	1	15259	1	9	0	15270
10074	15246	1	35	4	0	15286
10075	1	18	4	15265	0	15288
10076	7	40	2	15142	0	15191
10077	6	15276	1	3	0	15286
10078	4	15245	0	5	0	15254
10079	1	15387	0	6	0	15394
10080	15399	1	13	2	0	15415
10081	5	49	0	15164	0	15218
10082	4	14814	0	12	0	14830
10083	3	26	5	14801	0	14835
10084	11	0	14982	2	0	14995
10085	8	0	15271	2	0	15281
10086	3	19	0	15282	0	15304
10087	15323	1	11	3	0	15338
10088	15231	1	10	1	0	15243
10089	15160	2	67	0	0	15229
10090	6	0	15708	0	0	15714
10091	2	30	0	16735	0	16767
10092	2	34	0	16461	0	16497
10093	3	0	16414	3	0	16420
10094	16024	3	46	7	0	16080
10095	20	1	16316	3	0	16340
10096	8	0	16389	2	0	16399
10097	9	0	16317	5	0	16331
10098	0	41	2	16142	0	16185
10099	2	29	1	17297	0	17329
10100	6	0	18081	0	0	18087
10101	2	22	0	18209	0	18233
10102	18296	0	28	0	0	18324
10103	2	38	4	18299	0	18343
10104	34	0	17303	2	0	17339
10105	13	1	18003	4	0	18021
10106	1	24	2	17684	0	17711
10107	17584	0	38	1	0	17623
10108	0	17600	0	9	0	17609
10109	16700	1	73	2	0	16776
10110	16904	3	45	5	0	16957
10111	4	0	16818	2	0	16824
10112	3	22	2	16876	0	16903
10113	16517	3	31	0	0	16551
10114	15497	6	29	1	0	15533
10115	0	15440	0	2	0	15442
10116	1	42	1	15423	0	15467
10117	1	32	0	15298	0	15331
10118	6	0	15287	4	0	15297
10119	7	23	3	15036	0	15069
10120	9	1	14933	2	0	14945
10121	9	0	15222	4	0	15235
10122	3	11	0	15550	0	15564
10123	15533	1	24	3	0	15561
10124	2	15872	0	12	0	15886
10125	15825	2	53	1	0	15881
10126	16002	2	30	1	0	16035
10127	1	15971	0	8	0	15980
10128	4	18	1	15834	0	15857
10129	16108	1	13	1	0	16123
10130	0	15794	0	7	0	15801
10131	15940	2	33	5	0	15980
10132	1	15804	0	12	0	15817
10133	0	28	0	15462	0	15490
10134	2	16	0	15559	0	15577
10135	15357	1	23	2	0	15383
10136	15340	3	37	1	0	15381
10137	3	15389	0	5	0	15397
10138	9	0	15018	0	0	15027
10139	6	0	15547	1	0	15554
10140	1	35	2	15509	0	15547
10141	4	15503	1	3	0	15511
10142	2	36	1	15446	0	15485
10143	6	17	3	15470	0	15496
10144	3	26	1	15580	0	15610
10145	11	0	15569	5	0	15585
10146	5	1	15534	6	0	15546
10147	5	15586	0	3	0	15594
10148	2	30	1	15022	0	15055
10149	3	88	0	14858	0	14949
10150	7	0	14880	2	0	14889
10151	14930	1	27	4	0	14962
10152	4	28	0	15229	0	15261
10153	10	0	15147	1	0	15158
10154	15139	2	29	9	0	15179
10155	0	15178	0	5	0	15183
10156	5	0	15487	0	0	15492
10157	1	21	0	15502	0	15524
10158	15435	0	12	1	0	15448
10159	2	0	15593	1	0	15596
10160	0	30	9	15199	0	15238
10161	3	40	2	15163	0	15208
10162	0	16	0	15448	0	15464
10163	15373	0	9	0	0	15382
10164	18	14794	0	8	0	14820
10165	4	20	1	14036	0	14061
10166	8	1	15242	5	0	15256
10167	5	31	0	14852	0	14888
10168	6	14589	0	68	0	14663
10169	4	14808	0	9	0	14821
10170	14837	1	23	1	0	14862
10171	12983	1605	16	14	0	14618
10172	4	0	14638	3	0	14645
10173	14554	1	26	2	0	14583
10174	3	14880	0	2	0	14885
10175	13143	0	26	3	0	13172
10176	2	30	3	12466	0	12501
10177	3	0	12378	2	0	12383
10178	3	35	4	12227	0	12269
10179	2	0	12233	4	0	12239
10180	12306	0	9	2	0	12317
10181	0	24	1	11541	0	11566
10182	1	11508	0	3	0	11512
10183	0	55	0	11657	0	11712
10184	5	0	11707	2	0	11714
10185	1	11486	2	8	0	11497
10186	11513	3	26	0	0	11542
10187	0	12132	0	5	0	12137
10188	1	12213	0	1	0	12215
10189	1	45	1	12423	0	12470
10190	0	12507	0	2	0	12509
10191	2	33	0	12456	0	12491
10192	4	0	12541	2	0	12547
10193	13321	1	14	2	0	13338
10194	13206	0	39	2	0	13247
10195	3	0	13267	0	0	13270
10196	12919	2	17	2	0	12940
10197	0	12763	0	5	0	12768
10198	12799	2	21	2	0	12824
10199	2	13	1	12992	0	13008
10200	4	1	12937	2	0	12944
10201	0	12865	0	4	0	12869
10202	0	24	3	12811	0	12838
10203	8	13	0	13087	0	13108
10204	13040	0	7	2	0	13049
10205	13018	0	20	2	0	13040
10206	2	13096	0	3	0	13101
10207	3	12944	1	2	0	12950
10208	0	13110	0	5	0	13115
10209	1	15	0	12555	0	12571
10210	12611	1	7	0	0	12619
10211	12737	1	9	1	0	12748
10212	1	17	0	12842	0	12860
10213	1	14	2	13072	0	13089
10214	13106	0	6	1	0	13113
10215	2	33	2	12300	0	12337
10216	2	0	12326	1	0	12329
10217	12581	1	29	2	0	12613
10218	12474	1	71	1	0	12547
10219	6	0	12924	2	0	12932
10220	13044	0	20	2	0	13066
10221	0	6	1	13042	0	13049
10222	0	26	0	13020	0	13046
10223	0	21	2	13046	0	13069
10224	13110	1	6	3	0	13120
10225	1	13140	0	2	0	13143
10226	3	66	2	12998	0	13069
10227	0	13151	0	4	0	13155
10228	12847	0	15	0	0	12862
10229	4	41	0	13306	0	13351
10230	3	39	1	13607	0	13650
10231	2	13298	0	4	0	13304
10232	7	1	13325	1	0	13334
10233	0	16	0	13376	0	13392
10234	13150	0	5	0	0	13155
10235	12950	5	14	2	0	12971
10236	2	0	13287	1	0	13290
10237	1	40	0	13356	0	13397
10238	3	13151	0	1	0	13155
10239	1	10	1	12899	0	12911
10240	13150	1	11	1	0	13163
10241	13133	1	18	1	0	13153
10242	4	18	0	12190	0	12212
10243	1	12392	0	1	0	12394
10244	12366	3	12	3	0	12384
10245	3	15	0	12204	0	12222
10246	12203	1	5	1	0	12210
10247	12107	1	12	0	0	12120
10248	0	20	1	12020	0	12041
10249	1	27	1	12026	0	12055
10250	2	35	1	12386	0	12424
10251	0	12372	0	2	0	12374
10252	4	39	0	12232	0	12275
10253	3	26	0	12272	0	12301
10254	4	0	12318	2	0	12324
10255	18	1	12590	4	0	12613
10256	2	18	1	12973	0	12994
10257	12921	3	20	4	0	12948
10258	1	12847	0	10	0	12858
10259	12438	1	18	6	0	12463
10260	7	0	13178	3	0	13188
10261	10	0	13277	8	0	13295
10262	4	12514	1	9	0	12528
10263	2	20	1	12433	0	12456
10264	7	0	12317	2	0	12326
10265	11	0	12572	2	0	12585
10266	3	19	3	12764	0	12789
10267	12733	0	9	3	0	12745
10268	12675	2	38	1	0	12716
10269	1	9	2	11956	0	11968
10270	9	0	12193	3	0	12205
10271	3	64	1	12820	0	12888
10272	3	21	2	12813	0	12839
10273	2	12699	0	3	0	12704
10274	12498	0	13	4	0	12515
10275	12769	0	14	3	0	12786
10276	0	12283	0	1	0	12284
10277	3	27	0	12093	0	12123
10278	2	12166	1	5	0	12174
10279	11847	2	20	0	0	11869
10280	6	1	12223	0	0	12230
10281	7	0	12121	6	0	12134
10282	5	0	12400	1	0	12406
10283	1	33	0	12559	0	12593
10284	0	16	2	12457	0	12475
10285	12567	1	3	1	0	12572
10286	1	28	0	13003	0	13032
10287	3	14	16	12965	0	12998
10288	6	2	12987	6	0	13001
10289	4	1	12771	2	0	12778
10290	12635	1	29	4	0	12669
10291	1	12684	0	5	0	12690
10292	12589	0	19	1	0	12609
10293	1	56	0	12672	0	12729
10294	1	19	0	12595	0	12615
10295	2	12256	0	4	0	12262
10296	2	13	1	12085	0	12101
10297	12634	0	12	1	0	12647
10298	1	37	0	12563	0	12601
10299	6	0	12714	1	0	12721
10300	1	12628	0	0	0	12629
10301	12664	1	12	2	0	12679
10302	12668	1	34	6	0	12709
10303	12659	2	4	1	0	12666
10304	13056	0	16	1	0	13073
10305	0	22	0	12625	0	12647
10306	1	20	1	12513	0	12535
10307	3	0	12581	3	0	12587
10308	5	21	0	12559	0	12585
10309	8	0	12731	2	0	12741
10310	2	17	1	12879	0	12899
10311	13082	0	14	4	0	13100
10312	1	12953	0	6	0	12960
10313	4	24	1	12707	0	12736
10314	0	6	2	12750	0	12758
10315	12751	0	2	2	0	12755
10316	12685	3	26	2	0	12716
10317	5	0	13184	2	0	13191
10318	0	13273	0	5	0	13278
10319	6	30	2	13189	0	13227
10320	2	13	1	13284	0	13300
10321	13227	2	11	2	0	13242
10322	13220	1	23	1	0	13245
10323	4	0	13669	1	0	13674
10324	5	0	13642	4	0	13651
10325	1	24	1	13518	0	13544
10326	3	24	0	13136	0	13163
10327	4	0	13397	3	0	13404
10328	13419	2	43	5	0	13469
10329	2	12	1	13497	0	13512
10330	13349	1	21	0	0	13371
10331	0	12925	0	2	0	12927
10332	12584	1	20	1	0	12606
10333	10	0	12617	3	0	12630
10334	2	12937	2	3	0	12944
10335	3	12228	0	6	0	12237
10336	12185	0	10	1	0	12196
10337	13014	3	18	0	0	13035
10338	3	29	2	13903	0	13937
10339	3	13780	0	3	0	13786
10340	0	13575	0	1	0	13576
10341	1	17	1	13588	0	13607
10342	13670	1	6	4	0	13681
10343	13648	1	29	1	0	13679
10344	4	0	13568	2	0	13574
10345	13956	3	25	1	0	13985
10346	2	13522	0	3	0	13527
10347	12942	2	33	0	0	12977
10348	3	13215	0	4	0	13222
10349	2	12880	1	2	0	12885
10350	1	31	1	12850	0	12883
10351	13331	1	1	2	0	13335
10352	13298	0	61	4	0	13363
10353	2	0	14218	0	0	14220
10354	1	13	0	14337	0	14351
10355	14254	0	15	1	0	14270
10356	1	8	1	14014	0	14024
10357	14241	0	7	2	0	14250
10358	13968	0	11	2	0	13981
10359	2	0	13903	1	0	13906
10360	4	28	0	13867	0	13899
10361	0	39	0	13784	0	13823
10362	0	13	3	13187	0	13203
10363	2	0	13192	0	0	13194
10364	1	83	0	13170	0	13254
10365	12	35	1	13131	0	13179
10366	1	13232	0	7	0	13240
10367	12	2	13165	2	0	13181
10368	0	13163	0	8	0	13171
10369	13843	0	16	1	0	13860
10370	1	34	1	13864	0	13900
10371	6	48	1	13850	0	13905
10372	0	13554	0	4	0	13558
10373	13763	2	18	0	0	13783
10374	13869	0	16	2	0	13887
10375	1	13711	0	6	0	13718
10376	1	13708	0	10	0	13719
10377	13471	0	15	2	0	13488
10378	19	0	13575	2	0	13596
10379	8	0	13645	5	0	13658
10380	13226	0	21	6	0	13253
10381	1	13209	0	9	0	13219
10382	12832	4	17	1	0	12854
10383	3	1	12924	0	0	12928
10384	13206	0	30	4	0	13240
10385	1	13018	0	0	0	13019
10386	0	45	2	12920	0	12967
10387	0	11	2	12961	0	12974
10388	2	38	1	12860	0	12901
10389	3	10	0	12922	0	12935
10390	1	24	2	13008	0	13035
10391	1	12735	1	6	0	12743
10392	12450	1	29	4	0	12484
10393	8	0	12462	1	0	12471
10394	0	30	2	13266	0	13298
10395	3	0	13339	0	0	13342
10396	5	19	1	13246	0	13271
10397	1	29	1	13229	0	13260
10398	13214	0	21	1	0	13236
10399	4	1	12937	3	0	12945
10400	0	13183	0	3	0	13186
10401	2	29	1	13156	0	13188
10402	1	10	0	13022	0	13033
10403	4	0	13045	2	0	13051
10404	1	30	1	13721	0	13753
10405	1	10	0	13789	0	13800
10406	14730	3	10	3	0	14746
10407	4	14464	0	4	0	14472
10408	14296	2	45	5	0	14348
10409	14412	1	47	1	0	14461
10410	1	32	0	14428	0	14461
10411	5	0	14473	1	0	14479
10412	3	1	14704	7	0	14715
10413	2	76	0	14088	0	14166
10414	2	33	0	13465	0	13500
10415	6	13356	1	6	0	13369
10416	13532	0	22	0	0	13554
10417	2	13596	0	4	0	13602
10418	1	14034	0	6	0	14041
10419	14363	2	15	0	0	14380
10420	3	46	1	14213	0	14263
10421	0	13898	0	4	0	13902
10422	5	70	1	13761	0	13837
10423	6	1	13922	2	0	13931
10424	5	0	14479	3	0	14487
10425	1	13	1	14410	0	14425
10426	4	0	14555	0	0	14559
10427	0	54	15	14248	0	14317
10428	3	49	0	14154	0	14206
10429	0	25	0	13449	0	13474
10430	13426	0	23	2	0	13451
10431	5	13744	2	4	0	13755
10432	0	13702	1	7	0	13710
10433	13547	20	16	3	0	13586
10434	13524	0	14	2	0	13540
10435	1	19	0	13242	0	13262
10436	4	1	13870	1	0	13876
10437	2	33	0	13958	0	13993
10438	9	0	13985	2	0	13996
10439	1	14170	0	8	0	14179
10440	1	15	2	14012	0	14030
10441	14053	1	11	3	0	14068
10442	2	55	0	13978	0	14035
10443	4	0	13922	2	0	13928
10444	15613	2	33	0	0	15648
10445	2	0	15028	3	0	15033
10446	4	1	15249	5	0	15259
10447	6	15094	2	4	0	15106
10448	8	14593	0	97	0	14698
10449	6	14976	0	1	0	14983
10450	15049	0	22	7	0	15078
10451	15198	2	22	1	0	15223
10452	5	57	0	15217	0	15279
10453	2	33	2	15293	0	15330
10454	1	24	3	15026	0	15054
10455	4	15058	0	1	0	15063
10456	15094	2	37	1	0	15134
10457	0	15669	0	8	0	15677
10458	0	10	1	15545	0	15556
10459	16283	1	15	1	0	16300
10460	0	18	0	16174	0	16192
10461	4	13	1	16064	0	16082
10462	16027	0	15	6	0	16048
10463	15835	3	15	1	0	15854
10464	3	0	15913	1	0	15917
10465	9	3	15909	4	0	15925
10466	6	0	16069	2	0	16077
10467	4	39	0	15658	0	15701
10468	2	21	5	15299	0	15327
10469	1	14958	0	3	0	14962
10470	15035	4	11	2	0	15052
10471	0	61	0	15366	0	15427
10472	1	30	1	15477	0	15509
10473	3	16317	0	7	0	16327
10474	0	16203	0	1	0	16204
10475	3	23	0	16403	0	16429
10476	0	10	2	16651	0	16663
10477	17192	0	21	4	0	17217
10478	16930	1	120	1	0	17052
10479	3	21	2	16828	0	16854
10480	2	0	16163	2	0	16167
10481	5	0	16393	4	0	16402
10482	1	38	2	15585	0	15626
10483	6	75	2	15525	0	15608
10484	0	15422	1	7	0	15430
10485	15824	6	28	1	0	15859
10486	1	21	1	15841	0	15864
10487	14	0	15762	1	0	15777
10488	11	29	2	15623	0	15665
10489	15	0	15422	0	0	15437
10490	2	3	15471	5	0	15481
10491	2	11	1	15514	0	15528
10492	15303	1	21	2	0	15327
10493	7	0	15453	0	0	15460
10494	5	31	2	14856	0	14894
10495	5	0	14583	1	0	14589
10496	2	26	2	14538	0	14568
10497	4	28	2	14356	0	14390
10498	33	0	14333	5	0	14371
10499	9	1	14516	7	0	14533
10500	4	26	2	14185	0	14217
10501	1	33	1	14141	0	14176
10502	1	16	0	13996	0	14013
10503	2	9	1	14091	0	14103
10504	14100	0	4	1	0	14105
10505	14159	0	14	2	0	14175
10506	0	14204	0	1	0	14205
10507	13959	1	20	3	0	13983
10508	0	16	1	13956	0	13973
10509	13517	0	13	1	0	13531
10510	0	0	15817	2	0	15819
10511	15822	2	19	0	0	15843
10512	1	32	0	16025	0	16058
10513	0	27	2	15976	0	16005
10514	15999	2	19	2	0	16022
10515	5	20	1	15938	0	15964
10516	7	0	15938	0	0	15945
10517	15790	3	41	8	0	15842
10518	1	15794	0	7	0	15802
10519	4	29	2	13590	0	13625
10520	5	1	13772	0	0	13778
10521	4	39	2	13686	0	13731
10522	3	0	13887	3	0	13893
10523	4	26	0	13864	0	13894
10524	1	13881	0	6	0	13888
10525	3	63	0	13720	0	13786
10526	0	14135	0	3	0	14138
10527	4	67	3	14078	0	14152
10528	1	20	1	14384	0	14406
10529	0	39	0	14319	0	14358
10530	0	5	0	14459	0	14464
10531	2	32	1	14295	0	14330
10532	9	0	14373	6	0	14388
10533	1	33	2	13757	0	13793
10534	0	9	1	14171	0	14181
10535	13643	1	28	2	0	13674
10536	0	13676	1	6	0	13683
10537	13725	0	87	1	0	13813
10538	7	34	3	13779	0	13823
10539	15	1	13719	3	0	13738
10540	5	14067	0	8	0	14080
10541	14074	4	31	7	0	14116
10542	2	14774	0	11	0	14787
10543	0	14615	1	11	0	14627
10544	15648	1	62	4	0	15715
10545	2	21	1	15719	0	15743
10546	15624	2	12	4	0	15642
10547	5	19	1	15400	0	15425
10548	8	0	15279	0	0	15287
10549	7	0	14715	4	0	14726
10550	14640	1	27	6	0	14674
10551	14259	0	28	4	0	14291
10552	1	17	2	14269	0	14289
10553	1	17	0	13715	0	13733
10554	13829	0	12	2	0	13843
10555	2	13759	1	13	0	13775
10556	3	13689	0	5	0	13697
10557	13647	6	27	3	0	13683
10558	13566	1	61	2	0	13630
10559	1	13241	0	5	0	13247
10560	4	22	0	13195	0	13221
10561	5	0	13249	0	0	13254
10562	4	0	13316	1	0	13321
10563	12998	2	113	1	0	13114
10564	4	0	13194	2	0	13200
10565	2	26	0	13420	0	13448
10566	1	19	0	13286	0	13306
10567	1	13284	0	3	0	13288
10568	13250	1	24	4	0	13279
10569	4	17	0	13680	0	13701
10570	16	0	13613	0	0	13629
10571	2	13590	0	5	0	13597
10572	5	24	3	13530	0	13562
10573	2	1	13609	3	0	13615
10574	11	1	13563	7	0	13582
10575	1	13819	1	11	0	13832
10576	13784	0	69	3	0	13856
10577	1	13909	0	5	0	13915
10578	13644	1	35	1	0	13681
10579	4	0	14397	0	0	14401
10580	15490	2	29	7	0	15528
10581	2	15741	0	11	0	15754
10582	2	34	1	16469	0	16506
10583	0	19	0	16561	0	16580
10584	16493	1	17	4	0	16515
10585	3	0	16516	2	0	16521
10586	14340	0	20	2	0	14362
10587	14285	2	43	1	0	14331
10588	6	0	13607	1	0	13614
10589	4	0	13733	2	0	13739
10590	0	17	1	13805	0	13823
10591	13713	0	16	1	0	13730
10592	13755	4	18	0	0	13777
10593	0	13979	0	2	0	13981
10594	1	54	0	13907	0	13962
10595	0	8	3	14410	0	14421
10596	1	11	2	14691	0	14705
10597	1	10	0	14670	0	14681
10598	14479	1	17	1	0	14498
10599	4	7	0	14493	0	14504
10600	9	1	14339	1	0	14350
10601	5	0	14361	10	0	14376
10602	14100	0	26	0	0	14126
10603	3	14166	0	5	0	14174
10604	1	13817	0	1	0	13819
10605	0	31	16	13928	0	13975
10606	1	24	0	14202	0	14227
10607	2	20	0	14802	0	14824
10608	1	11	1	14765	0	14778
10609	3	0	14830	3	0	14836
10610	3	31	0	14437	0	14471
10611	1	22	1	14239	0	14263
10612	5	1	14043	3	0	14052
10613	13887	0	85	4	0	13976
10614	1	13830	0	5	0	13836
10615	13643	2	30	4	0	13679
10616	4	0	13519	0	0	13523
10617	18	0	13819	2	0	13839
10618	5	13347	3	29	0	13384
10619	13499	0	20	2	0	13521
10620	13504	1	40	6	0	13551
10621	13538	7	18	5	0	13568
10622	1	13619	1	11	0	13632
10623	13495	2	75	3	0	13575
10624	11	0	13672	3	0	13686
10625	5	13395	0	4	0	13404
10626	13785	1	42	3	0	13831
10627	1	13839	0	7	0	13847
10628	13764	0	30	1	0	13795
10629	13774	5	35	10	0	13824
10630	1	1	13704	0	0	13706
10631	2	13705	0	10	0	13717
10632	13594	0	23	2	0	13619
10633	4	2	13625	0	0	13631
10634	2	13480	0	5	0	13487
10635	28	17	0	13481	0	13526
10636	8	1	13723	1	0	13733
10637	2	0	14019	6	0	14027
10638	3	14	0	14028	0	14045
10639	13970	1	19	2	0	13992
10640	3	13586	2	8	0	13599
10641	14	0	13618	5	0	13637
10642	5	2	13871	5	0	13883
10643	13818	2	72	3	0	13895
10644	4	13574	0	4	0	13582
10645	13362	2	34	1	0	13399
10646	3	14003	0	3	0	14009
10647	14037	0	20	5	0	14062
10648	14316	0	30	1	0	14347
10649	1	15088	0	3	0	15092
10650	0	10	1	14776	0	14787
10651	14683	0	11	1	0	14695
10652	1	32	3	15057	0	15093
10653	0	8	1	15056	0	15065
10654	14979	4	24	0	0	15007
10655	1	14147	1	5	0	14154
10656	13303	0	20	0	0	13323
10657	4	0	13280	1	0	13285
10658	0	15	1	12494	0	12510
10659	0	11	0	12517	0	12528
10660	12459	1	10	1	0	12471
10661	12463	4	21	0	0	12488
10662	2	11	0	12707	0	12720
10663	2	0	13068	2	0	13072
10664	0	38	6	13060	0	13104
10665	0	16	1	13276	0	13293
10666	2	11	1	13231	0	13245
10667	2	17	0	13288	0	13307
10668	13251	1	15	1	0	13268
10669	4	0	13148	0	0	13152
10670	0	12672	1	6	0	12679
10671	5	13	3	12704	0	12725
10672	5	9	1	12900	0	12915
10673	5	1	12958	2	0	12966
10674	1	1	13928	3	0	13933
10675	0	24	0	13967	0	13991
10676	2	27	1	13910	0	13940
10677	10	0	13879	3	0	13892
10678	2	5	0	13875	0	13882
10679	14023	0	22	0	0	14045
10680	1	13957	2	6	0	13966
10681	10	0	13768	0	0	13778
10682	2	13663	0	13	0	13678
10683	2	23	0	13161	0	13186
10684	3	0	13358	1	0	13362
10685	3	13477	0	6	0	13486
10686	2	14	8	13697	0	13721
10687	1	0	14591	0	0	14592
10688	2	14	4	14540	0	14560
10689	0	2	2	14798	0	14802
10690	14761	0	7	4	0	14772
10691	1	9	0	14487	0	14497
10692	14536	0	12	0	0	14548
10693	14303	0	36	1	0	14340
10694	14798	0	30	1	0	14829
10695	1	17	0	14764	0	14782
10696	4	0	13753	1	0	13758
10697	1	1	13726	1	0	13729
10698	13294	3	30	5	0	13332
10699	10	2	13418	2	0	13432
10700	13291	1	33	3	0	13328
10701	0	13388	0	6	0	13394
10702	12976	0	42	0	0	13018
10703	4	1	13045	2	0	13052
10704	7	0	13866	2	0	13875
10705	3	17	1	13753	0	13774
10706	2	1	13594	2	0	13599
10707	2	1	13651	2	0	13656
10708	1	39	3	14473	0	14516
10709	2	23	2	14420	0	14447
10710	4	21	1	14411	0	14437
10711	0	14024	1	5	0	14030
10712	4	19	0	13860	0	13883
10713	3	14531	0	4	0	14538
10714	14560	1	18	3	0	14582
10715	14593	2	16	1	0	14612
10716	1	19	1	14517	0	14538
10717	1	14234	0	7	0	14242
10718	6	1	14272	1	0	14280
10719	14769	1	7	0	0	14777
10720	0	20	1	14835	0	14856
10721	5	21	0	14868	0	14894
10722	1	18	2	14337	0	14358
10723	14197	2	191	0	0	14390
10724	1	13413	0	13	0	13427
10725	5	13352	0	4	0	13361
10726	13548	2	42	1	0	13593
10727	1	13538	0	12	0	13551
10728	13080	0	32	2	0	13114
10729	13256	12	43	1	0	13312
10730	2	13233	0	69	0	13304
10731	4	48	0	13067	0	13119
10732	0	13883	0	2	0	13885
10733	2	28	2	13729	0	13761
10734	0	10	0	13865	0	13875
10735	13846	1	15	6	0	13868
10736	13816	0	53	3	0	13872
10737	3	82	0	13728	0	13813
10738	1	1	13748	2	0	13752
10739	13462	4	37	6	0	13509
10740	0	13812	1	1	0	13814
10741	1	27	1	13346	0	13375
10742	3	25	2	13381	0	13411
10743	6	12	2	13455	0	13475
10744	13512	1	6	4	0	13523
10745	13405	1	34	1	0	13441
10746	0	13600	0	5	0	13605
10747	1	13099	0	2	0	13102
10748	1	22	1	12731	0	12755
10749	1	18	0	12502	0	12521
10750	3	0	11928	2	0	11933
10751	0	8	0	11992	0	12000
10752	11	0	11960	2	0	11973
10753	7	0	12040	4	0	12051
10754	1	12257	0	9	0	12267
10755	4	12	2	11961	0	11979
10756	12114	1	12	1	0	12128
10757	3	25	1	12088	0	12117
10758	3	1	11945	1	0	11950
10759	12052	3	40	4	0	12099
10760	11789	0	49	3	0	11841
10761	4	0	12157	1	0	12162
10762	3	4	2	11860	0	11869
10763	11051	0	23	0	0	11074
10764	2	10927	1	10	0	10940
10765	10845	2	19	0	0	10866
10766	11632	0	11	3	0	11646
10767	1	14	1	11953	0	11969
10768	0	12	1	12132	0	12145
10769	12008	1	7	1	0	12017
10770	4	14	1	11624	0	11643
10771	4	1	11636	0	0	11641
10772	12012	1	17	4	0	12034
10773	11929	2	85	1	0	12017
10774	8	12408	0	10	0	12426
10775	0	12131	0	4	0	12135
10776	3	17	3	12034	0	12057
10777	1	12074	0	2	0	12077
10778	4	17	3	12173	0	12197
10779	12183	2	9	0	0	12194
10780	12751	4	22	1	0	12778
10781	0	12878	0	7	0	12885
10782	12777	1	28	1	0	12807
10783	2	12645	1	2	0	12650
10784	11785	1	31	0	0	11817
10785	11948	1	22	2	0	11973
10786	2	0	11921	3	0	11926
10787	12248	1	54	6	0	12309
10788	2	12371	1	2	0	12376
10789	2	11691	0	13	0	11706
10790	11758	1	35	2	0	11796
10791	4	14	2	11879	0	11899
10792	4	0	12073	0	0	12077
10793	1	33	0	12165	0	12199
10794	2	21	1	11989	0	12013
10795	6	0	11729	1	0	11736
10796	11719	1	33	1	0	11754
10797	1	11726	0	7	0	11734
10798	11656	6	30	0	0	11692
10799	2	9	1	12122	0	12134
10800	12126	2	160	2	0	12290
10801	0	12285	0	5	0	12290
10802	1	10	0	12225	0	12236
10803	12145	1	18	0	0	12164
10804	3	0	12036	1	0	12040
10805	9	1	11967	4	0	11981
10806	11807	2	37	1	0	11847
10807	6	11589	1	9	0	11605
10808	1	11053	1	0	0	11055
10809	1	13	0	11124	0	11138
10810	0	11484	0	3	0	11487
10811	0	195	1	11255	0	11451
10812	5	73	2	11376	0	11456
10813	1	11	1	11538	0	11551
10814	1	11038	0	3	0	11042
10815	5	14	2	10783	0	10804
10816	5	1	10839	1	0	10846
10817	0	10938	1	0	0	10939
10818	2	15	1	10883	0	10901
10819	0	11135	0	4	0	11139
10820	11141	0	10	7	0	11158
10821	11245	1	11	1	0	11258
10822	11687	0	12	2	0	11701
10823	0	11767	0	12	0	11779
10824	2	10	1	11800	0	11813
10825	8	1	11783	0	0	11792
10826	1335	1	10538	1	0	11875
10827	13981	4	34	2	0	14021
10828	14013	0	25	3	0	14041
10829	1	9	3	14080	0	14093
10830	3	23	1	13774	0	13801
10831	21	0	13812	0	0	13833
10832	7	14099	4	12	0	14122
10833	2	14145	0	9	0	14156
10834	1	0	14371	1	0	14373
10835	4	48	6	14346	0	14404
10836	2	29	1	14346	0	14378
10837	1	25	0	14658	0	14684
10838	0	10	1	14898	0	14909
10839	15138	2	15	4	0	15159
10840	9	0	15233	0	0	15242
10841	15383	1	31	6	0	15421
10842	1	6	0	14814	0	14821
10843	14457	3	27	4	0	14491
10844	48	30	1	14134	0	14213
10845	3	0	14328	0	0	14331
10846	5	36	0	14131	0	14172
10847	6	0	14186	1	0	14193
10848	0	25	2	13755	0	13782
10849	7	1	13645	1	0	13654
10850	3	12888	0	7	0	12898
10851	0	19	0	12906	0	12925
10852	7	23	2	12892	0	12924
10853	4	13030	1	2	0	13037
10854	12968	0	43	1	0	13012
10855	1	17	1	13346	0	13365
10856	4	3	2	12873	0	12882
10857	12767	1	5	2	0	12775
10858	12730	1	12	0	0	12743
10859	12727	1	15	2	0	12745
10860	12724	1	37	0	0	12762
10861	3	0	12677	0	0	12680
10862	12394	1	35	4	0	12434
10863	12465	0	25	1	0	12491
10864	2	101	2	12516	0	12621
10865	0	11	0	12765	0	12776
10866	12626	0	14	2	0	12642
10867	0	12410	1	7	0	12418
10868	1	20	0	12333	0	12354
10869	8	0	12391	1	0	12400
10870	0	12188	4	6	0	12198
10871	12141	1	26	1	0	12169
10872	12130	0	31	2	0	12163
10873	13117	5	19	2	0	13143
10874	13163	1	27	2	0	13193
10875	0	14	1	12814	0	12829
10876	5	0	12596	0	0	12601
10877	3	0	12784	1	0	12788
10878	2	6	0	12767	0	12775
10879	12815	2	25	0	0	12842
10880	1	12	0	12869	0	12882
10881	3	1	12949	1	0	12954
10882	12785	0	53	1	0	12839
10883	12969	0	57	2	0	13028
10884	5	41	1	12918	0	12965
10885	6	0	12724	0	0	12730
10886	13	1	12792	1	0	12807
10887	12872	3	27	5	0	12907
10888	0	12855	1	4	0	12860
10889	8	0	13113	0	0	13121
10890	0	226	0	13231	0	13457
10891	13626	0	17	0	0	13643
10892	8	13578	0	6	0	13592
10893	4	13556	0	4	0	13564
10894	14860	0	26	3	0	14889
10895	2	17	2	14606	0	14627
10896	14856	0	25	2	0	14883
10897	3	10	1	14677	0	14691
10898	4	9	0	14166	0	14179
10899	10	1	14339	3	0	14353
10900	4	0	14309	1	0	14314
10901	0	0	14302	2	0	14304
10902	3	26	0	14194	0	14223
10903	11990	2	30	2	0	12024
10904	6	0	12278	0	0	12284
10905	0	19	0	12070	0	12089
10906	4	2	12525	3	0	12534
10907	2	12709	0	5	0	12716
10908	3	27	1	12345	0	12376
10909	2	28	0	12532	0	12562
10910	2	8	1	12385	0	12396
10911	12541	0	3	2	0	12546
10912	3	11	1	12512	0	12527
10913	0	12	1	12199	0	12212
10914	11997	1	13	2	0	12013
10915	5	0	11791	1	0	11797
10916	11501	2	12	2	0	11517
10917	11492	0	31	1	0	11524
10918	2	0	11536	0	0	11538
10919	11555	1	29	3	0	11588
10920	1	9	0	11391	0	11401
10921	7	1	11380	1	0	11389
10922	11976	2	14	0	0	11992
10923	12220	1	34	0	0	12255
10924	1	6	0	12206	0	12213
10925	3	16	3	12308	0	12330
10926	0	14	1	12314	0	12329
10927	12443	1	22	1	0	12467
10928	2	12283	0	8	0	12293
10929	12561	2	34	2	0	12599
10930	4	13221	0	10	0	13235
10931	0	12967	1	7	0	12975
10932	1	23	1	13215	0	13240
10933	1	36	1	13215	0	13253
10934	1	32	1	13306	0	13340
10935	1	23	2	13611	0	13637
10936	8	0	13680	2	0	13690
10937	13897	4	22	3	0	13926
10938	1	31	1	14120	0	14153
10939	1	0	14133	3	0	14137
10940	1	24	1	15233	0	15259
10941	2	26	3	15115	0	15146
10942	7	0	15524	1	0	15532
10943	1	34	5	15698	0	15738
10944	2	11	0	15813	0	15826
10945	15842	0	18	0	0	15860
10946	11	0	15945	0	0	15956
10947	16056	0	38	7	0	16101
10948	4	15952	0	9	0	15965
10949	14982	0	43	0	0	15025
10950	15390	1	62	0	0	15453
10951	0	13	1	15278	0	15292
10952	5	0	15563	0	0	15568
10953	1	15263	2	7	0	15273
10954	7	32	1	15038	0	15078
10955	2	15217	0	16	0	15235
10956	15101	5	17	7	0	15130
10957	10	0	15370	1	0	15381
10958	2	0	15801	1	0	15804
10959	3	18	5	15520	0	15546
10960	8	0	15545	1	0	15554
10961	7	22	1	15328	0	15358
10962	1	17	0	15224	0	15242
10963	15318	0	29	2	0	15349
10964	0	14948	0	4	0	14952
10965	3	43	0	14644	0	14690
10966	1	41	1	14720	0	14763
10967	2	29	0	14561	0	14592
10968	1	14884	1	3	0	14889
10969	0	13544	2	4	0	13550
10970	13608	1	22	3	0	13634
10971	13528	0	23	3	0	13554
10972	13159	2	38	3	0	13202
10973	6	0	13423	1	0	13430
10974	1	84	0	13409	0	13494
10975	4	0	13154	2	0	13160
10976	6	12598	0	741	0	13345
10977	13243	3	37	3	0	13286
10978	0	0	13385	0	0	13385
10979	3	34	1	13704	0	13742
10980	4	1	13773	2	0	13780
10981	14278	0	14	3	0	14295
10982	13817	0	69	0	0	13886
10983	13709	0	42	4	0	13755
10984	13625	2	82	1	0	13710
10985	1	0	13577	1	0	13579
10986	13978	1	44	3	0	14026
10987	14662	1	33	2	0	14698
10988	1	14759	0	9	0	14769
10989	15086	0	22	1	0	15109
10990	15291	1	21	0	0	15313
10991	2	17	2	15273	0	15294
10992	2	15511	1	3	0	15517
10993	15510	1	24	0	0	15535
10994	15470	2	28	1	0	15501
10995	6	2	15639	3	0	15650
10996	8	0	15833	6	0	15847
10997	6	1	16017	2	0	16026
10998	1	290	1	15576	0	15868
10999	15738	4	20	4	0	15766
11000	2	15666	0	12	0	15680
11001	15639	1	35	2	0	15677
11002	5	15740	0	8	0	15753
11003	15723	1	28	3	0	15755
11004	5	15907	1	8	0	15921
11005	0	15106	0	9	0	15115
11006	14912	1	20	2	0	14935
11007	2	14688	0	6	0	14696
11008	3	22	0	14473	0	14498
11009	5	0	14595	2	0	14602
11010	10	0	14614	2	0	14626
11011	3	24	0	14298	0	14325
11012	0	27	2	14203	0	14232
11013	3	0	13847	1	0	13851
11014	3	19	0	13651	0	13673
11015	0	5	0	13721	0	13726
11016	12435	0	16	2	0	12453
11017	0	12005	0	1	0	12006
11018	6	28	0	11652	0	11686
11019	4	11789	1	4	0	11798
11020	11766	2	13	2	0	11783
11021	2	11592	0	5	0	11599
11022	11572	1	10	1	0	11584
11023	11488	2	14	3	0	11507
11024	0	14	4	11506	0	11524
11025	1	21	1	11444	0	11467
11026	5	23	0	11355	0	11383
11027	4	15	1	11490	0	11510
11028	3	1	11034	4	0	11042
11029	11116	4	33	1	0	11154
11030	0	11091	0	5	0	11096
11031	1	19	0	10896	0	10916
11032	6	23	0	10805	0	10834
11033	1	10492	1	3	0	10497
11034	10567	1	19	0	0	10587
11035	0	10891	0	1	0	10892
11036	3	28	1	10828	0	10860
11037	0	15	0	10799	0	10814
11038	1	19	2	10871	0	10893
11039	0	13	0	10972	0	10985
11040	10945	0	12	1	0	10958
11041	5	0	11032	0	0	11037
11042	2	26	4	11506	0	11538
11043	3	21	26	11438	0	11488
11044	3	25	1	11171	0	11200
11045	3	14	0	13511	0	13528
11046	13572	0	15	0	0	13587
11047	2	0	13759	1	0	13762
11048	2	33	0	16272	0	16307
11049	8	16255	2	17	0	16282
11050	4	16180	0	7	0	16191
11051	15940	3	30	9	0	15982
11052	1	0	16014	1	0	16016
11053	16964	2	51	1	0	17018
11054	7	0	17347	1	0	17355
11055	6	19	1	17079	0	17105
11056	16370	12	17	3	0	16402
11057	0	16354	0	13	0	16367
11058	8	40	1	16127	0	16176
11059	9	16096	0	8	0	16113
11060	15837	7	51	4	0	15899
11061	15689	8	34	1	0	15732
11062	1	25	1	15726	0	15753
11063	10	0	14703	2	0	14715
11064	10	4	14729	1	0	14744
11065	3	26	3	14126	0	14158
11066	2	13809	0	3	0	13814
11067	5	31	2	13765	0	13803
11068	1	15	1	13722	0	13739
11069	4	16	1	13764	0	13785
11070	6	0	13619	0	0	13625
11071	1	37	2	13493	0	13533
11072	5	29	1	13160	0	13195
11073	0	12822	0	9	0	12831
11074	1	83	2	12104	0	12190
11075	0	19	1	12579	0	12599
11076	7	30	0	12616	0	12653
11077	1	7	1	12576	0	12585
11078	1	14	0	12443	0	12458
11079	0	8	1	12219	0	12228
11080	3	36	1	11991	0	12031
11081	1	26	9	12027	0	12063
11082	6	1	12058	1	0	12066
11083	0	20	1	12036	0	12057
11084	12014	2	32	1	0	12049
11085	4	19	1	11941	0	11965
11086	5	0	11963	0	0	11968
11087	11975	0	27	5	0	12007
11088	11976	2	14	5	0	11997
11089	11942	0	44	3	0	11989
11090	12022	3	37	0	0	12062
11091	1	24	0	11829	0	11854
11092	10	0	11879	0	0	11889
11093	3	11863	0	38	0	11904
11094	0	11947	0	6	0	11953
11095	2	32	2	11860	0	11896
11096	1	14	0	11846	0	11861
11097	3	28	1	11858	0	11890
11098	1	19	0	11844	0	11864
11099	1	9	1	11834	0	11845
11100	11873	0	5	0	0	11878
11101	3	11847	1	7	0	11858
11102	1	11541	0	5	0	11547
11103	2	56	1	11224	0	11283
11104	3	15	2	11171	0	11191
11105	2	15	1	11221	0	11239
11106	1	12	1	11240	0	11254
11107	5	0	11332	3	0	11340
11108	1	11309	0	20	0	11330
11109	1	10	0	11085	0	11096
11110	11009	0	19	2	0	11030
11111	4	15	0	10655	0	10674
11112	5	0	11030	2	0	11037
11113	14	0	10984	2	0	11000
11114	1	0	11372	6	0	11379
11115	3	7	1	11269	0	11280
11116	10687	0	6	0	0	10693
11117	0	6	0	10679	0	10685
11118	1	4	2	10639	0	10646
11119	10629	0	7	2	0	10638
11120	2	3	0	10641	0	10646
11121	2	11	0	8139	0	8152
11122	5	0	7858	3	0	7866
11123	0	6163	0	1	0	6164
11124	1	9	1	5096	0	5107
11125	5130	1	4	1	0	5136
11126	1	11	0	4172	0	4184
11127	4	0	4136	1	0	4141
11128	5	6	0	4002	0	4013
11129	0	3584	0	3	0	3587
11130	0	8	1	3548	0	3557
11131	0	0	3589	0	0	3589
11132	0	3578	0	1	0	3579
11133	0	18	2	3572	0	3592
11134	1	8	0	3651	0	3660
11135	0	6	0	3637	0	3643
11136	0	8	0	3631	0	3639
11137	2	0	3659	0	0	3661
11138	1	3722	0	0	0	3723
11139	3735	0	3	1	0	3739
11140	3631	0	6	0	0	3637
11141	1	9	0	3573	0	3583
11142	3	0	3631	0	0	3634
11143	3813	2	5	1	0	3821
11144	0	10	0	3982	0	3992
11145	3	0	3999	1	0	4003
11146	6	13	0	3861	0	3880
11147	1	9	0	3881	0	3891
11148	0	3	1	3982	0	3986
11149	1	0	3969	0	0	3970
11150	2	16	0	3966	0	3984
11151	0	3944	0	2	0	3946
11152	3950	0	4	0	0	3954
11153	4081	1	3	0	0	4085
11154	4404	1	9	0	0	4414
11155	0	4503	0	1	0	4504
11156	4667	1	4	0	0	4672
11157	1	2	0	4675	0	4678
11158	4595	0	2	0	0	4597
11159	4615	0	18	1	0	4634
11160	2	0	4641	0	0	4643
11161	0	4558	0	2	0	4560
11162	4580	0	4	0	0	4584
11163	1	16	0	4581	0	4598
11164	1	0	4657	0	0	4658
11165	2	4689	0	4	0	4695
11166	4659	0	10	0	0	4669
11167	1	13	2	4721	0	4737
11168	2	10	1	4667	0	4680
11169	1	19	0	4643	0	4663
11170	1	4662	0	1	0	4664
11171	3	7	2	4612	0	4624
11172	0	4628	0	1	0	4629
11173	0	8	21	4523	0	4552
11174	2	1	4619	0	0	4622
11175	3	9	0	4647	0	4659
11176	0	18	0	4621	0	4639
11177	0	7	3	4630	0	4640
11178	4	0	4637	0	0	4641
11179	1	16	4	4623	0	4644
11180	0	11	0	4655	0	4666
11181	0	14	1	4648	0	4663
11182	1	3	0	4788	0	4792
11183	0	7	0	4875	0	4882
11184	4	0	4871	0	0	4875
11185	1	10	0	4942	0	4953
11186	1	11	1	4915	0	4928
11187	4958	1	3	2	0	4964
11188	0	4572	0	4	0	4576
11189	0	4228	0	1	0	4229
11190	0	9	0	4229	0	4238
11191	1	13	0	4381	0	4395
11192	0	4302	0	1	0	4303
11193	2	15	0	4291	0	4308
11194	1	4349	0	3	0	4353
11195	0	13	0	4498	0	4511
11196	0	11	1	4518	0	4530
11197	2	0	4494	0	0	4496
11198	2	4654	0	4	0	4660
11199	0	4690	0	1	0	4691
11200	4626	0	9	1	0	4636
11201	0	4593	0	3	0	4596
11202	1	8	0	4517	0	4526
11203	3	0	4569	0	0	4572
11204	0	6	0	4681	0	4687
11205	4703	0	2	0	0	4705
11206	6	0	4745	0	0	4751
11207	0	4747	0	8	0	4755
11208	0	4	1	4735	0	4740
11209	1	5	0	4941	0	4947
11210	5087	1	5	0	0	5093
11211	0	2	0	5365	0	5367
11212	0	4	1	5317	0	5322
11213	1	1	0	5304	0	5306
11214	2	1	0	5287	0	5290
11215	5404	0	5	2	0	5411
11216	5421	1	10	1	0	5433
11217	0	5	0	5438	0	5443
11218	5386	0	4	0	0	5390
11219	3	11	0	5213	0	5227
11220	4	0	5256	0	0	5260
11221	4	1	6053	3	0	6061
11222	2	18	0	6041	0	6061
11223	0	6357	0	3	0	6360
11224	0	4	0	6394	0	6398
11225	6466	0	6	0	0	6472
11226	0	7	1	6467	0	6475
11227	6477	0	8	0	0	6485
11228	1	18	0	6454	0	6473
11229	4	0	6301	2	0	6307
11230	0	6020	0	2	0	6022
11231	1	5980	0	3	0	5984
11232	2	28	0	5997	0	6027
11233	4	0	6056	0	0	6060
11234	0	6054	0	3	0	6057
11235	2	8	0	6039	0	6049
11236	6066	0	2	1	0	6069
11237	2	0	6137	0	0	6139
11238	1	9	0	6165	0	6175
11239	3	13	0	6115	0	6131
11240	6	0	6065	1	0	6072
11241	2	0	6074	0	0	6076
11242	4	0	6223	1	0	6228
11243	0	8	0	6500	0	6508
11244	10	0	6479	1	0	6490
11245	6595	2	24	2	0	6623
11246	0	11	1	6635	0	6647
11247	5	0	6686	1	0	6692
11248	1	6811	0	1	0	6813
11249	9	1	7051	2	0	7063
11250	0	10	0	7219	0	7229
11251	7239	1	1	0	0	7241
11252	0	19	0	7321	0	7340
11253	1	5	0	7321	0	7327
11254	7389	0	1	0	0	7390
11255	1	61	1	7317	0	7380
11256	1	0	7337	0	0	7338
11257	7424	1	12	1	0	7438
11258	0	7290	0	6	0	7296
11259	7305	1	7	1	0	7314
11260	0	5	0	7331	0	7336
11261	1	1	7339	2	0	7343
11262	3	0	7505	0	0	7508
11263	0	15	1	7528	0	7544
11264	2	7	0	7515	0	7524
11265	3	1	7603	1	0	7608
11266	1	0	7738	1	0	7740
11267	7509	2	20	0	0	7531
11268	1	6	1	7591	0	7599
11269	7614	0	11	0	0	7625
11270	3	12	2	7542	0	7559
11271	8	0	7398	2	0	7408
11272	0	0	7475	1	0	7476
11273	0	18	0	7488	0	7506
11274	2	17	0	7255	0	7274
11275	2	0	7249	0	0	7251
11276	7529	0	18	3	0	7550
11277	0	12	0	7536	0	7548
11278	7536	0	5	1	0	7542
11279	1	7412	0	4	0	7417
11280	1	24	0	7246	0	7271
11281	7145	2	15	8	0	7170
11282	1	0	7196	0	0	7197
11283	0	12	1	7175	0	7188
11284	0	15	1	7147	0	7163
11285	0	11	0	7062	0	7073
11286	3	0	6909	0	0	6912
11287	0	10	1	6685	0	6696
11288	1	6550	0	1	0	6552
11289	11	14	3	6513	0	6541
11290	3	0	6509	1	0	6513
11291	1	0	6666	1	0	6668
11292	0	16	5	6642	0	6663
11293	2	7	1	6671	0	6681
11294	0	3	0	6686	0	6689
11295	0	2	0	6967	0	6969
11296	6794	0	6	2	0	6802
11297	6076	1	11	1	0	6089
11298	3	0	6233	1	0	6237
11299	0	6076	1	1	0	6078
11300	1	14	0	6013	0	6028
11301	6036	0	15	0	0	6051
11302	6059	1	7	2	0	6069
11303	6030	0	17	0	0	6047
11304	6054	2	27	0	0	6083
11305	3	0	6082	0	0	6085
11306	5995	0	6	1	0	6002
11307	1	5916	0	0	0	5917
11308	0	12	0	5746	0	5758
11309	0	0	6163	0	0	6163
11310	2	22	0	6658	0	6682
11311	1	0	6959	2	0	6962
11312	0	18	0	6981	0	6999
11313	0	7	0	6889	0	6896
11314	7129	0	3	2	0	7134
11315	1	6	0	7088	0	7095
11316	3	0	7199	1	0	7203
11317	1	7	0	7063	0	7071
11318	6787	0	7	1	0	6795
11319	0	23	0	6831	0	6854
11320	0	1	6626	0	0	6627
11321	3	6794	0	1	0	6798
11322	6785	1	11	1	0	6798
11323	2	11	2	6609	0	6624
11324	1	6448	0	0	0	6449
11325	6357	1	8	2	0	6368
11326	9	5	6554	0	0	6568
11327	1	6489	0	3	0	6493
11328	1	21	1	6956	0	6979
11329	8	0	7087	1	0	7096
11330	1	8	1	7133	0	7143
11331	7116	0	6	1	0	7123
11332	6	0	7273	1	0	7280
11333	2	10	1	7166	0	7179
11334	8	0	7243	0	0	7251
11335	0	37	1	7035	0	7073
11336	3	25	2	7170	0	7200
11337	7205	0	9	1	0	7215
11338	2	7076	1	3	0	7082
11339	4	14	1	7056	0	7075
11340	7025	0	27	0	0	7052
11341	6840	0	8	4	0	6852
11342	0	9	0	6909	0	6918
11343	0	7128	0	3	0	7131
11344	1	7072	0	1	0	7074
11345	1	25	0	6992	0	7018
11346	0	16	0	7071	0	7087
11347	6991	0	11	0	0	7002
11348	0	12	0	7138	0	7150
11349	1	0	7131	0	0	7132
11350	7084	0	17	1	0	7102
11351	0	6930	0	6	0	6936
11352	6874	0	23	4	0	6901
11353	10	0	6952	0	0	6962
11354	1	7143	1	5	0	7150
11355	7158	0	8	3	0	7169
11356	7142	0	20	1	0	7163
11357	1	0	7153	0	0	7154
11358	7378	2	17	4	0	7401
11359	7461	2	7	1	0	7471
11360	1	7534	0	2	0	7537
11361	0	11	2	7414	0	7427
11362	1	0	7926	0	0	7927
11363	1	23	0	7831	0	7855
11364	4	0	7970	0	0	7974
11365	1	5	0	7988	0	7994
11366	8048	0	7	0	0	8055
11367	1	10	1	7977	0	7989
11368	0	0	7965	0	0	7965
11369	7958	2	15	0	0	7975
11370	0	14	1	7965	0	7980
11371	4	0	7692	0	0	7696
11372	7598	2	15	0	0	7615
11373	0	9	0	7881	0	7890
11374	19	0	7788	0	0	7807
11375	1	0	8032	0	0	8033
11376	6	8	3	8206	0	8223
11377	2	0	8217	0	0	8219
11378	1	8217	0	0	0	8218
11379	0	15	0	8245	0	8260
11380	8302	0	6	2	0	8310
11381	5	0	8297	0	0	8302
11382	6	0	8246	3	0	8255
11383	8140	0	15	1	0	8156
11384	1	0	8186	1	0	8188
11385	7369	1	12	4	0	7386
11386	10	0	7548	0	0	7558
11387	0	8	3	7261	0	7272
11388	3	0	7300	0	0	7303
11389	0	12	1	7384	0	7397
11390	3	1	7143	3	0	7150
11391	5	0	7156	2	0	7163
11392	7069	1	12	1	0	7083
11393	2	7086	0	0	0	7088
11394	7048	0	13	0	0	7061
11395	1	7342	0	1	0	7344
11396	0	14	1	7209	0	7224
11397	0	9	0	7245	0	7254
11398	7266	0	2	0	0	7268
11399	1	12	0	7290	0	7303
11400	2	0	7209	0	0	7211
11401	7251	1	12	2	0	7266
11402	6923	1	15	0	0	6939
11403	0	6	0	7314	0	7320
11404	4	0	6849	1	0	6854
11405	4	24	0	6725	0	6753
11406	0	6585	0	2	0	6587
11407	1	20	1	6273	0	6295
11408	0	17	1	6522	0	6540
11409	1	298	6186	1	0	6486
11410	6561	1	17	0	0	6579
11411	0	6480	0	1	0	6481
11412	6400	0	21	2	0	6423
11413	0	6369	0	4	0	6373
11414	0	14	2	6299	0	6315
11415	0	6447	0	6	0	6453
11416	2	0	6487	0	0	6489
11417	2	14	3	6553	0	6572
11418	1	16	0	6541	0	6558
11419	0	3	0	6424	0	6427
11420	6392	0	2	1	0	6395
11421	1	7	0	6418	0	6426
11422	6362	0	4	1	0	6367
11423	6401	1	9	2	0	6413
11424	6104	2	12	1	0	6119
11425	2	0	6370	0	0	6372
11426	0	11	0	6259	0	6270
11427	1	2	0	6260	0	6263
11428	1	1	1	6257	0	6260
11429	6218	0	3	0	0	6221
11430	1	4	1	6194	0	6200
11431	1	9	1	6224	0	6235
11432	6265	0	4	1	0	6270
11433	0	6	1	6481	0	6488
11434	4	0	6189	0	0	6193
11435	5	0	6249	2	0	6256
11436	1	4	2	6166	0	6173
11437	6094	0	9	0	0	6103
11438	5929	3	15	2	0	5949
11439	0	11	1	5914	0	5926
11440	4	0	6343	0	0	6347
11441	0	6408	0	2	0	6410
11442	0	18	1	6237	0	6256
11443	1	14	2	6239	0	6256
11444	1	5	2	6241	0	6249
11445	6219	5	8	3	0	6235
11446	5	0	6293	2	0	6300
11447	6286	0	31	1	0	6318
11448	0	20	1	6340	0	6361
11449	0	5833	0	6	0	5839
11450	5671	0	17	2	0	5690
11451	5619	0	11	3	0	5633
11452	1	0	5497	0	0	5498
11453	1	5362	0	4	0	5367
11454	0	5436	0	5	0	5441
11455	5472	0	6	1	0	5479
11456	0	10	0	5457	0	5467
11457	3	31	0	5417	0	5451
11458	2	15	1	5439	0	5457
11459	0	5495	0	4	0	5499
11460	0	5306	0	2	0	5308
11461	5305	1	5	0	0	5311
11462	0	11	0	5202	0	5213
11463	0	0	5170	2	0	5172
11464	1	9	0	5151	0	5161
11465	2	0	5084	2	0	5088
11466	5	0	5136	1	0	5142
11467	3	1	5189	1	0	5194
11468	0	5273	0	3	0	5276
11469	4	11	0	5176	0	5191
11470	0	5281	0	1	0	5282
11471	0	9	0	5288	0	5297
11472	0	4	1	5703	0	5708
11473	5665	0	2	1	0	5668
11474	0	3	0	5681	0	5684
11475	5609	0	0	0	0	5609
11476	5585	0	10	1	0	5596
11477	1	15	0	5554	0	5570
11478	0	5486	0	0	0	5486
11479	1	20	0	4997	0	5018
11480	0	5088	0	2	0	5090
11481	0	18	1	5087	0	5106
11482	3	0	5118	1	0	5122
11483	2	13	0	5430	0	5445
11484	1	5	0	5640	0	5646
11485	5676	0	3	0	0	5679
11486	0	5722	0	0	0	5722
11487	0	17	1	5711	0	5729
11488	0	5	0	5753	0	5758
11489	1	5752	0	3	0	5756
11490	0	6	0	5755	0	5761
11491	5742	0	5	0	0	5747
11492	5736	0	9	0	0	5745
11493	0	5693	0	3	0	5696
11494	0	7	0	5790	0	5797
11495	5782	0	4	1	0	5787
11496	0	5796	0	2	0	5798
11497	1	14	2	5739	0	5756
11498	0	5780	1	0	0	5781
11499	5650	0	15	3	0	5668
11500	0	0	5797	1	0	5798
11501	1	1	5776	0	0	5778
11502	1	18	0	5734	0	5753
11503	4	0	5643	1	0	5648
11504	1	9	0	5792	0	5802
11505	5897	0	7	2	0	5906
11506	3	0	5963	0	0	5966
11507	2	27	1	5923	0	5953
11508	0	12	0	5919	0	5931
11509	5637	2	3	2	0	5644
11510	0	5519	1	2	0	5522
11511	5522	0	7	2	0	5531
11512	5516	0	8	0	0	5524
11513	0	5130	0	1	0	5131
11514	1	13	0	4887	0	4901
11515	2	0	4966	0	0	4968
11516	1	14	1	5140	0	5156
11517	2	5146	0	1	0	5149
11518	5353	1	7	0	0	5361
11519	1	14	0	5347	0	5362
11520	4	0	5402	0	0	5406
11521	1	24	7	5389	0	5421
11522	2	3	0	5345	0	5350
11523	0	15	0	5506	0	5521
11524	1	2	1	5458	0	5462
11525	1	5	1	5699	0	5706
11526	0	0	5691	1	0	5692
11527	5	1	5549	0	0	5555
11528	1	5705	1	9	0	5716
11529	1	5683	0	3	0	5687
11530	5598	0	12	2	0	5612
11531	3	0	5638	0	0	5641
11532	5909	2	14	5	0	5930
11533	3	0	6056	0	0	6059
11534	3	1	6182	0	0	6186
11535	0	10	0	6209	0	6219
11536	6196	0	5	0	0	6201
11537	0	13	0	6212	0	6225
11538	4	8	0	6216	0	6228
11539	2	0	6530	0	0	6532
11540	2	48	1	6504	0	6555
11541	0	16	0	6531	0	6547
11542	0	11	0	6437	0	6448
11543	1	14	0	6346	0	6361
11544	0	6	0	6371	0	6377
11545	6340	0	3	2	0	6345
11546	4	5	0	5939	0	5948
11547	2	0	5954	2	0	5958
11548	0	51	1	5524	0	5576
11549	18	0	5733	0	0	5751
11550	1	24	0	5798	0	5823
11551	3	0	5953	0	0	5956
11552	3	13	1	5951	0	5968
11553	1	10	1	5865	0	5877
11554	9	0	5860	1	0	5870
11555	5788	1	21	2	0	5812
11556	20	0	5839	0	0	5859
11557	1	4	1	5902	0	5908
11558	5583	0	4	0	0	5587
11559	2	10	1	5564	0	5577
11560	2	5	0	5375	0	5382
11561	2	0	5324	5	0	5331
11562	1	5530	0	20	0	5551
11563	1	5477	0	1	0	5479
11564	0	5448	0	5	0	5453
11565	1	7	0	5274	0	5282
11566	5373	0	4	0	0	5377
11567	1	5	0	5401	0	5407
11568	1	9	0	5419	0	5429
11569	5	19	0	5370	0	5394
11570	0	9	1	5234	0	5244
11571	2	5343	0	0	0	5345
11572	0	17	0	5316	0	5333
11573	0	5	0	5344	0	5349
11574	1	5333	1	1	0	5336
11575	5233	0	14	1	0	5248
11576	0	21	0	5139	0	5160
11577	5088	0	6	0	0	5094
11578	5126	0	14	0	0	5140
11579	0	4990	0	2	0	4992
11580	0	7	0	4904	0	4911
11581	3	1	5078	1	0	5083
11582	1	0	5326	0	0	5327
11583	0	7	0	5350	0	5357
11584	5334	0	5	0	0	5339
11585	5527	1	11	1	0	5540
11586	0	5	0	5539	0	5544
11587	5608	1	4	0	0	5613
11588	0	5588	0	2	0	5590
11589	5405	0	7	1	0	5413
11590	1	5518	0	2	0	5521
11591	0	20	0	5259	0	5279
11592	1	1	0	5571	0	5573
11593	1	5553	0	1	0	5555
11594	5320	0	8	0	0	5328
11595	1	0	5547	0	0	5548
11596	1	13	0	5474	0	5488
11597	0	0	5909	0	0	5909
11598	1	5	0	5935	0	5941
11599	5781	1	6	1	0	5789
11600	0	3	1	5794	0	5798
11601	5550	0	9	2	0	5561
11602	5601	0	7	1	0	5609
11603	0	6	0	5644	0	5650
11604	0	0	5478	1	0	5479
11605	0	5705	0	5	0	5710
11606	1	7	0	5328	0	5336
11607	5459	1	6	0	0	5466
11608	0	0	5536	1	0	5537
11609	1	12	0	5450	0	5463
11610	2	37	0	5314	0	5353
11611	2	4	0	5321	0	5327
11612	5279	0	0	0	0	5279
11613	1	3	1	5300	0	5305
11614	0	9	0	5292	0	5301
11615	1	0	5034	0	0	5035
11616	1	12	0	4988	0	5001
11617	1	10	0	5183	0	5194
11618	0	7	0	5199	0	5206
11619	0	5184	0	1	0	5185
11620	1	9	0	5147	0	5157
11621	0	6	1	5176	0	5183
11622	5146	1	3	0	0	5150
11623	6	0	5180	0	0	5186
11624	3	1	5260	3	0	5267
11625	0	5157	0	4	0	5161
11626	1	9	0	5092	0	5102
11627	5310	0	6	1	0	5317
11628	1	8	2	5433	0	5444
11629	0	7	0	5436	0	5443
11630	0	3	0	5470	0	5473
11631	0	10	0	5493	0	5503
11632	0	9	2	5376	0	5387
11633	2	0	5387	1	0	5390
11634	0	4	1	5426	0	5431
11635	5482	1	4	0	0	5487
11636	2	5437	0	2	0	5441
11637	1	8	1	5251	0	5261
11638	0	21	1	5279	0	5301
11639	1	0	5296	0	0	5297
11640	1	6	1	5383	0	5391
11641	0	3	0	5583	0	5586
11642	5523	2	10	0	0	5535
11643	0	5548	0	0	0	5548
11644	0	5	0	5642	0	5647
11645	2	15	0	5625	0	5642
11646	1	107	2	5588	0	5698
11647	2	0	5501	6	0	5509
11648	2	0	5522	3	0	5527
11649	2	5545	0	5	0	5552
11650	1	5538	1	3	0	5543
11651	1	11	0	5633	0	5645
11652	0	5925	0	1	0	5926
11653	2	33	2	6168	0	6205
11654	0	7	0	6480	0	6487
11655	1	10	0	6409	0	6420
11656	0	6	0	6339	0	6345
11657	2	1	6180	1	0	6184
11658	1	15	4	6094	0	6114
11659	2	11	0	6106	0	6119
11660	1	8	0	6198	0	6207
11661	6004	0	10	2	0	6016
11662	0	5967	0	2	0	5969
11663	2	9	0	6013	0	6024
11664	1	6013	0	2	0	6016
11665	5966	0	13	0	0	5979
11666	5835	0	15	1	0	5851
11667	0	5690	0	6	0	5696
11668	3	5682	0	6	0	5691
11669	5	2	5701	2	0	5710
11670	0	5543	0	2	0	5545
11671	0	5	1	5666	0	5672
11672	6271	0	10	1	0	6282
11673	0	5857	0	0	0	5857
11674	0	16	0	5806	0	5822
11675	0	7	0	5818	0	5825
11676	0	4	0	5914	0	5918
11677	5868	1	9	0	0	5878
11678	0	0	5851	1	0	5852
11679	5919	1	11	0	0	5931
11680	0	5787	0	1	0	5788
11681	3	23	1	5428	0	5455
11682	2	0	5509	1	0	5512
11683	5526	1	8	0	0	5535
11684	0	5760	0	2	0	5762
11685	3	12	0	5653	0	5668
11686	0	5760	1	1	0	5762
11687	0	46	1	5692	0	5739
11688	0	2	2	5982	0	5986
11689	4	0	5964	1	0	5969
11690	0	0	6170	0	0	6170
11691	2	3	0	6131	0	6136
11692	0	0	6250	0	0	6250
11693	0	25	3	6249	0	6277
11694	0	8	0	6257	0	6265
11695	0	2	0	6312	0	6314
11696	6321	1	8	0	0	6330
11697	0	8	1	6380	0	6389
11698	0	1	6394	0	0	6395
11699	6307	0	11	3	0	6321
11700	3	11	1	6266	0	6281
11701	0	1	1	6154	0	6156
11702	6203	1	4	2	0	6210
11703	0	5980	0	1	0	5981
11704	1	6	1	5921	0	5929
11705	0	5	0	5940	0	5945
11706	5896	0	6	0	0	5902
11707	1	0	6058	0	0	6059
11708	0	8	0	6195	0	6203
11709	0	10	0	6114	0	6124
11710	0	13	0	6115	0	6128
11711	0	6072	0	0	0	6072
11712	0	6	0	6062	0	6068
11713	6168	0	11	2	0	6181
11714	0	6143	0	2	0	6145
11715	6061	0	12	0	0	6073
11716	1	6054	0	5	0	6060
11717	5831	0	11	2	0	5844
11718	0	0	5895	1	0	5896
11719	0	0	5936	1	0	5937
11720	6071	2	9	0	0	6082
11721	0	0	6331	0	0	6331
11722	3	8	0	6248	0	6259
11723	2	9	0	6169	0	6180
11724	0	2	0	6254	0	6256
11725	6280	0	9	0	0	6289
11726	1	0	6321	2	0	6324
11727	6228	1	16	1	0	6246
11728	0	4	0	6005	0	6009
11729	5820	0	2	0	0	5822
11730	1	4	0	5592	0	5597
11731	5588	0	4	0	0	5592
11732	0	9	0	5588	0	5597
11733	1	0	5583	0	0	5584
11734	5439	1	9	1	0	5450
11735	5432	2	1	0	0	5435
11736	1	8	2	5388	0	5399
11737	1	10	0	5341	0	5352
11738	1	5471	0	0	0	5472
11739	5411	1	9	1	0	5422
11740	2	5412	0	1	0	5415
11741	5368	0	16	1	0	5385
11742	0	0	5344	0	0	5344
11743	5	0	5361	2	0	5368
11744	1	0	5494	0	0	5495
11745	5459	1	4	4	0	5468
11746	1	4961	0	10	0	4972
11747	2	5	0	4889	0	4896
11748	5110	1	7	0	0	5118
11749	0	5120	1	1	0	5122
11750	0	10	0	5103	0	5113
11751	0	5103	0	4	0	5107
11752	2	5021	0	2	0	5025
11753	0	4953	0	5	0	4958
11754	4974	0	7	2	0	4983
11755	4	5074	0	2	0	5080
11756	1	5030	0	7	0	5038
11757	2	5045	0	1	0	5048
11758	5053	0	4	0	0	5057
11759	5030	0	13	0	0	5043
11760	0	0	5035	1	0	5036
11761	5097	0	7	1	0	5105
11762	5130	0	7	0	0	5137
11763	0	4	0	5149	0	5153
11764	4856	0	4	0	0	4860
11765	2	0	5019	2	0	5023
11766	1	5205	0	3	0	5209
11767	5273	0	6	0	0	5279
11768	1	2	0	5157	0	5160
11769	4842	0	15	0	0	4857
11770	1	0	4837	2	0	4840
11771	4948	0	13	0	0	4961
11772	0	11	0	4922	0	4933
11773	3	0	4846	1	0	4850
11774	3	5134	2	3	0	5142
11775	1	5269	0	1	0	5271
11776	0	10	0	5288	0	5298
11777	1	14	0	5286	0	5301
11778	0	5207	0	0	0	5207
11779	5211	0	5	1	0	5217
11780	5220	0	6	0	0	5226
11781	5237	2	16	1	0	5256
11782	0	5076	0	0	0	5076
11783	3	16	2	4911	0	4932
11784	2	4962	0	2	0	4966
11785	4991	0	11	0	0	5002
11786	5243	0	13	0	0	5256
11787	0	5377	0	0	0	5377
11788	5382	0	5	1	0	5388
11789	0	6	0	5284	0	5290
11790	0	5	2	5320	0	5327
11791	5383	0	2	0	0	5385
11792	5331	0	7	1	0	5339
11793	5377	0	9	0	0	5386
11794	0	2	0	5266	0	5268
11795	0	11	0	5103	0	5114
11796	2	0	5090	0	0	5092
11797	3	11	1	4922	0	4937
11798	4	4	0	4941	0	4949
11799	0	0	4936	2	0	4938
11800	3	0	4865	2	0	4870
11801	1	0	5053	1	0	5055
11802	0	10	0	5247	0	5257
11803	2	0	5240	0	0	5242
11804	0	7	0	5243	0	5250
11805	0	1	15	5192	0	5208
11806	4	0	5104	0	0	5108
11807	7	1	5202	1	0	5211
11808	2	4	0	5393	0	5399
11809	1	0	5363	0	0	5364
11810	7	0	5293	2	0	5302
11811	1	5268	0	7	0	5276
11812	5299	0	10	1	0	5310
11813	5372	0	13	0	0	5385
11814	5292	0	16	0	0	5308
11815	0	5345	0	1	0	5346
11816	1	5271	0	2	0	5274
11817	0	4	0	5257	0	5261
11818	0	7	1	5276	0	5284
11819	0	0	5378	0	0	5378
11820	0	6	0	5321	0	5327
11821	5375	0	15	1	0	5391
11822	3	9	0	5338	0	5350
11823	1	5192	0	2	0	5195
11824	5149	1	8	0	0	5158
11825	5168	0	2	0	0	5170
11826	5182	1	22	0	0	5205
11827	2	0	5212	1	0	5215
11828	1	4	0	5172	0	5177
11829	5129	0	4	0	0	5133
11830	2	0	5119	2	0	5123
11831	2	5422	0	3	0	5427
11832	3	5352	0	3	0	5358
11833	5353	0	9	1	0	5363
11834	0	5209	0	1	0	5210
11835	0	12	0	5151	0	5163
11836	0	0	5308	0	0	5308
11837	0	6	0	5624	0	5630
11838	5605	0	9	0	0	5614
11839	0	5549	0	2	0	5551
11840	5161	0	14	1	0	5176
11841	3	0	5482	0	0	5485
11842	2	12	1	5522	0	5537
11843	2	5547	0	4	0	5553
11844	1	8	2	5566	0	5577
11845	5442	0	0	0	0	5442
11846	5409	0	8	0	0	5417
11847	5417	0	11	0	0	5428
11848	5569	1	16	1	0	5587
11849	0	1	1	5564	0	5566
11850	1	2	5096	1	0	5100
11851	1	30	2	5134	0	5167
11852	4	5157	0	2	0	5163
11853	5125	0	15	0	0	5140
11854	1	0	5280	0	0	5281
11855	5331	0	2	0	0	5333
11856	0	8	1	5329	0	5338
11857	9	0	5360	0	0	5369
11858	1	6	1	5347	0	5355
11859	5331	0	9	0	0	5340
11860	5296	0	15	2	0	5313
11861	5267	0	10	3	0	5280
11862	0	0	5158	0	0	5158
11863	1	6	4	5158	0	5169
11864	2	0	5127	0	0	5129
11865	4	5139	2	4	0	5149
11866	5232	1	15	4	0	5252
11867	0	5257	0	1	0	5258
11868	5249	0	11	1	0	5261
11869	0	6	0	5510	0	5516
11870	2	5541	0	0	0	5543
11871	5413	0	9	1	0	5423
11872	1	0	5429	0	0	5430
11873	0	6	1	5484	0	5491
11874	5438	1	9	3	0	5451
11875	1	0	5559	0	0	5560
11876	9	3	0	5742	0	5754
11877	0	5661	0	3	0	5664
11878	8	6	0	5343	0	5357
11879	0	6	0	5354	0	5360
11880	5496	0	12	0	0	5508
11881	0	5395	0	0	0	5395
11882	4	11	0	5382	0	5397
11883	1	5362	0	1	0	5364
11884	3	10	0	5147	0	5160
11885	2	5222	1	0	0	5225
11886	5213	0	4	0	0	5217
11887	0	0	5269	0	0	5269
11888	0	9	0	5376	0	5385
11889	2	3	0	5281	0	5286
11890	0	8	1	5261	0	5270
11891	1	14	0	5208	0	5223
11892	1	1	5223	0	0	5225
11893	0	5393	0	6	0	5399
11894	5394	0	9	3	0	5406
11895	5248	0	18	1	0	5267
11896	0	5206	0	1	0	5207
11897	5171	0	13	0	0	5184
11898	5470	0	5	1	0	5476
11899	0	5382	0	2	0	5384
11900	2	3	1	5351	0	5357
11901	0	5342	0	4	0	5346
11902	5303	2	14	1	0	5320
11903	2	0	5531	0	0	5533
11904	5724	3	10	0	0	5737
11905	1	0	5813	1	0	5815
11906	0	4	0	5823	0	5827
11907	5375	0	7	32	0	5414
11908	0	0	5412	0	0	5412
11909	5474	0	16	2	0	5492
11910	5569	0	14	0	0	5583
11911	2	24	0	5522	0	5548
11912	0	5093	0	1	0	5094
11913	5084	0	3	1	0	5088
11914	0	15	0	4952	0	4967
11915	0	5071	0	2	0	5073
11916	5067	0	6	3	0	5076
11917	1	14	0	4779	0	4794
11918	0	4799	0	3	0	4802
11919	1	3	0	4747	0	4751
11920	4764	0	5	0	0	4769
11921	4753	0	4	1	0	4758
11922	4788	0	5	1	0	4794
11923	0	5	1	4800	0	4806
11924	1	0	548	4098	0	4647
11925	1	0	4627	0	0	4628
11926	0	15	1	4379	0	4395
11927	1	0	4369	0	0	4370
11928	2	0	4442	2	0	4446
11929	3	0	4447	1	0	4451
11930	0	4344	0	3	0	4347
11931	1	4	1	4342	0	4348
11932	0	4404	0	4	0	4408
11933	4457	1	5	0	0	4463
11934	4457	0	20	0	0	4477
11935	1	6	0	4470	0	4477
11936	2	0	4512	0	0	4514
11937	3	7	0	4301	0	4311
11938	2	0	4248	1	0	4251
11939	2	8	0	4329	0	4339
11940	1	4274	0	2	0	4277
11941	0	4312	0	2	0	4314
11942	4255	0	9	0	0	4264
11943	1	0	4214	2	0	4217
11944	2	5	0	4296	0	4303
11945	0	7	0	3980	0	3987
11946	3992	0	8	0	0	4000
11947	0	3913	0	1	0	3914
11948	3879	2	15	1	0	3897
11949	0	3916	0	0	0	3916
11950	3700	0	16	2	0	3718
11951	3668	0	12	0	0	3680
11952	1	5	0	3526	0	3532
11953	2	0	3575	0	0	3577
11954	3577	0	83	2	0	3662
11955	0	3629	0	2	0	3631
11956	3544	0	12	2	0	3558
11957	1	4	0	3591	0	3596
11958	1	7	0	3624	0	3632
11959	2	3761	0	0	0	3763
11960	1	10	0	3671	0	3682
11961	0	3694	0	1	0	3695
11962	3	8	0	3591	0	3602
11963	0	1	0	3727	0	3728
11964	3700	1	5	2	0	3708
11965	4	0	3788	0	0	3792
11966	0	4101	0	4	0	4105
11967	0	1	0	4212	0	4213
11968	4156	0	4	1	0	4161
11969	4154	1	6	0	0	4161
11970	4265	0	15	1	0	4281
11971	0	0	4327	0	0	4327
11972	4365	0	6	0	0	4371
11973	0	3	0	4495	0	4498
11974	4233	1	7	1	0	4242
11975	0	4349	0	1	0	4350
11976	2	7	0	4336	0	4345
11977	4537	1	8	0	0	4546
11978	1	4259	0	5	0	4265
11979	0	9	2	4046	0	4057
11980	1	2	4055	2	0	4060
11981	4014	0	5	3	0	4022
11982	3993	1	13	0	0	4007
11983	1	0	4008	0	0	4009
11984	0	3925	0	5	0	3930
11985	1	3916	0	1	0	3918
11986	1	10	0	3805	0	3816
11987	0	8	0	3841	0	3849
11988	0	0	1	3844	0	3845
11989	1	0	3870	0	0	3871
11990	3886	0	16	1	0	3903
11991	3819	0	3	0	0	3822
11992	3848	1	3	0	0	3852
11993	3662	0	4	0	0	3666
11994	3654	0	11	0	0	3665
11995	3661	0	9	0	0	3670
11996	0	7	1	3639	0	3647
11997	0	0	3639	0	0	3639
11998	1	0	3742	0	0	3743
11999	3	9	2	3721	0	3735
12000	0	4	0	3805	0	3809
12001	0	11	0	3777	0	3788
12002	1	3808	0	0	0	3809
12003	3822	0	12	0	0	3834
12004	0	3730	0	1	0	3731
12005	0	7	0	3819	0	3826
12006	3862	0	6	0	0	3868
12007	0	3754	0	0	0	3754
12008	0	10	0	3709	0	3719
12009	0	7	1	3735	0	3743
12010	1	2	0	3764	0	3767
12011	1	3708	0	0	0	3709
12012	0	2	0	3704	0	3706
12013	0	0	3720	0	0	3720
12014	0	4	1	3708	0	3713
12015	0	11	0	3716	0	3727
12016	1	5	0	3932	0	3938
12017	0	4	0	3999	0	4003
12018	1	0	3976	0	0	3977
12019	0	3981	0	1	0	3982
12020	0	4	2	3928	0	3934
12021	0	7	0	3921	0	3928
12022	2	5	8	3925	0	3940
12023	0	3981	1	2	0	3984
12024	0	4125	0	0	0	4125
12025	4165	0	14	2	0	4181
12026	0	2	0	4212	0	4214
12027	7	0	4153	0	0	4160
12028	1	4104	0	2	0	4107
12029	4071	0	5	0	0	4076
12030	1	0	4411	2	0	4414
12031	1	0	4430	2	0	4433
12032	2	0	5727	0	0	5729
12033	1	6	2	5686	0	5695
12034	8	0	6174	1	0	6183
12035	0	6440	0	5	0	6445
12036	1	10	0	6491	0	6502
12037	1	0	6609	0	0	6610
12038	0	7	0	6773	0	6780
12039	6758	0	7	0	0	6765
12040	3	0	7152	0	0	7155
12041	6840	1	17	2	0	6860
12042	0	6938	0	2	0	6940
12043	6861	0	19	1	0	6881
12044	0	20	0	7211	0	7231
12045	7258	0	12	2	0	7272
12046	7279	0	8	4	0	7291
12047	7298	3	24	0	0	7325
12048	0	7430	1	2	0	7433
12049	7294	0	9	0	0	7303
12050	7259	1	25	0	0	7285
12051	11	1	7237	0	0	7249
12052	0	7235	0	1	0	7236
12053	1	22	1	7348	0	7372
12054	3	16	0	7400	0	7419
12055	0	20	0	7411	0	7431
12056	0	0	7551	2	0	7553
12057	0	12	2	7645	0	7659
12058	2	1	7703	1	0	7707
12059	7732	0	16	3	0	7751
12060	7677	1	13	1	0	7692
12061	1	0	7715	0	0	7716
12062	7695	3	21	2	0	7721
12063	7874	0	15	1	0	7890
12064	8042	2	28	0	0	8072
12065	0	12	5	8167	0	8184
12066	3	0	8189	2	0	8194
12067	1	8311	1	2	0	8315
12068	6	17	0	8277	0	8300
12069	6	0	8356	0	0	8362
12070	6	0	8338	2	0	8346
12071	8425	0	13	4	0	8442
12072	0	8584	0	3	0	8587
12073	8495	0	20	3	0	8518
12074	8506	1	14	1	0	8522
12075	2	8535	0	3	0	8540
12076	8447	3	12	1	0	8463
12077	7	0	8542	0	0	8549
12078	7	0	8659	10	0	8676
12079	12	1	8741	1	0	8755
12080	1	8794	0	1	0	8796
12081	8697	0	20	0	0	8717
12082	8993	2	25	0	0	9020
12083	0	9378	0	4	0	9382
12084	1	9705	0	4	0	9710
12085	4	25	1	10014	0	10044
12086	2	10	1	10023	0	10036
12087	10022	0	9	1	0	10032
12088	0	9979	0	5	0	9984
12089	9973	0	23	0	0	9996
12090	10130	1	24	1	0	10156
12091	1	1	10412	0	0	10414
12092	0	10416	0	8	0	10424
12093	0	17	0	10249	0	10266
12094	10251	2	12	0	0	10265
12095	1	11	0	10676	0	10688
12096	10620	0	9	1	0	10630
12097	11	0	10791	1	0	10803
12098	1	10929	0	8	0	10938
12099	2	10989	1	8	0	11000
12100	6	26	0	10755	0	10787
12101	2	10798	0	7	0	10807
12102	10767	2	11	4	0	10784
12103	4	0	10937	0	0	10941
12104	11383	1	29	5	0	11418
12105	7	1	11783	0	0	11791
12106	1	47	10	11279	0	11337
12107	5	12	0	11341	0	11358
12108	0	6	0	10250	0	10256
12109	10200	1	13	0	0	10214
12110	1	0	9775	3	0	9779
12111	3	25	1	9413	0	9442
12112	4	19	1	9695	0	9719
12113	2	9997	0	4	0	10003
12114	1	9787	0	5	0	9793
12115	2	9587	0	12	0	9601
12116	0	17	1	9605	0	9623
12117	3	30	1	9609	0	9643
12118	2	9734	0	5	0	9741
12119	3	9289	0	5	0	9297
12120	9717	2	16	1	0	9736
12121	1	23	3	9701	0	9728
12122	0	9641	0	1	0	9642
12123	9753	2	36	1	0	9792
12124	0	11	0	9742	0	9753
12125	9777	1	4	2	0	9784
12126	0	28	0	9709	0	9737
12127	4	0	9540	1	0	9545
12128	2	9551	0	7	0	9560
12129	9309	0	22	0	0	9331
12130	6	0	9488	1	0	9495
12131	1	9378	0	44	0	9423
12132	0	46	3	9443	0	9492
12133	1	20	1	9495	0	9517
12134	1	18	0	9498	0	9517
12135	1	17	1	9498	0	9517
12136	9	0	9483	0	0	9492
12137	2	9517	0	4	0	9523
12138	0	12	2	9523	0	9537
12139	9342	3	12	0	0	9357
12140	0	9073	0	3	0	9076
12141	1	18	3	8916	0	8938
12142	9	2	9147	1	0	9159
12143	0	9483	0	8	0	9491
12144	7	24	5	9318	0	9354
12145	2	9635	0	7	0	9644
12146	9568	2	98	0	0	9668
12147	9646	1	19	3	0	9669
12148	2	0	9484	0	0	9486
12149	9538	1	27	3	0	9569
12150	9401	1	54	2	0	9458
12151	9	0	9553	1	0	9563
12152	0	9682	0	4	0	9686
12153	3	25	0	9634	0	9662
12154	0	7	2	9656	0	9665
12155	9728	1	28	1	0	9758
12156	5	11	1	9701	0	9718
12157	1	0	9842	1	0	9844
12158	9432	1	21	2	0	9456
12159	6	0	9110	3	0	9119
12160	2	8713	0	4	0	8719
12161	8405	0	10	1	0	8416
12162	3	0	8718	3	0	8724
12163	6	1	8783	2	0	8792
12164	2	8165	2	4	0	8173
12165	0	25	2	8160	0	8187
12166	7	0	8293	0	0	8300
12167	3	25	1	8282	0	8311
12168	2	16	2	8597	0	8617
12169	12	1	8885	1	0	8899
12170	1	8966	0	5	0	8972
12171	1	13	0	8570	0	8584
12172	8501	0	11	3	0	8515
12173	8209	2	10	0	0	8221
12174	2	8	0	8280	0	8290
12175	3	0	8140	0	0	8143
12176	3	0	8134	0	0	8137
12177	0	11	0	7743	0	7754
12178	2	0	7625	7	0	7634
12179	7655	0	3	4	0	7662
12180	0	18	1	8041	0	8060
12181	0	14	0	7864	0	7878
12182	0	7921	0	5	0	7926
12183	0	14	2	7917	0	7933
12184	5	1	7941	0	0	7947
12185	7824	1	7	5	0	7837
12186	7672	2	16	4	0	7694
12187	3	0	7796	0	0	7799
12188	2	12	1	7413	0	7428
12189	0	30	0	7018	0	7048
12190	2	0	7124	0	0	7126
12191	1	90	1	6892	0	6984
12192	1	21	1	6936	0	6959
12193	0	6882	0	0	0	6882
12194	0	27	1	6843	0	6871
12195	5	3	0	6887	0	6895
12196	6514	1	3	1	0	6519
12197	6465	1	15	18	0	6499
12198	6452	2	22	1	0	6477
12199	6268	1	17	1	0	6287
12200	6211	0	29	2	0	6242
12201	4	0	6370	0	0	6374
12202	2	10	0	6436	0	6448
12203	0	8	2	6450	0	6460
12204	5	0	6533	0	0	6538
12205	6501	1	14	2	0	6518
12206	6316	0	12	2	0	6330
12207	4	0	6296	0	0	6300
12208	6164	1	8	1	0	6174
12209	6167	0	11	2	0	6180
12210	5	0	6790	1	0	6796
12211	0	35	2	6750	0	6787
12212	0	6980	0	1	0	6981
12213	1	27	1	7040	0	7069
12214	0	15	1	7141	0	7157
12215	1	25	1	7146	0	7173
12216	2	1	7203	2	0	7208
12217	7143	2	34	0	0	7179
12218	7115	1	12	0	0	7128
12219	5	15	0	6876	0	6896
12220	35	0	6827	1	0	6863
12221	3	12	0	6731	0	6746
12222	8	0	6889	21	0	6918
12223	5	1	6882	1	0	6889
12224	1	6840	1	3	0	6845
12225	2	10	1	7079	0	7092
12226	7097	0	6	3	0	7106
12227	6946	0	8	1	0	6955
12228	7005	0	6	0	0	7011
12229	1	15	0	7022	0	7038
12230	0	6891	0	3	0	6894
12231	1	20	0	6816	0	6837
12232	1	0	7020	2	0	7023
12233	7896	0	24	0	0	7920
12234	7944	0	9	0	0	7953
12235	1	15	2	7943	0	7961
12236	1	19	0	7897	0	7917
12237	3	14	1	7914	0	7932
12238	6	0	7595	2	0	7603
12239	7667	0	11	3	0	7681
12240	1	7618	0	4	0	7623
12241	2	7381	0	47	0	7430
12242	13	0	7506	1	0	7520
12243	5	33	0	8279	0	8317
12244	7	0	7980	0	0	7987
12245	7818	0	16	1	0	7835
12246	0	5	0	7797	0	7802
12247	8	1	7740	0	0	7749
12248	3	7936	0	3	0	7942
12249	7899	0	27	3	0	7929
12250	5	0	7998	1	0	8004
12251	0	7995	0	6	0	8001
12252	2	8062	0	3	0	8067
12253	8178	1	11	1	0	8191
12254	4	12	0	8221	0	8237
12255	5	0	7941	3	0	7949
12256	6	7621	0	4	0	7631
12257	7651	0	10	2	0	7663
12258	7810	2	12	1	0	7825
12259	1	7669	0	3	0	7673
12260	10	0	7681	0	0	7691
12261	0	10	1	7658	0	7669
12262	7659	1	10	1	0	7671
12263	7667	0	11	5	0	7683
12264	4	0	7781	1	0	7786
12265	0	12	1	7733	0	7746
12266	0	16	0	7645	0	7661
12267	1	0	7636	0	0	7637
12268	5	0	7712	1	0	7718
12269	7917	1	12	0	0	7930
12270	7976	0	19	0	0	7995
12271	7993	0	14	2	0	8009
12272	7913	5	45	4	0	7967
12273	0	0	7971	0	0	7971
12274	8028	0	21	1	0	8050
12275	2	13	3	8015	0	8033
12276	2	0	7936	0	0	7938
12277	3	1	7777	2	0	7783
12278	3	8031	0	6	0	8040
12279	0	20	0	8082	0	8102
12280	6	3	8222	2	0	8233
12281	8430	0	16	5	0	8451
12282	2	18	0	8566	0	8586
12283	0	8610	0	1	0	8611
12284	8596	1	12	4	0	8613
12285	8777	0	58	2	0	8837
12286	4	0	8395	0	0	8399
12287	3	8285	0	2	0	8290
12288	2	9	0	8297	0	8308
12289	8231	0	4	0	0	8235
12290	0	17	0	8104	0	8121
12291	12	0	8109	2	0	8123
12292	8373	1	10	2	0	8386
12293	6	8617	0	1	0	8624
12294	2	8417	0	4	0	8423
12295	4	8303	0	3	0	8310
12296	8272	2	9	2	0	8285
12297	8266	1	28	1	0	8296
12298	8385	0	13	0	0	8398
12299	0	17	1	9020	0	9038
12300	4	0	9383	0	0	9387
12301	2	20	0	9110	0	9132
12302	9095	0	5	1	0	9101
12303	2	5	0	9029	0	9036
12304	8939	0	9	3	0	8951
12305	9058	1	12	0	0	9071
12306	9048	3	18	1	0	9070
12307	1	8895	0	9	0	8905
12308	7983	3	6	0	0	7992
12309	4	0	8475	0	0	8479
12310	4	1	8500	1	0	8506
12311	2	8533	0	7	0	8542
12312	0	19	1	8560	0	8580
12313	8519	0	8	4	0	8531
12314	3	1	8691	0	0	8695
12315	8759	0	16	1	0	8776
12316	6	27	1	8802	0	8836
12317	2	8695	0	1	0	8698
12318	0	21	0	8148	0	8169
12319	1	1	8298	0	0	8300
12320	8235	2	22	6	0	8265
12321	4	0	8271	0	0	8275
12322	6	0	8244	1	0	8251
12323	8249	0	12	2	0	8263
12324	2	8262	0	0	0	8264
12325	8181	1	33	0	0	8215
12326	8005	0	19	1	0	8025
12327	7	0	8012	1	0	8020
12328	7880	1	15	2	0	7898
12329	5	0	7973	0	0	7978
12330	5	0	7851	1	0	7857
12331	6	0	8051	3	0	8060
12332	0	8250	0	2	0	8252
12333	8232	0	15	1	0	8248
12334	8158	0	25	0	0	8183
12335	8172	0	9	0	0	8181
12336	8363	0	18	1	0	8382
12337	2	0	8500	1	0	8503
12338	0	20	0	8499	0	8519
12339	0	10	1	9161	0	9172
12340	9123	0	9	0	0	9132
12341	0	9083	0	2	0	9085
12342	2	30	2	9061	0	9095
12343	9006	2	2	1	0	9011
12344	1	0	9432	1	0	9434
12345	1	14	0	9167	0	9182
12346	13	1	9147	3	0	9164
12347	3	9209	0	2	0	9214
12348	0	18	1	9149	0	9168
12349	9621	0	39	2	0	9662
12350	1	15	1	9669	0	9686
12351	6	0	9644	1	0	9651
12352	0	9666	0	2	0	9668
12353	9342	0	17	4	0	9363
12354	6	0	9439	1	0	9446
12355	9506	0	14	6	0	9526
12356	4	9326	0	8	0	9338
12357	9249	0	30	3	0	9282
12358	9225	1	17	2	0	9245
12359	2	22	0	9255	0	9279
12360	6	0	9557	0	0	9563
12361	2	9260	0	3	0	9265
12362	0	36	0	9133	0	9169
12363	3	47	0	9099	0	9149
12364	2	26	1	9173	0	9202
12365	7	23	0	9426	0	9456
12366	0	9432	2	5	0	9439
12367	9361	1	21	1	0	9384
12368	0	9143	0	2	0	9145
12369	1	16	4	9099	0	9120
12370	9247	1	11	1	0	9260
12371	1	20	0	9317	0	9338
12372	4	0	9733	2	0	9739
12373	1	9010	0	9	0	9020
12374	1	11	0	8913	0	8925
12375	0	15	0	8938	0	8953
12376	8633	0	16	3	0	8652
12377	0	0	8636	0	0	8636
12378	9170	1	19	2	0	9192
12379	9291	2	10	1	0	9304
12380	9129	0	14	1	0	9144
12381	4	0	9130	0	0	9134
12382	2	17	1	9099	0	9119
12383	3	27	6	9105	0	9141
12384	10	0	9349	3	0	9362
12385	5	0	8885	0	0	8890
12386	9345	1	15	2	0	9363
12387	0	5	0	9435	0	9440
12388	9416	1	7	2	0	9426
12389	9693	3	14	3	0	9713
12390	1	17	0	9399	0	9417
12391	3	0	9359	1	0	9363
12392	9250	2	15	3	0	9270
12393	1	23	0	9098	0	9122
12394	14	0	9102	4	0	9120
12395	2	8992	0	5	0	8999
12396	8983	1	19	2	0	9005
12397	1	9165	1	3	0	9170
12398	6	25	0	8954	0	8985
12399	2	9256	0	5	0	9263
12400	9237	0	25	0	0	9262
12401	9305	0	23	5	0	9333
12402	0	9308	2	7	0	9317
12403	9546	4	17	2	0	9569
12404	9721	0	16	1	0	9738
12405	0	9800	1	2	0	9803
12406	9967	0	34	1	0	10002
12407	1	11	1	9981	0	9994
12408	1	17	1	9734	0	9753
12409	9795	2	12	0	0	9809
12410	1	23	0	9602	0	9626
12411	1	9477	0	5	0	9483
12412	9624	0	11	3	0	9638
12413	9687	0	11	4	0	9702
12414	4	9366	0	9	0	9379
12415	9065	0	7	0	0	9072
12416	9346	0	18	1	0	9365
12417	1	24	0	9571	0	9596
12418	5	0	9582	2	0	9589
12419	2	9305	0	2	0	9309
12420	9302	0	15	2	0	9319
12421	9374	1	26	3	0	9404
12422	2	0	9278	1	0	9281
12423	9202	2	36	8	0	9248
12424	14	0	9387	1	0	9402
12425	10348	0	13	7	0	10368
12426	3	29	0	10370	0	10402
12427	4	1	10349	1	0	10355
12428	5	1	10583	2	0	10591
12429	5	112	1	10474	0	10592
12430	4	102	1	10286	0	10393
12431	1	0	10464	0	0	10465
12432	2	27	0	10394	0	10423
12433	9	0	10381	0	0	10390
12434	2	31	0	10538	0	10571
12435	1	14	0	10533	0	10548
12436	3	10578	0	9	0	10590
12437	6	10495	0	7	0	10508
12438	0	10643	0	4	0	10647
12439	0	19	0	10638	0	10657
12440	1	31	0	10753	0	10785
12441	4	0	10495	2	0	10501
12442	10512	0	52	2	0	10566
12443	10888	1	28	2	0	10919
12444	0	11068	1	2	0	11071
12445	10817	0	14	2	0	10833
12446	0	8	1	10950	0	10959
12447	10827	1	10	1	0	10839
12448	10441	0	12	5	0	10458
12449	4	29	0	10481	0	10514
12450	10424	1	7	2	0	10434
12451	4	10437	0	1	0	10442
12452	0	10105	0	7	0	10112
12453	3	73	0	10341	0	10417
12454	1	10826	0	4	0	10831
12455	0	30	3	10756	0	10789
12456	0	13	0	10816	0	10829
12457	10638	0	9	2	0	10649
12458	1	10699	0	2	0	10702
12459	11281	0	17	2	0	11300
12460	11000	2	21	0	0	11023
12461	3	10927	0	6	0	10936
12462	10419	4	13	4	0	10440
12463	5	0	10401	0	0	10406
12464	3	10303	0	3	0	10309
12465	10322	0	13	0	0	10335
12466	6	0	10336	0	0	10342
12467	3	10491	1	2	0	10497
12468	2	10547	1	2	0	10552
12469	10558	2	15	2	0	10577
12470	10990	1	18	0	0	11009
12471	11086	2	15	3	0	11106
12472	2	11244	0	2	0	11248
12473	1	8	1	11152	0	11162
12474	11199	0	12	0	0	11211
12475	10907	0	20	0	0	10927
12476	1	22	1	10931	0	10955
12477	1	0	10899	0	0	10900
12478	11	0	11063	2	0	11076
12479	1	29	1	10936	0	10967
12480	2	20	2	10877	0	10901
12481	4	0	10726	2	0	10732
12482	5	99	1	10373	0	10478
12483	2	10463	0	4	0	10469
12484	10741	4	15	1	0	10761
12485	4	18	0	10877	0	10899
12486	10892	1	10	1	0	10904
12487	8	10847	0	2	0	10857
12488	0	10696	0	6	0	10702
12489	10562	0	12	4	0	10578
12490	0	0	10984	2	0	10986
12491	11092	3	21	2	0	11118
12492	0	11706	1	5	0	11712
12493	0	17	1	11468	0	11486
12494	11492	1	9	2	0	11504
12495	1	12	2	11433	0	11448
12496	11446	2	6	0	0	11454
12497	11572	0	33	0	0	11605
12498	2	11526	0	9	0	11537
12499	10987	0	21	1	0	11009
12500	0	11155	0	2	0	11157
12501	10299	2	18	1	0	10320
12502	0	11	1	10663	0	10675
12503	10747	1	7	1	0	10756
12504	4	3	3	10857	0	10867
12505	10877	0	9	2	0	10888
12506	10857	1	14	3	0	10875
12507	10961	2	9	1	0	10973
12508	10972	2	15	3	0	10992
12509	10951	0	35	1	0	10987
12510	0	7	1	10801	0	10809
12511	10853	1	5	1	0	10860
12512	0	10970	0	2	0	10972
12513	37	1	11014	0	0	11052
12514	3	21	1	11032	0	11057
12515	4	0	11010	4	0	11018
12516	0	12	2	10998	0	11012
12517	21	0	10914	0	0	10935
12518	10973	1	19	5	0	10998
12519	13	26	1	10750	0	10790
12520	8	0	10644	3	0	10655
12521	4	0	11250	5	0	11259
12522	1	17	1	11227	0	11246
12523	11208	0	14	4	0	11226
12524	4	11126	0	5	0	11135
12525	11090	0	15	1	0	11106
12526	11903	0	22	4	0	11929
12527	1	12059	0	2	0	12062
12528	12100	2	28	2	0	12132
12529	0	14	0	11784	0	11798
12530	2	23	0	11315	0	11340
12531	0	6	2	11460	0	11468
12532	11515	0	6	3	0	11524
12533	0	11689	1	3	0	11693
12534	3	31	2	11550	0	11586
12535	0	14	1	11160	0	11175
12536	11194	1	95	1	0	11291
12537	3	45	2	11218	0	11268
12538	7	1	11233	0	0	11241
12539	0	11508	0	10	0	11518
12540	12044	0	23	0	0	12067
12541	4	30	1	11918	0	11953
12542	0	11863	0	17	0	11880
12543	11862	2	25	3	0	11892
12544	6	0	12116	1	0	12123
12545	2	11830	0	7	0	11839
12546	11791	0	17	1	0	11809
12547	0	30	0	11709	0	11739
12548	2	24	1	11462	0	11489
12549	9	1	11538	2	0	11550
12550	6	17	3	11602	0	11628
12551	8	1	11547	6	0	11562
12552	3	1	11501	3	0	11508
12553	5	0	11409	3	0	11417
12554	11538	2	15	3	0	11558
12555	11493	1	23	0	0	11517
12556	11597	0	24	2	0	11623
12557	2	13	0	11627	0	11642
12558	3	11749	0	0	0	11752
12559	1	11649	0	5	0	11655
12560	11690	1	15	2	0	11708
12561	11562	0	10	0	0	11572
12562	1	11520	0	3	0	11524
12563	11502	4	12	1	0	11519
12564	4	0	11816	0	0	11820
12565	1	0	11948	1	0	11950
12566	2	22	4	11458	0	11486
12567	0	9	2	11439	0	11450
12568	3	0	10765	0	0	10768
12569	5	21	0	11250	0	11276
12570	11123	0	20	1	0	11144
12571	3	0	11195	2	0	11200
12572	11366	0	26	3	0	11395
12573	0	10	1	11237	0	11248
12574	11	0	10997	1	0	11009
12575	0	10806	0	6	0	10812
12576	10788	0	34	0	0	10822
12577	0	0	10641	1	0	10642
12578	10567	2	29	2	0	10600
12579	2	18	1	11013	0	11034
12580	10714	0	13	0	0	10727
12581	4	0	10852	0	0	10856
12582	0	7	0	10876	0	10883
12583	10632	0	6	1	0	10639
12584	10623	2	16	1	0	10642
12585	10721	0	17	4	0	10742
12586	10757	1	16	3	0	10777
12587	0	14	0	10788	0	10802
12588	0	16	0	10226	0	10242
12589	0	0	10192	0	0	10192
12590	2	26	0	10048	0	10076
12591	0	25	3	10020	0	10048
12592	1	9881	0	19	0	9901
12593	10029	1	21	0	0	10051
12594	10220	1	13	3	0	10237
12595	0	9662	0	2	0	9664
12596	2	24	3	9535	0	9564
12597	0	11	0	9600	0	9611
12598	9524	0	13	1	0	9538
12599	4	0	9588	1	0	9593
12600	0	12	0	9633	0	9645
12601	2	0	9582	1	0	9585
12602	8889	1	15	2	0	8907
12603	8646	1	37	0	0	8684
12604	8584	1	10	0	0	8595
12605	2	4	1	8571	0	8578
12606	2	5	0	8605	0	8612
12607	9133	1	14	1	0	9149
12608	4	0	9149	0	0	9153
12609	2	9	0	9155	0	9166
12610	9167	0	4	1	0	9172
12611	4	13	0	8971	0	8988
12612	5	0	8930	0	0	8935
12613	2	2	9019	4	0	9027
12614	9093	1	30	3	0	9127
12615	4	8824	1	10	0	8839
12616	8397	0	25	0	0	8422
12617	8464	0	9	1	0	8474
12618	1	10	2	8452	0	8465
12619	5	24	0	8719	0	8748
12620	4	8466	0	1	0	8471
12621	8641	2	14	0	0	8657
12622	1	8696	0	8	0	8705
12623	0	8540	0	2	0	8542
12624	0	10	1	8519	0	8530
12625	8818	3	9	0	0	8830
12626	9293	0	6	2	0	9301
12627	2	20	0	9229	0	9251
12628	0	6	1	9236	0	9243
12629	0	5	1	9302	0	9308
12630	9089	1	5	1	0	9096
12631	1	0	9083	3	0	9087
12632	1	9061	0	6	0	9068
12633	9001	0	17	6	0	9024
12634	2	9	2	8915	0	8928
12635	8	0	8693	1	0	8702
12636	6	1	9108	3	0	9118
12637	2	9162	0	6	0	9170
12638	2	9095	0	9	0	9106
12639	6	32	3	9052	0	9093
12640	0	9197	1	0	0	9198
12641	0	16	0	9181	0	9197
12642	0	11	4	9677	0	9692
12643	9713	1	7	1	0	9722
12644	1	11	2	9696	0	9710
12645	0	13	2	9285	0	9300
12646	5	0	9291	2	0	9298
12647	0	13	0	9119	0	9132
12648	9120	0	14	0	0	9134
12649	9017	1	17	1	0	9036
12650	1	9007	1	6	0	9015
12651	8714	2	26	0	0	8742
12652	4	0	9135	0	0	9139
12653	0	8809	0	1	0	8810
12654	1	36	3	8742	0	8782
12655	2	7	1	8760	0	8770
12656	1	5	0	8785	0	8791
12657	8583	3	25	0	0	8611
12658	8591	1	14	1	0	8607
12659	11	0	8594	1	0	8606
12660	2	0	8613	7	0	8622
12661	3	0	8575	5	0	8583
12662	2	8505	1	37	0	8545
12663	1	8631	0	3	0	8635
12664	8682	0	20	4	0	8706
12665	8764	0	9	0	0	8773
12666	0	26	2	8779	0	8807
12667	3	17	1	9220	0	9241
12668	1	8968	0	5	0	8974
12669	2	20	1	8852	0	8875
12670	9	0	8853	2	0	8864
12671	1	8879	0	3	0	8883
12672	4	18	1	8880	0	8903
12673	2	0	9131	0	0	9133
12674	1	15	1	9176	0	9193
12675	1	9186	0	4	0	9191
12676	9239	0	10	0	0	9249
12677	9274	1	10	1	0	9286
12678	9194	0	15	0	0	9209
12679	0	6	0	9361	0	9367
12680	0	13	1	9764	0	9778
12681	9856	1	15	3	0	9875
12682	0	9197	0	3	0	9200
12683	9054	0	12	1	0	9067
12684	2	0	9226	0	0	9228
12685	9304	0	19	0	0	9323
12686	9993	0	36	2	0	10031
12687	0	8	1	10267	0	10276
12688	10023	1	9	1	0	10034
12689	10032	1	24	1	0	10058
12690	3	11	0	10133	0	10147
12691	3	1	10058	2	0	10064
12692	9950	2	23	3	0	9978
12693	3	0	10305	1	0	10309
12694	1	10378	0	8	0	10387
12695	0	24	0	10162	0	10186
12696	0	10	0	10248	0	10258
12697	9988	0	34	0	0	10022
12698	3	2	10304	1	0	10310
12699	4	28	0	10677	0	10709
12700	3	10412	0	1	0	10416
12701	1	10274	0	1	0	10276
12702	5	24	1	10093	0	10123
12703	10	0	10186	0	0	10196
12704	3	28	2	10242	0	10275
12705	4	19	0	10858	0	10881
12706	23	1	10777	3	0	10804
12707	3	10721	0	6	0	10730
12708	10948	3	21	5	0	10977
12709	1	11072	0	1	0	11074
12710	1	16	0	11282	0	11299
12711	11406	0	18	1	0	11425
12712	0	10976	0	6	0	10982
12713	6	0	10992	1	0	10999
12714	10769	1	16	1	0	10787
12715	2	10631	0	6	0	10639
12716	10420	0	17	2	0	10439
12717	4	0	10557	0	0	10561
12718	10612	0	7	2	0	10621
12719	1	27	2	11045	0	11075
12720	10	0	11216	0	0	11226
12721	1	24	1	11231	0	11257
12722	0	11147	0	1	0	11148
12723	1	11	0	11188	0	11200
12724	1	21	1	11085	0	11108
12725	8	1	11110	6	0	11125
12726	2	18	0	11255	0	11275
12727	3	1	11182	3	0	11189
12728	0	10859	0	10	0	10869
12729	0	13	0	10736	0	10749
12730	3	1	10757	4	0	10765
12731	3	10755	3	3	0	10764
12732	1	10804	1	7	0	10813
12733	6	0	10817	2	0	10825
12734	4	0	11517	0	0	11521
12735	3	9	1	11697	0	11710
12736	11535	1	11	1	0	11548
12737	3	11559	0	13	0	11575
12738	3	45	2	11457	0	11507
12739	12054	2	16	2	0	12074
12740	1	11962	0	4	0	11967
12741	11985	0	33	1	0	12019
12742	0	12080	0	4	0	12084
12743	11545	2	27	1	0	11575
12744	11592	3	23	1	0	11619
12745	11596	1	16	1	0	11614
12746	0	11672	0	3	0	11675
12747	0	6	0	11747	0	11753
12748	1	0	11797	0	0	11798
12749	0	12140	0	8	0	12148
12750	4	14	0	12132	0	12150
12751	3	18	0	12171	0	12192
12752	13	0	12182	1	0	12196
12753	1	12199	0	6	0	12206
12754	12331	1	16	2	0	12350
12755	0	12004	0	3	0	12007
12756	2	22	0	11626	0	11650
12757	4	1	11822	1	0	11828
12758	11866	2	24	5	0	11897
12759	1	8	0	11964	0	11973
12760	4	2	10696	1022	0	11724
12761	11664	0	38	6	0	11708
12762	4	11050	0	7	0	11061
12763	10783	0	24	2	0	10809
12764	10726	1	16	0	0	10743
12765	1	15	2	11038	0	11056
12766	3	0	11186	1	0	11190
12767	4	11130	1	3	0	11138
12768	6	0	11124	0	0	11130
12769	2	13	0	10807	0	10822
12770	1	4	0	10827	0	10832
12771	10766	0	20	0	0	10786
12772	4	0	10950	0	0	10954
12773	0	10577	0	3	0	10580
12774	2	15	0	10363	0	10380
12775	0	16	1	10495	0	10512
12776	10530	0	9	1	0	10540
12777	0	10491	0	4	0	10495
12778	0	9	0	10464	0	10473
12779	10457	2	27	0	0	10486
12780	5	10479	1	3	0	10488
12781	9903	2	28	1	0	9934
12782	9985	0	14	1	0	10000
12783	0	9866	0	6	0	9872
12784	9666	1	22	3	0	9692
12785	2	10878	0	8	0	10888
12786	10530	1	21	3	0	10555
12787	10568	17	18	2	0	10605
12788	1	10543	0	4	0	10548
12789	10356	0	21	2	0	10379
12790	10281	1	18	1	0	10301
12791	9990	2	22	1	0	10015
12792	2	0	10117	1	0	10120
12793	3	1	10151	0	0	10155
12794	2	0	10100	1	0	10103
12795	9600	0	41	4	0	9645
12796	5	0	9405	2	0	9412
12797	13	0	9451	1	0	9465
12798	0	6	1	9433	0	9440
12799	9370	2	13	0	0	9385
12800	1	0	9570	1	0	9572
12801	8	0	9997	1	0	10006
12802	0	12	1	9891	0	9904
12803	6	36	0	9790	0	9832
12804	2	24	1	10234	0	10261
12805	9	0	10303	1	0	10313
12806	2	10	1	10462	0	10475
12807	10462	0	11	1	0	10474
12808	1	10105	1	3	0	10110
12809	5	14	0	10946	0	10965
12810	4	13	1	10840	0	10858
12811	6	2	10845	0	0	10853
12812	1	10888	0	3	0	10892
12813	10928	0	26	5	0	10959
12814	0	10982	1	5	0	10988
12815	0	6	0	10678	0	10684
12816	2	0	10987	0	0	10989
12817	1	37	2	10903	0	10943
12818	0	8	1	10876	0	10885
12819	11087	0	10	1	0	11098
12820	17	23	1	10999	0	11040
12821	5	10837	0	13	0	10855
12822	2	10811	0	11	0	10824
12823	7	0	10664	2	0	10673
12824	10609	1	14	3	0	10627
12825	1	15	0	10161	0	10177
12826	2	16	2	10144	0	10164
12827	0	9	0	10192	0	10201
12828	10124	3	12	2	0	10141
12829	1	9960	0	0	0	9961
12830	9899	3	50	0	0	9952
12831	2	0	9989	1	0	9992
12832	5	0	10345	0	0	10350
12833	10122	0	27	0	0	10149
12834	2	29	3	10058	0	10092
12835	0	10	0	10110	0	10120
12836	1	15	1	10102	0	10119
12837	0	0	10129	0	0	10129
12838	10075	1	15	0	0	10091
12839	10236	0	22	1	0	10259
12840	10161	1	37	2	0	10201
12841	3	6	1	9828	0	9838
12842	8	0	9461	1	0	9470
12843	4	0	9422	4	0	9430
12844	4	1	9971	2	0	9978
12845	1	9879	0	7	0	9887
12846	0	6	1	9901	0	9908
12847	9850	0	43	1	0	9894
12848	1058	0	8653	0	0	9711
12849	9781	0	17	0	0	9798
12850	1	18	1	9827	0	9847
12851	4	15	0	9527	0	9546
12852	5	9614	1	6	0	9626
12853	3	10075	0	6	0	10084
12854	0	10468	1	2	0	10471
12855	0	17	1	10719	0	10737
12856	10711	1	4	0	0	10716
12857	10573	0	14	0	0	10587
12858	3	1	10574	0	0	10578
12859	10315	0	58	1	0	10374
12860	5	0	10542	0	0	10547
12861	0	16	1	9174	0	9191
12862	7	0	9194	3	0	9204
12863	9970	0	33	4	0	10007
12864	4	11	1	10017	0	10033
12865	7	1	9951	1	0	9960
12866	0	0	9988	0	0	9988
12867	10060	0	26	4	0	10090
12868	10017	1	27	2	0	10047
12869	3	9836	0	5	0	9844
12870	2	14	0	9849	0	9865
12871	2	1	9972	0	0	9975
12872	6	1	10016	2	0	10025
12873	1	19	1	10085	0	10106
12874	10104	0	18	4	0	10126
12875	0	9780	0	13	0	9793
12876	2	9	0	10813	0	10824
12877	11117	1	10	2	0	11130
12878	1	10	0	11009	0	11020
12879	5	10959	1	5	0	10970
12880	0	6	1	10521	0	10528
12881	10649	0	10	2	0	10661
12882	1	11	0	10581	0	10593
12883	10582	0	15	2	0	10599
12884	1	10469	0	4	0	10474
12885	9259	2	19	2	0	9282
12886	4	0	9361	0	0	9365
12887	9535	0	10	0	0	9545
12888	9505	0	27	1	0	9533
12889	0	9096	0	8	0	9104
12890	1	6	1	8783	0	8791
12891	8	0	8779	1	0	8788
12892	2	0	8778	0	0	8780
12893	8822	1	22	1	0	8846
12894	9107	0	27	1	0	9135
12895	1	8828	1	19	0	8849
12896	0	8785	0	16	0	8801
12897	8822	1	31	1	0	8855
12898	3	8897	0	4	0	8904
12899	1	8872	0	3	0	8876
12900	2	19	0	8851	0	8872
12901	1	26	1	8808	0	8836
12902	1	1	8853	0	0	8855
12903	0	5	0	8944	0	8949
12904	8915	1	16	0	0	8932
12905	3	1	8879	0	0	8883
12906	3	0	9420	1	0	9424
12907	1	8	2	9045	0	9056
12908	0	5	0	9424	0	9429
12909	1	21	1	9287	0	9310
12910	2	0	9508	0	0	9510
12911	3	15	2	9520	0	9540
12912	1	14	1	9506	0	9522
12913	9495	0	36	0	0	9531
12914	1	9455	0	2	0	9458
12915	9231	1	54	1	0	9287
12916	2	1	9282	0	0	9285
12917	9845	0	20	7	0	9872
12918	3	9647	0	3	0	9653
12919	9246	0	32	2	0	9280
12920	2	9544	0	5	0	9551
12921	9920	1	22	2	0	9945
12922	3	10096	0	3	0	10102
12923	1	10158	1	4	0	10164
12924	2	10	1	10114	0	10127
12925	10105	0	18	0	0	10123
12926	10074	1	42	2	0	10119
12927	10009	0	23	1	0	10033
12928	1	0	9689	1	0	9691
12929	8	1	9617	0	0	9626
12930	2	16	4	9229	0	9251
12931	6	8993	0	8	0	9007
12932	0	8962	0	3	0	8965
12933	1	6	0	8978	0	8985
12934	9025	0	5	0	0	9030
12935	9033	0	6	1	0	9040
12936	8954	0	39	2	0	8995
12937	0	0	9109	0	0	9109
12938	2	29	1	8138	0	8170
12939	2	0	8188	0	0	8190
12940	8243	2	35	6	0	8286
12941	8290	0	18	1	0	8309
12942	0	1	8938	0	0	8939
12943	0	10	1	8850	0	8861
12944	8915	0	9	1	0	8925
12945	0	9	0	8858	0	8867
12946	12	9	0	8842	0	8863
12947	1	19	0	8738	0	8758
12948	8697	0	6	0	0	8703
12949	2	16	1	8810	0	8829
12950	8952	0	14	2	0	8968
12951	1	8551	0	2	0	8554
12952	4	25	0	7281	0	7310
12953	0	10	1	7636	0	7647
12954	1	8	0	7707	0	7716
12955	7784	0	3	1	0	7788
12956	2	20	2	7826	0	7850
12957	1	4	0	7626	0	7631
12958	7660	0	1	0	0	7661
12959	7696	0	7	3	0	7706
12960	7640	1	20	1	0	7662
12961	0	0	8111	1	0	8112
12962	2	0	7839	4	0	7845
12963	7756	1	10	1	0	7768
12964	0	11	0	7779	0	7790
12965	1	5	0	7826	0	7832
12966	7904	0	7	0	0	7911
12967	8036	3	25	1	0	8065
12968	8043	1	23	0	0	8067
12969	0	8120	0	0	0	8120
12970	7828	4	13	1	0	7846
12971	8198	2	32	1	0	8233
12972	3	8833	0	1	0	8837
12973	0	8684	0	6	0	8690
12974	2	6	0	8661	0	8669
12975	10589	0	7	5	0	10601
12976	10573	1	15	4	0	10593
12977	10783	1	20	0	0	10804
12978	2	0	0	10840	0	10842
12979	10817	3	8	1	0	10829
12980	16	0	11478	0	0	11494
12981	10899	0	26	5	0	10930
12982	1	0	11295	0	0	11296
12983	1	0	12982	1	0	12984
12984	1	9	0	12737	0	12747
12985	12898	2	27	2	0	12929
12986	3	12	0	12778	0	12793
12987	122	0	12642	2	0	12766
12988	13	0	14214	3	0	14230
12989	1	3	0	14385	0	14389
12990	14662	0	26	2	0	14690
12991	0	14676	0	4	0	14680
12992	0	19	1	14619	0	14639
12993	2	24	3	15355	0	15384
12994	9	0	15359	1	0	15369
12995	8	0	15737	1	0	15746
12996	0	14	1	15663	0	15678
12997	15262	0	21	3	0	15286
12998	4	0	15170	1	0	15175
12999	0	31	1	15241	0	15273
13000	3	22	2	15249	0	15276
13001	0	21	1	15430	0	15452
13002	15511	0	14	0	0	15525
13003	4	1	15476	2	0	15483
13004	2	15097	1	9	0	15109
13005	3	18	1	15104	0	15126
13006	12	0	15304	1	0	15317
13007	4	15568	1	11	0	15584
13008	2	15508	1	8	0	15519
13009	15677	0	19	3	0	15699
13010	4	15785	0	6	0	15795
13011	15711	1	17	5	0	15734
13012	7	0	16215	2	0	16224
13013	0	13	0	16311	0	16324
13014	16581	3	22	1	0	16607
13015	1	16497	0	14	0	16512
13016	8	1	16872	1	0	16882
13017	12	31	2	17416	0	17461
13018	2	16710	0	11	0	16723
13019	0	20	1	16750	0	16771
13020	16819	0	22	0	0	16841
13021	0	16778	0	6	0	16784
13022	16540	0	26	1	0	16567
13023	16552	1	42	6	0	16601
13024	9	0	16525	2	0	16536
13025	3	16846	0	10	0	16859
13026	6	18	3	16738	0	16765
13027	110	0	16789	0	0	16899
13028	2	0	16908	1	0	16911
13029	3	18	0	16629	0	16650
13030	16525	0	22	0	0	16547
13031	16833	0	24	2	0	16859
13032	2	16	1	16806	0	16825
13033	9	0	16747	1	0	16757
13034	0	17031	0	5	0	17036
13035	16951	1	38	2	0	16992
13036	17034	1	33	4	0	17072
13037	2	16693	1	7	0	16703
13038	16584	0	76	1	0	16661
13039	0	0	16687	0	0	16687
13040	16809	2	31	3	0	16845
13041	16658	3	127	3	0	16791
13042	8	0	16792	0	0	16800
13043	4	48	1	16681	0	16734
13044	5	0	16517	4	0	16526
13045	4	16683	3	17	0	16707
13046	6	15843	0	10	0	15859
13047	8	27	1	15903	0	15939
13048	9	1	15917	1	0	15928
13049	2	16160	0	6	0	16168
13050	1	14574	0	3	0	14578
13051	14583	1	16	3	0	14603
13052	14701	2	21	2	0	14726
13053	1	20	0	14617	0	14638
13054	3	30	2	14685	0	14720
13055	2	14240	0	3	0	14245
13056	14217	2	25	2	0	14246
13057	14280	0	140	2	0	14422
13058	1	12603	0	5	0	12609
13059	4	26	5	12384	0	12419
13060	4	0	13467	3	0	13474
13061	1	18	1	13403	0	13423
13062	13562	0	15	3	0	13580
13063	4	55	2	13596	0	13657
13064	5	14	0	12444	0	12463
13065	12717	0	9	2	0	12728
13066	1	24	3	12364	0	12392
13067	1	12160	0	6	0	12167
13068	2	30	2	12064	0	12098
13069	0	18	0	11574	0	11592
13070	2	27	1	11886	0	11916
13071	1	11494	0	2	0	11497
13072	5	28	1	11411	0	11445
13073	11	0	11495	2	0	11508
13074	3	23	0	11327	0	11353
13075	9	0	11277	5	0	11291
13076	1	11253	0	10	0	11264
13077	1	21	0	11159	0	11181
13078	4	22	1	11884	0	11911
13079	7	40	1	12071	0	12119
13080	5	26	0	12203	0	12234
13081	5	1	12445	0	0	12451
13082	2	11996	1	16	0	12015
13083	3	20	1	12032	0	12056
13084	11	0	12187	1	0	12199
13085	2	32	0	12227	0	12261
13086	12220	2	23	8	0	12253
13087	11	2	12204	1	0	12218
13088	12139	0	18	4	0	12161
13089	4	15	2	12112	0	12133
13090	5	0	11764	2	0	11771
13091	2	11334	0	7	0	11343
13092	4	41	1	11758	0	11804
13093	25	0	11824	0	0	11849
13094	0	12254	0	2	0	12256
13095	3	20	1	12233	0	12257
13096	12317	0	20	0	0	12337
13097	12272	0	23	4	0	12299
13098	12244	1	118	0	0	12363
13099	2	0	12344	1	0	12347
13100	0	13538	0	10	0	13548
13101	2	33	0	13396	0	13431
13102	0	13	0	13565	0	13578
13103	13567	0	14	1	0	13582
13104	1	13731	0	5	0	13737
13105	14293	1	22	1	0	14317
13106	14290	1	17	3	0	14311
13107	13892	1	21	5	0	13919
13108	3	0	14098	0	0	14101
13109	14061	0	11	2	0	14074
13110	3	39	1	14091	0	14134
13111	3	14	0	14168	0	14185
13112	14110	2	22	1	0	14135
13113	4	31	0	13982	0	14017
13114	1	14027	1	3	0	14032
13115	4	20	0	14700	0	14724
13116	14601	0	23	1	0	14625
13117	9	0	14590	2	0	14601
13118	1	14527	1	1	0	14530
13119	6	19	2	14572	0	14599
13120	14481	2	10	2	0	14495
13121	6	0	14572	1	0	14579
13122	2	371	833	13348	0	14554
13123	7	0	14471	3	0	14481
13124	7	1	14978	5	0	14991
13125	24	0	14763	5	0	14792
13126	8	1	14756	9	0	14774
13127	15	0	14826	1	0	14842
13128	14732	0	51	3	0	14786
13129	1	14764	0	9	0	14774
13130	14628	0	27	2	0	14657
13131	14925	4	29	2	0	14960
13132	11	14743	0	15	0	14769
13133	0	14604	0	9	0	14613
13134	14613	1	17	7	0	14638
13135	14732	0	27	0	0	14759
13136	3	30	0	14891	0	14924
13137	1	15274	0	4	0	15279
13138	15297	3	52	2	0	15354
13139	1	15183	0	8	0	15192
13140	3	12	6	14862	0	14883
13141	15025	1	18	1	0	15045
13142	14978	2	26	1	0	15007
13143	2	22	1	14906	0	14931
13144	1	31	2	14533	0	14567
13145	3	0	15090	2	0	15095
13146	3	43	2	14718	0	14766
13147	9	0	14954	1	0	14964
13148	2	33	0	14802	0	14837
13149	0	15	1	14787	0	14803
13150	14948	0	24	1	0	14973
13151	14790	21	50	7	0	14868
13152	6	0	14845	0	0	14851
13153	14800	0	65	3	0	14868
13154	0	16	1	14069	0	14086
13155	5	0	14226	0	0	14231
13156	2	32	1	14111	0	14146
13157	2	32	0	13981	0	14015
13158	20	0	14389	1	0	14410
13159	4	31	4	14384	0	14423
13160	6	0	14564	0	0	14570
13161	3	21	2	14551	0	14577
13162	14605	1	26	1	0	14633
13163	1	14577	0	9	0	14587
13164	14314	1	43	0	0	14358
13165	1	14344	0	9	0	14354
13166	13966	1	93	1	0	14061
13167	0	14815	0	8	0	14823
13168	14391	2	20	4	0	14417
13169	2	14400	0	4	0	14406
13170	1	18	2	14017	0	14038
13171	8	0	14224	2	0	14234
13172	10	1	14518	4	0	14533
13173	3	21	0	14660	0	14684
13174	14489	0	16	8	0	14513
13175	1	14328	0	9	0	14338
13176	3	14	0	12938	0	12955
13177	4	0	13103	0	0	13107
13178	5	1	12943	1	0	12950
13179	1	28	1	12932	0	12962
13180	3	12659	0	2	0	12664
13181	12116	1	20	4	0	12141
13182	3	0	12298	1	0	12302
13183	3	0	12324	3	0	12330
13184	2	12152	0	10	0	12164
13185	12194	3	29	2	0	12228
13186	11907	1	21	2	0	11931
13187	2	26	0	11846	0	11874
13188	11796	0	11	2	0	11809
13189	11779	0	25	5	0	11809
13190	0	12001	1	4	0	12006
13191	11139	2	13	5	0	11159
13192	6	0	11044	2	0	11052
13193	5	16	3	11063	0	11087
13194	2	16	1	11223	0	11242
13195	11287	1	14	1	0	11303
13196	2	11123	1	5	0	11131
13197	11095	1	20	0	0	11116
13198	5	11126	0	10	0	11141
13199	3	10533	1	6	0	10543
13200	7	0	10494	4	0	10505
13201	8	0	10424	3	0	10435
13202	10353	1	19	4	0	10377
13203	10543	2	20	0	0	10565
13204	12	0	10682	2	0	10696
13205	3	10803	0	2	0	10808
13206	4	10615	0	5	0	10624
13207	10475	1	14	1	0	10491
13208	10496	1	10	3	0	10510
13209	1	14	0	10479	0	10494
13210	10474	0	7	1	0	10482
13211	4	45	1	10423	0	10473
13212	7	0	8732	5	0	8744
13213	5	1	8478	6	0	8490
13214	8404	0	8	1	0	8413
13215	3	28	0	8215	0	8246
13216	1	8120	0	2	0	8123
13217	7952	0	9	1	0	7962
13218	7933	2	17	3	0	7955
13219	2	0	7955	0	0	7957
13220	7986	0	17	2	0	8005
13221	7637	0	17	0	0	7654
13222	0	5	0	7699	0	7704
13223	1	7658	0	0	0	7659
13224	1	7639	0	1	0	7641
13225	1	23	0	7525	0	7549
13226	0	16	1	7561	0	7578
13227	2	14	1	7578	0	7595
13228	4	2	7498	0	0	7504
13229	1	0	7610	0	0	7611
13230	3	16	2	7745	0	7766
13231	11	0	7397	1	0	7409
13232	5	0	7485	2	0	7492
13233	2	16	1	7390	0	7409
13234	4	2	7078	0	0	7084
13235	0	7113	0	4	0	7117
13236	7270	0	18	0	0	7288
13237	0	14	0	7289	0	7303
13238	0	7129	0	14	0	7143
13239	9	2	7350	0	0	7361
13240	1	17	1	7687	0	7706
13241	5	1	7643	0	0	7649
13242	0	26	0	7949	0	7975
13243	1	18	0	7306	0	7325
13244	9	0	7398	0	0	7407
13245	8	154	1	7181	0	7344
13246	1	7251	1	3	0	7256
13247	3	18	2	7227	0	7250
13248	8	0	7342	1	0	7351
13249	3	8	0	7380	0	7391
13250	7437	0	6	2	0	7445
13251	0	7256	2	1	0	7259
13252	0	19	1	7122	0	7142
13253	4	0	7134	3	0	7141
13254	3	7570	0	3	0	7576
13255	0	7547	0	3	0	7550
13256	5	0	7580	2	0	7587
13257	2	11	0	7616	0	7629
13258	2	12	1	7391	0	7406
13259	4	0	7484	2	0	7490
13260	3	7547	1	9	0	7560
13261	0	7617	0	5	0	7622
13262	7762	2	12	1	0	7777
13263	0	7744	0	4	0	7748
13264	7861	2	9	3	0	7875
13265	2	9	1	7887	0	7899
13266	7597	1	8	2	0	7608
13267	9	0	7685	2	0	7696
13268	7736	1	9	3	0	7749
13269	1	15	0	7699	0	7715
13270	0	7573	0	4	0	7577
13271	7568	0	4	1	0	7573
13272	2	14	0	7665	0	7681
13273	2	7711	0	0	0	7713
13274	0	7756	0	3	0	7759
13275	7774	0	8	0	0	7782
13276	7677	0	6	3	0	7686
13277	7684	0	9	1	0	7694
13278	3	21	1	7876	0	7901
13279	1	7669	0	2	0	7672
13280	0	7707	0	2	0	7709
13281	1	8	0	7531	0	7540
13282	7686	1	5	1	0	7693
13283	7588	0	12	1	0	7601
13284	7561	0	16	0	0	7577
13285	6	1	7630	0	0	7637
13286	4	0	7613	3	0	7620
13287	7409	0	11	2	0	7422
13288	1	21	1	7392	0	7415
13289	3	8	0	7207	0	7218
13290	1	12	0	7362	0	7375
13291	0	13	3	7363	0	7379
13292	2	0	7309	0	0	7311
13293	1	24	8	7422	0	7455
13294	2	0	7357	1	0	7360
13295	7398	0	6	4	0	7408
13296	0	7403	0	4	0	7407
13297	4	11	0	7395	0	7410
13298	1	5	1	7423	0	7430
13299	7339	0	5	2	0	7346
13300	7280	0	10	2	0	7292
13301	7850	1	11	0	0	7862
13302	7908	0	15	2	0	7925
13303	2	0	8033	0	0	8035
13304	0	0	8277	1	0	8278
13305	0	5	0	7998	0	8003
13306	8050	0	8	2	0	8060
13307	8211	0	8	4	0	8223
13308	5	0	8596	0	0	8601
13309	1	4	0	8514	0	8519
13310	8597	0	6	1	0	8604
13311	2	24	0	8294	0	8320
13312	10	0	8498	1	0	8509
13313	2	12	0	8561	0	8575
13314	8544	0	30	1	0	8575
13315	2	8423	0	3	0	8428
13316	8029	2	5	0	0	8036
13317	7682	0	11	1	0	7694
13318	7728	0	5	0	0	7733
13319	0	9	0	7692	0	7701
13320	7807	0	0	0	0	7807
13321	2	7936	0	3	0	7941
13322	0	7559	0	1	0	7560
13323	1	21	0	7588	0	7610
13324	7584	0	11	0	0	7595
13325	1	7610	0	2	0	7613
13326	7617	0	4	0	0	7621
13327	7665	0	10	0	0	7675
13328	1	7460	0	1	0	7462
13329	2	17	0	7527	0	7546
13330	0	4	0	7221	0	7225
13331	6	0	7380	2	0	7388
13332	1	12	0	7375	0	7388
13333	3	0	7386	1	0	7390
13334	0	7411	0	3	0	7414
13335	1	10	0	7441	0	7452
13336	7477	2	9	0	0	7488
13337	7537	0	9	0	0	7546
13338	0	12	0	7414	0	7426
13339	3	0	7369	2	0	7374
13340	7325	0	12	6	0	7343
13341	2	7404	0	2	0	7408
13342	3	7267	0	4	0	7274
13343	1	7150	0	1	0	7152
13344	2	18	0	7071	0	7091
13345	1	0	7106	0	0	7107
13346	0	11	0	7155	0	7166
13347	5	0	7134	0	0	7139
13348	1	0	7043	4	0	7048
13349	0	0	7146	1	0	7147
13350	2	54	1	7014	0	7071
13351	0	12	0	6966	0	6978
13352	1	20	0	6963	0	6984
13353	0	5	0	6974	0	6979
13354	6799	0	7	0	0	6806
13355	0	6755	0	1	0	6756
13356	6694	1	12	0	0	6707
13357	1	6917	0	2	0	6920
13358	0	21	0	6724	0	6745
13359	1	0	0	7041	0	7042
13360	7082	1	5	2	0	7090
13361	7109	1	19	0	0	7129
13362	7167	0	11	0	0	7178
13363	7197	2	19	1	0	7219
13364	7254	8	16	0	0	7278
13365	0	7312	0	21	0	7333
13366	7149	0	10	0	0	7159
13367	1	7433	0	5	0	7439
13368	7597	1	12	2	0	7612
13369	5	0	8157	1	0	8163
13370	2	30	0	8219	0	8251
13371	1	8116	0	2	0	8119
13372	2	15	2	8096	0	8115
13373	2	0	8222	0	0	8224
13374	0	22	0	8276	0	8298
13375	8299	0	6	1	0	8306
13376	4	8252	1	1	0	8258
13377	0	7682	0	6	0	7688
13378	4	0	7686	0	0	7690
13379	2	11	0	7586	0	7599
13380	0	7358	0	2	0	7360
13381	0	15	0	7392	0	7407
13382	9	1	7466	1	0	7477
13383	1	7129	0	4	0	7134
13384	7	0	7152	1	0	7160
13385	5	0	7346	1	0	7352
13386	1	14	1	7201	0	7217
13387	7270	0	7	1	0	7278
13388	1	21	0	6949	0	6971
13389	10	0	7215	0	0	7225
13390	3	15	1	7182	0	7201
13391	12	0	7099	2	0	7113
13392	4	1	7112	2	0	7119
13393	7193	0	3	3	0	7199
13394	7074	1	9	2	0	7086
13395	6918	1	26	0	0	6945
13396	2	0	7098	1	0	7101
13397	14	0	6835	3	0	6852
13398	1	8	0	6731	0	6740
13399	0	8	0	6692	0	6700
13400	6685	1	11	1	0	6698
13401	0	3	0	6706	0	6709
13402	6	0	6654	3	0	6663
13403	24	2	6728	4	0	6758
13404	0	6752	0	4	0	6756
13405	1	23	2	6514	0	6540
13406	1	1	6518	0	0	6520
13407	0	10	0	6563	0	6573
13408	6578	1	10	0	0	6589
13409	1	0	6567	0	0	6568
13410	3	15	0	6719	0	6737
13411	2	17	1	6754	0	6774
13412	7	0	6735	1	0	6743
13413	0	27	0	6577	0	6604
13414	7	0	6583	2	0	6592
13415	6624	0	15	0	0	6639
13416	2	8	1	6612	0	6623
13417	0	6464	0	2	0	6466
13418	6370	3	10	1	0	6384
13419	6420	0	12	0	0	6432
13420	0	6427	0	4	0	6431
13421	1	18	2	6329	0	6350
13422	5	6407	0	5	0	6417
13423	4	6380	0	2	0	6386
13424	4	0	6403	0	0	6407
13425	0	7530	0	9	0	7539
13426	6	0	7519	1	0	7526
13427	7596	0	5	0	0	7601
13428	7593	0	9	1	0	7603
13429	1	7708	0	2	0	7711
13430	0	7701	0	3	0	7704
13431	0	7639	0	3	0	7642
13432	7685	0	6	0	0	7691
13433	6	12	2	7531	0	7551
13434	2	0	7574	2	0	7578
13435	1	7492	0	8	0	7501
13436	1	25	1	7436	0	7463
13437	3	19	1	7524	0	7547
13438	0	7418	0	3	0	7421
13439	7410	0	10	6	0	7426
13440	0	1	7402	1	0	7404
13441	2	8	0	7594	0	7604
13442	0	7300	0	2	0	7302
13443	7207	1	7	0	0	7215
13444	5	1	6996	0	0	7002
13445	0	6646	1	2	0	6649
13446	1	16	0	6608	0	6625
13447	0	0	6606	1	0	6607
13448	7006	0	6	0	0	7012
13449	1	31	0	7008	0	7040
13450	6	0	7045	0	0	7051
13451	0	7081	0	1	0	7082
13452	7249	1	24	0	0	7274
13453	0	7187	0	0	0	7187
13454	7003	1	4	2	0	7010
13455	7007	0	9	2	0	7018
13456	1	11	1	6987	0	7000
13457	0	6922	0	1	0	6923
13458	8	0	6926	0	0	6934
13459	0	15	2	7009	0	7026
13460	1	18	1	7870	0	7890
13461	0	7	0	7741	0	7748
13462	0	6	0	7813	0	7819
13463	2	1	0	7779	0	7782
13464	7733	0	2	2	0	7737
13465	7524	0	6	0	0	7530
13466	7565	2	18	2	0	7587
13467	0	7584	0	1	0	7585
13468	7	0	7411	1	0	7419
13469	5	0	7556	0	0	7561
13470	3	0	7603	2	0	7608
13471	4	23	2	7603	0	7632
13472	0	14	2	7434	0	7450
13473	1	17	1	7414	0	7433
13474	3	0	7422	1	0	7426
13475	2	7466	1	6	0	7475
13476	12	0	7455	0	0	7467
13477	2	0	7891	1	0	7894
13478	0	11	2	7760	0	7773
13479	7	0	7747	1	0	7755
13480	1	9	0	7753	0	7763
13481	7790	0	9	1	0	7800
13482	7783	1	20	1	0	7805
13483	4	0	7875	0	0	7879
13484	2	13	0	8034	0	8049
13485	23	0	7813	2	0	7838
13486	0	7592	0	15	0	7607
13487	7445	1	14	0	0	7460
13488	3	0	7443	0	0	7446
13489	3	7780	0	0	0	7783
13490	1	7784	0	1	0	7786
13491	2	7828	0	0	0	7830
13492	3	0	8781	0	0	8784
13493	1	26	0	8752	0	8779
13494	0	8834	0	3	0	8837
13495	1	17	1	8806	0	8825
13496	0	15	1	8897	0	8913
13497	8902	0	22	0	0	8924
13498	1	8854	0	1	0	8856
13499	8770	2	34	0	0	8806
13500	2	8785	0	0	0	8787
13501	0	7446	0	2	0	7448
13502	5	0	7632	0	0	7637
13503	2	18	0	7560	0	7580
13504	2	1	7440	7	0	7450
13505	1	7437	0	16	0	7454
13506	9	0	7451	0	0	7460
13507	8	0	7517	2	0	7527
13508	0	7470	0	2	0	7472
13509	7492	1	11	0	0	7504
13510	0	7437	0	3	0	7440
13511	7207	0	15	4	0	7226
13512	5	0	7299	1	0	7305
13513	8	0	7237	1	0	7246
13514	2	7336	0	6	0	7344
13515	7411	1	10	1	0	7423
13516	0	7479	0	1	0	7480
13517	3	9	0	7412	0	7424
13518	7444	0	18	0	0	7462
13519	3	0	7772	0	0	7775
13520	1	19	1	7653	0	7674
13521	7475	0	7	3	0	7485
13522	0	7558	0	5	0	7563
13523	2	13	2	7172	0	7189
13524	5	0	7193	2	0	7200
13525	7050	1	11	2	0	7064
13526	1	15	0	7049	0	7065
13527	0	1	7681	2	0	7684
13528	5	23	0	7489	0	7517
13529	3	7511	0	3	0	7517
13530	3	0	7614	0	0	7617
13531	0	18	1	7574	0	7593
13532	7739	0	13	1	0	7753
13533	0	6	0	7706	0	7712
13534	7648	0	7	0	0	7655
13535	1	7508	0	7	0	7516
13536	6489	2	9	1	0	6501
13537	2	0	6528	1	0	6531
13538	9	0	6503	1	0	6513
13539	7	0	6586	3	0	6596
13540	1	6624	1	0	0	6626
13541	2	20	1	6513	0	6536
13542	1	37	0	6527	0	6565
13543	1	5	1	6570	0	6577
13544	6	32	0	6577	0	6615
13545	5	1	6456	1	0	6463
13546	6399	2	13	1	0	6415
13547	1	6535	0	8	0	6544
13548	6392	0	15	3	0	6410
13549	1	20	1	6427	0	6449
13550	0	6704	0	3	0	6707
13551	1	5	0	6709	0	6715
13552	6746	0	7	0	0	6753
13553	0	6409	0	0	0	6409
13554	6359	1	6	0	0	6366
13555	6589	0	11	0	0	6600
13556	1	17	2	6692	0	6712
13557	5	0	6814	0	0	6819
13558	6758	1	21	4	0	6784
13559	1	9	0	6519	0	6529
13560	6447	0	11	1	0	6459
13561	6581	0	9	0	0	6590
13562	6516	1	29	1	0	6547
13563	0	0	6680	0	0	6680
13564	0	10	0	6596	0	6606
13565	6302	1	20	2	0	6325
13566	1	1	6285	0	0	6287
13567	0	5432	0	6	0	5438
13568	0	11	1	5424	0	5436
13569	2	0	5459	1	0	5462
13570	1	0	5476	2	0	5479
13571	0	13	0	5800	0	5813
13572	2	31	4	5718	0	5755
13573	0	9	1	5777	0	5787
13574	2	20	1	5766	0	5789
13575	4	1	5820	0	0	5825
13576	1	5696	0	2	0	5699
13577	1	85	0	5628	0	5714
13578	5791	0	4	1	0	5796
13579	5812	2	8	0	0	5822
13580	5827	0	4	0	0	5831
13581	0	14	0	5852	0	5866
13582	0	17	0	5850	0	5867
13583	3	6086	0	5	0	6094
13584	1	6060	0	4	0	6065
13585	0	2	0	6143	0	6145
13586	6190	0	9	0	0	6199
13587	6225	1	10	0	0	6236
13588	6184	0	0	0	0	6184
13589	6290	0	8	0	0	6298
13590	6151	1	10	5	0	6167
13591	1	6161	0	1	0	6163
13592	0	4	0	6104	0	6108
13593	6141	0	6	1	0	6148
13594	6091	1	6	2	0	6100
13595	0	9	3	5833	0	5845
13596	0	15	1	5802	0	5818
13597	2	0	5812	1	0	5815
13598	0	17	0	5958	0	5975
13599	2	43	0	5935	0	5980
13600	2	0	5907	0	0	5909
13601	1	35	3	6035	0	6074
13602	1	5379	0	37	0	5417
13603	3	0	5406	1	0	5410
13604	1	5376	0	5	0	5382
13605	1	20	0	5390	0	5411
13606	2	12	0	5430	0	5444
13607	1	5306	0	2	0	5309
13608	3	5329	0	5	0	5337
13609	5562	0	6	0	0	5568
13610	5543	0	11	0	0	5554
13611	3	0	5609	0	0	5612
13612	5644	1	9	2	0	5656
13613	5525	1	14	1	0	5541
13614	5499	1	54	1	0	5555
13615	5408	1	30	0	0	5439
13616	0	0	5467	0	0	5467
13617	0	0	5535	1	0	5536
13618	5544	1	13	3	0	5561
13619	0	5566	0	4	0	5570
13620	2	0	5558	0	0	5560
13621	5544	3	7	0	0	5554
13622	5533	1	19	0	0	5553
13623	1	0	5475	0	0	5476
13624	5470	0	7	1	0	5478
13625	0	9	0	5385	0	5394
13626	1	0	5090	0	0	5091
13627	5168	0	2	3	0	5173
13628	0	5467	0	4	0	5471
13629	5418	0	5	0	0	5423
13630	5559	1	4	1	0	5565
13631	0	4	1	5291	0	5296
13632	2	5	0	5096	0	5103
13633	1	1	0	4998	0	5000
13634	4998	0	1	0	0	4999
13635	5001	0	3	0	0	5004
13636	0	2	1	4995	0	4998
13637	4	5	1	4831	0	4841
13638	1	0	4992	0	0	4993
13639	4973	0	8	2	0	4983
13640	0	6	1	5546	0	5553
13641	1	10	1	5471	0	5483
13642	0	5556	0	2	0	5558
13643	2	8	0	5491	0	5501
13644	0	0	1	5557	0	5558
13645	5757	2	5	1	0	5765
13646	1	5733	0	1	0	5735
13647	0	26	1	5331	0	5358
13648	1	16	2	5401	0	5420
13649	0	6	1	5358	0	5365
13650	0	0	5546	1	0	5547
13651	1	4	0	5814	0	5819
13652	5777	0	11	2	0	5790
13653	0	0	5936	1	0	5937
13654	0	7	0	5836	0	5843
13655	1	3	1	5775	0	5780
13656	5775	0	5	1	0	5781
13657	5726	0	11	1	0	5738
13658	2	1	5801	0	0	5804
13659	5421	1	9	0	0	5431
13660	1	1	5481	0	0	5483
13661	5592	1	7	1	0	5601
13662	0	5542	1	1	0	5544
13663	5460	0	18	2	0	5480
13664	0	5528	0	1	0	5529
13665	5542	0	13	2	0	5557
13666	0	5572	0	0	0	5572
13667	0	22	1	5410	0	5433
13668	3	17	0	5539	0	5559
13669	0	11	0	5501	0	5512
13670	0	5567	0	1	0	5568
13671	2	23	0	5483	0	5508
13672	0	5593	0	0	0	5593
13673	0	10	0	5358	0	5368
13674	5460	0	7	1	0	5468
13675	5418	1	9	0	0	5428
13676	0	5536	0	2	0	5538
13677	1	7	0	5358	0	5366
13678	5374	0	8	1	0	5383
13679	2	5174	0	5	0	5181
13680	1	5177	0	3	0	5181
13681	5374	0	7	1	0	5382
13682	5362	2	6	0	0	5370
13683	0	5338	0	4	0	5342
13684	5316	0	10	0	0	5326
13685	1	15	0	5245	0	5261
13686	2	0	5253	0	0	5255
13687	5229	2	6	0	0	5237
13688	5187	1	27	1	0	5216
13689	0	0	5240	0	0	5240
13690	5218	0	13	1	0	5232
13691	5247	0	18	3	0	5268
13692	5146	0	18	2	0	5166
13693	0	5228	0	0	0	5228
13694	5216	0	9	1	0	5226
13695	5611	1	4	0	0	5616
13696	0	1	0	5520	0	5521
13697	2	2	0	5525	0	5529
13698	1	4	0	5678	0	5683
13699	5726	0	1	0	0	5727
13700	1	0	0	5732	0	5733
13701	5756	0	4	1	0	5761
13702	5773	0	2	0	0	5775
13703	0	1	0	6185	0	6186
13704	0	9	0	5828	0	5837
13705	0	2	0	5973	0	5975
13706	6044	1	2	1	0	6048
13707	0	6814	0	0	0	6814
13708	2	12	0	7106	0	7120
13709	0	10	0	7277	0	7287
13710	7280	1	4	0	0	7285
13711	7244	0	11	0	0	7255
13712	5	0	7387	0	0	7392
13713	1	1	7410	1	0	7413
13714	7256	0	28	1	0	7285
13715	1	12	1	7128	0	7142
13716	3	6	1	6584	0	6594
13717	3	0	7046	1	0	7050
13718	2	10	0	7086	0	7098
13719	3	7063	0	1	0	7067
13720	0	6965	0	5	0	6970
13721	6883	3	11	4	0	6901
13722	3	0	6888	3	0	6894
13723	0	6751	0	5	0	6756
13724	1	15	0	6761	0	6777
13725	0	0	6848	0	0	6848
13726	4	19	1	6756	0	6780
13727	1	14	0	6779	0	6794
13728	9	0	6807	1	0	6817
13729	3	6680	0	7	0	6690
13730	0	17	0	6838	0	6855
13731	6910	0	14	1	0	6925
13732	7082	1	14	1	0	7098
13733	7166	4	12	0	0	7182
13734	1	7116	2	5	0	7124
13735	7146	1	14	3	0	7164
13736	1	6	0	7104	0	7111
13737	6	0	7048	2	0	7056
13738	7145	0	45	1	0	7191
13739	1	7061	0	0	0	7062
13740	4	15	0	7058	0	7077
13741	0	19	0	7168	0	7187
13742	0	7252	0	0	0	7252
13743	1	10	0	7257	0	7268
13744	0	6	0	7305	0	7311
13745	0	3	0	7334	0	7337
13746	7263	1	2	1	0	7267
13747	7239	0	13	3	0	7255
13748	2	0	7392	0	0	7394
13749	2	26	2	7410	0	7440
13750	0	4	0	7364	0	7368
13751	0	2	0	7406	0	7408
13752	7289	0	8	0	0	7297
13753	1	0	7443	0	0	7444
13754	7671	0	11	0	0	7682
13755	7665	0	23	1	0	7689
13756	1	7	0	7671	0	7679
13757	7490	0	12	3	0	7505
13758	4	0	7565	1	0	7570
13759	7524	0	8	2	0	7534
13760	2	7611	0	5	0	7618
13761	3	0	7508	1	0	7512
13762	3	0	7832	1	0	7836
13763	1	28	1	7791	0	7821
13764	6	0	7843	0	0	7849
13765	8024	0	27	0	0	8051
13766	1	8035	0	11	0	8047
13767	7983	2	18	0	0	8003
13768	0	10	0	8101	0	8111
13769	11	0	7987	1	0	7999
13770	0	0	8581	1	0	8582
13771	0	5	0	8306	0	8311
13772	8337	0	11	1	0	8349
13773	1	8291	1	4	0	8297
13774	3	7829	0	2	0	7834
13775	8123	9	10	1	0	8143
13776	1	8655	0	103	0	8759
13777	8729	0	21	1	0	8751
13778	1	12	1	8764	0	8778
13779	8299	1	11	2	0	8313
13780	0	5	1	8753	0	8759
13781	8660	1	5	1	0	8667
13782	4	11	1	8426	0	8442
13783	1	7758	1	2	0	7762
13784	7421	2	24	1	0	7448
13785	0	7462	0	3	0	7465
13786	2	0	7511	0	0	7513
13787	1	11	1	7617	0	7630
13788	3	7438	0	4	0	7445
13789	7415	1	9	3	0	7428
13790	7518	0	18	1	0	7537
13791	1	7495	0	0	0	7496
13792	2	1	7845	0	0	7848
13793	1	10	0	7376	0	7387
13794	0	7792	0	2	0	7794
13795	3	16	1	7770	0	7790
13796	0	5	0	7854	0	7859
13797	8208	0	5	1	0	8214
13798	0	8421	0	3	0	8424
13799	0	4	0	8427	0	8431
13800	8678	1	9	1	0	8689
13801	8423	0	11	3	0	8437
13802	8621	0	22	1	0	8644
13803	0	6	0	8635	0	8641
13804	8606	0	10	1	0	8617
13805	0	8821	0	1	0	8822
13806	8671	0	31	2	0	8704
13807	0	8760	0	3	0	8763
13808	8491	1	18	0	0	8510
13809	8774	1	18	1	0	8794
13810	2	14	2	8808	0	8826
13811	5	0	8796	1	0	8802
13812	5	1	8926	2	0	8934
13813	1	8929	0	4	0	8934
13814	8755	3	23	1	0	8782
13815	2	0	8846	0	0	8848
13816	9027	1	26	0	0	9054
13817	2	8937	0	8	0	8947
13818	1	8741	0	1	0	8743
13819	1	19	1	8951	0	8972
13820	1	9295	1	7	0	9304
13821	5	0	9384	1	0	9390
13822	1	11	0	9509	0	9521
13823	0	9310	0	6	0	9316
13824	5	13	0	9292	0	9310
13825	9310	3	9	0	0	9322
13826	4	27	1	9246	0	9278
13827	4	1	9375	0	0	9380
13828	1	9443	0	2	0	9446
13829	0	30	0	9198	0	9228
13830	0	20	3	9207	0	9230
13831	1	10	0	9254	0	9265
13832	9301	0	1	0	0	9302
13833	9228	0	17	1	0	9246
13834	3	0	9184	0	0	9187
13835	1	0	9238	3	0	9242
13836	0	9221	0	3	0	9224
13837	8985	0	19	0	0	9004
13838	0	17	2	8845	0	8864
13839	0	45	0	8783	0	8828
13840	4	25	0	8815	0	8844
13841	2	12	0	8702	0	8716
13842	3	0	8722	0	0	8725
13843	8676	0	17	1	0	8694
13844	0	15	0	8588	0	8603
13845	3	0	8599	1	0	8603
13846	8017	0	31	1	0	8049
13847	8284	1	20	4	0	8309
13848	1	0	8315	0	0	8316
13849	5	0	8448	0	0	8453
13850	1	9	0	8391	0	8401
13851	8201	0	8	0	0	8209
13852	8005	0	9	1	0	8015
13853	0	19	1	8108	0	8128
13854	1	30	0	8043	0	8074
13855	4	1	8027	2	0	8034
13856	1	15	1	7641	0	7658
13857	5	0	7608	0	0	7613
13858	7898	1	22	4	0	7925
13859	2	7784	0	11	0	7797
13860	7826	0	20	1	0	7847
13861	2	8143	0	1	0	8146
13862	8021	0	20	2	0	8043
13863	4	12	2	8223	0	8241
13864	1	7	2	8209	0	8219
13865	8221	1	9	2	0	8233
13866	8182	0	22	1	0	8205
13867	8378	0	8	2	0	8388
13868	8047	1	21	0	0	8069
13869	0	0	8120	2	0	8122
13870	7660	1	33	5	0	7699
13871	7629	1	12	0	0	7642
13872	7635	2	28	1	0	7666
13873	0	8	0	7474	0	7482
13874	7246	0	6	0	0	7252
13875	1	7270	0	1	0	7272
13876	0	8	0	7208	0	7216
13877	4	10	1	7199	0	7214
13878	0	0	7258	0	0	7258
13879	5	21	0	7404	0	7430
13880	2	7677	0	3	0	7682
13881	7749	2	24	3	0	7778
13882	1	7808	0	1	0	7810
13883	8122	0	17	3	0	8142
13884	1	6	1	8329	0	8337
13885	8002	1	8	1	0	8012
13886	3	8265	0	3	0	8271
13887	8055	0	25	1	0	8081
13888	8141	0	23	3	0	8167
13889	1	5	1	8245	0	8252
13890	1	14	1	8224	0	8240
13891	2	0	8237	0	0	8239
13892	4	18	2	8251	0	8275
13893	2	9	0	8170	0	8181
13894	1	0	8235	0	0	8236
13895	4	33	1	7824	0	7862
13896	2	0	7709	5	0	7716
13897	7722	0	19	2	0	7743
13898	1	14	2	7646	0	7663
13899	6	0	7693	0	0	7699
13900	7707	4	16	3	0	7730
13901	5	8	4	7839	0	7856
13902	3	0	7964	0	0	7967
13903	7911	1	28	3	0	7943
13904	0	17	1	7723	0	7741
13905	0	6	2	7623	0	7631
13906	7689	1	5	0	0	7695
13907	0	11	3	7706	0	7720
13908	0	18	1	7652	0	7671
13909	3	14	1	7628	0	7646
13910	2	7646	0	2	0	7650
13911	7613	1	8	0	0	7622
13912	7760	0	8	0	0	7768
13913	0	12	2	7757	0	7771
13914	8041	0	3	1	0	8045
13915	8044	0	7	1	0	8052
13916	8010	2	13	0	0	8025
13917	8009	0	28	0	0	8037
13918	7970	1	22	1	0	7994
13919	0	0	8075	0	0	8075
13920	0	0	8200	2	0	8202
13921	8069	1	23	4	0	8097
13922	2	7766	0	4	0	7772
13923	5	14	1	7649	0	7669
13924	4	1	8001	0	0	8006
13925	5	0	8291	2	0	8298
13926	3	10	5	8375	0	8393
13927	8334	0	15	2	0	8351
13928	2	18	1	8259	0	8280
13929	3	0	8160	0	0	8163
13930	8717	0	24	0	0	8741
13931	2	15	0	8686	0	8703
13932	0	37	0	8568	0	8605
13933	0	7	0	8506	0	8513
13934	0	19	1	8352	0	8372
13935	4	0	8502	0	0	8506
13936	0	6	1	8617	0	8624
13937	8055	0	22	0	0	8077
13938	5	0	8040	0	0	8045
13939	7910	0	16	0	0	7926
13940	8153	0	28	0	0	8181
13941	8156	1	9	1	0	8167
13942	8293	6	20	1	0	8320
13943	2	8329	0	1	0	8332
13944	3	8193	0	2	0	8198
13945	0	8276	0	3	0	8279
13946	8225	1	28	4	0	8258
13947	1	1	8869	1	0	8872
13948	9388	2	12	3	0	9405
13949	4	8	1	9436	0	9449
13950	9808	0	5	2	0	9815
13951	4	5	1	9868	0	9878
13952	9719	0	16	0	0	9735
13953	0	21	1	9675	0	9697
13954	0	3	1	9280	0	9284
13955	9363	1	6	2	0	9372
13956	0	8785	1	4	0	8790
13957	5	0	8754	3	0	8762
13958	1	8506	0	12	0	8519
13959	2	1	8568	0	0	8571
13960	3	9	0	8574	0	8586
13961	8560	1	6	0	0	8567
13962	0	9	0	8142	0	8151
13963	8182	1	14	0	0	8197
13964	1	8121	2	3	0	8127
13965	10	0	8044	1	0	8055
13966	2	8154	1	11	0	8168
13967	2	8055	0	3	0	8060
13968	8162	1	29	4	0	8196
13969	8565	0	8	0	0	8573
13970	0	8507	0	2	0	8509
13971	0	15	1	8504	0	8520
13972	1	12	0	8624	0	8637
13973	8622	0	10	2	0	8634
13974	1	0	8684	0	0	8685
13975	3	0	8710	0	0	8713
13976	0	26	1	8649	0	8676
13977	2	1	8460	1	0	8464
13978	8470	0	20	1	0	8491
13979	8585	4	26	2	0	8617
13980	0	8762	0	1	0	8763
13981	1	1	8843	0	0	8845
13982	1	16	1	8993	0	9011
13983	4	0	8913	2	0	8919
13984	2	7	0	9007	0	9016
13985	9055	0	9	3	0	9067
13986	0	9074	0	4	0	9078
13987	16	3	9030	0	0	9049
13988	6	9383	0	10	0	9399
13989	0	9109	0	3	0	9112
13990	9105	0	21	3	0	9129
13991	9096	0	12	4	0	9112
13992	0	0	9219	0	0	9219
13993	1	9215	0	3	0	9219
13994	0	16	0	9154	0	9170
13995	0	18	0	9179	0	9197
13996	0	16	1	9176	0	9193
13997	6	0	9748	3	0	9757
13998	4	16	0	10027	0	10047
13999	1	12	0	9992	0	10005
14000	9682	1	4	3	0	9690
14001	9273	0	9	0	0	9282
14002	9430	1	13	2	0	9446
14003	9510	0	18	0	0	9528
14004	9491	2	26	1	0	9520
14005	1	9363	1	5	0	9370
14006	8903	13	15	0	0	8931
14007	4	0	9320	0	0	9324
14008	5	16	0	9685	0	9706
14009	9777	1	12	0	0	9790
14010	1	9800	0	6	0	9807
14011	9644	0	30	6	0	9680
14012	10213	1	8	2	0	10224
14013	1	10	0	10171	0	10182
14014	3	17	3	10072	0	10095
14015	0	10194	0	1	0	10195
14016	4	23	0	9911	0	9938
14017	1	0	10014	1	0	10016
14018	2	13	1	10253	0	10269
14019	3	0	10193	1	0	10197
14020	10475	1	23	3	0	10502
14021	3	21	0	10016	0	10040
14022	7	0	10081	0	0	10088
14023	3	9511	1	4	0	9519
14024	0	9258	1	7	0	9266
14025	9441	0	21	4	0	9466
14026	2	21	0	9088	0	9111
14027	5	0	9042	4	0	9051
14028	0	9046	1	12	0	9059
14029	5	0	9055	0	0	9060
14030	9060	0	29	1	0	9090
14031	8939	0	25	0	0	8964
14032	9076	0	22	0	0	9098
14033	0	8	0	9128	0	9136
14034	4	0	8983	3	0	8990
14035	0	9240	0	5	0	9245
14036	2	20	9	9084	0	9115
14037	5	0	9303	1	0	9309
14038	1	0	9458	4	0	9463
14039	4	27	0	9736	0	9767
14040	9670	1	21	2	0	9694
14041	0	17	0	9620	0	9637
14042	2	13	0	9502	0	9517
14043	5	0	9763	0	0	9768
14044	0	21	1	9781	0	9803
14045	3	15	2	9455	0	9475
14046	10	0	9285	0	0	9295
14047	1	0	9452	1	0	9454
14048	3	26	4	9632	0	9665
14049	6	0	9728	1	0	9735
14050	1	9	1	9723	0	9734
14051	9727	0	11	3	0	9741
14052	1	9637	0	31	0	9669
14053	2	17	0	9871	0	9890
14054	2	0	10070	1	0	10073
14055	10680	0	24	1	0	10705
14056	0	10539	0	0	0	10539
14057	10429	0	24	1	0	10454
14058	2	11	1	10445	0	10459
14059	0	14	2	10443	0	10459
14060	10563	1	21	0	0	10585
14061	0	0	10556	0	0	10556
14062	10649	4	28	2	0	10683
14063	0	11	0	10467	0	10478
14064	10093	1	34	1	0	10129
14065	10297	0	22	0	0	10319
14066	3	14	1	10299	0	10317
14067	1	10537	0	1	0	10539
14068	10451	0	23	0	0	10474
14069	10270	1	22	1	0	10294
14070	10	0	10286	0	0	10296
14071	10503	1	28	2	0	10534
14072	6	18	1	10691	0	10716
14073	1	10300	0	2	0	10303
14074	4	20	0	10002	0	10026
14075	3	10188	0	7	0	10198
14076	10270	0	16	1	0	10287
14077	10513	1	16	0	0	10530
14078	0	17	2	10427	0	10446
14079	3	0	10424	1	0	10428
14080	4	0	10468	0	0	10472
14081	3	11	0	10656	0	10670
14082	10644	0	13	0	0	10657
14083	10334	1	13	4	0	10352
14084	1	10295	0	4	0	10300
14085	2	18	2	10410	0	10432
14086	3	0	10305	0	0	10308
14087	2	0	10383	0	0	10385
14088	1	7	0	9955	0	9963
14089	9932	0	20	0	0	9952
14090	2	12	0	9971	0	9985
14091	5	1	9696	1	0	9703
14092	10148	0	10	6	0	10164
14093	1	22	0	9855	0	9878
14094	1	27	0	9793	0	9821
14095	3	3	0	9707	0	9713
14096	1	9577	1	7	0	9586
14097	11	0	9590	0	0	9601
14098	6	0	10060	0	0	10066
14099	1	5	1	10128	0	10135
14100	2	0	10083	1	0	10086
14101	10221	1	11	3	0	10236
14102	0	34	0	10911	0	10945
14103	0	13	1	11033	0	11047
14104	3	21	0	11040	0	11064
14105	0	11100	0	4	0	11104
14106	11161	1	18	0	0	11180
14107	3	5	0	11222	0	11230
14108	11418	1	25	0	0	11444
14109	2	11302	0	11	0	11315
14110	10842	0	27	0	0	10869
14111	10566	0	299	3	0	10868
14112	10797	2	67	1	0	10867
14113	0	10660	0	4	0	10664
14114	0	10374	0	3	0	10377
14115	10328	1	6	1	0	10336
14116	0	10239	0	5	0	10244
14117	17	0	10216	2	0	10235
14118	8	9926	2	0	0	9936
14119	2	9892	0	8	0	9902
14120	9864	3	10	5	0	9882
14121	9	0	9914	1	0	9924
14122	5	1	10482	0	0	10488
14123	0	33	0	10362	0	10395
14124	10030	0	53	1	0	10084
14125	3	0	9951	0	0	9954
14126	2	13	0	9952	0	9967
14127	9	0	9866	0	0	9875
14128	1	0	10026	1	0	10028
14129	9410	1	25	2	0	9438
14130	3	0	9278	0	0	9281
14131	0	40	0	8591	0	8631
14132	2	27	0	8558	0	8587
14133	5	8581	0	4	0	8590
14134	2	8650	0	4	0	8656
14135	0	11	1	8644	0	8656
14136	4	0	8742	0	0	8746
14137	0	55	2	8563	0	8620
14138	1	28	1	8717	0	8747
14139	4	0	8754	0	0	8758
14140	1	8	1	9018	0	9028
14141	8785	0	9	0	0	8794
14142	1	0	8853	2	0	8856
14143	8523	0	20	1	0	8544
14144	0	11	1	8637	0	8649
14145	1	14	1	8361	0	8377
14146	3	8324	0	0	0	8327
14147	1	16	1	8380	0	8398
14148	1	6	1	8380	0	8388
14149	8561	0	4	2	0	8567
14150	2	10	1	8642	0	8655
14151	3	6	1	8722	0	8732
14152	8873	1	9	0	0	8883
14153	3	25	0	8592	0	8620
14154	4	13	2	8632	0	8651
14155	1	8659	1	6	0	8667
14156	8115	0	11	0	0	8126
14157	0	9	0	8226	0	8235
14158	1	14	0	8178	0	8193
14159	4	0	8600	0	0	8604
14160	1	5	1	8507	0	8514
14161	1	6	1	9036	0	9044
14162	8903	0	9	3	0	8915
14163	8861	1	32	2	0	8896
14164	0	7	1	9273	0	9281
14165	7	0	9348	0	0	9355
14166	3	9352	2	2	0	9359
14167	1	9478	0	4	0	9483
14168	7	11	0	9148	0	9166
14169	10228	1	9	0	0	10238
14170	3	13	1	10405	0	10422
14171	10574	0	7	2	0	10583
14172	2	18	3	10547	0	10570
14173	2	8	0	10004	0	10014
14174	9997	1	9	1	0	10008
14175	10114	2	8	0	0	10124
14176	1	10082	0	0	0	10083
14177	1	9956	0	4	0	9961
14178	0	18	0	9233	0	9251
14179	1	16	1	8997	0	9015
14180	6	0	9034	6	0	9046
14181	9057	0	15	4	0	9076
14182	6	9176	0	1	0	9183
14183	0	9153	1	8	0	9162
14184	8850	3	16	4	0	8873
14185	1	0	8953	3	0	8957
14186	4	1	9045	2	0	9052
14187	5	0	9236	1	0	9242
14188	1	9258	1	5	0	9265
14189	0	32	0	9144	0	9176
14190	2	11	0	9183	0	9196
14191	0	6	0	9209	0	9215
14192	9179	0	9	1	0	9189
14193	9218	0	21	1	0	9240
14194	0	9303	0	4	0	9307
14195	3	27	0	8828	0	8858
14196	5	1	8823	1	0	8830
14197	1	8782	1	6	0	8790
14198	8747	0	26	3	0	8776
14199	0	1	8782	0	0	8783
14200	8869	0	18	5	0	8892
14201	3	0	9038	1	0	9042
14202	3	17	0	9285	0	9305
14203	2	9192	0	3	0	9197
14204	9254	0	28	2	0	9284
14205	1	9270	0	6	0	9277
14206	9302	0	19	3	0	9324
14207	1	9	1	9472	0	9483
14208	5	0	9341	0	0	9346
14209	0	17	0	9696	0	9713
14210	0	22	0	9303	0	9325
14211	1	0	9323	0	0	9324
14212	9223	0	17	6	0	9246
14213	0	9215	0	2	0	9217
14214	8995	3	14	1	0	9013
14215	0	8922	0	2	0	8924
14216	2	17	1	8997	0	9017
14217	3	0	9152	3	0	9158
14218	9243	1	12	5	0	9261
14219	1	9163	0	3	0	9167
14220	0	12	1	9174	0	9187
14221	0	8	1	9210	0	9219
14222	9120	0	4	0	0	9124
14223	9023	0	20	2	0	9045
14224	0	9163	1	1	0	9165
14225	8922	0	16	4	0	8942
14226	8686	1	16	1	0	8704
14227	8345	2	17	1	0	8365
14228	5	0	8421	1	0	8427
14229	3	8808	0	6	0	8817
14230	1	8719	0	2	0	8722
14231	4	16	0	8695	0	8715
14232	0	11	0	8746	0	8757
14233	8712	0	12	1	0	8725
14234	0	8438	0	1	0	8439
14235	8383	0	17	0	0	8400
14236	1	12	1	8385	0	8399
14237	1	11	2	7451	0	7465
14238	7528	0	5	1	0	7534
14239	7459	2	10	2	0	7473
14240	2	0	7223	0	0	7225
14241	2	10	1	7061	0	7074
14242	4	0	6886	0	0	6890
14243	0	0	6718	2	0	6720
14244	17	0	6726	2	0	6745
14245	5948	0	7	1	0	5956
14246	1	15	0	5880	0	5896
14247	0	14	0	5805	0	5819
14248	0	7	0	5851	0	5858
14249	0	0	5937	0	0	5937
14250	3	7	0	5895	0	5905
14251	1	9	1	5770	0	5781
14252	5656	0	13	0	0	5669
14253	5673	0	7	1	0	5681
14254	5680	0	6	1	0	5687
14255	5737	0	11	1	0	5749
14256	0	10	0	5665	0	5675
14257	5712	0	6	0	0	5718
14258	0	5	0	5467	0	5472
14259	1	0	5444	0	0	5445
14260	5451	0	54	1	0	5506
14261	1	5353	0	3	0	5357
14262	1	13	5	5155	0	5174
14263	2	11	1	5238	0	5252
14264	1	5249	0	0	0	5250
14265	5332	1	14	2	0	5349
14266	0	5414	0	2	0	5416
14267	8	0	5368	1	0	5377
14268	5	0	5471	0	0	5476
14269	5420	0	8	3	0	5431
14270	5166	0	22	2	0	5190
14271	1	3	5189	0	0	5193
14272	4967	0	12	1	0	4980
14273	1	0	5021	0	0	5022
14274	4829	0	18	2	0	4849
14275	5	0	4898	0	0	4903
14276	0	0	4974	0	0	4974
14277	1	9	0	4538	0	4548
14278	1	10	0	4565	0	4576
14279	4565	0	10	0	0	4575
14280	4559	3	7	0	0	4569
14281	4504	0	5	0	0	4509
14282	4515	2	4	1	0	4522
14283	0	4449	0	0	0	4449
14284	0	12	1	4090	0	4103
14285	1	4109	0	0	0	4110
14286	0	19	0	4088	0	4107
14287	1	8	0	4099	0	4108
14288	0	14	0	4073	0	4087
14289	2	0	4066	0	0	4068
14290	4133	0	7	0	0	4140
14291	1	4436	0	1	0	4438
14292	0	3854	0	6	0	3860
14293	1	0	3814	0	0	3815
14294	3	5	1	3753	0	3762
14295	0	4	0	3758	0	3762
14296	3996	0	3	2	0	4001
14297	0	0	0	3932	0	3932
14298	0	2	0	3889	0	3891
14299	0	1	0	3885	0	3886
14300	11	0	0	3721	0	3732
14301	3844	0	4	0	0	3848
14302	3842	0	6	0	0	3848
14303	3884	0	3	0	0	3887
14304	0	2	0	3696	0	3698
14305	3263	0	2	0	0	3265
14306	0	1	0	3216	0	3217
14307	0	4	0	3225	0	3229
14308	1	0	3178	2	0	3181
14309	5	0	3309	1	0	3315
14310	0	0	3265	1	0	3266
14311	3249	0	7	2	0	3258
14312	0	9	0	3209	0	3218
14313	0	3205	1	0	0	3206
14314	3215	0	6	0	0	3221
14315	0	1	3259	0	0	3260
14316	3367	0	7	0	0	3374
14317	1	3382	0	0	0	3383
14318	3278	1	6	1	0	3286
14319	0	7	0	3252	0	3259
14320	3425	0	0	0	0	3425
14321	1	3422	1	0	0	3424
14322	0	3451	0	3	0	3454
14323	3421	0	3	1	0	3425
14324	1	3370	0	1	0	3372
14325	2	3428	0	1	0	3431
14326	0	3425	0	4	0	3429
14327	3476	0	2	1	0	3479
14328	3462	0	3	1	0	3466
14329	3426	0	3	0	0	3429
14330	1	5	0	3411	0	3417
14331	0	15	0	3388	0	3403
14332	3	0	3552	0	0	3555
14333	3	10	1	3494	0	3508
14334	2	1	3499	0	0	3502
14335	0	17	1	3483	0	3501
14336	1	0	1	3434	0	3436
14337	3370	0	8	0	0	3378
14338	3407	0	5	2	0	3414
14339	1	3342	0	0	0	3343
14340	2	9	0	3318	0	3329
14341	0	0	3352	0	0	3352
14342	0	11	1	3252	0	3264
14343	1	2	0	3260	0	3263
14344	0	5	0	3166	0	3171
14345	3	1	3156	0	0	3160
14346	0	0	3177	0	0	3177
14347	3281	0	4	0	0	3285
14348	0	5	0	3241	0	3246
14349	1	0	3238	0	0	3239
14350	3205	1	4	1	0	3211
14351	0	3154	0	1	0	3155
14352	3128	1	7	0	0	3136
14353	0	0	3177	0	0	3177
14354	3254	0	12	0	0	3266
14355	1	6	0	3237	0	3244
14356	4	0	3257	0	0	3261
14357	0	3343	0	4	0	3347
14358	3507	0	5	0	0	3512
14359	3	13	0	3418	0	3434
14360	0	9	0	3358	0	3367
14361	0	3368	0	2	0	3370
14362	2	3	0	3309	0	3314
14363	1	0	3372	0	0	3373
14364	0	3426	0	5	0	3431
14365	3388	0	2	0	0	3390
14366	0	4	0	3375	0	3379
14367	0	10	1	3053	0	3064
14368	2	0	3207	0	0	3209
14369	1	8	0	3246	0	3255
14370	3	1	3228	0	0	3232
14371	0	3077	0	4	0	3081
14372	3025	0	4	0	0	3029
14373	3000	1	7	0	0	3008
14374	3047	2	4	0	0	3053
14375	0	3150	0	2	0	3152
14376	1	8	0	3133	0	3142
14377	0	4	0	3031	0	3035
14378	0	1	0	3021	0	3022
14379	3001	1	5	0	0	3007
14380	2988	0	5	1	0	2994
14381	0	7	0	2983	0	2990
14382	1	0	3095	1	0	3097
14383	0	16	0	3133	0	3149
14384	0	4	0	3046	0	3050
14385	0	4	0	2969	0	2973
14386	0	1	1	2973	0	2975
14387	3123	0	0	0	0	3123
14388	1	4	0	3186	0	3191
14389	0	4	0	3267	0	3271
14390	0	3257	0	1	0	3258
14391	0	8	0	3144	0	3152
14392	0	3285	0	2	0	3287
14393	3	11	1	3278	0	3293
14394	3366	0	7	0	0	3373
14395	0	3356	0	2	0	3358
14396	3164	3	8	2	0	3177
14397	2	0	3223	0	0	3225
14398	1	6	0	3155	0	3162
14399	3	0	3188	0	0	3191
14400	0	14	0	3109	0	3123
14401	3	10	0	3020	0	3033
14402	1	3054	0	1	0	3056
14403	0	3040	0	2	0	3042
14404	1	3032	0	0	0	3033
14405	3087	0	2	1	0	3090
14406	0	3147	0	1	0	3148
14407	1	2964	0	2	0	2967
14408	0	4	0	2937	0	2941
14409	2930	0	3	0	0	2933
14410	0	2987	0	2	0	2989
14411	2971	1	4	0	0	2976
14412	2960	0	14	0	0	2974
14413	1	0	3094	0	0	3095
14414	0	2	0	3198	0	3200
14415	0	1	0	3119	0	3120
14416	0	7	0	3132	0	3139
14417	0	7	1	3092	0	3100
14418	3	1	3082	2	0	3088
14419	1	0	3099	3	0	3103
14420	3193	1	6	1	0	3201
14421	1	3191	0	16	0	3208
14422	2	3164	0	5	0	3171
14423	3171	0	8	1	0	3180
14424	0	3269	0	3	0	3272
14425	0	2	0	3269	0	3271
14426	3276	0	3	1	0	3280
14427	1	0	3247	0	0	3248
14428	0	0	1	3337	0	3338
14429	0	1	3308	1	0	3310
14430	3284	0	15	2	0	3301
14431	1	1	3349	0	0	3351
14432	3368	1	10	1	0	3380
14433	3406	0	2	0	0	3408
14434	3237	0	10	0	0	3247
14435	3245	0	3	0	0	3248
14436	3271	0	6	0	0	3277
14437	0	3	0	3366	0	3369
14438	3371	0	6	1	0	3378
14439	0	1	0	3345	0	3346
14440	1	4	0	3283	0	3288
14441	0	1	0	3335	0	3336
14442	3	0	3355	0	0	3358
14443	0	6	0	3372	0	3378
14444	0	10	0	3275	0	3285
14445	0	0	3287	0	0	3287
14446	3304	0	9	2	0	3315
14447	1	4	0	3332	0	3337
14448	3	1	3309	0	0	3313
14449	0	0	3375	1	0	3376
14450	2	4	0	3525	0	3531
14451	0	0	3448	0	0	3448
14452	1	15	1	3476	0	3493
14453	2	8	0	3475	0	3485
14454	2	3522	0	2	0	3526
14455	0	3552	0	2	0	3554
14456	3562	0	8	2	0	3572
14457	1	6	0	3558	0	3565
14458	2	8	0	3422	0	3432
14459	2	3	0	3411	0	3416
14460	0	0	3384	0	0	3384
14461	0	3	0	3815	0	3818
14462	3803	0	4	0	0	3807
14463	0	0	3700	0	0	3700
14464	3	10	1	3616	0	3630
14465	0	2	0	3493	0	3495
14466	0	4	0	3425	0	3429
14467	0	3321	0	1	0	3322
14468	3324	1	12	0	0	3337
14469	3383	0	1	0	0	3384
14470	0	3245	0	5	0	3250
14471	0	11	0	3221	0	3232
14472	1	0	3246	0	0	3247
14473	1	0	3339	0	0	3340
14474	3351	2	10	1	0	3364
14475	0	5	0	3310	0	3315
14476	3295	0	7	1	0	3303
14477	2	3321	0	4	0	3327
14478	1	3287	0	4	0	3292
14479	3386	0	3	0	0	3389
14480	0	3394	0	0	0	3394
14481	0	5	0	3408	0	3413
14482	0	7	0	3447	0	3454
14483	0	3439	0	1	0	3440
14484	3424	0	10	1	0	3435
14485	1	0	3424	1	0	3426
14486	3410	0	3	3	0	3416
14487	3	0	3476	0	0	3479
14488	3394	1	7	1	0	3403
14489	0	0	3352	0	0	3352
14490	2	3444	0	0	0	3446
14491	1	3	0	3447	0	3451
14492	3463	0	5	1	0	3469
14493	2	0	3466	0	0	3468
14494	3	0	3593	0	0	3596
14495	0	7	0	3567	0	3574
14496	4	0	3539	0	0	3543
14497	1	11	3	3619	0	3634
14498	1	7	0	3551	0	3559
14499	1	0	3676	0	0	3677
14500	2	4	0	3585	0	3591
14501	3616	1	2	1	0	3620
14502	0	3621	0	3	0	3624
14503	3481	0	1	0	0	3482
14504	0	4	0	3529	0	3533
14505	3506	1	4	0	0	3511
14506	3523	0	31	0	0	3554
14507	0	10	1	3590	0	3601
14508	0	3530	0	1	0	3531
14509	3414	0	2	0	0	3416
14510	0	0	3445	0	0	3445
14511	0	0	3468	1	0	3469
14512	3465	0	7	0	0	3472
14513	1	2	0	3376	0	3379
14514	0	0	3385	0	0	3385
14515	1	4	1	3397	0	3403
14516	3387	0	6	0	0	3393
14517	3429	0	15	0	0	3444
14518	3434	5	11	1	0	3451
14519	0	3637	0	3	0	3640
14520	0	8	0	3557	0	3565
14521	1	4	0	3549	0	3554
14522	3547	0	8	0	0	3555
14523	0	3573	0	2	0	3575
14524	3578	0	9	0	0	3587
14525	1	10	0	3564	0	3575
14526	3392	0	2	0	0	3394
14527	2	0	3682	1	0	3685
14528	2	3615	0	7	0	3624
14529	0	3	0	3662	0	3665
14530	0	3725	0	1	0	3726
14531	1	7	0	3743	0	3751
14532	3766	0	8	0	0	3774
14533	0	1	3767	0	0	3768
14534	3846	0	7	1	0	3854
14535	0	3860	0	1	0	3861
14536	1	2	1	3409	0	3413
14537	0	1	0	3422	0	3423
14538	3389	1	11	0	0	3401
14539	2	0	3505	0	0	3507
14540	0	13	0	3642	0	3655
14541	0	8	0	3599	0	3607
14542	0	9	0	3674	0	3683
14543	0	1	0	3676	0	3677
14544	3674	0	1	2	0	3677
14545	3644	1	6	1	0	3652
14546	1	0	3663	0	0	3664
14547	1	0	3787	1	0	3789
14548	3693	0	4	0	0	3697
14549	3722	0	8	0	0	3730
14550	0	7	2	3800	0	3809
14551	0	3	0	3819	0	3822
14552	3862	0	3	0	0	3865
14553	0	3811	0	2	0	3813
14554	1	10	1	3827	0	3839
14555	1	7	0	3897	0	3905
14556	0	0	3907	0	0	3907
14557	1	6	0	3965	0	3972
14558	2	1	3997	0	0	4000
14559	1	2	0	4002	0	4005
14560	4002	2	5	0	0	4009
14561	0	2	2	3975	0	3979
14562	0	0	3907	1	0	3908
14563	0	3927	0	4	0	3931
14564	1	10	0	3838	0	3849
14565	3	0	3850	0	0	3853
14566	0	3918	1	2	0	3921
14567	4	17	0	3900	0	3921
14568	2	0	3919	3	0	3924
14569	3966	0	7	0	0	3973
14570	0	3897	0	0	0	3897
14571	0	3798	0	11	0	3809
14572	0	3660	0	1	0	3661
14573	1	2	0	3808	0	3811
14574	6	0	3980	0	0	3986
14575	1	4138	1	6	0	4146
14576	0	3	0	4148	0	4151
14577	4190	0	11	0	0	4201
14578	1	6	0	4167	0	4174
14579	3	0	4126	2	0	4131
14580	1	4102	0	1	0	4104
14581	4061	0	30	4	0	4095
14582	0	4072	0	2	0	4074
14583	3	0	3956	3	0	3962
14584	0	3903	0	2	0	3905
14585	0	4	0	3917	0	3921
14586	3	0	4011	2	0	4016
14587	0	4017	0	0	0	4017
14588	0	9	0	4036	0	4045
14589	1	9	0	4031	0	4041
14590	0	3994	0	2	0	3996
14591	2	2	0	3971	0	3975
14592	5	0	4013	0	0	4018
14593	3	0	3998	1	0	4002
14594	0	5	0	4007	0	4012
14595	3782	0	1	0	0	3783
14596	3859	0	9	0	0	3868
14597	0	2	0	3926	0	3928
14598	0	3975	0	0	0	3975
14599	0	2	1	3960	0	3963
14600	3998	0	4	0	0	4002
14601	0	0	0	3988	0	3988
14602	0	2	0	3979	0	3981
14603	3648	0	4	0	0	3652
14604	0	3670	0	0	0	3670
14605	0	3	1	3543	0	3547
14606	3559	1	2	0	0	3562
14607	0	0	3621	0	0	3621
14608	3671	0	7	1	0	3679
14609	0	24	0	3653	0	3677
14610	3613	0	1	0	0	3614
14611	3607	0	5	0	0	3612
14612	3641	0	6	0	0	3647
14613	0	3637	0	13	0	3650
14614	11	0	3624	1	0	3636
14615	1	3534	0	1	0	3536
14616	3416	0	15	0	0	3431
14617	0	3474	0	2	0	3476
14618	0	0	0	3398	0	3398
14619	3422	1	7	1	0	3431
14620	0	3404	0	2	0	3406
14621	1	0	3397	1	0	3399
14622	1	7	0	3355	0	3363
14623	2	0	3238	1	0	3241
14624	0	3253	0	2	0	3255
14625	0	10	0	3221	0	3231
14626	0	8	0	3283	0	3291
14627	0	4	0	3490	0	3494
14628	3	11	0	3454	0	3468
14629	0	3410	0	0	0	3410
14630	3379	1	12	0	0	3392
14631	0	0	3328	0	0	3328
14632	0	2	0	3302	0	3304
14633	3179	1	8	0	0	3188
14634	1	0	3137	4	0	3142
14635	0	3159	0	0	0	3159
14636	1	9	0	3139	0	3149
14637	2	0	3167	0	0	3169
14638	1	3060	0	2	0	3063
14639	3087	0	4	1	0	3092
14640	0	3183	0	3	0	3186
14641	1	9	0	3094	0	3104
14642	0	1	0	3285	0	3286
14643	3305	0	4	0	0	3309
14644	0	3523	0	1	0	3524
14645	0	2	0	3516	0	3518
14646	3458	2	3	0	0	3463
14647	3464	1	5	2	0	3472
14648	0	3490	0	0	0	3490
14649	3278	0	3	1	0	3282
14650	3152	0	7	1	0	3160
14651	0	6	0	3020	0	3026
14652	0	0	3029	1	0	3030
14653	0	2	0	2981	0	2983
14654	2	2	1	2947	0	2952
14655	2	0	2926	1	0	2929
14656	0	3075	0	0	0	3075
14657	0	10	0	3047	0	3057
14658	1	12	0	3052	0	3065
14659	0	3	0	3043	0	3046
14660	0	2	0	3060	0	3062
14661	0	2930	0	0	0	2930
14662	2939	0	11	0	0	2950
14663	2937	1	5	0	0	2943
14664	2910	7	17	0	0	2934
14665	0	2880	0	1	0	2881
14666	0	5	0	2845	0	2850
14667	1	0	2888	0	0	2889
14668	0	4	0	2914	0	2918
14669	2	2903	0	1	0	2906
14670	2956	1	8	0	0	2965
14671	2960	0	6	0	0	2966
14672	2882	0	9	0	0	2891
14673	0	2805	0	0	0	2805
14674	0	2760	1	2	0	2763
14675	4	2731	0	3	0	2738
14676	1	1	2697	0	0	2699
14677	3	0	2663	0	0	2666
14678	0	6	0	2681	0	2687
14679	2751	0	2	0	0	2753
14680	2728	0	1	0	0	2729
14681	0	8	0	2750	0	2758
14682	0	5	1	2646	0	2652
14683	0	4	0	2565	0	2569
14684	0	1	0	2533	0	2534
14685	2533	0	1	0	0	2534
14686	2524	0	8	0	0	2532
14687	0	2546	0	0	0	2546
14688	2542	0	5	0	0	2547
14689	2573	0	1	0	0	2574
14690	2518	0	15	3	0	2536
14691	0	0	2500	0	0	2500
14692	2499	0	8	0	0	2507
14693	0	2578	0	0	0	2578
14694	0	3	0	2681	0	2684
14695	0	10	0	2709	0	2719
14696	0	2709	0	0	0	2709
14697	1	2	0	2716	0	2719
14698	2711	0	4	0	0	2715
14699	0	2	0	2787	0	2789
14700	1	0	2692	0	0	2693
14701	2737	2	8	1	0	2748
14702	0	2678	1	1	0	2680
14703	0	0	1	2469	0	2470
14704	0	3	0	2728	0	2731
14705	1	4	1	2713	0	2719
14706	0	0	2739	0	0	2739
14707	1	2711	0	4	0	2716
14708	1	4	0	2712	0	2717
14709	1	0	2749	0	0	2750
14710	0	8	0	2728	0	2736
14711	2	0	2978	0	0	2980
14712	1	28	0	2981	0	3010
14713	0	2971	0	2	0	2973
14714	1	1	0	2979	0	2981
14715	2967	0	7	0	0	2974
14716	2843	0	10	1	0	2854
14717	0	2	2873	1	0	2876
14718	3	1	2753	1	0	2758
14719	1	0	2759	0	0	2760
14720	0	1	0	2489	0	2490
14721	0	2	0	2473	0	2475
14722	1	3	0	2552	0	2556
14723	0	2571	0	0	0	2571
14724	0	5	0	2576	0	2581
14725	1	16	0	2581	0	2598
14726	0	1	0	2635	0	2636
14727	2665	0	0	0	0	2665
14728	2641	0	17	3	0	2661
14729	1	0	2669	0	0	2670
14730	4	0	2702	1	0	2707
14731	2631	0	5	2	0	2638
14732	2546	0	1	0	0	2547
14733	2	0	2534	1	0	2537
14734	1	0	2580	0	0	2581
14735	2667	1	2	1	0	2671
14736	2633	1	10	0	0	2644
14737	3	0	2676	0	0	2679
14738	0	17	0	2674	0	2691
14739	1	1	0	2679	0	2681
14740	0	2655	0	0	0	2655
14741	2	3	0	2747	0	2752
14742	1	0	2762	0	0	2763
14743	0	1	0	2873	0	2874
14744	1	9	0	2836	0	2846
14745	5	0	2873	0	0	2878
14746	2881	0	5	1	0	2887
14747	2914	0	7	0	0	2921
14748	1	3	1	2923	0	2928
14749	0	8	0	3014	0	3022
14750	3038	0	3	1	0	3042
14751	3188	0	10	0	0	3198
14752	3192	0	6	0	0	3198
14753	3236	1	8	1	0	3246
14754	0	3263	0	1	0	3264
14755	3212	0	10	1	0	3223
14756	0	3278	0	1	0	3279
14757	0	8	1	3286	0	3295
14758	1	15	0	3284	0	3300
14759	0	3342	0	0	0	3342
14760	1	9	1	3302	0	3313
14761	0	5	0	3564	0	3569
14762	0	3614	0	1	0	3615
14763	0	5	0	3564	0	3569
14764	0	11	0	3595	0	3606
14765	0	2	0	3562	0	3564
14766	2	0	3790	4	0	3796
14767	0	3848	0	9	0	3857
14768	1	2	0	3814	0	3817
14769	0	3861	0	2	0	3863
14770	3790	2	3	0	0	3795
14771	0	0	4284	1	0	4285
14772	1	0	4298	1	0	4300
14773	4378	1	7	0	0	4386
14774	0	6	1	4655	0	4662
14775	1	0	4647	1	0	4649
14776	5	0	4882	2	0	4889
14777	1	5	0	4985	0	4991
14778	4968	1	7	1	0	4977
14779	5046	1	8	0	0	5055
14780	0	0	1	4794	0	4795
14781	208	0	4591	1	0	4800
14782	0	4814	0	2	0	4816
14783	0	11	0	4754	0	4765
14784	5	1	4851	1	0	4858
14785	1	4592	0	5	0	4598
14786	1	6	2	4610	0	4619
14787	4709	0	2	0	0	4711
14788	2	5	6	4658	0	4671
14789	1	4716	0	0	0	4717
14790	4681	1	11	1	0	4694
14791	0	0	4711	0	0	4711
14792	0	4685	0	3	0	4688
14793	1	0	4727	0	0	4728
14794	4875	0	1	0	0	4876
14795	2	7	0	4907	0	4916
14796	0	7	0	4962	0	4969
14797	4971	1	7	0	0	4979
14798	0	5	1	4975	0	4981
14799	7	0	4977	2	0	4986
14800	4981	0	7	3	0	4991
14801	1	5223	0	0	0	5224
14802	0	9	1	5170	0	5180
14803	5139	0	3	1	0	5143
14804	0	5189	0	4	0	5193
14805	3	3	0	5156	0	5162
14806	5274	3	3	0	0	5280
14807	2	5	0	5334	0	5341
14808	1	5519	0	3	0	5523
14809	80	0	5589	0	0	5669
14810	1	8	0	5628	0	5637
14811	0	4	0	5619	0	5623
14812	5660	0	11	0	0	5671
14813	0	4	0	5661	0	5665
14814	5658	0	9	0	0	5667
14815	5695	3	13	0	0	5711
14816	0	10	0	5769	0	5779
14817	1	5830	0	1	0	5832
14818	0	8	0	5838	0	5846
14819	5869	2	8	3	0	5882
14820	3	5812	1	3	0	5819
14821	3	5793	0	11	0	5807
14822	5878	3	8	0	0	5889
14823	5900	0	8	1	0	5909
14824	0	5955	0	2	0	5957
14825	5781	0	11	0	0	5792
14826	5824	1	8	0	0	5833
14827	0	6	1	5643	0	5650
14828	1	1	5869	1	0	5872
14829	5	19	0	5897	0	5921
14830	1	0	5898	0	0	5899
14831	2	16	0	5888	0	5906
14832	1	0	5851	0	0	5852
14833	6313	0	31	1	0	6345
14834	1	10	0	6394	0	6405
14835	6300	0	6	1	0	6307
14836	0	24	0	6282	0	6306
14837	1	6023	1	3	0	6028
14838	5964	0	22	0	0	5986
14839	1	0	6078	1	0	6080
14840	6125	0	3	3	0	6131
14841	2	6025	1	1	0	6029
14842	5777	0	8	0	0	5785
14843	5872	0	5	0	0	5877
14844	0	5976	0	1	0	5977
14845	1	9	0	5984	0	5994
14846	6004	0	7	1	0	6012
14847	0	5609	0	1	0	5610
14848	2	9	0	5512	0	5523
14849	5597	0	2	1	0	5600
14850	1	11	0	5313	0	5325
14851	0	15	1	5290	0	5306
14852	0	15	0	5083	0	5098
14853	0	0	5020	0	0	5020
14854	1	10	0	5065	0	5076
14855	4967	0	4	2	0	4973
14856	1	0	4987	0	0	4988
14857	3	1	0	4988	0	4992
14858	1	5	0	4916	0	4922
14859	1	0	4920	1	0	4922
14860	4752	1	16	4	0	4773
14861	4749	0	10	1	0	4760
14862	1	0	4830	0	0	4831
14863	1	9	0	4959	0	4969
14864	0	10	0	4930	0	4940
14865	6	0	5024	0	0	5030
14866	0	8	2	5098	0	5108
14867	2	81	0	4993	0	5076
14868	1	0	5203	1	0	5205
14869	5113	0	12	6	0	5131
14870	0	6	0	5048	0	5054
14871	5015	0	18	0	0	5033
14872	4982	2	10	2	0	4996
14873	0	0	5180	0	0	5180
14874	3	10	1	5111	0	5125
14875	5083	0	2	0	0	5085
14876	2	4986	0	0	0	4988
14877	8	13	0	4874	0	4895
14878	0	10	0	4895	0	4905
14879	0	4	1	4880	0	4885
14880	2	0	4845	0	0	4847
14881	4879	0	17	1	0	4897
14882	0	7	0	4774	0	4781
14883	0	7	0	4677	0	4684
14884	3	0	4560	0	0	4563
14885	1	11	0	4514	0	4526
14886	0	3	1	4502	0	4506
14887	4519	1	9	0	0	4529
14888	0	4491	0	14	0	4505
14889	12	0	4486	0	0	4498
14890	4586	1	7	2	0	4596
14891	0	22	0	4559	0	4581
14892	3	0	4486	0	0	4489
14893	4	0	4350	1	0	4355
14894	2	9	0	4340	0	4351
14895	2	0	4316	0	0	4318
14896	3	3	4302	0	0	4308
14897	0	4221	0	0	0	4221
14898	1	6	1	4179	0	4187
14899	3	0	4509	0	0	4512
14900	0	3	0	5009	0	5012
14901	5002	0	4	0	0	5006
14902	0	7	0	4927	0	4934
14903	0	5	0	4895	0	4900
14904	4941	0	4	1	0	4946
14905	5384	0	4	0	0	5388
14906	1	12	0	5361	0	5374
14907	4	0	5337	1	0	5342
14908	0	5003	0	1	0	5004
14909	2	5	0	4768	0	4775
14910	4775	0	6	45	0	4826
14911	5163	0	11	4	0	5178
14912	0	5402	0	1	0	5403
14913	2	5391	0	2	0	5395
14914	5344	0	5	2	0	5351
14915	5239	0	22	4	0	5265
14916	4	0	5279	0	0	5283
14917	0	7	1	5250	0	5258
14918	0	5212	0	3	0	5215
14919	5165	0	5	0	0	5170
14920	0	13	2	4976	0	4991
14921	0	5079	0	2	0	5081
14922	1	0	5131	0	0	5132
14923	1	7	0	5200	0	5208
14924	1	5096	0	2	0	5099
14925	5090	0	6	1	0	5097
14926	5136	0	9	1	0	5146
14927	1	5127	0	5	0	5133
14928	5162	0	10	1	0	5173
14929	5438	2	11	2	0	5453
14930	0	5434	0	1	0	5435
14931	1	5662	0	2	0	5665
14932	0	12	1	5656	0	5669
14933	5665	1	4	2	0	5672
14934	0	0	5684	1	0	5685
14935	5664	1	33	3	0	5701
14936	3	5689	0	0	0	5692
14937	5514	1	11	1	0	5527
14938	5512	1	4	0	0	5517
14939	5523	0	8	0	0	5531
14940	2	6	0	5506	0	5514
14941	0	5418	0	2	0	5420
14942	5301	2	10	1	0	5314
14943	2	0	5335	0	0	5337
14944	0	5214	0	1	0	5215
14945	1	7	0	5187	0	5195
14946	2	0	5202	0	0	5204
14947	3	0	5187	1	0	5191
14948	0	28	5	5162	0	5195
14949	1	22	0	4971	0	4994
14950	0	7	2	4974	0	4983
14951	2	9	0	4982	0	4993
14952	0	4950	0	1	0	4951
14953	1	4950	0	1	0	4952
14954	4953	2	6	0	0	4961
14955	1	6	0	4917	0	4924
14956	0	2	0	4763	0	4765
14957	0	3	0	4844	0	4847
14958	4860	1	1	1	0	4863
14959	4887	0	4	0	0	4891
14960	0	3	0	4823	0	4826
14961	4752	0	4	0	0	4756
14962	4753	0	11	1	0	4765
14963	4740	0	11	0	0	4751
14964	3	6	3	4712	0	4724
14965	3	0	4695	0	0	4698
14966	1	0	4709	1	0	4711
14967	2	0	4685	1	0	4688
14968	0	0	4732	0	0	4732
14969	0	0	0	4744	0	4744
14970	4674	0	7	0	0	4681
14971	4649	2	11	2	0	4664
14972	1	3	4780	0	0	4784
14973	1	1	4751	0	0	4753
14974	1	4503	0	2	0	4506
14975	0	5	1	4074	0	4080
14976	4046	0	12	0	0	4058
14977	1	0	4056	0	0	4057
14978	4177	0	9	0	0	4186
14979	1	4229	0	2	0	4232
14980	0	11	0	3975	0	3986
14981	0	5	1	3603	0	3609
14982	0	4	0	3638	0	3642
14983	3684	0	2	0	0	3686
14984	1	3	0	3700	0	3704
14985	1	5	0	3724	0	3730
14986	3675	0	6	0	0	3681
14987	0	7	0	3305	0	3312
14988	1	0	3078	0	0	3079
14989	3077	0	3	3	0	3083
14990	0	10	0	3087	0	3097
14991	1	9	0	3057	0	3067
14992	0	3054	0	1	0	3055
14993	3044	0	8	0	0	3052
14994	3058	0	5	0	0	3063
14995	0	1	0	3042	0	3043
14996	2	0	3140	0	0	3142
14997	3015	0	8	1	0	3024
14998	2	0	3125	0	0	3127
14999	0	1	0	3127	0	3128
15000	0	5	0	3156	0	3161
15001	3188	0	2	0	0	3190
15002	0	4	1	3148	0	3153
15003	0	0	3132	0	0	3132
15004	3047	0	12	1	0	3060
15005	4	0	2776	0	0	2780
15006	5	0	2675	1	0	2681
15007	2461	1	2	3	0	2467
15008	1	4	0	2470	0	2475
15009	1	2482	0	0	0	2483
15010	2523	0	8	2	0	2533
15011	2543	0	6	0	0	2549
15012	3	0	2529	0	0	2532
15013	2569	0	4	1	0	2574
15014	1	6	0	2486	0	2493
15015	0	0	2451	0	0	2451
15016	0	2448	0	1	0	2449
15017	2464	0	2	0	0	2466
15018	0	2557	0	0	0	2557
15019	0	10	0	2512	0	2522
15020	0	6	0	2539	0	2545
15021	0	9	0	2526	0	2535
15022	0	5	0	2570	0	2575
15023	0	2561	0	1	0	2562
15024	7	0	2555	0	0	2562
15025	0	2628	0	0	0	2628
15026	2626	0	3	2	0	2631
15027	0	7	0	2594	0	2601
15028	2645	0	3	0	0	2648
15029	0	4	1	2668	0	2673
15030	2680	0	4	2	0	2686
15031	1	2721	0	1	0	2723
15032	2697	0	10	0	0	2707
15033	2669	0	3	1	0	2673
15034	2614	0	10	1	0	2625
15035	2727	4	11	0	0	2742
15036	0	2730	0	1	0	2731
15037	1	0	2697	0	0	2698
15038	0	7	1	2736	0	2744
15039	2753	0	4	0	0	2757
15040	2811	0	7	0	0	2818
15041	0	7	0	2810	0	2817
15042	1	0	2674	1	0	2676
15043	2	7	0	2664	0	2673
15044	0	2604	0	0	0	2604
15045	2612	0	3	0	0	2615
15046	1	7	0	2676	0	2684
15047	0	2627	1	1	0	2629
15048	0	2639	0	2	0	2641
15049	0	2653	0	1	0	2654
15050	0	3	0	2751	0	2754
15051	2800	0	7	0	0	2807
15052	0	2791	0	0	0	2791
15053	2	5	0	2773	0	2780
15054	2774	1	2	3	0	2780
15055	2	4	0	2669	0	2675
15056	2586	0	3	0	0	2589
15057	2589	0	18	1	0	2608
15058	0	2732	0	0	0	2732
15059	0	11	0	2683	0	2694
15060	1	2779	0	1	0	2781
15061	2716	0	1	4	0	2721
15062	2737	0	3	0	0	2740
15063	2750	1	9	0	0	2760
15064	0	4	0	2755	0	2759
15065	0	0	2721	0	0	2721
15066	2768	0	3	0	0	2771
15067	2837	1	4	0	0	2842
15068	1	13	0	2838	0	2852
15069	0	2851	0	0	0	2851
15070	1	7	1	2883	0	2892
15071	0	1	0	2914	0	2915
15072	2939	0	4	0	0	2943
15073	2930	0	3	5	0	2938
15074	0	1	2834	0	0	2835
15075	2	0	1	2784	0	2787
15076	2697	0	7	0	0	2704
15077	1	9	0	2734	0	2744
15078	2	0	2743	1	0	2746
15079	2	2809	0	4	0	2815
15080	0	2786	0	8	0	2794
15081	2800	0	12	1	0	2813
15082	0	3	0	2775	0	2778
15083	0	5	1	2758	0	2764
15084	2745	0	1	0	0	2746
15085	4	0	2821	0	0	2825
15086	0	3	1	2793	0	2797
15087	1	0	2778	1	0	2780
15088	0	2764	0	1	0	2765
15089	2763	0	6	0	0	2769
15090	2765	1	5	0	0	2771
15091	2760	0	7	1	0	2768
15092	1	0	2935	0	0	2936
15093	2933	0	3	0	0	2936
15094	2857	0	6	0	0	2863
15095	0	1	1	2871	0	2873
15096	2852	0	2	0	0	2854
15097	0	0	2864	0	0	2864
15098	2826	0	11	0	0	2837
15099	1	0	2838	0	0	2839
15100	0	2822	0	2	0	2824
15101	0	11	1	2771	0	2783
15102	0	2789	0	1	0	2790
15103	5	0	2779	0	0	2784
15104	1	2736	0	1	0	2738
15105	2778	0	5	0	0	2783
15106	1	2808	0	0	0	2809
15107	1	2751	0	10	0	2762
15108	3	0	2761	2	0	2766
15109	1	2	0	2801	0	2804
15110	2788	1	2	0	0	2791
15111	2	0	2676	0	0	2678
15112	0	2693	0	1	0	2694
15113	0	7	0	2630	0	2637
15114	0	0	2632	0	0	2632
15115	1	0	2669	3	0	2673
15116	1	4	0	2671	0	2676
15117	0	0	2752	0	0	2752
15118	0	5	0	2790	0	2795
15119	0	2863	0	0	0	2863
15120	0	12	0	2826	0	2838
15121	1	2711	0	0	0	2712
15122	0	4	0	2704	0	2708
15123	2798	0	1	0	0	2799
15124	0	6	2	2789	0	2797
15125	1	2852	0	1	0	2854
15126	1	4	0	2832	0	2837
15127	0	0	3006	0	0	3006
15128	0	2	1	3017	0	3020
15129	2982	0	5	0	0	2987
15130	4	0	3067	0	0	3071
15131	0	5	0	3174	0	3179
15132	3258	0	4	2	0	3264
15133	0	3202	0	1	0	3203
15134	0	1	0	3058	0	3059
15135	3062	0	4	0	0	3066
15136	2	15	0	2953	0	2970
15137	0	0	3062	2	0	3064
15138	3033	0	4	3	0	3040
15139	0	3143	0	1	0	3144
15140	1	3093	1	6	0	3101
15141	3052	0	9	1	0	3062
15142	3023	0	2	0	0	3025
15143	3	2	0	2957	0	2962
15144	2945	1	3	1	0	2950
15145	4	0	2952	0	0	2956
15146	2900	0	9	1	0	2910
15147	0	2874	0	0	0	2874
15148	2727	0	3	0	0	2730
15149	0	0	2747	1	0	2748
15150	1	7	0	2732	0	2740
15151	0	16	0	2829	0	2845
15152	1	6	0	2844	0	2851
15153	0	2790	0	1	0	2791
15154	2810	0	5	0	0	2815
15155	0	5	0	2744	0	2749
15156	0	2749	0	1	0	2750
15157	2740	0	6	0	0	2746
15158	2740	0	1	0	0	2741
15159	2768	1	1	0	0	2770
15160	2762	0	2	0	0	2764
15161	2760	0	1	1	0	2762
15162	0	2	0	2748	0	2750
15163	0	0	0	2730	0	2730
15164	2759	0	1	0	0	2760
15165	0	1	0	2748	0	2749
15166	0	1	0	2792	0	2793
15167	1	0	2733	2	0	2736
15168	2630	0	4	1	0	2635
15169	2650	0	2	1	0	2653
15170	2649	0	4	0	0	2653
15171	1	3	1	2635	0	2640
15172	1	2666	0	2	0	2669
15173	2679	0	3	0	0	2682
15174	2660	0	2	0	0	2662
15175	1	1	0	2753	0	2755
15176	2761	0	7	0	0	2768
15177	0	1	2774	0	0	2775
15178	0	2749	0	2	0	2751
15179	1	2721	0	0	0	2722
15180	4	0	2717	1	0	2722
15181	0	2734	0	2	0	2736
15182	0	2783	0	0	0	2783
15183	2802	0	2	1	0	2805
15184	0	2964	0	0	0	2964
15185	0	5	0	3058	0	3063
15186	3062	1	3	0	0	3066
15187	2	0	3057	0	0	3059
15188	3028	0	8	0	0	3036
15189	2	0	3066	0	0	3068
15190	157	1	2866	0	0	3024
15191	2927	0	9	0	0	2936
15192	3	0	2976	0	0	2979
15193	0	2868	0	0	0	2868
15194	0	6	0	2888	0	2894
15195	2951	0	4	0	0	2955
15196	0	2873	0	0	0	2873
15197	2	10	0	2916	0	2928
15198	3	0	3060	1	0	3064
15199	1	4	0	3089	0	3094
15200	3063	0	8	0	0	3071
15201	0	0	2877	0	0	2877
15202	0	2	0	2803	0	2805
15203	2671	0	4	2	0	2677
15204	2694	0	7	0	0	2701
15205	0	9	0	2669	0	2678
15206	0	3	1	2584	0	2588
15207	2	0	2492	1	0	2495
15208	2	0	2410	1	0	2413
15209	2424	0	3	0	0	2427
15210	2434	2	5	0	0	2441
15211	0	2718	0	1	0	2719
15212	2701	0	4	0	0	2705
15213	2666	1	5	0	0	2672
15214	2	0	2663	0	0	2665
15215	0	2522	0	1	0	2523
15216	2522	1	0	0	0	2523
15217	2565	0	3	2	0	2570
15218	2825	1	3	0	0	2829
15219	0	1	1	2867	0	2869
15220	1	3	0	2812	0	2816
15221	0	2928	0	1	0	2929
15222	0	4	0	2883	0	2887
15223	3003	0	1	2	0	3006
15224	1	6	0	2989	0	2996
15225	4	0	2983	0	0	2987
15226	0	0	3002	0	0	3002
15227	0	3	0	2886	0	2889
15228	1	0	2901	3	0	2905
15229	0	0	2931	0	0	2931
15230	0	3	0	3025	0	3028
15231	4	11	0	3030	0	3045
15232	4	0	3039	2	0	3045
15233	2	0	3062	0	0	3064
15234	2	3082	0	2	0	3086
15235	3143	1	2	0	0	3146
15236	0	3118	0	2	0	3120
15237	3102	0	2	4	0	3108
15238	3192	0	4	1	0	3197
15239	0	3186	0	0	0	3186
15240	3185	1	5	1	0	3192
15241	0	4	0	3208	0	3212
15242	0	0	3304	0	0	3304
15243	2	9	0	3286	0	3297
15244	0	3	1	3316	0	3320
15245	3326	0	1	1	0	3328
15246	3298	0	5	1	0	3304
15247	3279	0	4	0	0	3283
15248	3283	0	4	1	0	3288
15249	3358	4	5	1	0	3368
15250	0	3490	0	0	0	3490
15251	0	5	1	3396	0	3402
15252	0	0	3620	0	0	3620
15253	1	11	0	3616	0	3628
15254	0	10	1	3625	0	3636
15255	0	1	1	3650	0	3652
15256	3640	0	2	0	0	3642
15257	0	1	0	3596	0	3597
15258	3539	0	1	1	0	3541
15259	1	0	3626	3	0	3630
15260	0	4	0	3596	0	3600
15261	0	0	3525	0	0	3525
15262	3497	0	18	0	0	3515
15263	0	6	0	3501	0	3507
15264	1	0	3651	0	0	3652
15265	0	5	0	3722	0	3727
15266	3708	1	2	0	0	3711
15267	3	1	3692	1	0	3697
15268	3649	0	2	1	0	3652
15269	3554	0	6	0	0	3560
15270	3545	0	3	0	0	3548
15271	3544	0	1	0	0	3545
15272	0	3558	0	0	0	3558
15273	1	3384	0	0	0	3385
15274	0	3347	0	1	0	3348
15275	1	6	0	3298	0	3305
15276	0	3417	0	0	0	3417
15277	3415	0	2	0	0	3417
15278	0	3708	0	0	0	3708
15279	1	3712	0	0	0	3713
15280	0	11	0	3622	0	3633
15281	0	8	1	3636	0	3645
15282	3643	0	3	0	0	3646
15283	0	7	0	3636	0	3643
15284	1	0	3653	0	0	3654
15285	2	1	3731	0	0	3734
15286	2	0	3719	0	0	3721
15287	0	5	0	3394	0	3399
15288	0	4	2	3373	0	3379
15289	1	0	3346	1	0	3348
15290	3	0	3372	0	0	3375
15291	1	0	3394	2	0	3397
15292	3457	0	8	1	0	3466
15293	0	7	0	3403	0	3410
15294	1	9	2	3200	0	3212
15295	3274	0	2	1	0	3277
15296	1	7	0	3431	0	3439
15297	0	3403	0	3	0	3406
15298	0	3391	0	1	0	3392
15299	0	0	0	3321	0	3321
15300	3378	0	0	0	0	3378
15301	3362	0	5	0	0	3367
15302	3409	0	2	0	0	3411
15303	0	2	1	3428	0	3431
15304	12	0	3371	0	0	3383
15305	1	3	0	3411	0	3415
15306	0	0	3429	1	0	3430
15307	3437	1	17	2	0	3457
15308	1	1	0	3459	0	3461
15309	3363	0	2	0	0	3365
15310	1	0	3356	0	0	3357
15311	3304	0	22	2	0	3328
15312	4	0	3352	0	0	3356
15313	1	3330	0	2	0	3333
15314	0	3272	0	0	0	3272
15315	3300	3	6	0	0	3309
15316	1	3	1	3356	0	3361
15317	3	0	3420	1	0	3424
15318	2	3323	0	3	0	3328
15319	0	3335	0	0	0	3335
15320	0	8	1	3331	0	3340
15321	3317	0	5	1	0	3323
15322	3330	0	2	0	0	3332
15323	0	3405	0	4	0	3409
15324	3365	0	1	0	0	3366
15325	0	5	0	3352	0	3357
15326	5	0	3341	1	0	3347
15327	0	3190	0	1	0	3191
15328	3	9	0	3247	0	3259
15329	0	2	0	3269	0	3271
15330	3240	1	3	0	0	3244
15331	0	0	3322	1	0	3323
15332	3363	0	9	0	0	3372
15333	3406	0	2	0	0	3408
15334	0	3	0	3391	0	3394
15335	0	1	0	3129	0	3130
15336	3166	1	2	1	0	3170
15337	0	3	0	3147	0	3150
15338	0	0	3127	0	0	3127
15339	0	1	3466	0	0	3467
15340	1	3310	0	10	0	3321
15341	0	3275	0	0	0	3275
15342	1	7	0	3245	0	3253
15343	0	3360	0	2	0	3362
15344	3388	0	3	2	0	3393
15345	0	3386	0	0	0	3386
15346	2	5	0	3391	0	3398
15347	0	6	0	3373	0	3379
15348	4	0	3362	0	0	3366
15349	0	12	0	3391	0	3403
15350	0	44	0	3353	0	3397
15351	0	3524	0	0	0	3524
15352	1	9	0	3441	0	3451
15353	1	1	0	3495	0	3497
15354	1	0	3193	0	0	3194
15355	0	3236	0	0	0	3236
15356	0	10	0	3254	0	3264
15357	0	3264	0	3	0	3267
15358	5	0	3254	0	0	3259
15359	1	3248	0	1	0	3250
15360	3259	0	9	0	0	3268
15361	3259	0	8	0	0	3267
15362	3275	3	2	0	0	3280
15363	0	3383	0	1	0	3384
15364	3398	0	9	0	0	3407
15365	3	11	0	3393	0	3407
15366	3375	0	6	0	0	3381
15367	0	3362	0	2	0	3364
15368	3287	0	6	0	0	3293
15369	3305	0	11	1	0	3317
15370	0	3242	0	0	0	3242
15371	3	0	3320	1	0	3324
15372	0	5	0	3175	0	3180
15373	2	0	3197	0	0	3199
15374	0	10	0	3206	0	3216
15375	0	6	1	3215	0	3222
15376	1	0	3157	0	0	3158
15377	0	13	0	3200	0	3213
15378	3121	0	16	0	0	3137
15379	0	0	3141	0	0	3141
15380	0	2915	0	1	0	2916
15381	0	6	0	2941	0	2947
15382	0	19	0	2903	0	2922
15383	1	0	2941	1	0	2943
15384	2	10	0	3027	0	3039
15385	1	3013	1	0	0	3015
15386	3045	0	6	0	0	3051
15387	1	3043	2	1	0	3047
15388	3086	0	3	0	0	3089
15389	0	3338	0	0	0	3338
15390	0	3280	0	3	0	3283
15391	2	0	3312	1	0	3315
15392	0	17	0	3277	0	3294
15393	1	22	0	3291	0	3314
15394	1	17	0	3390	0	3408
15395	1	3482	0	0	0	3483
15396	0	2	0	3461	0	3463
15397	3472	0	5	0	0	3477
15398	2	1	1	3475	0	3479
15399	3385	0	5	0	0	3390
15400	0	0	3438	1	0	3439
15401	3310	0	6	1	0	3317
15402	0	12	1	3196	0	3209
15403	0	2	1	3221	0	3224
15404	3148	0	10	0	0	3158
15405	1	0	3465	1	0	3467
15406	0	3409	0	1	0	3410
15407	0	4	0	3408	0	3412
15408	3357	1	3	1	0	3362
15409	3341	0	4	0	0	3345
15410	0	8	0	3347	0	3355
15411	2	0	3380	1	0	3383
15412	3290	0	13	3	0	3306
15413	3	0	3363	0	0	3366
15414	1	5	0	3132	0	3138
15415	4	0	3184	0	0	3188
15416	1	8	0	3170	0	3179
15417	6	0	3172	0	0	3178
15418	1	3189	0	2	0	3192
15419	2	12	0	3156	0	3170
15420	0	3220	0	2	0	3222
15421	3250	0	4	1	0	3255
15422	3271	0	13	0	0	3284
15423	0	0	3373	0	0	3373
15424	1	4	0	3381	0	3386
15425	3383	0	4	0	0	3387
15426	0	2	1	3402	0	3405
15427	0	13	0	3228	0	3241
15428	0	0	3259	2	0	3261
15429	3170	0	9	1	0	3180
15430	0	0	3272	0	0	3272
15431	1	9	0	3226	0	3236
15432	1	0	3206	0	0	3207
15433	3328	0	7	0	0	3335
15434	3425	1	5	6	0	3437
15435	3406	1	1	1	0	3409
15436	0	3	0	3419	0	3422
15437	1	0	3409	1	0	3411
15438	0	0	3439	1	0	3440
15439	1	8	2	3555	0	3566
15440	1	3524	1	3	0	3529
15441	3617	3	15	2	0	3637
15442	0	5	0	3630	0	3635
15443	0	0	3691	1	0	3692
15444	0	4	0	3688	0	3692
15445	0	0	3657	1	0	3658
15446	0	22	0	3607	0	3629
15447	6	0	3501	1	0	3508
15448	1	0	3503	2	0	3506
15449	1	3509	0	4	0	3514
15450	1	1	3515	1	0	3518
15451	2	0	3604	3	0	3609
15452	0	56	0	3566	0	3622
15453	0	11	0	3636	0	3647
15454	0	3641	0	1	0	3642
15455	3684	1	7	1	0	3693
15456	0	3891	0	1	0	3892
15457	2	3	0	3869	0	3874
15458	3879	0	8	0	0	3887
15459	0	4	0	3863	0	3867
15460	4002	0	5	0	0	4007
15461	1	6	0	4029	0	4036
15462	1	0	4013	0	0	4014
15463	0	3	0	3970	0	3973
15464	0	5	0	3893	0	3898
15465	3642	1	4	3	0	3650
15466	3661	0	7	0	0	3668
15467	3632	1	10	1	0	3644
15468	0	3558	0	2	0	3560
15469	0	3427	0	2	0	3429
15470	3359	0	2	0	0	3361
15471	1	0	3286	0	0	3287
15472	0	0	3354	0	0	3354
15473	0	8	0	3344	0	3352
15474	0	0	3325	2	0	3327
15475	1	0	3310	0	0	3311
15476	3391	0	11	0	0	3402
15477	3399	0	10	0	0	3409
15478	0	3387	0	3	0	3390
15479	0	3070	0	2	0	3072
15480	0	8	2	3058	0	3068
15481	0	3233	0	1	0	3234
15482	3233	0	1	0	0	3234
15483	0	10	1	3252	0	3263
15484	2	3249	0	0	0	3251
15485	3236	2	3	0	0	3241
15486	3	0	3253	1	0	3257
15487	1	0	3216	1	0	3218
15488	3133	0	17	0	0	3150
15489	1	0	3170	1	0	3172
15490	3080	0	6	0	0	3086
15491	0	5	0	3190	0	3195
15492	2	0	3198	0	0	3200
15493	1	3282	2	2	0	3287
15494	0	3276	0	0	0	3276
15495	3295	1	8	7	0	3311
15496	1	3254	0	3	0	3258
15497	3257	2	7	0	0	3266
15498	3234	0	10	0	0	3244
15499	0	3186	0	1	0	3187
15500	0	0	0	3127	0	3127
15501	4	0	3198	0	0	3202
15502	1	3130	0	1	0	3132
15503	2	15	0	3132	0	3149
15504	0	6	0	3141	0	3147
15505	3146	0	6	0	0	3152
15506	0	5	0	3244	0	3249
15507	0	0	3239	0	0	3239
15508	0	3252	0	0	0	3252
15509	2	1	1	3171	0	3175
15510	3049	0	3	0	0	3052
15511	3053	0	5	0	0	3058
15512	0	0	0	3075	0	3075
15513	2987	0	2	0	0	2989
15514	1	0	2970	0	0	2971
15515	1	6	0	2721	0	2728
15516	4	0	2764	1	0	2769
15517	0	7	1	2677	0	2685
15518	0	2	1	2711	0	2714
15519	0	4	0	2665	0	2669
15520	0	2	0	2680	0	2682
15521	0	2	0	2675	0	2677
15522	2710	0	3	1	0	2714
15523	2712	1	6	1	0	2720
15524	0	2738	0	0	0	2738
15525	2668	0	5	1	0	2674
15526	2	2	0	2653	0	2657
15527	1	5	0	2593	0	2599
15528	0	7	0	2602	0	2609
15529	0	0	2593	0	0	2593
15530	1	11	2	2572	0	2586
15531	0	2350	0	1	0	2351
15532	2348	0	7	0	0	2355
15533	2336	0	7	0	0	2343
15534	2	0	2345	0	0	2347
15535	0	2121	0	0	0	2121
15536	0	4	1	2105	0	2110
15537	0	0	2152	1	0	2153
15538	2	2	0	2234	0	2238
15539	0	2265	0	2	0	2267
15540	2282	0	5	0	0	2287
15541	0	2272	0	3	0	2275
15542	0	0	2268	0	0	2268
15543	0	1	2303	2	0	2306
15544	1	2327	0	1	0	2329
15545	0	2294	0	1	0	2295
15546	2285	0	2	1	0	2288
15547	2315	0	3	0	0	2318
15548	0	8	0	2333	0	2341
15549	0	0	2383	0	0	2383
15550	0	5	0	2522	0	2527
15551	0	2	0	2718	0	2720
15552	2658	0	3	0	0	2661
15553	2691	0	4	0	0	2695
15554	0	2	0	2674	0	2676
15555	2	0	2645	1	0	2648
15556	0	2511	0	3	0	2514
15557	2486	0	3	1	0	2490
15558	0	2581	0	0	0	2581
15559	0	4	0	2528	0	2532
15560	0	13	0	2744	0	2757
15561	0	8	1	2763	0	2772
15562	0	5	0	2902	0	2907
15563	2950	0	2	0	0	2952
15564	0	7	0	2926	0	2933
15565	0	2957	0	2	0	2959
15566	0	2	0	2956	0	2958
15567	2882	0	4	0	0	2886
15568	0	2888	0	5	0	2893
15569	2	3	0	2704	0	2709
15570	2	0	2713	0	0	2715
15571	2855	0	4	0	0	2859
15572	0	7	0	2863	0	2870
15573	1	1	2849	0	0	2851
15574	11	0	2876	1	0	2888
15575	1	11	0	2893	0	2905
15576	2866	0	3	0	0	2869
15577	2786	0	5	2	0	2793
15578	1	2819	0	1	0	2821
15579	2808	0	4	1	0	2813
15580	2865	0	2	0	0	2867
15581	2826	0	7	0	0	2833
15582	2725	0	4	0	0	2729
15583	0	2	0	2697	0	2699
15584	0	9	0	2713	0	2722
15585	2	0	2735	1	0	2738
15586	1	2742	0	3	0	2746
15587	0	2726	0	3	0	2729
15588	2	0	2743	0	0	2745
15589	2770	0	0	1	0	2771
15590	0	1	0	2849	0	2850
15591	2865	0	3	0	0	2868
15592	2816	0	3	0	0	2819
15593	200	0	2656	0	0	2856
15594	1	0	0	2851	0	2852
15595	2840	0	2	0	0	2842
15596	1	4	0	2822	0	2827
15597	2	0	2843	0	0	2845
15598	1	3	0	2805	0	2809
15599	2	2776	0	0	0	2778
15600	1	2758	0	2	0	2761
15601	7	0	2745	1	0	2753
15602	2	2723	0	1	0	2726
15603	2718	0	0	0	0	2718
15604	2859	0	1	0	0	2860
15605	0	5	0	2829	0	2834
15606	4	6	0	2857	0	2867
15607	0	2	0	2898	0	2900
15608	2888	0	5	0	0	2893
15609	0	2881	0	4	0	2885
15610	2896	1	10	0	0	2907
15611	2942	0	15	1	0	2958
15612	0	2907	0	3	0	2910
15613	2807	3	15	1	0	2826
15614	0	2821	0	4	0	2825
15615	2748	1	7	2	0	2758
15616	0	0	2858	1	0	2859
15617	2868	0	7	0	0	2875
15618	0	3094	0	1	0	3095
15619	0	9	0	3069	0	3078
15620	1	6	1	3108	0	3116
15621	0	4	0	3123	0	3127
15622	3123	0	4	0	0	3127
15623	1	0	0	3067	0	3068
15624	1	0	3043	1	0	3045
15625	2829	0	7	3	0	2839
15626	0	0	2880	0	0	2880
15627	1	10	0	2649	0	2660
15628	0	0	2666	0	0	2666
15629	0	6	0	2758	0	2764
15630	0	2816	0	1	0	2817
15631	1	1	0	2778	0	2780
15632	1	2811	0	0	0	2812
15633	1	3	0	2793	0	2797
15634	2858	0	5	0	0	2863
15635	0	1	0	2872	0	2873
15636	2634	0	2	0	0	2636
15637	1	0	2712	1	0	2714
15638	2693	0	7	1	0	2701
15639	2660	0	2	0	0	2662
15640	2696	0	10	2	0	2708
15641	0	2	0	2618	0	2620
15642	2593	0	9	1	0	2603
15643	0	0	2590	0	0	2590
15644	2522	0	15	1	0	2538
15645	0	0	2594	0	0	2594
15646	2695	1	4	0	0	2700
15647	2	2	0	2657	0	2661
15648	1	0	2650	0	0	2651
15649	1	7	0	2659	0	2667
15650	0	11	0	2603	0	2614
15651	1	0	2684	0	0	2685
15652	2695	1	22	0	0	2718
15653	0	2707	0	0	0	2707
15654	2673	0	14	0	0	2687
15655	0	2675	0	3	0	2678
15656	2625	0	2	1	0	2628
15657	0	0	2684	0	0	2684
15658	2835	0	8	0	0	2843
15659	0	2861	0	0	0	2861
15660	2	5	0	2756	0	2763
15661	0	9	0	2788	0	2797
15662	0	3	0	2803	0	2806
15663	1	0	2813	1	0	2815
15664	0	14	1	2784	0	2799
15665	1	0	2762	0	0	2763
15666	2737	0	12	0	0	2749
15667	2751	1	4	1	0	2757
15668	1	3	0	2722	0	2726
15669	0	0	2691	1	0	2692
15670	2672	0	11	0	0	2683
15671	1	0	2738	0	0	2739
15672	0	4	0	2821	0	2825
15673	0	2	0	2811	0	2813
15674	0	5	0	2817	0	2822
15675	0	0	0	2871	0	2871
15676	2976	0	6	0	0	2982
15677	0	2980	0	3	0	2983
15678	0	0	2983	0	0	2983
15679	0	2953	0	1	0	2954
15680	2888	0	9	0	0	2897
15681	1	4	0	2942	0	2947
15682	2888	0	4	0	0	2892
15683	1	9	0	2886	0	2896
15684	2	5	0	2887	0	2894
15685	1	8	0	2851	0	2860
15686	0	1	2851	1	0	2853
15687	1	2919	2	3	0	2925
15688	1	1	2938	0	0	2940
15689	1	3	0	2935	0	2939
15690	2933	0	2	0	0	2935
15691	2919	0	8	0	0	2927
15692	2828	1	11	0	0	2840
15693	0	2746	0	3	0	2749
15694	2740	0	0	0	0	2740
15695	0	2	0	2760	0	2762
15696	0	2	0	2687	0	2689
15697	0	6	0	2727	0	2733
15698	0	2721	0	1	0	2722
15699	0	5	0	2691	0	2696
15700	0	2758	0	0	0	2758
15701	2745	0	2	1	0	2748
15702	2733	0	6	1	0	2740
15703	0	1	0	2757	0	2758
15704	0	0	2763	0	0	2763
15705	2846	0	4	1	0	2851
15706	0	1	0	2782	0	2783
15707	1	0	2769	0	0	2770
15708	2721	0	8	0	0	2729
15709	0	0	0	2741	0	2741
15710	2697	0	1	0	0	2698
15711	1	2660	0	2	0	2663
15712	1	4	0	2597	0	2602
15713	0	2645	0	0	0	2645
15714	0	6	1	2552	0	2559
15715	0	2696	0	0	0	2696
15716	0	10	0	2673	0	2683
15717	3	0	2685	0	0	2688
15718	2697	0	5	0	0	2702
15719	1	2661	0	0	0	2662
15720	1	1	2543	1	0	2546
15721	2539	0	3	1	0	2543
15722	1	5	0	2461	0	2467
15723	1	0	2448	0	0	2449
15724	0	2379	0	1	0	2380
15725	0	3	0	2530	0	2533
15726	0	0	2559	0	0	2559
15727	2	3	0	2555	0	2560
15728	0	11	0	2569	0	2580
15729	0	0	2608	0	0	2608
15730	1	8	1	2542	0	2552
15731	2	0	2583	0	0	2585
15732	0	6	0	2544	0	2550
15733	0	0	2470	0	0	2470
15734	1	3	0	2532	0	2536
15735	0	5	0	2456	0	2461
15736	1	4	0	2469	0	2474
15737	0	2510	0	0	0	2510
15738	2521	0	8	0	0	2529
15739	2530	0	3	0	0	2533
15740	1	4	2	2512	0	2519
15741	2448	1	2	1	0	2452
15742	1	0	2458	1	0	2460
15743	0	2464	0	3	0	2467
15744	2505	0	3	1	0	2509
15745	1	2501	0	4	0	2506
15746	0	4	1	2484	0	2489
15747	1	3	0	2498	0	2502
15748	2526	0	4	1	0	2531
15749	0	14	0	2509	0	2523
15750	3	0	2517	0	0	2520
15751	0	2446	0	0	0	2446
15752	2362	0	3	0	0	2365
15753	0	4	0	2422	0	2426
15754	0	2391	0	0	0	2391
15755	2	3	0	2326	0	2331
15756	0	2349	0	0	0	2349
15757	2332	0	5	1	0	2338
15758	2328	0	3	0	0	2331
15759	0	0	2328	0	0	2328
15760	0	0	2433	0	0	2433
15761	0	3	2	2445	0	2450
15762	0	2318	0	1	0	2319
15763	0	3	0	2336	0	2339
15764	2331	0	3	0	0	2334
15765	0	0	2326	0	0	2326
15766	1	1	0	2416	0	2418
15767	5	0	2411	0	0	2416
15768	3	0	2401	1	0	2405
15769	0	2241	0	0	0	2241
15770	0	4	0	2240	0	2244
15771	2225	0	4	0	0	2229
15772	0	0	2288	0	0	2288
15773	0	2326	0	0	0	2326
15774	2351	1	5	0	0	2357
15775	0	1	0	2364	0	2365
15776	2327	0	4	0	0	2331
15777	2398	0	5	0	0	2403
15778	2394	0	6	0	0	2400
15779	0	0	2367	0	0	2367
15780	2307	0	8	0	0	2315
15781	2128	0	18	0	0	2146
15782	0	2230	0	1	0	2231
15783	0	5	0	2209	0	2214
15784	0	5	0	2242	0	2247
15785	0	1	0	2256	0	2257
15786	2245	0	1	1	0	2247
15787	2181	1	7	0	0	2189
15788	0	0	2193	0	0	2193
15789	0	4	1	2270	0	2275
15790	3	2267	0	0	0	2270
15791	2129	0	5	0	0	2134
15792	0	0	2235	0	0	2235
15793	0	3	0	2233	0	2236
15794	0	8	0	2218	0	2226
15795	0	2212	0	0	0	2212
15796	1	3	0	2178	0	2182
15797	1	5	0	2210	0	2216
15798	0	3	0	2238	0	2241
15799	2221	0	5	1	0	2227
15800	0	3	1	2232	0	2236
15801	0	4	0	2090	0	2094
15802	2072	0	1	1	0	2074
15803	0	1	1	2060	0	2062
15804	0	2001	0	0	0	2001
15805	1854	2	0	0	0	1856
15806	2023	0	1	1	0	2025
15807	1985	0	5	0	0	1990
15808	1991	3	7	1	0	2002
15809	0	1973	0	0	0	1973
15810	1956	0	2	0	0	1958
15811	1980	0	0	0	0	1980
15812	0	5	0	1971	0	1976
15813	0	0	2003	0	0	2003
15814	0	1	6	2095	0	2102
15815	1	7	0	2150	0	2158
15816	1	4	0	2183	0	2188
15817	1	7	0	2222	0	2230
15818	0	1	0	2206	0	2207
15819	2252	0	2	0	0	2254
15820	0	3	0	2221	0	2224
15821	0	0	2202	0	0	2202
15822	1	8	0	2118	0	2127
15823	0	2109	0	0	0	2109
15824	0	5	1	2162	0	2168
15825	0	0	2171	0	0	2171
15826	2162	0	5	2	0	2169
15827	2176	0	6	0	0	2182
15828	1	0	2195	0	0	2196
15829	0	2275	0	1	0	2276
15830	2309	0	4	1	0	2314
15831	2312	0	4	0	0	2316
15832	2316	1	3	0	0	2320
15833	2676	0	5	0	0	2681
15834	1	7	0	2670	0	2678
15835	2	1	2878	0	0	2881
15836	1	2	1	2811	0	2815
15837	0	1	1	2772	0	2774
15838	2	0	3021	0	0	3023
15839	7	1	4554	0	0	4562
15840	4700	0	34	2	0	4736
15841	0	4747	0	1	0	4748
15842	1	4	0	4646	0	4651
15843	8	0	5003	0	0	5011
15844	5702	3	14	0	0	5719
15845	4	0	5852	0	0	5856
15846	5936	0	12	0	0	5948
15847	1	5879	0	2	0	5882
15848	0	11	1	5884	0	5896
15849	3	0	6345	1	0	6349
15850	6503	1	12	5	0	6521
15851	0	6694	3	1	0	6698
15852	1	6706	0	2	0	6709
15853	1	11	0	6740	0	6752
15854	4	17	2	7992	0	8015
15855	8123	0	58	0	0	8181
15856	0	9074	1	4	0	9079
15857	0	5	0	9087	0	9092
15858	9082	2	13	0	0	9097
15859	9307	1	14	6	0	9328
15860	9239	1	53	1	0	9294
15861	1	0	9308	1	0	9310
15862	1	0	9290	4	0	9295
15863	9217	0	9	2	0	9228
15864	1	9441	0	1	0	9443
15865	1	9429	0	6	0	9436
15866	10	51	2	9381	0	9444
15867	0	9628	0	2	0	9630
15868	9603	2	44	1	0	9650
15869	1	33	0	9638	0	9672
15870	0	0	9688	2	0	9690
15871	9620	1	17	1	0	9639
15872	9763	1	16	1	0	9781
15873	3	14	3	9772	0	9792
15874	1	10	0	9776	0	9787
15875	0	18	1	9806	0	9825
15876	1	12	0	9813	0	9826
15877	2	0	9797	4	0	9803
15878	1	9840	0	3	0	9844
15879	2	38	2	9798	0	9840
15880	0	10404	0	7	0	10411
15881	4	36	0	10365	0	10405
15882	3	10886	0	3	0	10892
15883	10934	1	36	2	0	10973
15884	11186	0	26	2	0	11214
15885	1	11259	0	5	0	11265
15886	11730	3	17	1	0	11751
15887	0	16	0	11762	0	11778
15888	11755	1	7	1	0	11764
15889	1	11756	0	2	0	11759
15890	11553	1	14	3	0	11571
15891	11816	0	28	2	0	11846
15892	2	30	1	11824	0	11857
15893	10	1	11817	4	0	11832
15894	0	11829	0	7	0	11836
15895	3	21	2	12070	0	12096
15896	12679	1	23	2	0	12705
15897	5	1	12887	0	0	12893
15898	1	16	1	13028	0	13046
15899	2	15	0	13042	0	13059
15900	13049	0	9	3	0	13061
15901	13052	0	20	3	0	13075
15902	13085	1	21	2	0	13109
15903	0	13095	0	6	0	13101
15904	12689	0	23	2	0	12714
15905	30	0	13424	1	0	13455
15906	15	0	13808	1	0	13824
15907	6	0	13934	2	0	13942
15908	5	69	0	13853	0	13927
15909	5	1	13861	0	0	13867
15910	14060	0	21	2	0	14083
15911	3	35	2	14113	0	14153
15912	13	0	14422	4	0	14439
15913	14941	2	21	3	0	14967
15914	1	22	1	14684	0	14708
15915	3	14	0	13789	0	13806
15916	14155	1	11	1	0	14168
15917	2	25	2	14245	0	14274
15918	3	0	14462	1	0	14466
15919	3	27	1	14199	0	14230
15920	4	0	13885	2	0	13891
15921	0	20	0	13868	0	13888
15922	13904	0	12	1	0	13917
15923	1	13883	0	7	0	13891
15924	0	13650	1	4	0	13655
15925	0	46	2	13773	0	13821
15926	2	22	0	15639	0	15663
15927	2	16379	0	3	0	16384
15928	3	15225	0	8	0	15236
15929	5	60	1	15205	0	15271
15930	0	16	0	15320	0	15336
15931	16385	1	12	1	0	16399
15932	2	15640	0	11	0	15653
15933	1	15552	0	7	0	15560
15934	3	15557	0	6	0	15566
15935	15281	1	15	6	0	15303
15936	7	0	15379	1	0	15387
15937	15464	2	19	2	0	15487
15938	2	28	1	15646	0	15677
15939	3	15635	0	18	0	15656
15940	1	15503	0	13	0	15517
15941	15727	1	25	4	0	15757
15942	5	27	0	15710	0	15742
15943	4	15593	0	5	0	15602
15944	15656	0	13	5	0	15674
15945	15617	0	14	9	0	15640
15946	5	0	15695	0	0	15700
15947	15976	0	40	1	0	16017
15948	16136	0	27	1	0	16164
15949	2	23	1	16370	0	16396
15950	3	16703	0	7	0	16713
15951	2	16612	1	3	0	16618
15952	0	37	0	16774	0	16811
15953	16823	0	12	2	0	16837
15954	8	1	16760	0	0	16769
15955	6	0	16711	3	0	16720
15956	7	0	16186	8	0	16201
15957	6	0	16171	2	0	16179
15958	4	15996	1	7	0	16008
15959	2	15906	1	10	0	15919
15960	14	1	15915	6	0	15936
15961	28	0	16130	2	0	16160
15962	3	15693	2	7	0	15705
15963	2	25	0	15700	0	15727
15964	7	0	16245	0	0	16252
15965	2	47	4	16153	0	16206
15966	0	18	0	16322	0	16340
15967	7	22	2	16225	0	16256
15968	2	28	2	16234	0	16266
15969	9	0	16395	2	0	16406
15970	3	32	1	16605	0	16641
15971	16279	1	11	4	0	16295
15972	9	0	15746	0	0	15755
15973	15278	4	26	7	0	15315
15974	2	30	1	15368	0	15401
15975	4	0	15331	2	0	15337
15976	15200	7	20	2	0	15229
15977	2	25	2	15355	0	15384
15978	15347	1	27	1	0	15376
15979	6	36	1	15394	0	15437
15980	2	15098	2	4	0	15106
15981	10	1	15216	1	0	15228
15982	1	6	0	15272	0	15279
15983	15173	0	12	0	0	15185
15984	15116	1	25	3	0	15145
15985	14902	2	39	6	0	14949
15986	14719	0	34	2	0	14755
15987	14648	6	19	0	0	14673
15988	0	14285	0	6	0	14291
15989	13752	1	18	0	0	13771
15990	3	0	13755	0	0	13758
15991	13871	1	21	4	0	13897
15992	6	15	2	14262	0	14285
15993	10	0	14131	1	0	14142
15994	6	0	14501	4	0	14511
15995	2	14	0	14559	0	14575
15996	14293	0	17	0	0	14310
15997	3	14639	0	6	0	14648
15998	15076	0	15	2	0	15093
15999	2	15512	0	1	0	15515
16000	1	33	2	15149	0	15185
16001	0	16	0	15092	0	15108
16002	13688	0	10	0	0	13698
16003	9	18	0	12970	0	12997
16004	4	0	12975	1	0	12980
16005	13020	0	13	3	0	13036
16006	1	22	0	12983	0	13006
16007	6	16	1	11824	0	11847
16008	5	0	11668	1	0	11674
16009	11717	0	19	2	0	11738
16010	11790	1	31	0	0	11822
16011	1	11761	0	6	0	11768
16012	6	0	11522	0	0	11528
16013	2	0	12103	3	0	12108
16014	6	23	0	11938	0	11967
16015	5	25	1	11926	0	11957
16016	0	11995	1	4	0	12000
16017	4	0	12025	0	0	12029
16018	1	41	0	11984	0	12026
16019	12	0	12183	4	0	12199
16020	0	39	2	12267	0	12308
16021	0	12257	1	6	0	12264
16022	1	35	2	11906	0	11944
16023	0	10	0	11995	0	12005
16024	0	21	0	11848	0	11869
16025	11735	3	11	1	0	11750
16026	9	0	11793	3	0	11805
16027	1	12479	0	4	0	12484
16028	3	22	2	12380	0	12407
16029	12744	1	2	3	0	12750
16030	0	19	0	13263	0	13282
16031	13180	1	13	6	0	13200
16032	8	0	13248	0	0	13256
16033	13917	3	21	7	0	13948
16034	5	32	0	13919	0	13956
16035	5	1	13807	5	0	13818
16036	2	14097	0	5	0	14104
16037	3	33	2	14008	0	14046
16038	1	17	0	14013	0	14031
16039	14030	2	15	2	0	14049
16040	2	13840	0	2	0	13844
16041	3	13725	1	4	0	13733
16042	1	13968	0	2	0	13971
16043	13905	1	13	2	0	13921
16044	2	14303	0	2	0	14307
16045	0	24	2	14146	0	14172
16046	0	14	1	14375	0	14390
16047	14344	0	15	2	0	14361
16048	2	14519	0	1	0	14522
16049	0	29	4	14329	0	14362
16050	14368	1	16	0	0	14385
16051	14445	2	13	2	0	14462
16052	14453	7	23	1	0	14484
16053	1	14679	0	6	0	14686
16054	14514	0	11	0	0	14525
16055	2	39	5	14627	0	14673
16056	3	14435	0	6	0	14444
16057	2	14474	0	4	0	14480
16058	0	16	1	14476	0	14493
16059	15297	0	18	2	0	15317
16060	15297	1	11	1	0	15310
16061	2	37	3	15387	0	15429
16062	1	15434	0	0	0	15435
16063	15127	0	67	1	0	15195
16064	5	1	15553	0	0	15559
16065	7	0	15653	3	0	15663
16066	15264	1	14	3	0	15282
16067	3	4	15317	0	0	15324
16068	3	24	0	15634	0	15661
16069	15889	0	14	1	0	15904
16070	0	32	0	15297	0	15329
16071	12	0	15358	0	0	15370
16072	2	14280	0	17	0	14299
16073	1	28	1	14035	0	14065
16074	2	0	14061	1	0	14064
16075	14317	1	10	0	0	14328
16076	0	61	0	14241	0	14302
16077	4	1	14387	0	0	14392
16078	2	34	2	14713	0	14751
16079	0	14311	1	4	0	14316
16080	5	64	0	14466	0	14535
16081	3	25	2	14438	0	14468
16082	3	64	0	14383	0	14450
16083	1	15068	0	5	0	15074
16084	15065	1	25	2	0	15093
16085	0	16	1	15138	0	15155
16086	3	28	2	15045	0	15078
16087	0	38	1	15036	0	15075
16088	8	2	15073	5	0	15088
16089	1	15	0	14736	0	14752
16090	14969	0	11	1	0	14981
16091	2	15074	0	4	0	15080
16092	1	145	1	14802	0	14949
16093	1	17	0	15079	0	15097
16094	15118	1	17	2	0	15138
16095	3	14955	0	8	0	14966
16096	14945	0	24	1	0	14970
16097	15562	1	22	1	0	15586
16098	0	22	2	15505	0	15529
16099	16167	3	35	5	0	16210
16100	0	15999	0	8	0	16007
16101	15573	2	20	2	0	15597
16102	1	18	4	15719	0	15742
16103	15332	0	21	2	0	15355
16104	15169	4	32	5	0	15210
16105	5	1	14895	1	0	14902
16106	14416	0	28	2	0	14446
16107	14852	0	22	2	0	14876
16108	14073	0	82	4	0	14159
16109	5	1	14153	2	0	14161
16110	0	13752	0	0	0	13752
16111	2	24	3	13420	0	13449
16112	13535	1	12	4	0	13552
16113	0	13657	0	9	0	13666
16114	14075	0	25	1	0	14101
16115	4	74	1	13979	0	14058
16116	7	0	13777	0	0	13784
16117	13812	1	21	5	0	13839
16118	4	192	5	13341	0	13542
16119	3	0	13743	2	0	13748
16120	13318	1	13	2	0	13334
16121	4	0	13419	1	0	13424
16122	0	20	1	13359	0	13380
16123	1	35	0	13352	0	13388
16124	13220	0	13	6	0	13239
16125	13239	1	17	3	0	13260
16126	0	13237	0	4	0	13241
16127	13043	0	17	2	0	13062
16128	9	0	13311	2	0	13322
16129	6	0	13179	5	0	13190
16130	13014	0	17	4	0	13035
16131	1	12669	0	5	0	12675
16132	12820	3	12	3	0	12838
16133	2	13052	1	8	0	13063
16134	13246	1	15	1	0	13263
16135	2	84	0	12960	0	13046
16136	8	0	13056	0	0	13064
16137	1	20	2	12918	0	12941
16138	1	6	0	12882	0	12889
16139	12811	0	12	3	0	12826
16140	3	0	12463	2	0	12468
16141	13176	2	24	4	0	13206
16142	2	13058	0	8	0	13068
16143	13430	5	31	1	0	13467
16144	1	60	1	13135	0	13197
16145	3	1	13543	0	0	13547
16146	4	12	3	13523	0	13542
16147	13725	1	16	1	0	13743
16148	5	34	0	13681	0	13720
16149	2	27	1	13524	0	13554
16150	2	14340	0	0	0	14342
16151	5	33	0	14089	0	14127
16152	4	0	14359	0	0	14363
16153	1	48	2	14582	0	14633
16154	3	24	1	14286	0	14314
16155	14349	0	14	1	0	14364
16156	2	26	0	14105	0	14133
16157	4	1	14331	1	0	14337
16158	1	14363	1	7	0	14372
16159	4	192	1	13778	0	13975
16160	0	39	0	14351	0	14390
16161	14375	0	12	1	0	14388
16162	0	14519	0	9	0	14528
16163	3	23	0	14516	0	14542
16164	14886	0	9	2	0	14897
16165	14828	3	15	1	0	14847
16166	1	25	0	15221	0	15247
16167	4	0	15178	2	0	15184
16168	14970	2	26	5	0	15003
16169	2	23	3	15080	0	15108
16170	15226	1	20	1	0	15248
16171	15134	4	13	0	0	15151
16172	1	14974	0	4	0	14979
16173	14811	2	18	2	0	14833
16174	0	15011	0	1	0	15012
16175	1	52	1	14638	0	14692
16176	3	12	3	14760	0	14778
16177	1	14532	0	11	0	14544
16178	14515	1	25	2	0	14543
16179	14565	0	24	2	0	14591
16180	2	0	14668	4	0	14674
16181	4	0	15481	1	0	15486
16182	1	108	3	15263	0	15375
16183	15014	0	19	1	0	15034
16184	1	23	0	15221	0	15245
16185	2	20	2	15041	0	15065
16186	7	0	14930	3	0	14940
16187	8	1	14913	3	0	14925
16188	7	0	14920	2	0	14929
16189	14674	3	21	2	0	14700
16190	14421	1	13	2	0	14437
16191	2	14469	0	21	0	14492
16192	0	14114	0	2	0	14116
16193	2	31	3	14095	0	14131
16194	0	0	14351	1	0	14352
16195	14174	6	25	5	0	14210
16196	1	0	14382	0	0	14383
16197	2	45	4	14308	0	14359
16198	1	14	0	14316	0	14331
16199	2	17	3	14638	0	14660
16200	0	9	0	14647	0	14656
16201	14688	1	10	0	0	14699
16202	4	16	1	14719	0	14740
16203	9	2	14643	1	0	14655
16204	14367	4	22	16	0	14409
16205	2	0	14553	0	0	14555
16206	9	0	15850	6	0	15865
16207	3	16151	2	3	0	16159
16208	1	20	1	16345	0	16367
16209	17766	3	30	2	0	17801
16210	3	47	0	18161	0	18211
16211	6	0	17957	2	0	17965
16212	3	38	0	18142	0	18183
16213	18129	5	18	3	0	18155
16214	1	18058	1	4	0	18064
16215	17657	1	36	1	0	17695
16216	1	17741	2	6	0	17750
16217	17355	2	32	1	0	17390
16218	2	17785	0	6	0	17793
16219	1	16927	0	8	0	16936
16220	17	0	17110	0	0	17127
16221	0	16736	0	6	0	16742
16222	16826	1	21	3	0	16851
16223	0	32	1	17103	0	17136
16224	17076	3	18	5	0	17102
16225	1	16526	0	10	0	16537
16226	16149	3	51	0	0	16203
16227	7	0	16715	1	0	16723
16228	5	49	0	17379	0	17433
16229	0	17599	0	6	0	17605
16230	3	29	0	17475	0	17507
16231	0	9	0	17521	0	17530
16232	17537	0	13	0	0	17550
16233	1	17270	0	5	0	17276
16234	16917	2	26	3	0	16948
16235	27	0	16966	3	0	16996
16236	24	1	17119	3	0	17147
16237	2	17043	0	3	0	17048
16238	0	32	1	17497	0	17530
16239	3	0	17883	0	0	17886
16240	2	21	1	17962	0	17986
16241	3	22	2	17915	0	17942
16242	6	1	17258	10	0	17275
16243	7	1	17297	6	0	17311
16244	2	0	17177	3	0	17182
16245	12	2	17244	5	0	17263
16246	0	17084	1	9	0	17094
16247	0	111	8	17067	0	17186
16248	3	32	0	16999	0	17034
16249	8	0	17076	0	0	17084
16250	6	24	5	16587	0	16622
16251	5	0	16678	1	0	16684
16252	3	37	1	16778	0	16819
16253	2	54	1	16634	0	16691
16254	1	16540	0	5	0	16546
16255	2	52	1	16367	0	16422
16256	4	34	0	16896	0	16934
16257	2	43	1	16622	0	16668
16258	16	1	16540	4	0	16561
16259	1	16321	0	10	0	16332
16260	16239	1	18	0	0	16258
16261	16405	2	27	0	0	16434
16262	0	18	1	16590	0	16609
16263	6	83	0	16745	0	16834
16264	1	16791	1	2	0	16795
16265	16709	1	25	1	0	16736
16266	1	16630	0	4	0	16635
16267	16472	5	23	4	0	16504
16268	5	0	16561	1	0	16567
16269	17333	0	25	4	0	17362
16270	1	17640	0	4	0	17645
16271	4	49	1	17399	0	17453
16272	7	29	2	18188	0	18226
16273	2	18479	0	16	0	18497
16274	18718	2	18	2	0	18740
16275	0	22	0	18429	0	18451
16276	3	25	0	18448	0	18476
16277	18665	0	11	3	0	18679
16278	18542	2	37	1	0	18582
16279	7	0	18519	1	0	18527
16280	18302	1	40	4	0	18347
16281	2	55	1	17493	0	17551
16282	4	1	16909	1	0	16915
16283	7	23	2	16936	0	16968
16284	37	0	16532	1	0	16570
16285	6	0	15840	3	0	15849
16286	1	30	0	15453	0	15484
16287	16	2	15114	2	0	15134
16288	0	15451	0	8	0	15459
16289	4	41	3	15463	0	15511
16290	5	31	0	16046	0	16082
16291	10	1	16051	1	0	16063
16292	1	16068	1	14	0	16084
16293	16128	1	27	2	0	16158
16294	2	23	0	16438	0	16463
16295	16679	0	15	5	0	16699
16296	1	16425	0	24	0	16450
16297	17	1	16363	1	0	16382
16298	2	20	1	16411	0	16434
16299	15840	1	11	1	0	15853
16300	12	0	16072	2	0	16086
16301	16453	2	31	4	0	16490
16302	5	16109	0	4	0	16118
16303	1	15446	1	7	0	15455
16304	15487	1	15	2	0	15505
16305	1	18	1	16647	0	16667
16306	2	32	1	16617	0	16652
16307	1	16870	1	4	0	16876
16308	1	21	1	16849	0	16872
16309	0	16	0	16562	0	16578
16310	16729	0	9	0	0	16738
16311	0	23	1	16351	0	16375
16312	5	0	16590	0	0	16595
16313	3	40	1	16572	0	16616
16314	1	24	0	15858	0	15883
16315	9	0	15877	2	0	15888
16316	1	32	0	15872	0	15905
16317	15903	1	7	0	0	15911
16318	15854	0	6	2	0	15862
16319	15942	1	24	1	0	15968
16320	3	21	1	16008	0	16033
16321	13	0	15850	0	0	15863
16322	3	16606	0	5	0	16614
16323	3	51	0	16475	0	16529
16324	10	1	17032	1	0	17044
16325	3	31	0	17028	0	17062
16326	0	13	0	17056	0	17069
16327	17168	0	16	2	0	17186
16328	0	17060	1	4	0	17065
16329	10	0	17030	1	0	17041
16330	17252	1	46	3	0	17302
16331	3	17157	1	6	0	17167
16332	0	16704	0	8	0	16712
16333	16485	1	24	3	0	16513
16334	6	37	4	16867	0	16914
16335	5	2	17073	3	0	17083
16336	11	118	4	17251	0	17384
16337	1	17141	0	12	0	17154
16338	17399	2	27	6	0	17434
16339	1	42	2	17506	0	17551
16340	17518	2	20	2	0	17542
16341	3	50	0	17384	0	17437
16342	0	17395	0	10	0	17405
16343	16900	1	30	1	0	16932
16344	16899	0	16	3	0	16918
16345	1	16513	0	5	0	16519
16346	16295	0	41	4	0	16340
16347	1	38	2	16395	0	16436
16348	1	15465	0	8	0	15474
16349	15792	0	23	1	0	15816
16350	0	15664	0	3	0	15667
16351	15612	0	26	0	0	15638
16352	0	11	1	15844	0	15856
16353	15565	1	2	1	0	15569
16354	16468	2	25	2	0	16497
16355	16286	1	9	3	0	16299
16356	4	20	1	16197	0	16222
16357	0	4	0	16257	0	16261
16358	15641	0	10	0	0	15651
16359	4	0	15711	4	0	15719
16360	3	94	0	15994	0	16091
16361	1	15745	0	3	0	15749
16362	3	34	0	15643	0	15680
16363	0	38	1	15176	0	15215
16364	7	1	15210	4	0	15222
16365	3	38	2	15276	0	15319
16366	0	14565	0	1	0	14566
16367	2	41	1	14806	0	14850
16368	8	0	14934	1	0	14943
16369	0	46	0	15165	0	15211
16370	1	25	0	15152	0	15178
16371	14885	1	14	2	0	14902
16372	15224	3	25	2	0	15254
16373	1	18	3	15704	0	15726
16374	0	15782	0	4	0	15786
16375	1	15362	2	16	0	15381
16376	4	2	15565	1	0	15572
16377	3	15	2	15744	0	15764
16378	15586	3	20	3	0	15612
16379	2	26	0	15785	0	15813
16380	7	0	15627	1	0	15635
16381	6	43	67	14617	0	14733
16382	0	36	1	14719	0	14756
16383	2	27	0	14567	0	14596
16384	131	1	14483	3	0	14618
16385	4	14511	0	16	0	14531
16386	14484	1	25	4	0	14514
16387	14522	2	51	0	0	14575
16388	1	13	0	14045	0	14059
16389	11	0	14323	3	0	14337
16390	0	14854	0	13	0	14867
16391	2	41	2	14703	0	14748
16392	7	14919	0	8	0	14934
16393	1	14900	1	13	0	14915
16394	14958	1	29	3	0	14991
16395	9	1	14932	2	0	14944
16396	2	0	15111	5	0	15118
16397	1	45	1	15195	0	15242
16398	1	21	1	14283	0	14306
16399	6	0	14265	3	0	14274
16400	3	87	2	14303	0	14395
16401	6	0	14374	3	0	14383
16402	14513	1	39	1	0	14554
16403	3	37	1	14327	0	14368
16404	3	0	14234	5	0	14242
16405	43	63	3	14237	0	14346
16406	1	14216	0	6	0	14223
16407	14209	1	80	2	0	14292
16408	0	14174	0	4	0	14178
16409	14104	0	10	0	0	14114
16410	6	0	13862	0	0	13868
16411	14713	0	25	1	0	14739
16412	4	18	1	14695	0	14718
16413	2	0	14587	1	0	14590
16414	5	30	4	14293	0	14332
16415	3	0	14028	1	0	14032
16416	14060	2	39	6	0	14107
16417	1	14360	0	4	0	14365
16418	5	49	2	14303	0	14359
16419	8	14312	1	2	0	14323
16420	14426	0	21	0	0	14447
16421	14806	1	26	2	0	14835
16422	2	14911	0	4	0	14917
16423	3	51	0	14763	0	14817
16424	1	18	1	14841	0	14861
16425	0	15	2	14590	0	14607
16426	14694	0	17	0	0	14711
16427	0	14676	0	79	0	14755
16428	1	11	3	14525	0	14540
16429	1	8	1	14515	0	14525
16430	13492	1	16	0	0	13509
16431	7	0	13565	1	0	13573
16432	4	0	13525	1	0	13530
16433	13502	0	46	4	0	13552
16434	4	0	13830	1	0	13835
16435	4	0	14146	2	0	14152
16436	1	14	0	13956	0	13971
16437	13917	0	7	2	0	13926
16438	1	19	4	13842	0	13866
16439	6	0	13864	0	0	13870
16440	13891	0	61	4	0	13956
16441	11	0	14173	1	0	14185
16442	1	13905	0	9	0	13915
16443	1	24	1	13480	0	13506
16444	14041	0	15	1	0	14057
16445	2	35	0	14118	0	14155
16446	0	11	1	14131	0	14143
16447	14531	2	11	1	0	14545
16448	3	13	2	14032	0	14050
16449	1	24	0	13537	0	13562
16450	3	0	13504	6	0	13513
16451	4	23	0	13324	0	13351
16452	13323	2	6	0	0	13331
16453	13267	3	10	1	0	13281
16454	13236	0	15	2	0	13253
16455	5	49	0	13166	0	13220
16456	0	12991	0	6	0	12997
16457	13253	3	16	5	0	13277
16458	0	13380	0	3	0	13383
16459	13747	2	24	6	0	13779
16460	3	9	0	13744	0	13756
16461	13642	0	25	1	0	13668
16462	13597	0	51	1	0	13649
16463	13691	1	32	4	0	13728
16464	1	13335	1	7	0	13344
16465	3	12705	0	7	0	12715
16466	12633	0	10	4	0	12647
16467	6	13098	0	6	0	13110
16468	13	13169	0	13	0	13195
16469	3	13166	0	10	0	13179
16470	13143	0	11	1	0	13155
16471	2	30	5	13062	0	13099
16472	2	12	1	13036	0	13051
16473	13017	1	16	0	0	13034
16474	2	0	13590	0	0	13592
16475	2	22	13	13503	0	13540
16476	2	157	2	13284	0	13445
16477	6	52	1	13436	0	13495
16478	3	27	3	13395	0	13428
16479	5	13406	0	8	0	13419
16480	1	13211	0	5	0	13217
16481	13313	3	9	1	0	13326
16482	0	32	2	13287	0	13321
16483	1	19	1	12861	0	12882
16484	0	0	13163	2	0	13165
16485	3	20	8	12892	0	12923
16486	8	0	12907	1	0	12916
16487	3	93	2	12769	0	12867
16488	11	0	12792	1	0	12804
16489	2	12970	0	8	0	12980
16490	5	13	0	12914	0	12932
16491	12931	0	24	1	0	12956
16492	12927	0	36	1	0	12964
16493	1	13	0	12713	0	12727
16494	6	0	12698	3	0	12707
16495	5	0	12365	3	0	12373
16496	12460	0	32	3	0	12495
16497	5	12153	1	14	0	12173
16498	11899	2	26	3	0	11930
16499	12073	1	29	4	0	12107
16500	7	0	12421	1	0	12429
16501	6	20	10	12580	0	12616
16502	5	38	2	12291	0	12336
16503	2	47	1	12126	0	12176
16504	0	9	1	12381	0	12391
16505	4	21	0	12358	0	12383
16506	4	1	12454	0	0	12459
16507	1	0	12410	4	0	12415
16508	0	17	1	12090	0	12108
16509	0	14	0	11763	0	11777
16510	0	6	0	11694	0	11700
16511	12330	1	1	2	0	12334
16512	1	8	1	12345	0	12355
16513	12428	1	8	2	0	12439
16514	2	6	0	12477	0	12485
16515	12458	0	6	0	0	12464
16516	12244	1	9	4	0	12258
16517	12567	0	9	2	0	12578
16518	12205	0	9	0	0	12214
16519	12513	0	4	2	0	12519
16520	1	13	0	11950	0	11964
16521	11879	1	13	1	0	11894
16522	1	11850	0	2	0	11853
16523	11772	1	37	2	0	11812
16524	1	16	0	11885	0	11902
16525	3	0	12112	2	0	12117
16526	2	26	1	12046	0	12075
16527	2	0	12043	3	0	12048
16528	0	10	3	12018	0	12031
16529	3	11	1	11964	0	11979
16530	6	0	12002	2	0	12010
16531	8	0	11818	5	0	11831
16532	3	17	0	11602	0	11622
16533	11207	3	15	0	0	11225
16534	2	1	11273	1	0	11277
16535	4	11364	3	12	0	11383
16536	9	0	11429	1	0	11439
16537	11358	1	13	2	0	11374
16538	0	9	1	11510	0	11520
16539	11366	2	12	0	0	11380
16540	12106	1	22	2	0	12131
16541	1	22	1	12154	0	12178
16542	2	0	12137	2	0	12141
16543	2	20	1	11739	0	11762
16544	0	10	0	11528	0	11538
16545	11844	1	58	0	0	11903
16546	0	11778	0	7	0	11785
16547	5	23	3	11706	0	11737
16548	49	0	11715	0	0	11764
16549	11678	0	23	2	0	11703
16550	1	11630	0	3	0	11634
16551	0	40	1	11451	0	11492
16552	3	11	0	11429	0	11443
16553	1	10	0	11502	0	11513
16554	11451	1	4	0	0	11456
16555	11418	1	20	0	0	11439
16556	1	16	0	11524	0	11541
16557	10	2	11332	1	0	11345
16558	2	11390	4	6	0	11402
16559	11033	3	23	1	0	11060
16560	10812	2	28	1	0	10843
16561	2	9	1	10982	0	10994
16562	2	45	1	10836	0	10884
16563	6	0	10839	5	0	10850
16564	2	10669	0	12	0	10683
16565	10710	0	20	1	0	10731
16566	11047	0	34	3	0	11084
16567	1	10957	0	5	0	10963
16568	11035	0	43	1	0	11079
16569	0	10	2	11074	0	11086
16570	2	0	10992	1	0	10995
16571	0	11	0	11040	0	11051
16572	3	0	11002	2	0	11007
16573	10963	2	21	4	0	10990
16574	1	10517	0	5	0	10523
16575	4	10	0	10289	0	10303
16576	2	0	10506	0	0	10508
16577	8	0	10665	5	0	10678
16578	10734	1	25	1	0	10761
16579	2	10919	1	9	0	10931
16580	10769	1	19	0	0	10789
16581	10765	0	10	3	0	10778
16582	10909	1	18	1	0	10929
16583	0	7	2	10910	0	10919
16584	7	0	10906	3	0	10916
16585	2	10294	1	5	0	10302
16586	5	8	0	10083	0	10096
16587	6	0	10183	0	0	10189
16588	6	2	10448	1	0	10457
16589	2	5	2	10702	0	10711
16590	7	0	10707	3	0	10717
16591	10502	1	19	1	0	10523
16592	2	16	10	10543	0	10571
16593	0	15	2	10201	0	10218
16594	10243	1	10	0	0	10254
16595	0	10151	0	5	0	10156
16596	10103	0	8	0	0	10111
16597	3	23	0	10077	0	10103
16598	2	12	0	9744	0	9758
16599	1	5	2	10639	0	10647
16600	1	6	0	10552	0	10559
16601	10405	1	13	2	0	10421
16602	34	0	10450	0	0	10484
16603	0	10468	1	5	0	10474
16604	1	12	0	10313	0	10326
16605	10257	0	13	0	0	10270
16606	10147	1	41	2	0	10191
16607	1	10842	0	1	0	10844
16608	10902	1	18	0	0	10921
16609	4	12492	0	3	0	12499
16610	1	12202	0	3	0	12206
16611	1	20	0	12020	0	12041
16612	1	0	12710	0	0	12711
16613	0	34	2	12745	0	12781
16614	12860	0	30	2	0	12892
16615	2	12529	0	9	0	12540
16616	0	20	0	12054	0	12074
16617	4	0	12115	1	0	12120
16618	12917	1	38	1	0	12957
16619	12918	0	11	0	0	12929
16620	12856	1	45	3	0	12905
16621	9	0	12598	3	0	12610
16622	13199	0	23	1	0	13223
16623	0	13439	1	6	0	13446
16624	3	30	2	13210	0	13245
16625	2	12809	1	4	0	12816
16626	12820	0	32	2	0	12854
16627	12884	1	23	2	0	12910
16628	4	0	12921	0	0	12925
16629	3	13424	0	3	0	13430
16630	1	21	0	13391	0	13413
16631	0	11	0	13466	0	13477
16632	0	14	0	13561	0	13575
16633	4	15	0	13598	0	13617
16634	2	16	3	13459	0	13480
16635	8	0	13460	0	0	13468
16636	0	13381	0	9	0	13390
16637	13281	2	30	2	0	13315
16638	6	0	13233	0	0	13239
16639	0	13207	1	10	0	13218
16640	13219	2	24	4	0	13249
16641	1	0	13312	1	0	13314
16642	13366	21	25	1	0	13413
16643	13301	2	42	1	0	13346
16644	13285	2	28	2	0	13317
16645	1	13231	0	5	0	13237
16646	6	0	13258	1	0	13265
16647	1	13163	0	2	0	13166
16648	2	20	0	12992	0	13014
16649	8	13011	0	6	0	13025
16650	13300	1	24	2	0	13327
16651	13405	0	48	0	0	13453
16652	13131	3	33	1	0	13168
16653	78	0	12987	1	0	13066
16654	1	13652	0	5	0	13658
16655	1	16	1	13548	0	13566
16656	13663	1	23	1	0	13688
16657	0	13430	0	9	0	13439
16658	1	14	0	13376	0	13391
16659	22	0	13454	1	0	13477
16660	13154	2	22	5	0	13183
16661	3	0	13224	2	0	13229
16662	3	0	13224	1	0	13228
16663	12945	0	53	2	0	13000
16664	3	0	13055	0	0	13058
16665	12902	1	47	0	0	12950
16666	0	13311	0	7	0	13318
16667	13325	1	20	1	0	13347
16668	0	21	3	13184	0	13208
16669	0	14	0	13197	0	13211
16670	2	5	0	13243	0	13250
16671	13008	1	7	3	0	13019
16672	12880	0	15	3	0	12898
16673	12914	1	8	1	0	12924
16674	1	12591	0	3	0	12595
16675	1	19	3	11612	0	11635
16676	3	0	13077	1	0	13081
16677	4	21	23	13191	0	13239
16678	1	13313	0	4	0	13318
16679	3	17	1	13341	0	13362
16680	3	3	0	13448	0	13454
16681	14005	0	12	1	0	14018
16682	5	21	5	14011	0	14042
16683	3	0	13383	3	0	13389
16684	9	2	14223	2	0	14236
16685	2	32	1	12306	0	12341
16686	12331	1	10	1	0	12343
16687	1	13	0	12604	0	12618
16688	4	11	4	12060	0	12079
16689	4	0	12114	2	0	12120
16690	3	12095	0	6	0	12104
16691	1	16	2	12471	0	12490
16692	12608	1	11	1	0	12621
16693	0	12438	0	1	0	12439
16694	0	23	1	11454	0	11478
16695	5	0	12130	1	0	12136
16696	1	10	1	11731	0	11743
16697	11877	1	22	2	0	11902
16698	2	11719	0	13	0	11734
16699	13	0	11570	0	0	11583
16700	0	11	1	11557	0	11569
16701	4	0	11450	2	0	11456
16702	11489	1	24	0	0	11514
16703	11455	1	42	4	0	11502
16704	2	1	11541	1	0	11545
16705	3	11	2	11216	0	11232
16706	2	1	11162	3	0	11168
16707	0	11171	0	10	0	11181
16708	3	48	0	11132	0	11183
16709	1	2	11396	1	0	11400
16710	2	11	1	11496	0	11510
16711	0	11766	0	7	0	11773
16712	1	18	0	11765	0	11784
16713	4	0	11718	1	0	11723
16714	11721	1	17	7	0	11746
16715	0	11749	0	5	0	11754
16716	11502	0	31	3	0	11536
16717	3	0	11529	3	0	11535
16718	11619	0	46	4	0	11669
16719	4	0	12027	1	0	12032
16720	12261	1	27	5	0	12294
16721	12322	1	10	2	0	12335
16722	1	29	1	12272	0	12303
16723	1	16	1	12342	0	12360
16724	12420	0	12	0	0	12432
16725	1	12590	0	6	0	12597
16726	12455	1	23	1	0	12480
16727	0	24	1	12311	0	12336
16728	2	11768	0	2	0	11772
16729	5	23	2	11736	0	11766
16730	2	37	3	12304	0	12346
16731	0	17	1	12310	0	12328
16732	0	12290	0	5	0	12295
16733	12157	0	67	1	0	12225
16734	1	14	0	12233	0	12248
16735	6	0	12138	1	0	12145
16736	4	0	12294	1	0	12299
16737	1	0	12306	3	0	12310
16738	12110	0	30	6	0	12146
16739	12097	1	43	0	0	12141
16740	2	0	12280	0	0	12282
16741	0	23	1	12441	0	12465
16742	8	16	1	12059	0	12084
16743	8	0	12180	0	0	12188
16744	8	1	12159	4	0	12172
16745	3	18	1	12691	0	12713
16746	12716	0	14	1	0	12731
16747	12843	3	22	4	0	12872
16748	13283	6	41	0	0	13330
16749	1	14294	0	9	0	14304
16750	1	12760	0	13	0	12774
16751	4	30	1	12750	0	12785
16752	12563	0	30	0	0	12593
16753	1	1	12636	0	0	12638
16754	12845	2	43	0	0	12890
16755	7	12833	1	2	0	12843
16756	3	12594	0	36	0	12633
16757	12622	4	43	4	0	12673
16758	3	12769	2	26	0	12800
16759	1	12116	1	10	0	12128
16760	12182	0	19	4	0	12205
16761	1	11827	0	3	0	11831
16762	4	14	0	11597	0	11615
16763	0	8	0	11648	0	11656
16764	12154	0	11	0	0	12165
16765	12128	1	23	2	0	12154
16766	3	11916	0	13	0	11932
16767	1	11427	0	4	0	11432
16768	3	1	11410	2	0	11416
16769	11536	1	16	0	0	11553
16770	11552	1	14	2	0	11569
16771	11082	1	6	1	0	11090
16772	0	9	3	10977	0	10989
16773	6	4	1	10925	0	10936
16774	10937	0	10	0	0	10947
16775	4	6	0	10927	0	10937
16776	0	1	10978	0	0	10979
16777	1	15	1	11122	0	11139
16778	2	11309	1	1	0	11313
16779	0	83	2	11190	0	11275
16780	0	10	1	11722	0	11733
16781	0	8	0	11777	0	11785
16782	11911	0	12	2	0	11925
16783	0	11674	0	6	0	11680
16784	2	19	1	11548	0	11570
16785	6	0	11754	0	0	11760
16786	5	0	11968	2	0	11975
16787	10	29	1	11611	0	11651
16788	2	12	0	11759	0	11773
16789	11666	1	18	0	0	11685
16790	5	14	2	11646	0	11667
16791	2	11575	1	5	0	11583
16792	14	1	11689	0	0	11704
16793	4	12	1	11836	0	11853
16794	6	0	11759	1	0	11766
16795	5	13	1	11350	0	11369
16796	11413	0	14	2	0	11429
16797	11694	0	27	0	0	11721
16798	0	11653	0	3	0	11656
16799	0	12	1	11493	0	11506
16800	11508	2	3	2	0	11515
16801	11288	0	14	3	0	11305
16802	11377	0	11	0	0	11388
16803	11333	2	20	0	0	11355
16804	11358	3	28	0	0	11389
16805	0	11348	0	0	0	11348
16806	10695	0	33	0	0	10728
16807	4	0	10918	1	0	10923
16808	2	17	3	11727	0	11749
16809	11772	0	18	1	0	11791
16810	11721	0	23	1	0	11745
16811	11520	0	53	3	0	11576
16812	3	0	12012	0	0	12015
16813	1	7	2	12050	0	12060
16814	12141	0	10	2	0	12153
16815	1	12084	0	9	0	12094
16816	12549	1	26	3	0	12579
16817	12582	0	21	5	0	12608
16818	12526	1	42	1	0	12570
16819	2	9	2	12446	0	12459
16820	12283	1	19	0	0	12303
16821	0	0	12042	0	0	12042
16822	2	0	12215	0	0	12217
16823	11983	0	41	1	0	12025
16824	2	0	12010	0	0	12012
16825	10830	1	43	3	0	10877
16826	5	0	10966	2	0	10973
16827	2	15	1	11020	0	11038
16828	10918	0	27	1	0	10946
16829	1	10787	1	9	0	10798
16830	10679	1	29	2	0	10711
16831	4	10968	0	6	0	10978
16832	1	10740	0	2	0	10743
16833	1	76	0	10329	0	10406
16834	1	17	1	10646	0	10665
16835	1	19	0	10524	0	10544
16836	10	0	10554	1	0	10565
16837	10612	0	51	0	0	10663
16838	10678	1	7	1	0	10687
16839	10929	0	25	0	0	10954
16840	10417	0	7	0	0	10424
16841	10345	1	51	1	0	10398
16842	1	0	10438	1	0	10440
16843	0	0	10537	1	0	10538
16844	10	14	5	10633	0	10662
16845	3	0	10833	1	0	10837
16846	10922	1	24	2	0	10949
16847	1	11117	0	3	0	11121
16848	6	12	1	11104	0	11123
16849	11326	0	9	1	0	11336
16850	0	4	1	11681	0	11686
16851	11	0	11547	1	0	11559
16852	3	0	11636	4	0	11643
16853	3	14	2	11958	0	11977
16854	7	0	11517	3	0	11527
16855	12845	4	22	3	0	12874
16856	3	7	1	12560	0	12571
16857	8	0	12539	3	0	12550
16858	2	12210	1	6	0	12219
16859	2	26	0	12081	0	12109
16860	10	0	12504	2	0	12516
16861	1	11	3	12961	0	12976
16862	3	19	0	13081	0	13103
16863	8	0	13197	1	0	13206
16864	3	28	12	13046	0	13089
16865	3	18	1	13159	0	13181
16866	0	11	0	13085	0	13096
16867	13374	2	38	3	0	13417
16868	7	13313	0	6	0	13326
16869	1	12965	0	12	0	12978
16870	8	0	13013	2	0	13023
16871	13148	2	27	11	0	13188
16872	17	0	13299	0	0	13316
16873	5	0	13465	2	0	13472
16874	1	8	1	13516	0	13526
16875	13540	2	17	1	0	13560
16876	3	13511	0	98	0	13612
16877	13555	3	32	9	0	13599
16878	14204	0	30	0	0	14234
16879	1	14554	0	2	0	14557
16880	14172	1	28	1	0	14202
16881	14253	3	31	2	0	14289
16882	3	13770	0	4	0	13777
16883	1	22	5	13717	0	13745
16884	0	22	1	13849	0	13872
16885	13820	0	15	2	0	13837
16886	3	13758	0	1	0	13762
16887	13709	2	7	1	0	13719
16888	13682	0	12	1	0	13695
16889	13738	0	12	0	0	13750
16890	0	22	0	13709	0	13731
16891	1	9	0	13560	0	13570
16892	13060	2	1	0	0	13063
16893	13042	1	11	4	0	13058
16894	13071	0	8	0	0	13079
16895	0	14	0	13313	0	13327
16896	5	0	13417	0	0	13422
16897	2	30	4	12944	0	12980
16898	2	30	2	12931	0	12965
16899	15	0	12945	1	0	12961
16900	2	0	12895	0	0	12897
16901	3	19	4	13136	0	13162
16902	4	0	13121	1	0	13126
16903	13438	0	23	3	0	13464
16904	0	10	3	13494	0	13507
16905	1	4	2	15477	0	15484
16906	15912	1	8	0	0	15921
16907	3	26	0	15664	0	15693
16908	5	34	1	15471	0	15511
16909	2	91	0	15432	0	15525
16910	9	42	1	15310	0	15362
16911	5	0	15422	2	0	15429
16912	2	29	1	15421	0	15453
16913	3	1	15402	2	0	15408
16914	5	15497	0	23	0	15525
16915	1	29	2	15381	0	15413
16916	7	0	15447	5	0	15459
16917	15556	0	39	0	0	15595
16918	3	15608	1	11	0	15623
16919	16940	2	33	1	0	16976
16920	11	34	4	16727	0	16776
16921	0	17036	0	10	0	17046
16922	17546	2	39	2	0	17589
16923	0	17394	0	10	0	17404
16924	17630	1	29	3	0	17663
16925	3	13	1	17469	0	17486
16926	17039	1	19	3	0	17062
16927	5	17225	0	15	0	17245
16928	16671	0	43	3	0	16717
16929	9	0	16789	0	0	16798
16930	2	17	4	16902	0	16925
16931	16227	1	23	1	0	16252
16932	16168	1	28	2	0	16199
16933	2	26	1	16328	0	16357
16934	28	0	16435	3	0	16466
16935	5	16688	0	4	0	16697
16936	0	17066	0	16	0	17082
16937	17112	0	45	3	0	17160
16938	1	33	1	17021	0	17056
16939	0	10	0	17099	0	17109
16940	17227	1	10	0	0	17238
16941	17046	2	42	6	0	17096
16942	9	0	17123	0	0	17132
16943	2	42	2	17138	0	17184
16944	11	1	16994	1	0	17007
16945	7	17309	1	12	0	17329
16946	17708	2	53	0	0	17763
16947	2	17430	1	8	0	17441
16948	3	17086	0	7	0	17096
16949	0	33	3	17099	0	17135
16950	17233	0	34	1	0	17268
16951	3	17689	1	7	0	17700
16952	18243	1	43	2	0	18289
16953	0	18219	0	7	0	18226
16954	3	16	6	17617	0	17642
16955	17273	0	26	0	0	17299
16956	7	0	17181	1	0	17189
16957	1	22	1	17012	0	17036
16958	37	1	16854	1	0	16893
16959	5	16843	1	9	0	16858
16960	0	16748	1	4	0	16753
16961	16885	1	35	10	0	16931
16962	1	16935	1	9	0	16946
16963	16975	0	25	2	0	17002
16964	16556	2	20	2	0	16580
16965	7	0	16458	1	0	16466
16966	16163	1	50	4	0	16218
16967	1	0	16369	2	0	16372
16968	4	16184	0	5	0	16193
16969	16205	1	29	0	0	16235
16970	1	16159	0	4	0	16164
16971	0	12	0	15892	0	15904
16972	16527	2	84	4	0	16617
16973	2	26	4	16517	0	16549
16974	9	0	16433	0	0	16442
16975	1	35	1	16286	0	16323
16976	0	4	1	16075	0	16080
16977	15942	0	13	2	0	15957
16978	4	0	15902	2	0	15908
16979	15418	0	24	4	0	15446
16980	15406	0	16	0	0	15422
16981	1	9	4	13082	0	13096
16982	0	16	0	12743	0	12759
16983	12631	1	14	0	0	12646
16984	0	12569	0	7	0	12576
16985	4	14	1	12511	0	12530
16986	8	0	12723	0	0	12731
16987	5	0	12660	3	0	12668
16988	1	12745	0	9	0	12755
16989	2	21	0	12698	0	12721
16990	0	11	0	12570	0	12581
16991	12689	0	15	0	0	12704
16992	2	12	2	12599	0	12615
16993	12665	2	18	0	0	12685
16994	3	12355	2	8	0	12368
16995	3	10915	0	14	0	10932
16996	7	10500	0	3	0	10510
16997	10332	0	12	0	0	10344
16998	10209	0	23	1	0	10233
16999	0	10084	0	3	0	10087
17000	9887	0	40	1	0	9928
17001	0	9722	0	4	0	9726
17002	2	109	3	9042	0	9156
17003	1	9359	1	3	0	9364
17004	9251	0	14	1	0	9266
17005	9222	0	18	0	0	9240
17006	0	10	0	9278	0	9288
17007	8797	0	9	0	0	8806
17008	4	22	3	8751	0	8780
17009	2	8137	1	93	0	8233
17010	7	15	1	7339	0	7362
17011	1	7530	0	1	0	7532
17012	6597	0	11	0	0	6608
17013	4	0	6590	0	0	6594
17014	6506	0	7	1	0	6514
17015	1	4	0	6380	0	6385
17016	1	0	6293	0	0	6294
17017	5687	0	5	1	0	5693
17018	3	0	5801	1	0	5805
17019	2	10	3	5893	0	5908
17020	1	17	0	5791	0	5809
17021	0	10	0	5572	0	5582
17022	0	10	0	5482	0	5492
17023	0	5344	1	4	0	5349
17024	1	7	0	5358	0	5366
17025	5288	0	1	2	0	5291
17026	3	1	5204	0	0	5208
17027	2	4672	0	1	0	4675
17028	3944	0	11	0	0	3955
17029	3965	0	6	0	0	3971
17030	1	9	1	3793	0	3804
17031	11	0	3864	0	0	3875
17032	2	11	1	3870	0	3884
17033	1	13	0	3813	0	3827
17034	1	0	3799	0	0	3800
17035	0	3789	1	0	0	3790
17036	3781	0	10	1	0	3792
17037	3799	0	14	0	0	3813
17038	3724	0	4	1	0	3729
17039	0	2	0	3755	0	3757
17040	0	4	0	3711	0	3715
17041	3855	1	3	0	0	3859
17042	0	13	1	3866	0	3880
17043	1	3873	0	1	0	3875
17044	3846	0	1	2	0	3849
17045	3845	0	8	0	0	3853
17046	3749	2	15	0	0	3766
17047	3773	1	3	0	0	3777
17048	1	0	3331	0	0	3332
17049	0	0	3363	1	0	3364
17050	1	9	1	3338	0	3349
17051	2	14	0	3316	0	3332
17052	0	0	3340	0	0	3340
17053	4	0	3381	1	0	3386
17054	0	10	0	3523	0	3533
17055	3645	0	1	1	0	3647
17056	0	9	0	3610	0	3619
17057	6	0	3539	0	0	3545
17058	0	3697	0	1	0	3698
17059	3794	0	6	0	0	3800
17060	3866	0	2	2	0	3870
17061	3854	1	5	0	0	3860
17062	3570	0	7	0	0	3577
17063	0	0	3694	0	0	3694
17064	0	8	0	3623	0	3631
17065	3781	0	0	0	0	3781
17066	0	51	0	3726	0	3777
17067	1	5	0	3686	0	3692
17068	1	3615	0	1	0	3617
17069	0	7	0	3614	0	3621
17070	3671	0	9	0	0	3680
17071	3	3691	0	2	0	3696
17072	3634	0	6	2	0	3642
17073	0	3896	0	0	0	3896
17074	0	8	0	3790	0	3798
17075	0	3916	0	0	0	3916
17076	0	3795	1	0	0	3796
17077	3781	0	2	0	0	3783
17078	5	0	3786	0	0	3791
17079	0	0	3650	0	0	3650
17080	1	1	3682	0	0	3684
17081	4150	0	6	2	0	4158
17082	0	4297	0	1	0	4298
17083	0	4252	0	4	0	4256
17084	4477	0	8	2	0	4487
17085	0	4500	0	1	0	4501
17086	0	4453	0	1	0	4454
17087	0	11	0	4435	0	4446
17088	1	0	4447	0	0	4448
17089	4	0	4660	1	0	4665
17090	0	3	0	4723	0	4726
17091	4711	0	11	2	0	4724
17092	0	4593	0	4	0	4597
17093	3	8	0	4415	0	4426
17094	1	0	4542	0	0	4543
17095	3	0	4530	1	0	4534
17096	1	14	0	4584	0	4599
17097	4540	0	8	0	0	4548
17098	4332	0	39	0	0	4371
17099	0	0	4431	0	0	4431
17100	4342	0	6	1	0	4349
17101	0	0	4444	0	0	4444
17102	0	14	1	4423	0	4438
17103	1	4401	0	1	0	4403
17104	4394	1	1	0	0	4396
17105	4	6	0	4344	0	4354
17106	1	10	1	4352	0	4364
17107	0	3	0	4303	0	4306
17108	0	6	2	4265	0	4273
17109	0	0	4281	0	0	4281
17110	0	4597	0	2	0	4599
17111	1	9	2	4599	0	4611
17112	4596	0	6	0	0	4602
17113	0	5	0	4595	0	4600
17114	0	16	0	4587	0	4603
17115	7	0	4555	3	0	4565
17116	3	0	4699	1	0	4703
17117	0	4937	0	2	0	4939
17118	1	4913	0	5	0	4919
17119	3	5	0	5191	0	5199
17120	5197	0	10	0	0	5207
17121	5	0	5306	1	0	5312
17122	0	5363	0	6	0	5369
17123	2	71	2	5253	0	5328
17124	0	5437	0	1	0	5438
17125	2	42	0	5321	0	5365
17126	0	5537	0	0	0	5537
17127	2	7	1	5542	0	5552
17128	5544	0	10	1	0	5555
17129	1	5538	0	1	0	5540
17130	1	22	0	5389	0	5412
17131	5440	1	5	1	0	5447
17132	0	5473	0	0	0	5473
17133	0	5309	0	0	0	5309
17134	3	5252	0	0	0	5255
17135	3	9	0	5121	0	5133
17136	0	18	0	5105	0	5123
17137	0	5126	0	1	0	5127
17138	0	11	0	5074	0	5085
17139	3	0	5094	0	0	5097
17140	0	4983	0	3	0	4986
17141	3	10	0	4873	0	4886
17142	0	4979	0	0	0	4979
17143	4	0	4982	0	0	4986
17144	0	5055	0	3	0	5058
17145	5087	1	7	0	0	5095
17146	0	8	0	5051	0	5059
17147	5065	1	13	0	0	5079
17148	3	0	5610	1	0	5614
17149	1	16	0	5376	0	5393
17150	4	0	5570	2	0	5576
17151	2	7	0	5671	0	5680
17152	5673	1	4	0	0	5678
17153	5	5	0	5657	0	5667
17154	5619	1	3	2	0	5625
17155	0	5585	0	5	0	5590
17156	5060	1	10	0	0	5071
17157	8	0	5051	1	0	5060
17158	0	4840	0	4	0	4844
17159	1	12	0	4716	0	4729
17160	0	4	0	4766	0	4770
17161	2	0	4755	3	0	4760
17162	2	4783	0	1	0	4786
17163	3	17	0	4914	0	4934
17164	0	4949	0	0	0	4949
17165	0	9	0	4912	0	4921
17166	1	4924	0	3	0	4928
17167	4939	0	0	0	0	4939
17168	0	10	0	4954	0	4964
17169	1	0	4947	2	0	4950
17170	0	4885	0	1	0	4886
17171	0	4839	0	5	0	4844
17172	0	0	4864	1	0	4865
17173	0	4822	0	2	0	4824
17174	0	8	0	4863	0	4871
17175	7	0	5075	0	0	5082
17176	2	10	0	5075	0	5087
17177	1	7	1	5051	0	5060
17178	6	0	5040	0	0	5046
17179	5100	1	12	2	0	5115
17180	0	16	0	5119	0	5135
17181	2	0	5139	1	0	5142
17182	1	5248	0	5	0	5254
17183	5362	0	10	1	0	5373
17184	2	5663	0	6	0	5671
17185	4	17	1	5329	0	5351
17186	5685	0	8	0	0	5693
17187	1	9	0	5695	0	5705
17188	6	0	5749	1	0	5756
17189	4	50	2	5687	0	5743
17190	3	0	5715	1	0	5719
17191	5560	0	12	3	0	5575
17192	0	0	5544	0	0	5544
17193	5133	0	17	4	0	5154
17194	5149	1	4	0	0	5154
17195	0	0	4789	0	0	4789
17196	3	0	4836	2	0	4841
17197	0	4755	0	2	0	4757
17198	4734	2	4	0	0	4740
17199	0	3	0	4764	0	4767
17200	1	2	0	4646	0	4649
17201	4650	0	3	1	0	4654
17202	4552	0	2	0	0	4554
17203	4564	0	8	0	0	4572
17204	4642	0	0	0	0	4642
17205	0	0	0	4507	0	4507
17206	4395	0	2	1	0	4398
17207	1	5	0	4356	0	4362
17208	1	11	0	4305	0	4317
17209	0	11	0	4316	0	4327
17210	0	0	4310	3	0	4313
17211	0	4374	0	2	0	4376
17212	0	4402	0	0	0	4402
17213	0	8	0	4316	0	4324
17214	4373	0	0	0	0	4373
17215	0	11	1	4352	0	4364
17216	4352	1	22	1	0	4376
17217	0	0	4586	0	0	4586
17218	4533	0	4	2	0	4539
17219	0	3	0	4498	0	4501
17220	4594	0	5	1	0	4600
17221	4559	1	12	2	0	4574
17222	4725	0	4	1	0	4730
17223	0	12	0	4627	0	4639
17224	3	0	4241	0	0	4244
17225	2	6	0	4364	0	4372
17226	3956	0	8	0	0	3964
17227	2	0	3992	0	0	3994
17228	0	3	0	4070	0	4073
17229	4053	0	9	0	0	4062
17230	2	0	4330	0	0	4332
17231	4451	0	13	0	0	4464
17232	4503	0	4	0	0	4507
17233	0	1	0	4458	0	4459
17234	0	0	0	4477	0	4477
17235	4562	0	0	0	0	4562
17236	1	5	0	4761	0	4767
17237	4754	0	13	3	0	4770
17238	0	4733	0	2	0	4735
17239	1	4539	0	1	0	4541
17240	0	7	0	4379	0	4386
17241	4	0	4472	1	0	4477
17242	2	4468	0	4	0	4474
17243	4493	0	9	2	0	4504
17244	0	4510	0	4	0	4514
17245	2	0	4483	0	0	4485
17246	0	3	0	4661	0	4664
17247	3	0	4626	0	0	4629
17248	1	4808	0	3	0	4812
17249	1	10	0	4759	0	4770
17250	1	4736	0	7	0	4744
17251	2	0	4832	0	0	4834
17252	1	7	0	4879	0	4887
17253	0	0	4892	0	0	4892
17254	0	9	1	4877	0	4887
17255	4775	0	4	2	0	4781
17256	3	0	4772	0	0	4775
17257	4595	0	7	2	0	4604
17258	1	0	4640	2	0	4643
17259	1	4	1	4610	0	4616
17260	1	0	4360	0	0	4361
17261	1	10	0	4340	0	4351
17262	0	5	0	3998	0	4003
17263	0	13	0	4031	0	4044
17264	0	7	0	3967	0	3974
17265	1	0	3950	2	0	3953
17266	3971	0	7	2	0	3980
17267	0	4	0	4006	0	4010
17268	3971	0	3	1	0	3975
17269	3954	0	5	0	0	3959
17270	3988	0	1	1	0	3990
17271	0	4	1	4073	0	4078
17272	0	9	0	4035	0	4044
17273	2	4021	0	0	0	4023
17274	4111	0	6	1	0	4118
17275	4088	0	1	0	0	4089
17276	4093	1	3	0	0	4097
17277	1	0	4104	0	0	4105
17278	0	12	0	4098	0	4110
17279	0	0	4117	0	0	4117
17280	4056	0	3	2	0	4061
17281	4079	0	7	1	0	4087
17282	1	14	1	4101	0	4117
17283	1	7	5	4127	0	4140
17284	1	4141	0	0	0	4142
17285	4138	1	12	0	0	4151
17286	4173	0	11	0	0	4184
17287	0	4352	0	2	0	4354
17288	4337	0	3	0	0	4340
17289	1	5	0	4421	0	4427
17290	0	4	0	4384	0	4388
17291	4373	2	3	0	0	4378
17292	3	0	4358	0	0	4361
17293	4177	0	8	1	0	4186
17294	4199	0	2	0	0	4201
17295	1	4275	0	0	0	4276
17296	4074	0	6	1	0	4081
17297	4	0	4247	1	0	4252
17298	1	7	0	4114	0	4122
17299	4103	0	5	0	0	4108
17300	0	4	1	4050	0	4055
17301	3	0	4003	0	0	4006
17302	1	14	2	4005	0	4022
17303	1	4170	0	3	0	4174
17304	1	10	1	4087	0	4099
17305	1	0	1	4050	0	4052
17306	2	2	1	3743	0	3748
17307	1	7	0	3605	0	3613
17308	3	0	3616	0	0	3619
17309	0	5	1	3676	0	3682
17310	3650	0	8	0	0	3658
17311	1	3586	0	3	0	3590
17312	0	7	1	3383	0	3391
17313	2	0	3727	1	0	3730
17314	1	4	2	3751	0	3758
17315	3767	0	6	0	0	3773
17316	3835	0	6	2	0	3843
17317	3723	0	4	1	0	3728
17318	1	6	1	3762	0	3770
17319	17	0	3763	0	0	3780
17320	1	3744	0	1	0	3746
17321	3715	0	1	1	0	3717
17322	0	5	0	3600	0	3605
17323	5	9	0	3504	0	3518
17324	2	0	3526	5	0	3533
17325	3	3412	0	7	0	3422
17326	0	3372	0	2	0	3374
17327	1	4	2	3411	0	3418
17328	0	0	3410	0	0	3410
17329	3380	0	15	1	0	3396
17330	0	0	3443	0	0	3443
17331	3507	0	19	0	0	3526
17332	0	3513	0	5	0	3518
17333	2	0	3413	0	0	3415
17334	3367	0	5	1	0	3373
17335	0	3329	0	1	0	3330
17336	3318	1	8	0	0	3327
17337	3	0	3384	0	0	3387
17338	0	3507	0	2	0	3509
17339	3509	2	5	1	0	3517
17340	2	0	3635	1	0	3638
17341	3785	0	9	1	0	3795
17342	0	6	0	3800	0	3806
17343	3894	1	8	0	0	3903
17344	0	2	0	3941	0	3943
17345	3889	1	6	0	0	3896
17346	5	0	3876	1	0	3882
17347	0	6	0	3923	0	3929
17348	1	20	0	3820	0	3841
17349	0	0	3845	1	0	3846
17350	0	8	0	3911	0	3919
17351	1	3912	0	0	0	3913
17352	0	8	1	3898	0	3907
17353	1	2	0	3894	0	3897
17354	0	7	0	4092	0	4099
17355	1	0	4061	0	0	4062
17356	4241	0	12	2	0	4255
17357	0	4	0	4350	0	4354
17358	1	0	4315	2	0	4318
17359	4395	0	12	0	0	4407
17360	4386	0	9	0	0	4395
17361	4407	1	8	2	0	4418
17362	0	17	0	4340	0	4357
17363	1	8	0	4133	0	4142
17364	2	17	0	4153	0	4172
17365	0	4123	0	1	0	4124
17366	4111	0	11	0	0	4122
17367	4114	0	6	0	0	4120
17368	1	4	0	4066	0	4071
17369	3	0	4053	0	0	4056
17370	4	0	4065	0	0	4069
17371	1	4012	0	6	0	4019
17372	0	3869	0	2	0	3871
17373	3913	1	8	0	0	3922
17374	1	3972	0	0	0	3973
17375	4082	1	4	0	0	4087
17376	4120	0	5	0	0	4125
17377	4219	0	4	0	0	4223
17378	0	1	0	4243	0	4244
17379	0	1	1	4055	0	4057
17380	4086	0	3	0	0	4089
17381	2	6	0	4078	0	4086
17382	1	0	4089	0	0	4090
17383	4395	0	7	3	0	4405
17384	1	6	0	4330	0	4337
17385	0	8	2	4305	0	4315
17386	1	4	2	4258	0	4265
17387	0	0	4209	1	0	4210
17388	4225	0	5	0	0	4230
17389	5	0	4017	0	0	4022
17390	0	19	1	4063	0	4083
17391	1	0	4061	0	0	4062
17392	0	5	1	4010	0	4016
17393	0	17	1	3983	0	4001
17394	0	0	4013	0	0	4013
17395	1	7	1	4059	0	4068
17396	0	4046	0	3	0	4049
17397	4014	0	8	0	0	4022
17398	4133	0	7	0	0	4140
17399	1	6	1	4319	0	4327
17400	2	0	4153	0	0	4155
17401	1	4190	0	7	0	4198
17402	1	4206	0	0	0	4207
17403	4164	0	9	1	0	4174
17404	1	0	4218	0	0	4219
17405	4517	1	3	2	0	4523
17406	0	1	0	4497	0	4498
17407	0	3	1	4453	0	4457
17408	4454	0	2	0	0	4456
17409	0	4417	0	3	0	4420
17410	4	1	4467	0	0	4472
17411	0	16	0	4489	0	4505
17412	1	0	4607	1	0	4609
17413	0	4468	0	11	0	4479
17414	0	8	0	4424	0	4432
17415	4697	0	5	0	0	4702
17416	4612	1	5	0	0	4618
17417	3	2	4610	0	0	4615
17418	1	4682	0	2	0	4685
17419	4630	1	2	2	0	4635
17420	2	4734	0	7	0	4743
17421	3	1	0	4732	0	4736
17422	4875	0	5	0	0	4880
17423	1	5	0	4894	0	4900
17424	3	0	5044	0	0	5047
17425	1	4	3	4917	0	4925
17426	6	0	4955	1	0	4962
17427	0	10	1	5004	0	5015
17428	5022	0	1	0	0	5023
17429	1	5019	1	2	0	5023
17430	4811	2	14	0	0	4827
17431	0	7	4	4898	0	4909
17432	0	5	1	4870	0	4876
17433	0	0	4755	1	0	4756
17434	1	0	4760	2	0	4763
17435	0	4671	0	5	0	4676
17436	1	0	4672	0	0	4673
17437	4692	0	11	5	0	4708
17438	1	4679	0	1	0	4681
17439	1	4633	0	0	0	4634
17440	0	4686	0	1	0	4687
17441	0	7	0	4686	0	4693
17442	3	0	4755	0	0	4758
17443	0	5040	0	2	0	5042
17444	3	18	3	4984	0	5008
17445	1	5067	0	5	0	5073
17446	5082	0	6	0	0	5088
17447	5100	1	3	0	0	5104
17448	3	7	0	5166	0	5176
17449	2	2	0	5389	0	5393
17450	5412	0	9	0	0	5421
17451	1	5230	0	1	0	5232
17452	0	5194	1	1	0	5196
17453	2	18	1	5116	0	5137
17454	16	0	5085	0	0	5101
17455	4	5095	0	0	0	5099
17456	5101	0	14	1	0	5116
17457	1	5104	0	2	0	5107
17458	2	4784	0	3	0	4789
17459	4793	0	7	1	0	4801
17460	0	4938	0	3	0	4941
17461	4	0	4939	0	0	4943
17462	2	4879	0	3	0	4884
17463	4883	0	10	0	0	4893
17464	1	4915	0	4	0	4920
17465	4920	0	4	1	0	4925
17466	1	6	2	5261	0	5270
17467	1	8	0	5268	0	5277
17468	1	1	5304	1	0	5307
17469	0	5194	0	8	0	5202
17470	1	6	0	5158	0	5165
17471	5360	0	20	1	0	5381
17472	5431	0	8	0	0	5439
17473	0	5389	0	0	0	5389
17474	0	8	0	5299	0	5307
17475	5079	0	7	0	0	5086
17476	4905	0	28	1	0	4934
17477	4	0	4966	0	0	4970
17478	7	0	4919	0	0	4926
17479	3	1	4917	2	0	4923
17480	1	4717	0	2	0	4720
17481	4678	2	6	0	0	4686
17482	0	4843	0	0	0	4843
17483	4826	0	6	0	0	4832
17484	0	4809	0	4	0	4813
17485	1	3	0	4778	0	4782
17486	4723	2	7	2	0	4734
17487	0	0	4717	0	0	4717
17488	4604	0	7	1	0	4612
17489	4640	0	12	0	0	4652
17490	1	4629	0	0	0	4630
17491	0	4297	0	1	0	4298
17492	4197	0	8	0	0	4205
17493	0	0	4140	2	0	4142
17494	4170	0	7	0	0	4177
17495	4181	0	5	0	0	4186
17496	0	3	2	4023	0	4028
17497	3923	0	1	0	0	3924
17498	1	4	0	3960	0	3965
17499	0	7	0	4000	0	4007
17500	0	13	0	3858	0	3871
17501	2	3774	0	2	0	3778
17502	3720	0	4	1	0	3725
17503	3762	1	3	0	0	3766
17504	1	10	0	3767	0	3778
17505	1	6	0	3786	0	3793
17506	0	3780	0	0	0	3780
17507	3547	1	2	0	0	3550
17508	1	0	3635	1	0	3637
17509	0	9	0	3596	0	3605
17510	0	0	3869	0	0	3869
17511	2	5	1	3899	0	3907
17512	1	0	3913	0	0	3914
17513	1	5	0	3967	0	3973
17514	3959	0	6	0	0	3965
17515	3	0	4012	1	0	4016
17516	4015	0	11	2	0	4028
17517	0	3975	1	1	0	3977
17518	0	8	0	3901	0	3909
17519	0	0	0	3782	0	3782
17520	3855	0	3	2	0	3860
17521	0	4	0	3812	0	3816
17522	2	1	3802	0	0	3805
17523	2005	1	1817	0	0	3823
17524	3724	0	12	0	0	3736
17525	3537	2	14	0	0	3553
17526	3557	2	4	3	0	3566
17527	0	3772	0	0	0	3772
17528	0	1	0	3763	0	3764
17529	3792	0	2	1	0	3795
17530	0	5	0	3757	0	3762
17531	3733	0	3	0	0	3736
17532	1	0	3779	1	0	3781
17533	4	0	3980	0	0	3984
17534	1	8	0	4287	0	4296
17535	3	4269	0	0	0	4272
17536	0	4130	1	7	0	4138
17537	4170	0	9	2	0	4181
17538	2	0	4602	1	0	4605
17539	4692	2	13	0	0	4707
17540	0	4680	0	9	0	4689
17541	4767	0	15	0	0	4782
17542	2	3	0	4467	0	4472
17543	1	0	4465	0	0	4466
17544	1	20	0	4464	0	4485
17545	1	5	0	4462	0	4468
17546	0	4563	0	0	0	4563
17547	0	4480	0	1	0	4481
17548	1	3	0	4758	0	4762
17549	0	4786	0	2	0	4788
17550	5	0	4766	1	0	4772
17551	5	0	4828	0	0	4833
17552	4803	0	12	1	0	4816
17553	4816	0	9	2	0	4827
17554	0	4861	0	1	0	4862
17555	0	7	1	4830	0	4838
17556	0	6	2	4910	0	4918
17557	2	0	4895	0	0	4897
17558	3	15	0	5013	0	5031
17559	0	4981	0	7	0	4988
17560	197	1	4771	0	0	4969
17561	2	0	5043	1	0	5046
17562	0	5047	0	4	0	5051
17563	0	0	5044	0	0	5044
17564	0	7	1	5150	0	5158
17565	4	7	0	5107	0	5118
17566	2	0	5210	0	0	5212
17567	0	6	2	5217	0	5225
17568	2	5207	0	1	0	5210
17569	0	5233	1	1	0	5235
17570	3	9	1	5178	0	5191
17571	2	0	5234	2	0	5238
17572	1	5040	1	5	0	5047
17573	1	15	0	5153	0	5169
17574	0	0	5192	0	0	5192
17575	5107	0	12	3	0	5122
17576	5129	0	16	0	0	5145
17577	5191	0	5	0	0	5196
17578	2	7	0	5223	0	5232
17579	0	9	0	5337	0	5346
17580	7	1	5401	2	0	5411
17581	0	13	0	5559	0	5572
17582	1	5	0	5559	0	5565
17583	2	0	5514	1	0	5517
17584	5388	0	61	6	0	5455
17585	1	5304	0	3	0	5308
17586	5242	0	11	0	0	5253
17587	0	5285	0	3	0	5288
17588	2	7	0	5212	0	5221
17589	2	0	5306	0	0	5308
17590	0	10	1	5439	0	5450
17591	1	0	5439	0	0	5440
17592	5415	0	106	5	0	5526
17593	0	0	5610	0	0	5610
17594	3	12	0	5685	0	5700
17595	0	0	5727	1	0	5728
17596	0	5715	1	1	0	5717
17597	1	7	0	5642	0	5650
17598	1	8	0	5602	0	5611
17599	3	7	0	5726	0	5736
17600	1	0	5954	2	0	5957
17601	1	0	6083	0	0	6084
17602	1	15	2	6147	0	6165
17603	4	10	0	5966	0	5980
17604	0	4	0	5973	0	5977
17605	6032	0	11	0	0	6043
17606	2	13	7	6033	0	6055
17607	0	0	6092	0	0	6092
17608	6214	1	13	5	0	6233
17609	0	10	0	5855	0	5865
17610	5741	0	12	0	0	5753
17611	5742	0	3	3	0	5748
17612	0	8	0	5765	0	5773
17613	5731	0	10	0	0	5741
17614	5300	0	13	0	0	5313
17615	4	0	5660	0	0	5664
17616	0	5635	0	2	0	5637
17617	3	20	0	5607	0	5630
17618	1	5	0	5621	0	5627
17619	5569	0	2	0	0	5571
17620	5529	1	19	1	0	5550
17621	5514	0	56	0	0	5570
17622	5	0	5351	1	0	5357
17623	9	5227	0	1	0	5237
17624	5070	1	12	2	0	5085
17625	0	5490	0	1	0	5491
17626	5486	1	22	1	0	5510
17627	1	8	0	5651	0	5660
17628	5643	0	2	0	0	5645
17629	5607	0	12	0	0	5619
17630	5659	0	20	0	0	5679
17631	2	0	5688	0	0	5690
17632	5630	0	17	0	0	5647
17633	0	5648	0	1	0	5649
17634	5373	1	9	2	0	5385
17635	5593	2	16	2	0	5613
17636	5582	0	15	1	0	5598
17637	1	13	0	5622	0	5636
17638	0	5624	0	3	0	5627
17639	5486	1	11	2	0	5500
17640	4	0	5652	1	0	5657
17641	0	5682	0	6	0	5688
17642	2	15	4	5687	0	5708
17643	8	5732	0	1	0	5741
17644	5740	2	4	0	0	5746
17645	5745	0	14	1	0	5760
17646	0	11	0	5775	0	5786
17647	3	0	5927	1	0	5931
17648	0	6036	0	4	0	6040
17649	1	13	0	5938	0	5952
17650	1	6	0	5966	0	5973
17651	1	3	0	5967	0	5971
17652	6176	0	3	0	0	6179
17653	6131	0	10	2	0	6143
17654	6116	0	7	0	0	6123
17655	6029	0	12	0	0	6041
17656	0	3	0	5824	0	5827
17657	2	0	6228	0	0	6230
17658	1	10	1	6285	0	6297
17659	0	9	0	6278	0	6287
17660	2	5	0	6714	0	6721
17661	1	3	1	6631	0	6636
17662	6726	0	17	0	0	6743
17663	1	3	0	6623	0	6627
17664	6477	0	8	0	0	6485
17665	6527	1	16	1	0	6545
17666	2	0	6572	0	0	6574
17667	2	0	6640	4	0	6646
17668	2	0	7054	1	0	7057
17669	0	16	208	6669	0	6893
17670	2	0	6959	0	0	6961
17671	0	7	0	7049	0	7056
17672	3	8	1	7039	0	7051
17673	7155	1	16	1	0	7173
17674	1	8	0	7138	0	7147
17675	2	6777	0	6	0	6785
17676	6844	0	6	0	0	6850
17677	0	6714	1	3	0	6718
17678	13	0	6709	0	0	6722
17679	3	6723	1	1	0	6728
17680	6779	0	10	1	0	6790
17681	2	8	0	6840	0	6850
17682	31	0	6795	1	0	6827
17683	6996	0	20	1	0	7017
17684	1	6	1	6882	0	6890
17685	5	0	6865	0	0	6870
17686	1	36	2	6883	0	6922
17687	3	18	0	6883	0	6904
17688	1	18	1	6884	0	6904
17689	0	6868	1	2	0	6871
17690	6840	2	12	2	0	6856
17691	0	8	0	6523	0	6531
17692	0	6483	1	4	0	6488
17693	2	17	0	6370	0	6389
17694	7	0	6682	1	0	6690
17695	1	6682	0	9	0	6692
17696	6967	0	8	0	0	6975
17697	6998	0	20	4	0	7022
17698	0	9	0	7048	0	7057
17699	0	6	0	7090	0	7096
17700	7167	0	10	2	0	7179
17701	6750	0	21	2	0	6773
17702	0	6778	1	3	0	6782
17703	6528	1	8	0	0	6537
17704	1	0	6658	0	0	6659
17705	1	0	6740	0	0	6741
17706	3	6653	0	4	0	6660
17707	1	6776	0	7	0	6784
17708	7022	0	8	0	0	7030
17709	0	7225	0	0	0	7225
17710	7423	0	13	3	0	7439
17711	7214	0	11	1	0	7226
17712	7333	0	27	0	0	7360
17713	0	94	0	7187	0	7281
17714	7238	1	6	0	0	7245
17715	3	1	7223	0	0	7227
17716	5	0	7098	5	0	7108
17717	0	7148	0	13	0	7161
17718	4	0	7062	0	0	7066
17719	5	10	1	7407	0	7423
17720	8	0	7395	1	0	7404
17721	1	0	7484	1	0	7486
17722	3	4	0	7693	0	7700
17723	7445	0	17	0	0	7462
17724	7328	0	13	0	0	7341
17725	1	0	7405	0	0	7406
17726	7470	0	14	2	0	7486
17727	2	1	7510	0	0	7513
17728	7391	1	10	1	0	7403
17729	7391	1	20	0	0	7412
17730	0	9	0	7388	0	7397
17731	2	6	1	7395	0	7404
17732	1	7347	0	3	0	7351
17733	0	7304	0	2	0	7306
17734	2	20	2	7348	0	7372
17735	0	7	1	7374	0	7382
17736	7076	1	3	2	0	7082
17737	1	7210	0	2	0	7213
17738	7309	0	16	1	0	7326
17739	0	7425	1	12	0	7438
17740	2	0	7367	0	0	7369
17741	1	6	0	7404	0	7411
17742	7224	0	6	1	0	7231
17743	7276	0	12	1	0	7289
17744	0	6886	0	2	0	6888
17745	3	6747	1	10	0	6761
17746	0	6620	0	3	0	6623
17747	0	7	0	6472	0	6479
17748	1	0	6632	1	0	6634
17749	0	6631	0	2	0	6633
17750	2	9	2	6640	0	6653
17751	1	20	0	6699	0	6720
17752	8	0	6631	1	0	6640
17753	2	0	6578	0	0	6580
17754	6518	2	9	1	0	6530
17755	2	0	6524	1	0	6527
17756	6624	0	10	1	0	6635
17757	6503	1	13	0	0	6517
17758	6506	1	7	0	0	6514
17759	6240	0	28	4	0	6272
17760	1	1	6252	0	0	6254
17761	0	6185	0	3	0	6188
17762	1	13	0	6072	0	6086
17763	5	0	6423	0	0	6428
17764	2	12	1	6515	0	6530
17765	2	6617	0	3	0	6622
17766	1	21	0	6586	0	6608
17767	1	8	0	6761	0	6770
17768	1	16	1	6793	0	6811
17769	6985	0	5	0	0	6990
17770	1	7	3	6666	0	6677
17771	1	12	1	6621	0	6635
17772	1	22	0	6424	0	6447
17773	0	6374	0	5	0	6379
17774	6496	2	9	1	0	6508
17775	0	6666	1	6	0	6673
17776	0	6566	0	2	0	6568
17777	1	7	0	6630	0	6638
17778	0	6	1	6647	0	6654
17779	6906	0	3	2	0	6911
17780	0	28	1	6796	0	6825
17781	7246	1	4	0	0	7251
17782	7212	0	12	2	0	7226
17783	0	9	1	7122	0	7132
17784	2	19	1	7014	0	7036
17785	0	6719	0	2	0	6721
17786	6667	1	12	1	0	6681
17787	0	6722	0	0	0	6722
17788	6549	1	7	5	0	6562
17789	1	0	6707	1	0	6709
17790	7665	1	16	3	0	7685
17791	7837	1	12	19	0	7869
17792	1	21	1	7900	0	7923
17793	5	0	8012	3	0	8020
17794	0	7770	0	6	0	7776
17795	1	10	0	7673	0	7684
17796	2	0	7648	2	0	7652
17797	2	7	0	7853	0	7862
17798	7688	0	4	1	0	7693
17799	2	1	7709	1	0	7713
17800	1	7846	0	3	0	7850
17801	0	7894	0	5	0	7899
17802	0	18	0	7833	0	7851
17803	4	7806	0	5	0	7815
17804	7838	1	11	0	0	7850
17805	7823	0	6	3	0	7832
17806	7773	5	18	0	0	7796
17807	0	0	7789	2	0	7791
17808	7551	1	8	1	0	7561
17809	0	7	1	7523	0	7531
17810	2	3	0	7469	0	7474
17811	0	11	1	7446	0	7458
17812	0	9	2	7453	0	7464
17813	3	0	7160	3	0	7166
17814	4	0	7012	1	0	7017
17815	2	0	6959	1	0	6962
17816	7132	1	24	3	0	7160
17817	1	6979	0	3	0	6983
17818	1	7	0	6997	0	7005
17819	7028	1	30	0	0	7059
17820	1	7036	0	2	0	7039
17821	0	6971	0	20	0	6991
17822	7078	3	12	4	0	7097
17823	7172	1	9	3	0	7185
17824	0	5866	0	1204	0	7070
17825	0	15	0	7157	0	7172
17826	2	7183	0	0	0	7185
17827	7103	1	18	1	0	7123
17828	7200	0	15	0	0	7215
17829	7080	0	13	0	0	7093
17830	0	8088	0	2	0	8090
17831	1	18	2	7885	0	7906
17832	3	0	7900	0	0	7903
17833	2	13	0	8173	0	8188
17834	1	10	0	8130	0	8141
17835	31	0	8102	1	0	8134
17836	8162	2	9	1	0	8174
17837	1	19	1	8333	0	8354
17838	6	12	0	8329	0	8347
17839	1	8029	0	5	0	8035
17840	8082	0	9	0	0	8091
17841	1	18	0	8090	0	8109
17842	0	7977	0	18	0	7995
17843	7982	2	12	1	0	7997
17844	1	7893	0	3	0	7897
17845	7727	0	30	3	0	7760
17846	1	0	7724	0	0	7725
17847	1	0	7681	5	0	7687
17848	13	0	8182	3	0	8198
17849	0	8011	0	6	0	8017
17850	2	25	2	7866	0	7895
17851	0	7907	1	1	0	7909
17852	7904	0	10	2	0	7916
17853	2	0	8153	1	0	8156
17854	8199	0	17	0	0	8216
17855	7971	2	21	3	0	7997
17856	0	8	0	7948	0	7956
17857	7473	0	7	0	0	7480
17858	2	19	0	7995	0	8016
17859	2	0	7992	0	0	7994
17860	7946	0	21	1	0	7968
17861	0	7828	0	2	0	7830
17862	1	10	0	6827	0	6838
17863	6971	1	7	0	0	6979
17864	0	7	1	6915	0	6923
17865	2	0	6946	1	0	6949
17866	1	21	2	6915	0	6939
17867	1	6673	0	1	0	6675
17868	6867	0	13	1	0	6881
17869	0	7	0	6711	0	6718
17870	6651	0	4	1	0	6656
17871	2	14	0	6631	0	6647
17872	4	22	1	6423	0	6450
17873	0	6546	0	2	0	6548
17874	6199	0	7	5	0	6211
17875	0	6133	0	2	0	6135
17876	1	11	0	6093	0	6105
17877	1	6268	1	3	0	6273
17878	6197	2	15	1	0	6215
17879	6319	0	17	0	0	6336
17880	6336	1	8	1	0	6346
17881	2	6438	0	3	0	6443
17882	0	6379	0	1	0	6380
17883	6291	2	7	2	0	6302
17884	0	6808	0	0	0	6808
17885	3	14	0	6745	0	6762
17886	2	0	6804	1	0	6807
17887	6904	0	20	4	0	6928
17888	6911	0	13	0	0	6924
17889	6908	0	21	4	0	6933
17890	1	6915	0	13	0	6929
17891	6610	0	45	2	0	6657
17892	4	0	6717	0	0	6721
17893	0	6992	1	6	0	6999
17894	1	8	1	7402	0	7412
17895	1	7529	0	4	0	7534
17896	7749	0	11	0	0	7760
17897	0	8044	0	1	0	8045
17898	4	25	0	7932	0	7961
17899	0	8147	0	3	0	8150
17900	3	38	2	8092	0	8135
17901	0	17	0	8053	0	8070
17902	1	0	8066	2	0	8069
17903	2	54	0	8021	0	8077
17904	8049	0	14	1	0	8064
17905	8062	1	16	0	0	8079
17906	0	10	0	7131	0	7141
17907	6	0	7174	1	0	7181
17908	2	37	2	6882	0	6923
17909	7059	0	7	0	0	7066
17910	7025	1	17	0	0	7043
17911	7029	22	9	2	0	7062
17912	0	6980	0	2	0	6982
17913	6772	0	24	4	0	6800
17914	0	0	7084	1	0	7085
17915	7015	0	11	1	0	7027
17916	1	17	0	6954	0	6972
17917	1	6	1	6811	0	6819
17918	2	2	0	6863	0	6867
17919	6851	0	3	0	0	6854
17920	6890	0	10	2	0	6902
17921	1	6	2	6881	0	6890
17922	5	0	6860	0	0	6865
17923	1	13	0	6483	0	6497
17924	1	7	1	6336	0	6345
17925	2	1	6680	0	0	6683
17926	3	6712	0	4	0	6719
17927	0	14	0	6767	0	6781
17928	6778	0	13	1	0	6792
17929	1	8	1	6333	0	6343
17930	0	8	1	6380	0	6389
17931	6358	0	8	1	0	6367
17932	2	6294	1	2	0	6299
17933	3	6227	0	1	0	6231
17934	5686	0	12	1	0	5699
17935	2	0	5784	0	0	5786
17936	5793	0	12	2	0	5807
17937	3	1	5831	1	0	5836
17938	0	5778	0	0	0	5778
17939	5731	0	6	1	0	5738
17940	5793	0	8	2	0	5803
17941	5593	2	7	1	0	5603
17942	5602	1	15	2	0	5620
17943	3	0	5712	1	0	5716
17944	0	15	0	5486	0	5501
17945	5403	1	12	0	0	5416
17946	2	0	5431	0	0	5433
17947	8	0	5438	2	0	5448
17948	1	5564	0	3	0	5568
17949	5480	0	13	1	0	5494
17950	0	1	0	5526	0	5527
17951	5669	0	10	0	0	5679
17952	0	5720	0	2	0	5722
17953	1	9	2	5543	0	5555
17954	2	14	0	5551	0	5567
17955	0	27	0	5377	0	5404
17956	4	0	5516	1	0	5521
17957	1	5461	0	2	0	5464
17958	5477	0	4	0	0	5481
17959	0	14	0	5457	0	5471
17960	4915	1	2	0	0	4918
17961	5131	1	3	0	0	5135
17962	1	9	0	5064	0	5074
17963	1	1	5368	1	0	5371
17964	0	16	1	5319	0	5336
17965	1	5003	0	0	0	5004
17966	1	22	2	4913	0	4938
17967	2	0	4990	1	0	4993
17968	5059	2	10	3	0	5074
17969	1	2	1	5083	0	5087
17970	4532	0	11	0	0	4543
17971	1	0	4482	0	0	4483
17972	4180	0	20	0	0	4200
17973	4	0	3880	0	0	3884
17974	3909	0	9	0	0	3918
17975	0	3894	0	1	0	3895
17976	0	3952	0	0	0	3952
17977	1	7	0	3949	0	3957
17978	0	13	2	3951	0	3966
17979	0	1	0	4047	0	4048
17980	3971	1	6	0	0	3978
17981	2	18	1	3918	0	3939
17982	5	0	3891	0	0	3896
17983	3904	0	9	3	0	3916
17984	0	3852	0	2	0	3854
17985	3700	1	10	4	0	3715
17986	3700	0	5	1	0	3706
17987	0	0	3721	0	0	3721
17988	0	8	1	3753	0	3762
17989	1	13	0	3753	0	3767
17990	2	0	3480	0	0	3482
17991	2	3612	0	0	0	3614
17992	3981	0	4	1	0	3986
17993	4105	0	10	0	0	4115
17994	0	8	1	4089	0	4098
17995	1	5	0	4133	0	4139
17996	0	12	1	4086	0	4099
17997	4064	1	23	0	0	4088
17998	0	4115	0	1	0	4116
17999	4130	1	7	0	0	4138
18000	4111	0	7	1	0	4119
18001	2	0	3831	0	0	3833
18002	0	58	0	3775	0	3833
18003	1	4018	0	0	0	4019
18004	1	15	0	4014	0	4030
18005	0	7	0	4045	0	4052
18006	0	0	3988	0	0	3988
18007	4010	0	11	1	0	4022
18008	4073	2	4	0	0	4079
18009	4044	0	30	0	0	4074
18010	0	3	0	4160	0	4163
18011	0	9	0	4032	0	4041
18012	0	4063	0	2	0	4065
18013	2	4036	0	1	0	4039
18014	4153	0	13	1	0	4167
18015	0	4202	0	2	0	4204
18016	2	0	4210	0	0	4212
18017	0	1	0	4242	0	4243
18018	4195	0	3	0	0	4198
18019	3	0	4174	0	0	4177
18020	2	0	4188	2	0	4192
18021	4261	0	23	1	0	4285
18022	4342	0	13	0	0	4355
18023	2	11	0	4256	0	4269
18024	4	0	4277	0	0	4281
18025	2	14	0	4283	0	4299
18026	2	0	4202	0	0	4204
18027	3	0	4036	2	0	4041
18028	1	4285	0	3	0	4289
18029	4302	1	3	0	0	4306
18030	4401	0	0	1	0	4402
18031	0	4319	0	2	0	4321
18032	0	15	2	4298	0	4315
18033	6	1	1	4298	0	4306
18034	0	2	0	4314	0	4316
18035	4322	0	1	1	0	4324
18036	1	4077	0	5	0	4083
18037	4145	1	4	1	0	4151
18038	4144	1	10	0	0	4155
18039	1	0	3824	0	0	3825
18040	1	3892	0	1	0	3894
18041	1	7	1	3935	0	3944
18042	1	0	3954	0	0	3955
18043	4026	0	6	0	0	4032
18044	4028	0	8	0	0	4036
18045	4035	0	3	1	0	4039
18046	4102	0	4	1	0	4107
18047	1	5	1	4092	0	4099
18048	1	1	4097	0	0	4099
18049	0	12	1	4328	0	4341
18050	4333	0	2	0	0	4335
18051	4190	0	6	0	0	4196
18052	1	4101	0	2	0	4104
18053	4044	1	9	0	0	4054
18054	1	0	4046	0	0	4047
18055	0	0	4040	0	0	4040
18056	4163	0	11	1	0	4175
18057	0	4193	0	2	0	4195
18058	1	16	0	4130	0	4147
18059	0	4556	0	0	0	4556
18060	0	16	0	4538	0	4554
18061	1	5	1	4565	0	4572
18062	2	3	0	4588	0	4593
18063	4546	0	2	0	0	4548
18064	4527	0	7	1	0	4535
18065	4533	0	14	0	0	4547
18066	1	0	4565	0	0	4566
18067	4471	1	7	0	0	4479
18068	1	3	0	4093	0	4097
18069	4	5	0	3964	0	3973
18070	0	0	4173	0	0	4173
18071	0	6	0	4152	0	4158
18072	4139	0	12	0	0	4151
18073	0	0	4140	0	0	4140
18074	0	2	0	4144	0	4146
18075	4146	1	6	1	0	4154
18076	4125	0	2	2	0	4129
18077	2	0	4117	1	0	4120
18078	851	0	3258	2	0	4111
18079	1	2	0	3949	0	3952
18080	3937	0	4	0	0	3941
18081	3999	1	2	0	0	4002
18082	0	10	0	4055	0	4065
18083	0	4060	0	2	0	4062
18084	4017	0	4	0	0	4021
18085	0	3992	0	1	0	3993
18086	0	5	0	3839	0	3844
18087	1	0	3899	0	0	3900
18088	2	0	3945	2	0	3949
18089	0	0	4045	1	0	4046
18090	1	18	1	4022	0	4042
18091	1	0	1	3938	0	3940
18092	3964	1	3	0	0	3968
18093	0	3995	0	0	0	3995
18094	4140	0	6	0	0	4146
18095	1	2	0	4090	0	4093
18096	2	3957	0	2	0	3961
18097	0	4006	0	5	0	4011
18098	0	7	0	3950	0	3957
18099	4028	0	2	0	0	4030
18100	0	4040	0	1	0	4041
18101	4012	1	9	0	0	4022
18102	1	3996	0	0	0	3997
18103	3679	0	9	0	0	3688
18104	3	0	3730	0	0	3733
18105	4	0	3752	2	0	3758
18106	1	3779	1	2	0	3783
18107	4105	0	5	1	0	4111
18108	0	4219	0	3	0	4222
18109	0	4256	0	3	0	4259
18110	1	17	0	4256	0	4274
18111	4320	1	9	3	0	4333
18112	0	4383	0	1	0	4384
18113	4379	2	4	2	0	4387
18114	0	4349	0	1	0	4350
18115	4182	0	14	0	0	4196
18116	1	4360	0	0	0	4361
18117	0	4256	0	3	0	4259
18118	0	16	1	4283	0	4300
18119	0	4287	0	0	0	4287
18120	4249	0	5	1	0	4255
18121	0	0	4364	1	0	4365
18122	0	32	0	4728	0	4760
18123	1	1	4747	0	0	4749
18124	0	4	0	4849	0	4853
18125	0	13	0	4583	0	4596
18126	2	1	4576	0	0	4579
18127	4564	0	11	0	0	4575
18128	0	4636	0	0	0	4636
18129	4639	0	15	2	0	4656
18130	0	4620	0	0	0	4620
18131	0	2	0	4507	0	4509
18132	4522	0	7	1	0	4530
18133	4530	0	7	0	0	4537
18134	4590	1	7	1	0	4599
18135	0	8	2	4443	0	4453
18136	4	12	0	4435	0	4451
18137	2	4433	0	1	0	4436
18138	4528	1	6	0	0	4535
18139	4562	0	7	0	0	4569
18140	4580	0	11	0	0	4591
18141	4590	2	8	0	0	4600
18142	0	4570	0	1	0	4571
18143	1	36	0	4451	0	4488
18144	0	0	4491	1	0	4492
18145	4498	1	9	0	0	4508
18146	4319	1	11	0	0	4331
18147	0	0	4373	0	0	4373
18148	0	0	4567	0	0	4567
18149	0	9	0	4559	0	4568
18150	0	5	1	4537	0	4543
18151	0	3	0	4523	0	4526
18152	4552	1	4	1	0	4558
18153	2	3	0	4424	0	4429
18154	0	0	4500	1	0	4501
18155	0	13	0	4438	0	4451
18156	2	0	4457	0	0	4459
18157	0	12	0	4444	0	4456
18158	0	8	0	4333	0	4341
18159	1	1	4368	0	0	4370
18160	4454	0	10	2	0	4466
18161	0	4440	0	4	0	4444
18162	4424	0	24	1	0	4449
18163	0	4	0	4343	0	4347
18164	4372	0	3	0	0	4375
18165	1	4274	0	3	0	4278
18166	0	4387	0	4	0	4391
18167	2	6	1	4394	0	4403
18168	8	0	4381	0	0	4389
18169	5	0	4408	0	0	4413
18170	0	4253	0	6	0	4259
18171	4289	0	2	0	0	4291
18172	0	5	1	4358	0	4364
18173	4440	0	6	1	0	4447
18174	1	4669	0	4	0	4674
18175	0	4669	0	1	0	4670
18176	0	3	0	4647	0	4650
18177	4648	0	20	0	0	4668
18178	4640	0	7	0	0	4647
18179	2	0	4677	0	0	4679
18180	0	0	4846	0	0	4846
18181	4832	1	20	0	0	4853
18182	1	4713	0	4	0	4718
18183	4379	0	13	1	0	4393
18184	0	16	1	4278	0	4295
18185	1	0	4323	3	0	4327
18186	4617	0	9	0	0	4626
18187	1	4670	0	0	0	4671
18188	0	4750	0	3	0	4753
18189	0	6	1	4685	0	4692
18190	4982	0	7	2	0	4991
18191	0	8	0	4986	0	4994
18192	4785	1	8	1	0	4795
18193	4	1	4782	0	0	4787
18194	4649	0	2	1	0	4652
18195	4253	0	15	0	0	4268
18196	0	0	4247	0	0	4247
18197	4107	0	16	1	0	4124
18198	0	4124	0	0	0	4124
18199	2	7	0	3998	0	4007
18200	1	4102	0	0	0	4103
18201	4092	3	6	2	0	4103
18202	0	4	0	4292	0	4296
18203	2	4303	0	0	0	4305
18204	0	10	0	4241	0	4251
18205	1	4463	0	1	0	4465
18206	0	2	0	4523	0	4525
18207	4733	0	5	0	0	4738
18208	0	4	0	4719	0	4723
18209	0	0	4635	0	0	4635
18210	4517	0	10	1	0	4528
18211	0	6	0	4298	0	4304
18212	2	0	4282	1	0	4285
18213	0	0	4331	1	0	4332
18214	0	1	4474	1	0	4476
18215	0	8	0	4473	0	4481
18216	0	3	1	4486	0	4490
18217	0	5	0	4480	0	4485
18218	1	1	0	4527	0	4529
18219	4578	0	3	0	0	4581
18220	4571	0	1	0	0	4572
18221	4561	0	0	2	0	4563
18222	4588	0	12	0	0	4600
18223	0	4	0	4428	0	4432
18224	0	0	4412	0	0	4412
18225	4415	0	8	2	0	4425
18226	4476	0	2	0	0	4478
18227	0	4	0	4472	0	4476
18228	0	1	0	4466	0	4467
18229	4535	0	4	1	0	4540
18230	1	11	1	4454	0	4467
18231	0	4430	0	0	0	4430
18232	4402	1	13	0	0	4416
18233	4672	0	12	2	0	4686
18234	0	0	4785	0	0	4785
18235	0	6	1	4769	0	4776
18236	0	3	0	4743	0	4746
18237	4760	0	6	0	0	4766
18238	4766	2	4	1	0	4773
18239	0	5	0	4819	0	4824
18240	2	0	4812	0	0	4814
18241	2	0	4828	1	0	4831
18242	2	21	1	4659	0	4683
18243	2	5	5	4638	0	4650
18244	4662	0	4	0	0	4666
18245	3	4914	0	7	0	4924
18246	1	4896	0	6	0	4903
18247	0	4792	0	5	0	4797
18248	1	5	1	4742	0	4749
18249	4786	0	7	0	0	4793
18250	4575	0	16	0	0	4591
18251	0	4635	0	2	0	4637
18252	4677	0	4	0	0	4681
18253	1	7	0	4654	0	4662
18254	1	0	4691	0	0	4692
18255	1	7	1	4617	0	4626
18256	1	13	0	4641	0	4655
18257	4	8	0	4660	0	4672
18258	4918	0	4	0	0	4922
18259	1	13	0	4890	0	4904
18260	0	4784	0	2	0	4786
18261	4793	0	6	2	0	4801
18262	0	4543	0	1	0	4544
18263	2	4416	0	1	0	4419
18264	1	4351	0	3	0	4355
18265	3	0	4383	1	0	4387
18266	0	4116	0	1	0	4117
18267	1	0	4124	0	0	4125
18268	4132	0	5	0	0	4137
18269	4117	0	5	1	0	4123
18270	1	0	4144	0	0	4145
18271	4118	3	12	0	0	4133
18272	4136	1	8	2	0	4147
18273	0	0	4319	1	0	4320
18274	0	4467	0	2	0	4469
18275	0	4	0	4487	0	4491
18276	4551	0	5	0	0	4556
18277	0	6	1	4583	0	4590
18278	4379	1	2	1	0	4383
18279	4363	1	5	0	0	4369
18280	1	0	4449	0	0	4450
18281	4473	1	15	2	0	4491
18282	0	4401	0	3	0	4404
18283	4244	2	11	0	0	4257
18284	1	9	0	4265	0	4275
18285	3	0	4311	0	0	4314
18286	0	9	0	4361	0	4370
18287	4425	0	13	0	0	4438
18288	1	4369	0	1	0	4371
18289	3	0	4354	1	0	4358
18290	1	4	0	4234	0	4239
18291	3	0	4219	0	0	4222
18292	0	4200	0	1	0	4201
18293	4259	0	5	0	0	4264
18294	0	10	0	4216	0	4226
18295	66	0	4123	0	0	4189
18296	0	0	4259	0	0	4259
18297	4226	0	4	0	0	4230
18298	0	4	1	4224	0	4229
18299	0	1	0	4161	0	4162
18300	0	0	4096	0	0	4096
18301	3	0	4122	2	0	4127
18302	0	4254	2	1	0	4257
18303	1	14	1	4236	0	4252
18304	0	8	0	4325	0	4333
18305	4	4259	0	1	0	4264
18306	4	0	4281	0	0	4285
18307	4343	0	21	1	0	4365
18308	1	14	0	4354	0	4369
18309	1	0	4107	1	0	4109
18310	1	6	0	3995	0	4002
18311	0	4084	0	3	0	4087
18312	7	0	4097	2	0	4106
18313	4215	2	8	0	0	4225
18314	0	0	4251	1	0	4252
18315	1	0	4212	3	0	4216
18316	2	0	4155	1	0	4158
18317	0	0	4280	1	0	4281
18318	0	6	0	4257	0	4263
18319	3	0	4279	0	0	4282
18320	2	10	3	4335	0	4350
18321	0	4103	0	2	0	4105
18322	4104	0	16	0	0	4120
18323	0	15	0	4140	0	4155
18324	3	0	4115	1	0	4119
18325	0	4323	0	0	0	4323
18326	0	6	1	4262	0	4269
18327	4317	0	10	0	0	4327
18328	1	4137	0	0	0	4138
18329	0	5	4	4130	0	4139
18330	4138	1	4	0	0	4143
18331	2	0	4143	1	0	4146
18332	4216	0	8	0	0	4224
18333	0	0	4261	0	0	4261
18334	4049	0	14	0	0	4063
18335	4052	0	7	0	0	4059
18336	2	2	4062	0	0	4066
18337	0	4161	0	1	0	4162
18338	0	11	2	4222	0	4235
18339	2	0	4270	0	0	4272
18340	0	4	0	4286	0	4290
18341	1	3	3	4279	0	4286
18342	0	0	4245	0	0	4245
18343	1	0	4340	1	0	4342
18344	0	1	0	4416	0	4417
18345	4549	1	28	1	0	4579
18346	1	4586	1	1	0	4589
18347	0	4597	0	3	0	4600
18348	4552	1	10	2	0	4565
18349	4406	0	3	0	0	4409
18350	0	3	0	4243	0	4246
18351	1	8	1	4259	0	4269
18352	2	12	0	4347	0	4361
18353	4511	0	4	0	0	4515
18354	1	4533	0	0	0	4534
18355	0	4676	0	1	0	4677
18356	1	13	0	4531	0	4545
18357	2	6	0	4570	0	4578
18358	1	0	0	4598	0	4599
18359	4541	0	3	0	0	4544
18360	0	4499	0	0	0	4499
18361	4456	0	9	1	0	4466
18362	1	0	4452	2	0	4455
18363	0	4396	0	6	0	4402
18364	0	6	1	4375	0	4382
18365	4388	0	11	0	0	4399
18366	0	1	4312	0	0	4313
18367	0	0	4453	0	0	4453
18368	0	11	1	4455	0	4467
18369	0	6	0	4469	0	4475
18370	0	3	0	4485	0	4488
18371	0	9	1	4525	0	4535
18372	1	4	0	4467	0	4472
18373	0	4513	0	0	0	4513
18374	1	9	1	4499	0	4510
18375	4493	1	3	0	0	4497
18376	0	4421	1	6	0	4428
18377	4213	3	13	2	0	4231
18378	3	0	4284	0	0	4287
18379	0	0	4523	1	0	4524
18380	1	5	0	4449	0	4455
18381	1	0	4452	0	0	4453
18382	0	14	2	4592	0	4608
18383	2	2	0	4546	0	4550
18384	4589	0	4	0	0	4593
18385	4542	2	10	0	0	4554
18386	0	4582	0	2	0	4584
18387	1	4474	0	3	0	4478
18388	0	11	0	4322	0	4333
18389	4298	1	2	0	0	4301
18390	403	0	3893	0	0	4296
18391	2	5	1	4351	0	4359
18392	0	1	0	4338	0	4339
18393	1	0	4244	0	0	4245
18394	0	4134	0	82	0	4216
18395	0	13	0	4127	0	4140
18396	1	0	4175	1	0	4177
18397	0	4	0	4207	0	4211
18398	4380	0	7	0	0	4387
18399	0	4351	0	1	0	4352
18400	0	4049	0	9	0	4058
18401	1	3	0	4076	0	4080
18402	4045	0	6	0	0	4051
18403	0	3970	0	3	0	3973
18404	3955	0	12	0	0	3967
18405	1	0	4099	0	0	4100
18406	0	0	4111	0	0	4111
18407	0	3	1	4005	0	4009
18408	2	7	0	3908	0	3917
18409	3966	0	5	0	0	3971
18410	0	9	2	4005	0	4016
18411	3	0	4096	0	0	4099
18412	0	0	1	4110	0	4111
18413	1	9	0	3927	0	3937
18414	3	0	3831	2	0	3836
18415	3982	0	19	1	0	4002
18416	0	4	1	4033	0	4038
18417	4121	0	4	0	0	4125
18418	1	4066	0	2	0	4069
18419	4008	0	50	0	0	4058
18420	1	4187	0	2	0	4190
18421	2	3966	0	0	0	3968
18422	3	3	2	4134	0	4142
18423	4109	0	5	0	0	4114
18424	4098	0	12	0	0	4110
18425	0	2	0	4414	0	4416
18426	4376	2	1	0	0	4379
18427	4412	0	5	1	0	4418
18428	1	6	1	4271	0	4279
18429	4092	1	4	2	0	4099
18430	0	4023	0	0	0	4023
18431	3717	0	4	1	0	3722
18432	2	0	3742	0	0	3744
18433	3870	0	2	0	0	3872
18434	0	9	0	3856	0	3865
18435	1	1	0	3860	0	3862
18436	0	4	1	3891	0	3896
18437	0	11	0	3936	0	3947
18438	0	10	0	3936	0	3946
18439	2	3947	0	2	0	3951
18440	0	3947	0	0	0	3947
18441	3880	0	6	0	0	3886
18442	0	0	3932	1	0	3933
18443	4009	0	9	1	0	4019
18444	0	0	4064	0	0	4064
18445	1	6	0	4106	0	4113
18446	0	2	0	4073	0	4075
18447	4004	2	6	3	0	4015
18448	1	0	4130	1	0	4132
18449	3	8	0	4285	0	4296
18450	3	0	4298	0	0	4301
18451	1	4291	0	1	0	4293
18452	0	2	0	4252	0	4254
18453	4255	0	4	0	0	4259
18454	4181	0	1	1	0	4183
18455	4093	3	11	0	0	4107
18456	1	4125	0	3	0	4129
18457	0	3979	0	3	0	3982
18458	4030	0	4	0	0	4034
18459	5	4103	0	1	0	4109
18460	0	4341	0	2	0	4343
18461	7	1	4323	1	0	4332
18462	2	4289	0	3	0	4294
18463	2	4291	0	1	0	4294
18464	0	4	0	4274	0	4278
18465	6	0	4260	0	0	4266
18466	2	0	4348	1	0	4351
18467	4280	3	7	0	0	4290
18468	2	0	4318	0	0	4320
18469	4286	0	19	1	0	4306
18470	1	5	1	4355	0	4362
18471	3	4300	0	0	0	4303
18472	4317	0	13	0	0	4330
18473	4411	1	14	0	0	4426
18474	1	3	0	4248	0	4252
18475	1	7	0	4263	0	4271
18476	1	5	0	4294	0	4300
18477	4349	0	2	3	0	4354
18478	4346	0	3	0	0	4349
18479	4338	1	24	0	0	4363
18480	1	4197	0	1	0	4199
18481	4158	0	11	0	0	4169
18482	1	4352	0	0	0	4353
18483	0	4166	0	5	0	4171
18484	0	13	2	4167	0	4182
18485	0	4216	0	1	0	4217
18486	4210	0	22	0	0	4232
18487	0	3	0	4199	0	4202
18488	4173	2	6	2	0	4183
18489	1	4213	0	1	0	4215
18490	0	4157	0	1	0	4158
18491	4117	0	13	1	0	4131
18492	1	8876	0	0	0	8877
18493	0	5	0	8806	0	8811
18494	0	3	1	9009	0	9013
18495	9538	0	3	2	0	9543
18496	0	9	1	9523	0	9533
18497	5	0	12512	2	0	12519
18498	2	26	2	12395	0	12425
18499	13037	0	6	3	0	13046
18500	1	13230	0	2	0	13233
18501	12919	0	19	1	0	12939
18502	13458	4	13	2	0	13477
18503	13417	0	6	2	0	13425
18504	1	0	13724	2	0	13727
18505	3	1	13723	10	0	13737
18506	13700	2	23	6	0	13731
18507	2	13990	0	11	0	14003
18508	4	88	2	13864	0	13958
18509	2	37	1	15808	0	15848
18510	1	17082	0	8	0	17091
18511	3	17354	0	6	0	17363
18512	22	38	1	17993	0	18054
18513	5	42	2	18053	0	18102
18514	13	0	20337	2	0	20352
18515	9	0	20678	7	0	20694
18516	21141	2	68	3	0	21214
18517	21464	1	53	2	0	21520
18518	3	44	2	21385	0	21434
18519	7	0	21829	1	0	21837
18520	3	38	3	21907	0	21951
18521	21854	1	25	6	0	21886
18522	8	1	21959	0	0	21968
18523	8	94	1	22063	0	22166
18524	11	0	22092	20	0	22123
18525	0	22721	1	29	0	22751
18526	23	0	25308	6	0	25337
18527	3	26	2	27346	0	27377
18528	27212	4	28	4	0	27248
18529	2	30	2	27328	0	27362
18530	27396	5	32	3	0	27436
18531	27249	5	32	10	0	27296
18532	27634	10	67	3	0	27714
18533	2	0	28055	5	0	28062
18534	27285	5	305	2	0	27597
18535	1	66	3	27869	0	27939
18536	7	92	2	27657	0	27758
18537	12	3	29139	5	0	29159
18538	3	47	3	29716	0	29769
18539	29628	0	40	3	0	29671
18540	2	29667	0	14	0	29683
18541	29540	3	64	8	0	29615
18542	30166	4	32	4	0	30206
18543	30887	3	34	2	0	30926
18544	4	54	1	31625	0	31684
18545	11	0	32095	3	0	32109
18546	4	73	1	31942	0	32020
18547	4	66	0	32034	0	32104
18548	32227	2	35	1	0	32265
18549	32015	2	62	7	0	32086
18550	10	0	32344	2	0	32356
18551	6	56	4	32671	0	32737
18552	19	0	32425	6	0	32450
18553	32445	0	66	16	0	32527
18554	0	32748	2	12	0	32762
18555	32653	2	80	9	0	32744
18556	2	33077	0	12	0	33091
18557	32887	7	69	7	0	32970
18558	0	35073	1	10	0	35084
18559	6	96	4	34894	0	35000
18560	8	25	0	35290	0	35323
18561	35242	2	56	2	0	35302
18562	35170	5	84	9	0	35268
18563	35119	5	67	2	0	35193
18564	35048	1	53	4	0	35106
18565	35050	3	55	16	0	35124
18566	2	159	8	35123	0	35292
18567	1	31338	0	8	0	31347
18568	7	84	1	30756	0	30848
18569	1	30997	0	6	0	31004
18570	9	97	3	30892	0	31001
18571	0	28797	0	10	0	28807
18572	9	75	7	28813	0	28904
18573	13	0	28931	2	0	28946
18574	28859	4	44	9	0	28916
18575	0	28194	1	29	0	28224
18576	27827	8	45	20	0	27900
18577	14	1	28367	4	0	28386
18578	27865	4	54	17	0	27940
18579	6	2	29111	4	0	29123
18580	3	69	3	28832	0	28907
18581	2	29148	0	11	0	29161
18582	39	0	30314	0	0	30353
18583	3	82	1	30493	0	30579
18584	30477	1	30	3	0	30511
18585	1	47	3	28792	0	28843
18586	6	54	1	28046	0	28107
18587	7	61	2	27817	0	27887
18588	6	0	28305	5	0	28316
18589	9	70	0	29498	0	29577
18590	0	27339	0	6	0	27345
18591	7	38	1	27257	0	27303
18592	1	20	1	27660	0	27682
18593	27394	1	19	2	0	27416
18594	5	37	1	27831	0	27874
18595	14	1	27352	3	0	27370
18596	20	1	27293	15	0	27329
18597	22	6	27902	16	0	27946
18598	10	28083	2	13	0	28108
18599	28532	2	35	11	0	28580
18600	3	28755	0	20	0	28778
18601	28936	0	51	3	0	28990
18602	3	79	1	26679	0	26762
18603	10	0	24896	2	0	24908
18604	21	2	26028	11	0	26062
18605	2	26094	0	12	0	26108
18606	7	67	7	25968	0	26049
18607	2	52	2	26146	0	26202
18608	4	46	3	25665	0	25718
18609	3	0	25866	6	0	25875
18610	25722	0	59	8	0	25789
18611	14	0	26007	1	0	26022
18612	5	57	1	26436	0	26499
18613	2	67	1	24537	0	24607
18614	8	1	24592	11	0	24612
18615	24547	1	255	4	0	24807
18616	0	25364	1	3	0	25368
18617	25404	0	94	7	0	25505
18618	3	65	3	25785	0	25856
18619	1	25477	0	21	0	25499
18620	2	29	4	25379	0	25414
18621	26216	6	25	3	0	26250
18622	4	77	0	26252	0	26333
18623	7	0	26683	2	0	26692
18624	26380	2	82	11	0	26475
18625	25778	3	358	7	0	26146
18626	10	0	26430	2	0	26442
18627	3	29	1	26257	0	26290
18628	26113	0	17	0	0	26130
18629	1	46	4	27118	0	27169
18630	3	20	1	26975	0	26999
18631	6	53	0	27281	0	27340
18632	5	50	0	27024	0	27079
18633	16	0	27078	8	0	27102
18634	5	142	4	25211	0	25362
18635	6	1	25244	2	0	25253
18636	24847	2	60	45	0	24954
18637	25716	5	34	4	0	25759
18638	27294	1	64	7	0	27366
18639	27638	1	56	10	0	27705
18640	0	17	1	27898	0	27916
18641	27823	0	16	0	0	27839
18642	5	0	27890	10	0	27905
18643	12	0	27312	12	0	27336
18644	27469	0	60	8	0	27537
18645	6	27029	2	5	0	27042
18646	4	26716	1	10	0	26731
18647	9	34	2	26488	0	26533
18648	21	0	26744	2	0	26767
18649	26301	2	143	5	0	26451
18650	6	0	26688	8	0	26702
18651	3	26674	6	13	0	26696
18652	18	0	26502	8	0	26528
18653	69	26004	0	16	0	26089
18654	26930	3	47	3	0	26983
18655	4	27276	0	12	0	27292
18656	3	26013	0	12	0	26028
18657	11	51	3	26552	0	26617
18658	10	0	26998	4	0	27012
18659	4	74	1	27069	0	27148
18660	1	65	3	27664	0	27733
18661	11	2	28290	4	0	28307
18662	7	77	4	28003	0	28091
18663	3	27127	1	10	0	27141
18664	7	30	3	26056	0	26096
18665	27248	1	12	0	0	27261
18666	9	83	1	27206	0	27299
18667	52	0	28534	4	0	28590
18668	7	48	3	28630	0	28688
18669	9	0	28405	5	0	28419
18670	27866	1	57	9	0	27933
18671	2	24	1	28459	0	28486
18672	27785	3	55	4	0	27847
18673	6	0	27601	4	0	27611
18674	27049	1	119	5	0	27174
18675	0	26939	0	10	0	26949
18676	485	0	25475	3	0	25963
18677	3	71	2	26587	0	26663
18678	20	4	26537	10	0	26571
18679	6	27262	2	22	0	27292
18680	7	27272	0	17	0	27296
18681	27477	2	129	15	0	27623
18682	1	27475	0	34	0	27510
18683	27582	0	53	14	0	27649
18684	8	79	6	27979	0	28072
18685	20	1	27582	3	0	27606
18686	1	28006	0	9	0	28016
18687	4	135	2	27631	0	27772
18688	4	87	1	29160	0	29252
18689	6	118	2	29172	0	29298
18690	8	59	2	28915	0	28984
18691	4	28652	0	15	0	28671
18692	2	28532	0	9	0	28543
18693	28605	6	36	7	0	28654
18694	1	26422	2	6	0	26431
18695	2	42	1	25802	0	25847
18696	13	1	26750	6	0	26770
18697	4	26639	0	12	0	26655
18698	2	70	0	26728	0	26800
18699	5	103	0	28009	0	28117
18700	1	27979	1	14	0	27995
18701	27917	8	44	8	0	27977
18702	8	0	27565	2	0	27575
18703	27812	6	51	6	0	27875
18704	5	28608	1	12	0	28626
18705	27744	1	72	7	0	27824
18706	1	29100	0	8	0	29109
18707	10	56	2	28938	0	29006
18708	1	34	0	29047	0	29082
18709	28793	1	22	2	0	28818
18710	9	96	2	28711	0	28818
18711	9	1	28676	6	0	28692
18712	9	29122	0	21	0	29152
18713	6	28139	0	6	0	28151
18714	5	70	0	27811	0	27886
18715	296	0	27323	4	0	27623
18716	7	47	17	27960	0	28031
18717	5	56	5	27930	0	27996
18718	19	1	27586	8	0	27614
18719	10	5	27380	16	0	27411
18720	10	27454	1	19	0	27484
18721	27602	0	27	5	0	27634
18722	6	78	2	27605	0	27691
18723	2	27641	1	6	0	27650
18724	28437	7	36	2	0	28482
18725	4	65	4	28682	0	28755
18726	7	73	0	28529	0	28609
18727	0	29579	0	8	0	29587
18728	14	45	1	29441	0	29501
18729	29456	2	16	1	0	29475
18730	5	64	0	29535	0	29604
18731	4	74	1	28480	0	28559
18732	27	1	28820	7	0	28855
18733	11	2	28240	10	0	28263
18734	27818	7	48	4	0	27877
18735	6	113	3	27970	0	28092
18736	5	51	0	27583	0	27639
18737	1	42	3	26870	0	26916
18738	9	3	27333	2	0	27347
18739	27687	0	37	6	0	27730
18740	6	51	3	27864	0	27924
18741	1	32	1	26809	0	26843
18742	26378	0	35	3	0	26416
18743	0	25959	0	18	0	25977
18744	18	1	26243	1	0	26263
18745	9	154	4	28037	0	28204
18746	3	28427	0	14	0	28444
18747	3	45	2	28295	0	28345
18748	29483	1	21	4	0	29509
18749	6	47	4	29338	0	29395
18750	29324	3	37	1	0	29365
18751	29373	3	39	8	0	29423
18752	5	60	2	28527	0	28594
18753	8	28734	0	5	0	28747
18754	0	26923	2	27	0	26952
18755	18	0	28189	1	0	28208
18756	9	72	4	28117	0	28202
18757	7	68	3	28146	0	28224
18758	1	72	1	29699	0	29773
18759	29579	2	22	7	0	29610
18760	3	63	7	29593	0	29666
18761	8	0	29575	0	0	29583
18762	28680	2	62	9	0	28753
18763	4	51	2	29104	0	29161
18764	6	55	4	27537	0	27602
18765	9	0	27507	0	0	27516
18766	30022	1	52	4	0	30079
18767	5	85	2	30028	0	30120
18768	31	0	30273	3	0	30307
18769	6	121	2	30409	0	30538
18770	10	75	0	30298	0	30383
18771	18	29419	1	12	0	29450
18772	29783	3	61	5	0	29852
18773	31028	3	45	7	0	31083
18774	3	30919	0	9	0	30931
18775	29733	3	41	8	0	29785
18776	29814	5	48	3	0	29870
18777	9	36	10	29464	0	29519
18778	7	2	29521	4	0	29534
18779	8	0	30541	8	0	30557
18780	10	0	29745	7	0	29762
18781	16	0	30496	5	0	30517
18782	4	114	9	29179	0	29306
18783	3	76	3	29376	0	29458
18784	4	62	2	29472	0	29540
18785	0	26	1	29488	0	29515
18786	29402	0	22	2	0	29426
18787	1	29418	1	14	0	29434
18788	28453	8	81	6	0	28548
18789	13	0	28860	2	0	28875
18790	23	0	28667	13	0	28703
18791	8	36	2	28333	0	28379
18792	28289	2	33	0	0	28324
18793	28652	1	47	9	0	28709
18794	5	30352	1	11	0	30369
18795	3	30783	1	12	0	30799
18796	5	77	1	30718	0	30801
18797	31187	1	23	6	0	31217
18798	7	30904	0	12	0	30923
18799	30830	1	133	5	0	30969
18800	30152	2	50	7	0	30211
18801	29907	4	88	3	0	30002
18802	8	2	29953	8	0	29971
18803	1	28709	0	51	0	28761
18804	28534	2	38	5	0	28579
18805	31075	1	48	5	0	31129
18806	11	31008	0	5	0	31024
18807	2	30839	0	9	0	30850
18808	30881	0	33	1	0	30915
18809	5	81	2	30452	0	30540
18810	18	0	31276	3	0	31297
18811	30944	3	42	6	0	30995
18812	7	103	6	31100	0	31216
18813	2	31201	0	10	0	31213
18814	6	77	13	30243	0	30339
18815	10	0	33026	2	0	33038
18816	9	48	0	33922	0	33979
18817	34027	2	17	5	0	34051
18818	8	72	3	34138	0	34221
18819	11	170	3	32711	0	32895
18820	13	1	33026	22	0	33062
18821	8	60	2	31590	0	31660
18822	6	31015	0	14	0	31035
18823	31335	6	41	5	0	31387
18824	30454	6	48	2	0	30510
18825	11	1	32222	4	0	32238
18826	8	76	2	32822	0	32908
18827	5	32976	0	15	0	32996
18828	2	32973	2	24	0	33001
18829	33318	8	26	7	0	33359
18830	9	47	8	33803	0	33867
18831	21	1	32705	2	0	32729
18832	19	0	34918	5	0	34942
18833	6	30	0	35025	0	35061
18834	33548	1	47	3	0	33599
18835	33696	0	44	4	0	33744
18836	1	42	0	33952	0	33995
18837	35	2	33799	2	0	33838
18838	3	33973	0	20	0	33996
18839	33967	0	65	4	0	34036
18840	5	34838	0	20	0	34863
18841	34171	6	62	6	0	34245
18842	9	94	1	33596	0	33700
18843	17	1	33794	4	0	33816
18844	3	49	7	33719	0	33778
18845	34345	7	67	1	0	34420
18846	22	1	34479	5	0	34507
18847	8	34865	5	19	0	34897
18848	4	53	2	34893	0	34952
18849	34265	3	40	4	0	34312
18850	10	0	34996	1	0	35007
18851	5	82	1	38398	0	38486
18852	4	100	2	38186	0	38292
18853	15	0	38401	2	0	38418
18854	11	95	10	37823	0	37939
18855	12	0	37234	4	0	37250
18856	37635	3	68	10	0	37716
18857	2	45	1	37039	0	37087
18858	24	3	36749	2	0	36778
18859	8	40243	3	14	0	40268
18860	40786	5	100	11	0	40902
18861	42265	3	61	3	0	42332
18862	9	1424	1	40854	0	42288
18863	7	42744	1	22	0	42774
18864	42416	2	598	3	0	43019
18865	3	103	4	42768	0	42878
18866	14	0	42937	1	0	42952
18867	43019	1	49	12	0	43081
18868	1	41664	1	11	0	41677
18869	7	77	1	41153	0	41238
18870	40423	1	33	14	0	40471
18871	36	0	40487	9	0	40532
18872	17	1	42580	7	0	42605
18873	4	101	13	42226	0	42344
18874	12	1	42440	7	0	42460
18875	13	84	12	42572	0	42681
18876	11	42088	0	18	0	42117
18877	4	82	7	42535	0	42628
18878	42531	1	57	4	0	42593
18879	16	1	42390	4	0	42411
18880	5	41949	0	25	0	41979
18881	14	139	5	40321	0	40479
18882	33	2	41164	4	0	41203
18883	13	76	1	41488	0	41578
18884	10	41395	0	51	0	41456
18885	14	40708	0	24	0	40746
18886	40972	4	85	8	0	41069
18887	3	40869	1	26	0	40899
18888	20	2	40771	4	0	40797
18889	40093	5	78	14	0	40190
18890	14	0	40492	5	0	40511
18891	1	57	5	37239	0	37302
18892	21	1	37523	1	0	37546
18893	6	37822	6	18	0	37852
18894	1	81	4	37823	0	37909
18895	12	72	2	38405	0	38491
18896	10	74	1	37789	0	37874
18897	5	0	38290	5	0	38300
18898	12	57	3	39065	0	39137
18899	8	45	1	38507	0	38561
18900	38273	3	53	7	0	38336
18901	35710	1	51	7	0	35769
18902	17	0	36156	2	0	36175
18903	6	35819	1	15	0	35841
18904	17	1	36115	0	0	36133
18905	6	113	2	36173	0	36294
18906	17	0	35851	1	0	35869
18907	3	102	1	35649	0	35755
18908	5	43	2	33929	0	33979
18909	22	1	34062	4	0	34089
18910	35044	4	61	11	0	35120
18911	0	34567	0	13	0	34580
18912	14	75	4	34140	0	34233
18913	19	0	34832	3	0	34854
18914	13	3	34960	6	0	34982
18915	35072	0	52	7	0	35131
18916	3	35135	1	8	0	35147
18917	3	47	4	34838	0	34892
18918	36776	1	18	7	0	36802
18919	5	77	1	37220	0	37303
18920	4	46	1	37103	0	37154
18921	9	2	36103	14	0	36128
18922	34446	6	53	16	0	34521
18923	34513	1	97	4	0	34615
18924	8	31	4	34556	0	34599
18925	33484	1	51	5	0	33541
18926	5	91	6	36055	0	36157
18927	8	34556	2	5	0	34571
18928	5	35198	0	8	0	35211
18929	7	86	4	35373	0	35470
18930	36008	4	16	4	0	36032
18931	5	24	1	36466	0	36496
18932	35966	3	28	3	0	36000
18933	36040	7	38	3	0	36088
18934	6	36	4	35025	0	35071
18935	4	48	7	31724	0	31783
18936	20	0	30941	26	0	30987
18937	15	0	30761	9	0	30785
18938	2	63	1	30541	0	30607
18939	14	2	30001	3	0	30020
18940	29744	5	138	11	0	29898
18941	2	81	1	29710	0	29794
18942	26	0	29656	0	0	29682
18943	29798	0	93	6	0	29897
18944	30066	2	104	4	0	30176
18945	1	28942	0	6	0	28949
18946	10	46	4	28256	0	28316
18947	8	3	28572	6	0	28589
18948	28790	2	152	6	0	28950
18949	28968	2	118	24	0	29112
18950	12	0	29266	1	0	29279
18951	28889	1	43	5	0	28938
18952	1	20	0	28953	0	28974
18953	5	32	1	29054	0	29092
18954	28838	0	31	5	0	28874
18955	28708	5	47	1	0	28761
18956	3	54	1	28644	0	28702
18957	16	1	28262	15	0	28294
18958	4	27600	0	36	0	27640
18959	20	0	27346	4	0	27370
18960	413	1	26987	7	0	27408
18961	1	27490	1	6	0	27498
18962	13	102	4	27623	0	27742
18963	6	75	2	28558	0	28641
18964	10	2	29969	0	0	29981
18965	3	55	1	30062	0	30121
18966	29800	1	46	9	0	29856
18967	4	1	29854	4	0	29863
18968	29516	2	42	13	0	29573
18969	29373	1	65	5	0	29444
18970	29229	9	84	6	0	29328
18971	11	0	29084	2	0	29097
18972	17	1	29766	10	0	29794
18973	4	128	2	30759	0	30893
18974	6	63	3	30677	0	30749
18975	7	30547	1	14	0	30569
18976	30671	2	57	0	0	30730
18977	31480	0	38	7	0	31525
18978	0	31182	0	18	0	31200
18979	31284	0	60	7	0	31351
18980	6	34422	0	8	0	34436
18981	33495	3	57	1	0	33556
18982	6	68	5	34363	0	34442
18983	24	0	34324	6	0	34354
18984	17	1	34853	4	0	34875
18985	3	94	4	34563	0	34664
18986	4	47	9	34017	0	34077
18987	5	0	34328	2	0	34335
18988	5	91	5	34933	0	35034
18989	4	25	0	33927	0	33956
18990	34133	1	30	1	0	34165
18991	33890	3	44	8	0	33945
18992	32572	11	107	3	0	32693
18993	12	1	32295	2	0	32310
18994	2	30251	0	7	0	30260
18995	36	119	4	30070	0	30229
18996	19	2	30857	1	0	30879
18997	2	30809	1	14	0	30826
18998	31285	0	46	4	0	31335
18999	5	46	5	31173	0	31229
19000	3	35	3	31599	0	31640
19001	30987	1	21	5	0	31014
19002	2	33	0	27977	0	28012
19003	0	47	1	27498	0	27546
19004	26764	2	34	5	0	26805
19005	12	0	26270	3	0	26285
19006	4	26643	0	14	0	26661
19007	26071	1	89	4	0	26165
19008	6	2	26123	2	0	26133
19009	26312	3	49	4	0	26368
19010	3	26691	0	11	0	26705
19011	26486	1	34	1	0	26522
19012	26525	1	57	3	0	26586
19013	26126	2	67	1	0	26196
19014	1	27	4	26180	0	26212
19015	6	47	4	26431	0	26488
19016	6	26688	0	13	0	26707
19017	9	26274	1	7	0	26291
19018	6	26297	1	20	0	26324
19019	26170	1	41	9	0	26221
19020	14	0	26192	3	0	26209
19021	3	44	1	28017	0	28065
19022	2	100	3	27634	0	27739
19023	4	28090	2	1	0	28097
19024	1	68	3	27611	0	27683
19025	12	52	4	27749	0	27817
19026	9	27754	1	21	0	27785
19027	27853	3	66	7	0	27929
19028	3	28037	2	16	0	28058
19029	20	1	27672	5	0	27698
19030	27713	3	437	6	0	28159
19031	4	28181	0	7	0	28192
19032	27969	2	40	1	0	28012
19033	3	31	4	31932	0	31970
19034	13	31	2	32136	0	32182
19035	22	3	31969	10	0	32004
19036	22	0	32096	10	0	32128
19037	1	29	1	32089	0	32120
19038	31967	2	53	2	0	32024
19039	31221	5	68	10	0	31304
19040	10	31302	0	4	0	31316
19041	12	31138	0	17	0	31167
19042	3	31548	0	7	0	31558
19043	1	41	1	31253	0	31296
19044	31180	2	25	1	0	31208
19045	31029	2	33	4	0	31068
19046	31056	4	119	10	0	31189
19047	19	0	32542	0	0	32561
19048	4	32492	0	15	0	32511
19049	7	42	0	31051	0	31100
19050	31547	3	39	7	0	31596
19051	6	56	3	31942	0	32007
19052	4	26	0	32093	0	32123
19053	31352	1	19	4	0	31376
19054	31416	2	41	3	0	31462
19055	7	0	31930	1	0	31938
19056	4	69	3	28634	0	28710
19057	8	0	29039	2	0	29049
19058	7	57	4	28302	0	28370
19059	19	0	28227	1	0	28247
19060	4	28	2	27747	0	27781
19061	27900	2	26	4	0	27932
19062	3	27488	2	7	0	27500
19063	2	27217	0	7	0	27226
19064	6	89	2	27518	0	27615
19065	5	27564	0	18	0	27587
19066	27378	1	61	6	0	27446
19067	27524	0	47	2	0	27573
19068	13	0	27591	0	0	27604
19069	1	28578	0	15	0	28594
19070	0	48	8	28207	0	28263
19071	10	1	28121	1	0	28133
19072	28369	4	75	9	0	28457
19073	6	67	2	28423	0	28498
19074	10	1	28411	4	0	28426
19075	6	28	0	28939	0	28973
19076	28362	3	52	4	0	28421
19077	8	1	28660	3	0	28672
19078	28306	6	73	10	0	28395
19079	28444	3	56	6	0	28509
19080	1	29	0	28289	0	28319
19081	12	3	27916	3	0	27934
19082	13	0	27999	4	0	28016
19083	28025	0	48	7	0	28080
19084	27821	5	69	8	0	27903
19085	6	0	28709	2	0	28717
19086	4	61	3	28406	0	28474
19087	15	56	1	28221	0	28293
19088	5	28777	4	8	0	28794
19089	3	39	3	28912	0	28957
19090	29405	1	44	6	0	29456
19091	6	34	3	28918	0	28961
19092	15	0	28773	2	0	28790
19093	29152	4	78	10	0	29244
19094	6	64	3	27461	0	27534
19095	24	1	27541	4	0	27570
19096	6	27278	1	13	0	27298
19097	27113	3	59	6	0	27181
19098	0	26930	4	11	0	26945
19099	26516	1	32	13	0	26562
19100	45	0	28579	4	0	28628
19101	15	29302	1	21	0	29339
19102	3	29080	1	17	0	29101
19103	5	128	1	29020	0	29154
19104	6	52	3	29402	0	29463
19105	10	1	29583	3	0	29597
19106	4	32	4	29891	0	29931
19107	29580	2	30	3	0	29615
19108	10	1	29604	4	0	29619
19109	8	55	2	25637	0	25702
19110	13	0	25395	4	0	25412
19111	26906	5	96	5	0	27012
19112	5	26854	1	12	0	26872
19113	26839	5	43	4	0	26891
19114	26620	4	24	3	0	26651
19115	26561	6	76	1	0	26644
19116	9	0	25824	2	0	25835
19117	0	25955	0	7	0	25962
19118	3	72	3	25965	0	26043
19119	4	11	2	25972	0	25989
19120	26277	0	41	2	0	26320
19121	7	21	2	26352	0	26382
19122	26273	2	7	3	0	26285
19123	25061	0	32	4	0	25097
19124	24340	0	17	1	0	24358
19125	23827	0	58	4	0	23889
19126	0	14	0	23657	0	23671
19127	23061	2	25	5	0	23093
19128	5	0	23150	2	0	23157
19129	23295	1	23	4	0	23323
19130	23170	0	38	2	0	23210
19131	4	0	23586	0	0	23590
19132	22890	2	39	5	0	22936
19133	22782	0	20	4	0	22806
19134	2	21	2	22499	0	22524
19135	6	20	2	22426	0	22454
19136	26390	1	26	6	0	26423
19137	4	49	1	26473	0	26527
19138	6	60	3	25900	0	25969
19139	2	26371	0	3	0	26376
19140	2	42	1	25477	0	25522
19141	26867	1	18	4	0	26890
19142	6	42	1	27113	0	27162
19143	8	68	3	26932	0	27011
19144	1	27322	3	7	0	27333
19145	7	46	1	25560	0	25614
19146	2	20	1	25820	0	25843
19147	26018	3	28	2	0	26051
19148	9	80	4	25673	0	25766
19149	22	1	25842	3	0	25868
19150	8	25884	2	14	0	25908
19151	6	25936	0	16	0	25958
19152	25977	2	64	18	0	26061
19153	0	25652	0	12	0	25664
19154	25562	4	97	6	0	25669
19155	0	26883	0	15	0	26898
19156	26475	0	60	4	0	26539
19157	2	52	1	26457	0	26512
19158	5	32	3	26172	0	26212
19159	4	25512	0	13	0	25529
19160	7	47	2	25339	0	25395
19161	8	0	25507	0	0	25515
19162	25273	1	370	10	0	25654
19163	5	26092	1	14	0	26112
19164	25654	2	83	4	0	25743
19165	25874	2	37	3	0	25916
19166	25691	4	48	6	0	25749
19167	1	30	2	26146	0	26179
19168	4	42	1	26016	0	26063
19169	2	26031	1	3	0	26037
19170	25923	5	47	10	0	25985
19171	1	26378	0	14	0	26393
19172	26180	9	76	6	0	26271
19173	7	2	26632	4	0	26645
19174	26729	5	50	6	0	26790
19175	6	20	0	26467	0	26493
19176	30	1	24152	5	0	24188
19177	14	0	27280	2	0	27296
19178	3	67	3	27027	0	27100
19179	13	1	27146	3	0	27163
19180	6	93	0	27153	0	27252
19181	26980	1	47	2	0	27030
19182	4	51	2	26663	0	26720
19183	24	0	26669	2	0	26695
19184	11	27125	1	19	0	27156
19185	3	26943	3	6	0	26955
19186	4	19	1	25305	0	25329
19187	26023	2	11	2	0	26038
19188	6	274	1	26341	0	26622
19189	2	57	4	27071	0	27134
19190	5	25	2	27061	0	27093
19191	3	58	0	26794	0	26855
19192	18	0	25944	7	0	25969
19193	11	0	25953	12	0	25976
19194	26412	0	66	5	0	26483
19195	26533	2	97	4	0	26636
19196	3	39	1	26737	0	26780
19197	5	43	2	26640	0	26690
19198	35	2	26525	4	0	26566
19199	1	26381	1	22	0	26405
19200	26464	1	61	7	0	26533
19201	26241	3	49	2	0	26295
19202	4	39	2	26110	0	26155
19203	13	0	28193	5	0	28211
19204	6	51	4	28346	0	28407
19205	3	28075	0	31	0	28109
19206	23	2	28157	7	0	28189
19207	27731	1	68	6	0	27806
19208	3	19	6	28642	0	28670
19209	28548	9	46	3	0	28606
19210	18	0	28727	1	0	28746
19211	29510	5	93	6	0	29614
19212	0	31	10	25857	0	25898
19213	25612	0	27	4	0	25643
19214	4	38	2	25577	0	25621
19215	2	25434	0	12	0	25448
19216	1	24313	1	14	0	24329
19217	4	29	3	24118	0	24154
19218	1441	0	23147	5	0	24593
19219	2	24668	0	11	0	24681
19220	3	15	2	24611	0	24631
19221	24530	3	29	3	0	24565
19222	25157	1	34	3	0	25195
19223	2	79	0	24697	0	24778
19224	8	55	0	25436	0	25499
19225	5	25153	0	10	0	25168
19226	3	24697	0	25	0	24725
19227	24418	3	62	2	0	24485
19228	6	39	2	24975	0	25022
19229	1	32	2	25075	0	25110
19230	10	0	25850	3	0	25863
19231	3	45	6	24708	0	24762
19232	10	34	3	24791	0	24838
19233	4	141	0	25027	0	25172
19234	14	0	25134	0	0	25148
19235	8	44	2	25641	0	25695
19236	25570	1	62	3	0	25636
19237	6	0	25588	3	0	25597
19238	25937	4	39	7	0	25987
19239	8	35	4	25695	0	25742
19240	1	34	0	25615	0	25650
19241	4	40	3	25900	0	25947
19242	9	1	25335	16	0	25361
19243	25699	1	91	6	0	25797
19244	1	26286	0	10	0	26297
19245	26160	1	56	8	0	26225
19246	2	26647	0	8	0	26657
19247	8	34	2	26444	0	26488
19248	26481	3	108	3	0	26595
19249	12	2	26253	7	0	26274
19250	26681	1	99	10	0	26791
19251	9	0	27573	2	0	27584
19252	2	33	3	26892	0	26930
19253	6	0	24587	2	0	24595
19254	3	25430	0	14	0	25447
19255	2	47	1	25194	0	25244
19256	26162	2	88	7	0	26259
19257	3	56	16	25985	0	26060
19258	7	25752	0	12	0	25771
19259	7	40	2	26093	0	26142
19260	25989	2	28	0	0	26019
19261	26536	3	77	1	0	26617
19262	3	26322	0	17	0	26342
19263	1	25771	0	10	0	25782
19264	3	46	3	25624	0	25676
19265	7	19	1	25473	0	25500
19266	25546	0	12	1	0	25559
19267	25650	7	47	5	0	25709
19268	0	25674	0	1	0	25675
19269	3	46	3	25244	0	25296
19270	0	13	1	24732	0	24746
19271	7	0	24550	28	0	24585
19272	1	24719	1	18	0	24739
19273	3	24830	0	15	0	24848
19274	8	37	5	24832	0	24882
19275	9	0	25090	7	0	25106
19276	8	0	25697	7	0	25712
19277	1	41	1	25912	0	25955
19278	4	77	2	25778	0	25861
19279	16	1	23829	3	0	23849
19280	4	39	2	23659	0	23704
19281	4	1	23817	4	0	23826
19282	23603	4	69	5	0	23681
19283	2	28	0	23283	0	23313
19284	41	0	22422	3	0	22466
19285	13	0	22809	5	0	22827
19286	12	83	2	22504	0	22601
19287	440	0	21717	5	0	22162
19288	13	1	22150	13	0	22177
19289	1	22074	1	14	0	22090
19290	22042	1	43	1	0	22087
19291	5	0	22761	1	0	22767
19292	4	31	6	22925	0	22966
19293	4	79	2	22790	0	22875
19294	3	67	3	22189	0	22262
19295	3	0	22713	1	0	22717
19296	7	8	0	22583	0	22598
19297	22586	0	32	1	0	22619
19298	1	50	2	22156	0	22209
19299	13	0	22390	2	0	22405
19300	2	31	0	21736	0	21769
19301	22115	0	11	1	0	22127
19302	22124	1	35	1	0	22161
19303	22255	1	14	6	0	22276
19304	2	16	2	22244	0	22264
19305	22140	1	6	1	0	22148
19306	22367	1	36	4	0	22408
19307	22360	3	51	2	0	22416
19308	1	22470	1	7	0	22479
19309	22034	0	51	5	0	22090
19310	2	28	2	22256	0	22288
19311	42	0	22505	3	0	22550
19312	3	22967	1	19	0	22990
19313	22833	0	59	1	0	22893
19314	3	47	1	23367	0	23418
19315	8	30	2	22934	0	22974
19316	6	23314	0	52	0	23372
19317	7	22950	0	18	0	22975
19318	23264	1	36	4	0	23305
19319	1	22712	0	16	0	22729
19320	23911	2	112	11	0	24036
19321	2	23830	0	14	0	23846
19322	23607	4	53	4	0	23668
19323	6	23368	2	17	0	23393
19324	3	23092	0	18	0	23113
19325	22240	3	30	4	0	22277
19326	14	0	22435	2	0	22451
19327	3	22184	1	11	0	22199
19328	5	39	2	22157	0	22203
19329	2	42	3	22151	0	22198
19330	2	38	2	21711	0	21753
19331	9	177	4	21694	0	21884
19332	5	0	21047	2	0	21054
19333	20995	1	67	1	0	21064
19334	3	21	0	21202	0	21226
19335	20823	2	22	0	0	20847
19336	20329	2	41	4	0	20376
19337	19728	4	29	1	0	19762
19338	19624	2	46	1	0	19673
19339	9	0	19907	0	0	19916
19340	3	20	1	19857	0	19881
19341	6	1	19696	3	0	19706
19342	8	19767	1	13	0	19789
19343	7	154	0	19903	0	20064
19344	2	38	2	20022	0	20064
19345	1	26	3	20078	0	20108
19346	4	111	3	20112	0	20230
19347	7	0	19942	0	0	19949
19348	3	36	7	19725	0	19771
19349	2	33	0	20415	0	20450
19350	20243	2	32	5	0	20282
19351	21321	1	24	2	0	21348
19352	6	37	4	20648	0	20695
19353	5	30	2	20798	0	20835
19354	4	21	2	20882	0	20909
19355	23870	0	5	11	0	23886
19356	23886	0	16	4	0	23906
19357	23774	1	43	3	0	23821
19358	23975	5	62	0	0	24042
19359	2	24153	0	8	0	24163
19360	23690	1	65	7	0	23763
19361	23676	3	39	5	0	23723
19362	1	31	3	24999	0	25034
19363	0	28	1	24997	0	25026
19364	25037	1	47	5	0	25090
19365	2	25431	0	7	0	25440
19366	2	24738	0	11	0	24751
19367	24771	2	39	8	0	24820
19368	4	50	5	24549	0	24608
19369	7	29	3	24469	0	24508
19370	8	69	1	25395	0	25473
19371	7	51	0	25203	0	25261
19372	10	36	3	25521	0	25570
19373	2	26075	0	3	0	26080
19374	6	65	1	25699	0	25771
19375	25949	0	34	2	0	25985
19376	5	27	2	25732	0	25766
19377	1	21	1	26363	0	26386
19378	26506	6	33	5	0	26550
19379	2	26842	0	8	0	26852
19380	7	75	10	26245	0	26337
19381	3	26731	0	31	0	26765
19382	11	51	2	25791	0	25855
19383	10	0	25983	3	0	25996
19384	25970	1	77	8	0	26056
19385	2	26052	2	40	0	26096
19386	25202	4	79	8	0	25293
19387	13	4	26200	1	0	26218
19388	2	47	4	26877	0	26930
19389	4	28403	3	17	0	28427
19390	4	27792	0	20	0	27816
19391	28098	10	45	6	0	28159
19392	4	114	1	27577	0	27696
19393	9	0	27769	2	0	27780
19394	15	27	3	27416	0	27461
19395	6	0	27427	6	0	27439
19396	25365	3	65	13	0	25446
19397	3	1	25342	0	0	25346
19398	7	38	0	25199	0	25244
19399	3	25578	0	2	0	25583
19400	15	52	4	24928	0	24999
19401	4	24956	0	7	0	24967
19402	25689	3	87	5	0	25784
19403	1	37	4	25849	0	25891
19404	16	1	25846	2	0	25865
19405	10	1	26154	3	0	26168
19406	25822	4	70	5	0	25901
19407	25658	1	79	5	0	25743
19408	25723	3	84	1	0	25811
19409	25770	33	56	1	0	25860
19410	2	25992	0	14	0	26008
19411	25705	1	71	4	0	25781
19412	25679	3	101	6	0	25789
19413	11	0	25820	2	0	25833
19414	8	41	1	26105	0	26155
19415	25657	1	35	3	0	25696
19416	27	0	26094	5	0	26126
19417	8	41	4	26111	0	26164
19418	9	0	26743	3	0	26755
19419	5	42	4	28176	0	28227
19420	5	28276	3	11	0	28295
19421	28065	4	93	4	0	28166
19422	8	0	30161	4	0	30173
19423	31039	5	181	8	0	31233
19424	3	21	1	31264	0	31289
19425	30724	3	45	5	0	30777
19426	4	17	2	30861	0	30884
19427	29577	2	35	1	0	29615
19428	2	0	30331	1	0	30334
19429	31208	4	36	5	0	31253
19430	5	38	6	31155	0	31204
19431	0	25	1	29464	0	29490
19432	29736	0	46	1	0	29783
19433	8	61	1	29678	0	29748
19434	20	0	29696	2	0	29718
19435	9	21	2	29516	0	29548
19436	29978	1	51	4	0	30034
19437	4	30447	1	18	0	30470
19438	4	29351	4	23	0	29382
19439	29833	3	77	12	0	29925
19440	1	29981	0	9	0	29991
19441	5	49	7	30242	0	30303
19442	30703	0	47	4	0	30754
19443	30440	4	37	5	0	30486
19444	30610	1	100	2	0	30713
19445	5	0	31012	1	0	31018
19446	13	38	2	30678	0	30731
19447	1	30361	0	9	0	30371
19448	8	48	9	30167	0	30232
19449	24	0	30359	2	0	30385
19450	44	30603	2	16	0	30665
19451	19	42	0	30754	0	30815
19452	30977	0	73	6	0	31056
19453	5	29807	0	24	0	29836
19454	14	4	30948	3	0	30969
19455	13	49	4	30318	0	30384
19456	12	5	32022	4	0	32043
19457	2	23	4	31632	0	31661
19458	31467	2	34	3	0	31506
19459	2	52	1	31425	0	31480
19460	32955	2	23	1	0	32981
19461	33956	3	75	5	0	34039
19462	5	32687	0	25	0	32717
19463	31357	8	73	5	0	31443
19464	4	31354	0	21	0	31379
19465	7	0	29631	0	0	29638
19466	5	72	1	30289	0	30367
19467	5	69	2	30137	0	30213
19468	24	0	30112	2	0	30138
19469	2	30609	2	16	0	30629
19470	30720	2	54	0	0	30776
19471	30997	0	54	2	0	31053
19472	7	38	0	30964	0	31009
19473	2	66	3	30501	0	30572
19474	17	32	1	31060	0	31110
19475	30747	0	75	1	0	30823
19476	7	0	30809	3	0	30819
19477	10	2	30782	4	0	30798
19478	5	37	7	30111	0	30160
19479	23	0	29709	4	0	29736
19480	1557	1	28696	3	0	30257
19481	5	53	0	30113	0	30171
19482	13	0	29893	7	0	29913
19483	5	29414	0	14	0	29433
19484	2	56	0	30283	0	30341
19485	7	0	31183	0	0	31190
19486	8	48	6	32110	0	32172
19487	4	32594	1	17	0	32616
19488	4	149	4	32359	0	32516
19489	9	1	32386	0	0	32396
19490	4	42	11	32470	0	32527
19491	32269	0	82	0	0	32351
19492	5	1	31902	3	0	31911
19493	32084	3	108	3	0	32198
19494	4	31196	0	10	0	31210
19495	29657	1	106	2	0	29766
19496	9	44	0	28889	0	28942
19497	2	27018	0	23	0	27043
19498	27178	3	41	13	0	27235
19499	7	35	3	27160	0	27205
19500	12	1	27068	2	0	27083
19501	2	27232	1	11	0	27246
19502	4	24	3	27169	0	27200
19503	26778	1	31	3	0	26813
19504	26337	0	36	8	0	26381
19505	4	24	2	25739	0	25769
19506	8	3	25680	3	0	25694
19507	23894	0	59	6	0	23959
19508	6	1	23976	0	0	23983
19509	3	98	0	24530	0	24631
19510	24378	0	106	2	0	24486
19511	0	24397	0	9	0	24406
19512	23364	4	69	7	0	23444
19513	8	0	22927	1	0	22936
19514	23697	4	41	5	0	23747
19515	2	31	1	23324	0	23358
19516	3	54	6	23013	0	23076
19517	5	0	22359	1	0	22365
19518	6	25	2	25051	0	25084
19519	25065	1	17	2	0	25085
19520	7	43	1	24628	0	24679
19521	1	24123	0	8	0	24132
19522	4	35	4	23138	0	23181
19523	4	22890	1	21	0	22916
19524	14	3	22792	1	0	22810
19525	23117	0	37	9	0	23163
19526	5	47	1	23419	0	23472
19527	5	7	23576	0	0	23588
19528	5	22884	0	21	0	22910
19529	4	39	2	22675	0	22720
19530	0	34	0	22792	0	22826
19531	22867	0	18	4	0	22889
19532	7	26	0	21429	0	21462
19533	21412	0	26	0	0	21438
19534	21552	2	55	12	0	21621
19535	1	21694	1	17	0	21713
19536	20584	0	39	5	0	20628
19537	2	22	4	20280	0	20308
19538	9	0	20188	0	0	20197
19539	20389	0	72	4	0	20465
19540	2	40	2	20360	0	20404
19541	8	0	19944	2	0	19954
19542	19627	0	43	1	0	19671
19543	7	34	3	19387	0	19431
19544	1	19217	0	19	0	19237
19545	4	36	0	18954	0	18994
19546	3	18866	0	10	0	18879
19547	18720	4	41	2	0	18767
19548	11	0	18703	1	0	18715
19549	1	20499	0	13	0	20513
19550	6	23	5	20058	0	20092
19551	12	0	19985	0	0	19997
19552	15	0	20043	2	0	20060
19553	3	20513	1	7	0	20524
19554	5	50	3	22181	0	22239
19555	6	215	5	22040	0	22266
19556	3	15	0	22173	0	22191
19557	22043	5	24	1	0	22073
19558	5	0	22096	3	0	22104
19559	2	21387	0	13	0	21402
19560	3	60	2	20424	0	20489
19561	1	37	0	19280	0	19318
19562	13	1	19282	1	0	19297
19563	8	20	0	18902	0	18930
19564	18	1	18798	2	0	18819
19565	12	0	18592	2	0	18606
19566	5	2	18686	0	0	18693
19567	3	24	6	18097	0	18130
19568	3	69	4	17894	0	17970
19569	0	18	0	18006	0	18024
19570	17985	0	19	2	0	18006
19571	1	17951	0	11	0	17963
19572	17851	3	37	1	0	17892
19573	17796	1	75	3	0	17875
19574	17429	4	65	2	0	17500
19575	0	17393	2	16	0	17411
19576	16920	1	17	3	0	16941
19577	16975	0	22	1	0	16998
19578	3	19	0	16868	0	16890
19579	3	23	1	16747	0	16774
19580	8	21	1	16661	0	16691
19581	8	0	16619	0	0	16627
19582	16483	1	22	5	0	16511
19583	1	22	1	16520	0	16544
19584	15743	0	23	1	0	15767
19585	0	15790	1	6	0	15797
19586	3	24	1	14471	0	14499
19587	0	21	0	14536	0	14557
19588	14522	0	9	0	0	14531
19589	0	18	2	14344	0	14364
19590	14262	0	16	0	0	14278
19591	14123	1	49	3	0	14176
19592	6	14151	0	3	0	14160
19593	2	13983	0	6	0	13991
19594	5	13	2	10840	0	10860
19595	5	10896	0	4	0	10905
19596	3	14	1	10854	0	10872
19597	8	0	10839	1	0	10848
19598	3	0	10838	3	0	10844
19599	10802	0	33	3	0	10838
19600	10781	2	48	0	0	10831
19601	0	10290	0	4	0	10294
19602	9429	4	16	4	0	9453
19603	1	9111	0	5	0	9117
19604	2	24	0	8783	0	8809
19605	1	26	2	8805	0	8834
19606	1	29	1	8757	0	8788
19607	0	13	0	8672	0	8685
19608	8650	2	8	3	0	8663
19609	2	8610	0	0	0	8612
19610	8375	1	14	5	0	8395
19611	7959	1	225	3	0	8188
19612	1	0	7314	0	0	7315
19613	6176	1	48	0	0	6225
19614	1	6215	0	0	0	6216
19615	0	18	0	5836	0	5854
19616	2	11	1	5829	0	5843
19617	1	5853	1	0	0	5855
19618	5789	1	2	0	0	5792
19619	0	0	5777	0	0	5777
19620	5517	1	1	0	0	5519
19621	1	0	5543	0	0	5544
19622	1	2	0	4370	0	4373
19623	0	4	0	3646	0	3650
19624	0	0	0	3663	0	3663
19625	3510	0	0	1	0	3511
19626	3	0	3507	0	0	3510
19627	3454	0	4	2	0	3460
19628	3259	0	12	0	0	3271
19629	2903	0	0	1	0	2904
19630	1179	0	0	0	0	1179
19631	0	1	0	839	0	840
19632	0	0	767	0	0	767
19633	0	1	0	716	0	717
19634	1	0	699	0	0	700
19635	0	0	710	0	0	710
19636	0	725	0	0	0	725
19637	1	0	0	722	0	723
19638	0	4	0	725	0	729
19639	0	0	0	725	0	725
19640	0	0	0	726	0	726
19641	712	0	3	0	0	715
19642	737	0	0	0	0	737
19643	0	1	0	751	0	752
19644	1	0	756	0	0	757
19645	0	1	0	750	0	751
19646	0	0	0	745	0	745
19647	2	0	751	0	0	753
19648	1	1	0	766	0	768
19649	783	0	0	1	0	784
19650	788	0	0	0	0	788
19651	784	0	0	0	0	784
19652	0	1	0	796	0	797
19653	747	0	0	0	0	747
19654	744	0	3	0	0	747
19655	0	0	749	0	0	749
19656	1	0	763	0	0	764
19657	0	0	761	0	0	761
19658	754	0	0	0	0	754
19659	1	739	0	1	0	741
19660	730	0	2	0	0	732
19661	0	688	0	0	0	688
19662	1	2	0	698	0	701
19663	0	0	0	723	0	723
19664	0	3	0	715	0	718
19665	0	0	715	0	0	715
19666	725	0	1	0	0	726
19667	0	0	1	732	0	733
19668	0	0	718	0	0	718
19669	0	0	739	0	0	739
19670	740	0	1	0	0	741
19671	1	741	0	1	0	743
19672	742	0	0	0	0	742
19673	761	0	3	0	0	764
19674	0	757	0	2	0	759
19675	757	0	3	0	0	760
19676	0	0	773	0	0	773
19677	0	0	770	0	0	770
19678	0	0	783	0	0	783
19679	0	2	1	747	0	750
19680	0	0	749	0	0	749
19681	747	0	4	0	0	751
19682	719	0	2	0	0	721
19683	0	0	737	0	0	737
19684	0	1	0	738	0	739
19685	731	0	0	0	0	731
19686	0	721	0	0	0	721
19687	0	719	0	3	0	722
19688	714	0	0	0	0	714
19689	0	0	730	0	0	730
19690	0	1	1	725	0	727
19691	0	1	0	727	0	728
19692	0	2	0	723	0	725
19693	0	730	0	0	0	730
19694	0	1	0	737	0	738
19695	753	0	2	0	0	755
19696	0	3	0	749	0	752
19697	0	725	0	0	0	725
19698	720	0	1	0	0	721
19699	0	0	0	735	0	735
19700	0	1	0	781	0	782
19701	787	0	3	0	0	790
19702	811	0	3	0	0	814
19703	0	2	0	822	0	824
19704	831	0	0	0	0	831
19705	833	0	1	1	0	835
19706	0	823	0	1	0	824
19707	817	0	0	0	0	817
19708	0	822	0	1	0	823
19709	0	2	0	766	0	768
19710	1	0	796	0	0	797
19711	0	8	1	773	0	782
19712	0	1	0	792	0	793
19713	0	0	0	816	0	816
19714	823	0	0	1	0	824
19715	0	835	0	2	0	837
19716	830	0	2	0	0	832
19717	0	828	0	1	0	829
19718	796	0	1	0	0	797
19719	786	0	1	1	0	788
19720	766	0	1	0	0	767
19721	774	0	2	0	0	776
19722	0	0	789	0	0	789
19723	0	2	0	759	0	761
19724	0	0	0	758	0	758
19725	0	0	740	0	0	740
19726	738	0	1	0	0	739
19727	0	0	0	733	0	733
19728	1	0	727	0	0	728
19729	0	0	771	0	0	771
19730	0	1	0	756	0	757
19731	1	0	753	0	0	754
19732	0	0	0	767	0	767
19733	1	2	0	760	0	763
19734	1	0	765	0	0	766
19735	812	0	4	2	0	818
19736	0	2	0	823	0	825
19737	0	0	807	0	0	807
19738	0	2	0	841	0	843
19739	824	0	0	1	0	825
19740	0	0	826	0	0	826
19741	818	0	1	2	0	821
19742	812	3	2	0	0	817
19743	0	3	0	828	0	831
19744	0	1	0	785	0	786
19745	0	0	789	0	0	789
19746	0	1	2	789	0	792
19747	0	2	0	767	0	769
19748	0	2	0	779	0	781
19749	0	0	755	0	0	755
19750	766	0	1	0	0	767
19751	775	0	3	0	0	778
19752	759	0	0	0	0	759
19753	762	0	3	0	0	765
19754	0	0	0	761	0	761
19755	757	0	0	0	0	757
19756	767	0	1	0	0	768
19757	765	0	1	0	0	766
19758	780	0	1	0	0	781
19759	0	778	0	0	0	778
19760	776	0	3	0	0	779
19761	804	0	1	1	0	806
19762	0	813	0	0	0	813
19763	816	0	2	0	0	818
19764	0	0	0	816	0	816
19765	0	0	0	798	0	798
19766	804	0	0	0	0	804
19767	0	808	0	0	0	808
19768	0	794	0	0	0	794
19769	0	1	0	798	0	799
19770	0	0	835	0	0	835
19771	0	0	0	844	0	844
19772	0	1	0	845	0	846
19773	842	0	1	0	0	843
19774	838	0	1	0	0	839
19775	1	4	0	824	0	829
19776	2	0	782	0	0	784
19777	0	0	0	777	0	777
19778	747	0	0	0	0	747
19779	0	0	752	0	0	752
19780	0	783	0	0	0	783
19781	786	0	1	0	0	787
19782	0	0	0	787	0	787
19783	0	0	0	791	0	791
19784	0	0	0	759	0	759
19785	1	0	753	0	0	754
19786	726	0	0	0	0	726
19787	0	0	743	0	0	743
19788	0	741	0	0	0	741
19789	1	3	0	713	0	717
19790	0	2	0	728	0	730
19791	0	0	0	716	0	716
19792	0	0	705	0	0	705
19793	0	0	781	0	0	781
19794	1	0	787	0	0	788
19795	0	788	0	1	0	789
19796	0	2	0	781	0	783
19797	804	0	3	0	0	807
19798	800	0	0	0	0	800
19799	1	0	807	0	0	808
19800	0	821	0	0	0	821
19801	2	0	811	0	0	813
19802	1	807	0	0	0	808
19803	813	0	7	0	0	820
19804	865	0	1	0	0	866
19805	0	861	0	1	0	862
19806	864	1	2	0	0	867
19807	0	1	0	866	0	867
19808	0	1	0	857	0	858
19809	860	0	0	0	0	860
19810	859	0	3	1	0	863
19811	814	0	1	0	0	815
19812	0	801	0	0	0	801
19813	0	790	0	0	0	790
19814	749	0	0	0	0	749
19815	0	0	774	0	0	774
19816	0	0	1	822	0	823
19817	819	0	2	1	0	822
19818	0	817	0	0	0	817
19819	0	801	0	2	0	803
19820	793	0	0	0	0	793
19821	0	0	799	0	0	799
19822	783	0	3	1	0	787
19823	0	0	816	0	0	816
19824	0	0	829	0	0	829
19825	0	1	1	812	0	814
19826	0	0	814	1	0	815
19827	847	0	1	0	0	848
19828	844	0	1	1	0	846
19829	859	0	0	0	0	859
19830	849	0	2	0	0	851
19831	0	0	0	854	0	854
19832	862	0	1	0	0	863
19833	0	857	0	0	0	857
19834	0	0	0	851	0	851
19835	0	893	0	0	0	893
19836	894	0	1	0	0	895
19837	924	0	4	0	0	928
19838	0	3	0	940	0	943
19839	959	0	1	0	0	960
19840	991	0	0	0	0	991
19841	0	0	0	978	0	978
19842	0	0	0	970	0	970
19843	0	0	0	989	0	989
19844	0	0	981	1	0	982
19845	0	0	981	0	0	981
19846	1	0	1004	0	0	1005
19847	0	3	0	996	0	999
19848	0	0	999	0	0	999
19849	0	1	0	998	0	999
19850	1	0	979	0	0	980
19851	1	0	985	0	0	986
19852	1012	0	3	0	0	1015
19853	0	1013	0	0	0	1013
19854	988	1	0	0	0	989
19855	0	0	0	978	0	978
19856	0	0	1	964	0	965
19857	0	0	976	0	0	976
19858	0	996	0	1	0	997
19859	0	6	0	989	0	995
19860	2	0	1056	0	0	1058
19861	0	1061	0	0	0	1061
19862	0	0	0	1069	0	1069
19863	1073	0	2	0	0	1075
19864	1084	0	3	0	0	1087
19865	0	3	0	1086	0	1089
19866	1086	0	0	0	0	1086
19867	0	1068	0	0	0	1068
19868	0	2	0	1014	0	1016
19869	0	0	1018	0	0	1018
19870	0	1	0	1002	0	1003
19871	0	0	1020	0	0	1020
19872	1033	0	0	0	0	1033
19873	0	0	0	1016	0	1016
19874	0	1007	0	0	0	1007
19875	0	3	0	1002	0	1005
19876	0	0	1004	0	0	1004
19877	0	0	1001	0	0	1001
19878	1	0	1007	0	0	1008
19879	1008	0	3	0	0	1011
19880	0	951	0	0	0	951
19881	0	1	0	943	0	944
19882	945	0	3	0	0	948
19883	0	943	0	4	0	947
19884	949	0	2	0	0	951
19885	955	0	0	0	0	955
19886	944	0	1	0	0	945
19887	934	0	0	0	0	934
19888	0	0	952	0	0	952
19889	891	0	3	0	0	894
19890	0	0	908	0	0	908
19891	869	0	8	0	0	877
19892	0	1	0	870	0	871
19893	1	0	868	0	0	869
19894	0	905	0	0	0	905
19895	0	0	0	883	0	883
19896	0	913	0	0	0	913
19897	0	908	0	0	0	908
19898	907	0	3	0	0	910
19899	0	0	905	0	0	905
19900	1	904	0	3	0	908
19901	924	0	0	0	0	924
19902	0	967	0	0	0	967
19903	917	0	2	0	0	919
19904	0	0	0	989	0	989
19905	994	0	1	0	0	995
19906	0	0	0	1032	0	1032
19907	1062	0	0	0	0	1062
19908	0	1	0	1036	0	1037
19909	0	1022	0	0	0	1022
19910	0	0	0	1018	0	1018
19911	1020	0	0	0	0	1020
19912	0	1035	0	0	0	1035
19913	0	0	0	1002	0	1002
19914	1042	0	0	0	0	1042
19915	0	4	0	1009	0	1013
19916	0	1	0	985	0	986
19917	0	0	964	1	0	965
19918	0	0	1009	0	0	1009
19919	0	3	0	1006	0	1009
19920	1	0	996	0	0	997
19921	0	3	0	938	0	941
19922	0	3	0	932	0	935
19923	0	1	0	934	0	935
19924	0	0	940	0	0	940
19925	0	1	0	974	0	975
19926	0	2	0	966	0	968
19927	0	963	0	0	0	963
19928	0	2	0	947	0	949
19929	956	0	0	1	0	957
19930	0	1	0	957	0	958
19931	1	0	960	0	0	961
19932	964	0	9	0	0	973
19933	0	894	0	1	0	895
19934	0	0	0	871	0	871
19935	1	0	886	0	0	887
19936	888	0	6	0	0	894
19937	0	894	0	0	0	894
19938	910	0	6	0	0	916
19939	0	2	0	920	0	922
19940	896	0	0	0	0	896
19941	0	0	890	0	0	890
19942	0	910	0	0	0	910
19943	0	905	2	0	0	907
19944	910	1	1	0	0	912
19945	906	0	1	0	0	907
19946	0	0	897	0	0	897
19947	906	0	0	0	0	906
19948	902	2	0	0	0	904
19949	907	0	3	0	0	910
19950	0	906	0	0	0	906
19951	0	941	0	2	0	943
19952	953	0	4	1	0	958
19953	952	0	0	0	0	952
19954	0	937	0	2	0	939
19955	0	0	0	936	0	936
19956	0	0	947	0	0	947
19957	946	0	0	0	0	946
19958	941	0	2	0	0	943
19959	935	0	4	0	0	939
19960	0	942	0	0	0	942
19961	0	0	949	0	0	949
19962	956	0	1	0	0	957
19963	0	3	0	1007	0	1010
19964	0	5	0	1006	0	1011
19965	2	2	0	1009	0	1013
19966	0	0	1016	0	0	1016
19967	0	3	0	1028	0	1031
19968	0	0	1018	2	0	1020
19969	0	987	0	0	0	987
19970	1007	0	2	0	0	1009
19971	0	1028	0	1	0	1029
19972	0	1014	0	0	0	1014
19973	1028	0	1	0	0	1029
19974	0	1024	0	1	0	1025
19975	1	3	0	1034	0	1038
19976	1	1032	0	3	0	1036
19977	1044	0	0	0	0	1044
19978	0	898	0	0	0	898
19979	0	4	0	892	0	896
19980	0	0	907	0	0	907
19981	0	0	0	906	0	906
19982	0	921	0	0	0	921
19983	0	2	1	915	0	918
19984	0	0	0	921	0	921
19985	0	0	0	903	0	903
19986	1	0	0	906	0	907
19987	0	0	0	907	0	907
19988	0	0	0	857	0	857
19989	0	0	856	0	0	856
19990	843	0	3	0	0	846
19991	1	1	1	847	0	850
19992	0	0	845	0	0	845
19993	0	0	876	0	0	876
19994	0	0	0	888	0	888
19995	869	0	4	0	0	873
19996	0	0	877	0	0	877
19997	871	0	1	0	0	872
19998	1	0	896	0	0	897
19999	0	1	0	887	0	888
20000	0	0	0	863	0	863
20001	2	0	843	0	0	845
20002	890	0	0	0	0	890
20003	0	0	0	895	0	895
20004	4	0	889	0	0	893
20005	0	1	898	0	0	899
20006	0	1	0	905	0	906
20007	0	870	0	1	0	871
20008	895	0	3	0	0	898
20009	903	0	2	1	0	906
20010	0	0	908	0	0	908
20011	0	0	0	924	0	924
20012	916	0	0	0	0	916
20013	0	0	925	0	0	925
20014	903	0	1	0	0	904
20015	3	898	0	0	0	901
20016	0	2	0	880	0	882
20017	0	0	0	884	0	884
20018	927	0	0	0	0	927
20019	0	0	0	944	0	944
20020	0	1	0	939	0	940
20021	0	2	0	939	0	941
20022	911	0	1	0	0	912
20023	0	0	912	0	0	912
20024	924	0	0	0	0	924
20025	910	0	7	0	0	917
20026	915	0	4	0	0	919
20027	0	0	0	856	0	856
20028	0	0	863	0	0	863
20029	0	880	0	0	0	880
20030	0	893	0	4	0	897
20031	0	899	0	1	0	900
20032	0	0	917	0	0	917
20033	0	1	0	942	0	943
20034	963	0	0	0	0	963
20035	1030	0	4	0	0	1034
20036	0	2	0	1028	0	1030
20037	0	0	1009	0	0	1009
20038	1	0	1021	0	0	1022
20039	0	1	0	984	0	985
20040	0	0	984	0	0	984
20041	0	3	0	974	0	977
20042	0	5	0	975	0	980
20043	0	999	0	0	0	999
20044	0	2	0	1002	0	1004
20045	0	0	0	1017	0	1017
20046	1017	0	1	0	0	1018
20047	1	0	0	1011	0	1012
20048	0	0	0	1010	0	1010
20049	1033	0	0	0	0	1033
20050	0	1022	0	1	0	1023
20051	983	0	3	0	0	986
20052	0	0	990	0	0	990
20053	1015	1	1	0	0	1017
20054	1023	0	3	0	0	1026
20055	0	0	1031	0	0	1031
20056	0	1	1010	0	0	1011
20057	0	0	0	1009	0	1009
20058	969	0	4	0	0	973
20059	3	0	1009	0	0	1012
20060	0	2	0	1017	0	1019
20061	0	0	1033	0	0	1033
20062	0	1	0	1035	0	1036
20063	0	0	0	1017	0	1017
20064	1015	0	1	0	0	1016
20065	1006	0	0	0	0	1006
20066	995	0	2	0	0	997
20067	0	0	994	0	0	994
20068	0	0	1059	0	0	1059
20069	0	1	0	1000	0	1001
20070	0	4	1	994	0	999
20071	0	0	0	1005	0	1005
20072	1007	0	1	1	0	1009
20073	0	988	0	0	0	988
20074	992	0	1	0	0	993
20075	1008	0	3	1	0	1012
20076	0	996	0	0	0	996
20077	0	1029	0	0	0	1029
20078	1041	0	3	0	0	1044
20079	0	3	0	1041	0	1044
20080	0	1038	0	0	0	1038
20081	0	17	0	1021	0	1038
20082	0	0	1042	0	0	1042
20083	0	1	1	1040	0	1042
20084	1029	0	2	2	0	1033
20085	1	0	1022	0	0	1023
20086	2	0	1010	0	0	1012
20087	1	0	0	1023	0	1024
20088	0	1007	0	0	0	1007
20089	0	999	1	0	0	1000
20090	0	995	1	0	0	996
20091	1013	0	0	0	0	1013
20092	1009	0	3	0	0	1012
20093	1021	0	1	0	0	1022
20094	0	973	0	0	0	973
20095	964	0	0	0	0	964
20096	972	0	9	0	0	981
20097	0	0	981	0	0	981
20098	0	990	0	0	0	990
20099	1	3	0	988	0	992
20100	1001	0	0	1	0	1002
20101	0	0	1050	0	0	1050
20102	0	2	0	1068	0	1070
20103	0	1061	0	0	0	1061
20104	0	1	0	1060	0	1061
20105	0	1	0	1054	0	1055
20106	1039	0	2	0	0	1041
20107	1028	0	2	0	0	1030
20108	0	0	0	1073	0	1073
20109	0	0	1044	1	0	1045
20110	0	0	1021	0	0	1021
20111	921	0	1	0	0	922
20112	0	0	938	0	0	938
20113	0	6	0	937	0	943
20114	0	912	0	0	0	912
20115	929	0	1	0	0	930
20116	0	950	0	0	0	950
20117	952	0	3	1	0	956
20118	0	1	0	928	0	929
20119	0	1	0	921	0	922
20120	928	0	1	0	0	929
20121	918	0	2	0	0	920
20122	0	0	0	919	0	919
20123	0	3	0	889	0	892
20124	0	0	879	0	0	879
20125	0	0	855	0	0	855
20126	826	0	2	0	0	828
20127	0	0	836	0	0	836
20128	826	0	1	1	0	828
20129	814	0	2	0	0	816
20130	0	0	801	0	0	801
20131	0	829	0	1	0	830
20132	0	839	0	0	0	839
20133	1	0	871	0	0	872
20134	0	2	0	882	0	884
20135	852	0	1	0	0	853
20136	856	0	0	0	0	856
20137	846	0	1	0	0	847
20138	840	0	2	0	0	842
20139	839	1	1	0	0	841
20140	0	886	0	1	0	887
20141	883	0	0	0	0	883
20142	0	870	0	0	0	870
20143	819	0	9	0	0	828
20144	0	0	865	0	0	865
20145	0	4	0	867	0	871
20146	0	2	0	857	0	859
20147	0	865	0	0	0	865
20148	873	0	2	0	0	875
20149	873	0	2	0	0	875
20150	0	1	0	870	0	871
20151	0	1	0	861	0	862
20152	870	0	0	0	0	870
20153	1	1	0	796	0	798
20154	0	0	0	792	0	792
20155	790	0	0	0	0	790
20156	1	0	0	775	0	776
20157	793	0	0	0	0	793
20158	789	0	1	0	0	790
20159	0	0	790	0	0	790
20160	797	0	1	0	0	798
20161	782	0	1	0	0	783
20162	770	0	0	0	0	770
20163	0	0	804	0	0	804
20164	0	0	0	805	0	805
20165	0	2	0	804	0	806
20166	0	0	804	0	0	804
20167	793	0	4	0	0	797
20168	0	0	0	796	0	796
20169	5	0	782	0	0	787
20170	0	0	806	0	0	806
20171	0	0	0	799	0	799
20172	0	0	776	0	0	776
20173	0	0	0	791	0	791
20174	0	1	0	782	0	783
20175	0	0	833	0	0	833
20176	0	1	0	819	0	820
20177	2	748	0	2	0	752
20178	0	740	0	1	0	741
20179	732	0	0	2	0	734
20180	754	0	0	0	0	754
20181	0	750	0	2	0	752
20182	746	0	0	0	0	746
20183	745	0	3	0	0	748
20184	0	0	0	684	0	684
20185	0	0	0	685	0	685
20186	690	0	2	0	0	692
20187	0	695	0	0	0	695
20188	0	693	0	1	0	694
20189	0	5	0	676	0	681
20190	0	0	687	0	0	687
20191	687	0	4	0	0	691
20192	670	0	0	0	0	670
20193	665	1	9	1	0	676
20194	0	649	0	0	0	649
20195	0	1	0	668	0	669
20196	0	5	0	676	0	681
20197	717	0	1	0	0	718
20198	0	716	0	0	0	716
20199	0	0	0	707	0	707
20200	0	2	0	711	0	713
20201	1	0	0	725	0	726
20202	748	0	0	0	0	748
20203	0	742	0	0	0	742
20204	0	6	1	725	0	732
20205	0	730	0	0	0	730
20206	685	0	0	0	0	685
20207	1	0	729	0	0	730
20208	739	0	2	0	0	741
20209	0	0	725	0	0	725
20210	0	0	0	722	0	722
20211	705	0	2	0	0	707
20212	0	0	704	0	0	704
20213	709	0	3	0	0	712
20214	723	0	0	0	0	723
20215	723	0	1	0	0	724
20216	0	0	0	683	0	683
20217	0	0	1	682	0	683
20218	0	0	0	679	0	679
20219	678	0	5	0	0	683
20220	0	616	0	0	0	616
20221	612	0	2	0	0	614
20222	612	0	0	0	0	612
20223	0	0	606	0	0	606
20224	765	0	0	0	0	765
20225	775	0	1	0	0	776
20226	0	4	0	779	0	783
20227	0	1	0	775	0	776
20228	0	0	0	780	0	780
20229	778	0	0	0	0	778
20230	771	0	4	0	0	775
20231	801	1	1	2	0	805
20232	0	788	0	0	0	788
20233	0	759	0	0	0	759
20234	0	748	0	1	0	749
20235	752	0	2	1	0	755
20236	0	0	750	0	0	750
20237	0	0	755	1	0	756
20238	756	0	2	0	0	758
20239	0	0	746	0	0	746
20240	0	0	0	739	0	739
20241	0	727	0	0	0	727
20242	729	1	2	1	0	733
20243	740	0	1	0	0	741
20244	768	0	2	1	0	771
20245	0	1	0	767	0	768
20246	0	0	747	0	0	747
20247	0	0	757	0	0	757
20248	734	0	0	0	0	734
20249	730	0	2	1	0	733
20250	752	0	1	0	0	753
20251	0	0	0	709	0	709
20252	0	3	0	714	0	717
20253	0	0	716	0	0	716
20254	711	0	3	0	0	714
20255	0	0	0	716	0	716
20256	0	1	0	695	0	696
20257	0	0	0	700	0	700
20258	0	715	0	0	0	715
20259	0	0	0	730	0	730
20260	0	0	0	735	0	735
20261	735	0	0	0	0	735
20262	0	0	741	0	0	741
20263	731	0	4	0	0	735
20264	735	0	0	1	0	736
20265	0	0	0	733	0	733
20266	0	1	0	729	0	730
20267	732	0	0	0	0	732
20268	1	0	730	0	0	731
20269	0	773	0	0	0	773
20270	0	2	0	760	0	762
20271	747	0	0	0	0	747
20272	0	2	0	738	0	740
20273	0	0	703	0	0	703
20274	0	0	726	0	0	726
20275	752	0	4	0	0	756
20276	0	2	0	739	0	741
20277	0	0	736	0	0	736
20278	738	0	1	1	0	740
20279	740	0	1	0	0	741
20280	0	1	0	737	0	738
20281	0	4	0	762	0	766
20282	0	751	0	0	0	751
20283	745	0	3	0	0	748
20284	0	1	0	762	0	763
20285	1	2	0	751	0	754
20286	0	0	755	0	0	755
20287	743	0	1	0	0	744
20288	745	0	1	1	0	747
20289	0	754	0	1	0	755
20290	0	0	738	0	0	738
20291	1	0	901	0	0	902
20292	1	0	0	948	0	949
20293	947	0	3	0	0	950
20294	0	2	0	944	0	946
20295	955	0	2	0	0	957
20296	976	0	0	0	0	976
20297	1016	0	0	0	0	1016
20298	0	2	0	1056	0	1058
20299	1	2	0	1055	0	1058
20300	888	0	3	0	0	891
20301	0	0	882	0	0	882
20302	885	2	1	0	0	888
20303	892	0	2	0	0	894
20304	0	0	920	0	0	920
20305	0	0	916	0	0	916
20306	0	934	0	1	0	935
20307	0	2	0	905	0	907
20308	913	0	0	0	0	913
20309	1	0	0	915	0	916
20310	0	0	915	1	0	916
20311	1	957	0	1	0	959
20312	0	948	0	0	0	948
20313	2	0	1	935	0	938
20314	1	1	0	958	0	960
20315	0	954	0	5	0	959
20316	0	0	964	0	0	964
20317	975	0	4	0	0	979
20318	978	0	4	0	0	982
20319	0	977	0	0	0	977
20320	945	0	2	0	0	947
20321	1	1	0	957	0	959
20322	995	0	2	0	0	997
20323	0	2	0	985	0	987
20324	0	1010	0	0	0	1010
20325	0	0	1015	0	0	1015
20326	0	1	0	993	0	994
20327	0	0	1	986	0	987
20328	0	0	0	989	0	989
20329	1001	0	0	0	0	1001
20330	0	0	0	1002	0	1002
20331	0	0	1000	0	0	1000
20332	0	0	990	0	0	990
20333	970	0	1	0	0	971
20334	0	0	976	0	0	976
20335	981	0	0	0	0	981
20336	0	2	0	1013	0	1015
20337	0	0	0	1021	0	1021
20338	0	0	0	1003	0	1003
20339	0	0	0	1001	0	1001
20340	995	0	3	0	0	998
20341	1	0	1000	0	0	1001
20342	0	1	0	992	0	993
20343	0	968	0	0	0	968
20344	954	0	1	0	0	955
20345	0	1	0	941	0	942
20346	939	0	1	0	0	940
20347	2	0	940	0	0	942
20348	0	0	0	942	0	942
20349	0	925	0	1	0	926
20350	889	0	6	0	0	895
20351	0	0	909	0	0	909
20352	0	2	0	935	0	937
20353	1	3	0	938	0	942
20354	923	0	3	0	0	926
20355	0	0	917	0	0	917
20356	1	0	914	0	0	915
20357	0	0	0	888	0	888
20358	0	0	876	0	0	876
20359	0	0	896	0	0	896
20360	0	4	0	963	0	967
20361	0	0	0	968	0	968
20362	0	1	0	966	0	967
20363	968	0	2	0	0	970
20364	0	977	0	1	0	978
20365	1009	0	1	0	0	1010
20366	0	1	0	1010	0	1011
20367	0	839	0	0	0	839
20368	0	0	0	821	0	821
20369	822	0	4	0	0	826
20370	0	877	0	2	0	879
20371	0	1	0	865	0	866
20372	0	0	868	0	0	868
20373	823	0	0	0	0	823
20374	0	1	0	791	0	792
20375	0	2	0	825	0	827
20376	0	0	814	0	0	814
20377	0	0	819	0	0	819
20378	811	0	1	0	0	812
20379	0	786	0	0	0	786
20380	0	2	0	779	0	781
20381	755	0	2	0	0	757
20382	0	0	754	0	0	754
20383	0	759	1	4	0	764
20384	1	1	0	766	0	768
20385	758	0	2	0	0	760
20386	762	0	0	0	0	762
20387	740	0	4	0	0	744
20388	0	747	0	0	0	747
20389	0	0	756	0	0	756
20390	0	0	0	742	0	742
20391	0	0	0	738	0	738
20392	0	1	0	737	0	738
20393	0	0	0	730	0	730
20394	731	0	0	0	0	731
20395	720	0	0	0	0	720
20396	0	0	718	0	0	718
20397	1	1	705	0	0	707
20398	672	0	4	0	0	676
20399	672	0	2	0	0	674
20400	1	0	0	658	0	659
20401	0	658	1	1	0	660
20402	662	0	3	0	0	665
20403	2	675	0	0	0	677
20404	0	670	0	1	0	671
20405	0	1	0	662	0	663
20406	0	0	1	661	0	662
20407	0	0	0	669	0	669
20408	0	4	0	672	0	676
20409	0	0	678	0	0	678
20410	674	0	1	0	0	675
20411	677	0	1	0	0	678
20412	0	0	1	654	0	655
20413	0	0	1	747	0	748
20414	748	0	3	0	0	751
20415	1	0	750	0	0	751
20416	742	0	3	0	0	745
20417	745	0	0	0	0	745
20418	0	0	738	0	0	738
20419	762	0	2	0	0	764
20420	1	0	1	770	0	772
20421	0	0	0	763	0	763
20422	0	2	0	786	0	788
20423	0	2	1	777	0	780
20424	793	0	0	0	0	793
20425	0	1	0	790	0	791
20426	0	3	0	787	0	790
20427	0	836	0	0	0	836
20428	0	799	1	0	0	800
20429	0	1	0	796	0	797
20430	811	0	3	0	0	814
20431	0	6	0	801	0	807
20432	1	0	818	0	0	819
20433	0	0	842	0	0	842
20434	828	0	1	0	0	829
20435	0	824	0	0	0	824
20436	733	0	1	0	0	734
20437	0	0	764	0	0	764
20438	0	2	0	763	0	765
20439	767	0	1	0	0	768
20440	1	755	0	0	0	756
20441	705	0	1	1	0	707
20442	0	0	718	0	0	718
20443	0	6	0	737	0	743
20444	0	0	0	737	0	737
20445	737	0	0	0	0	737
20446	663	0	0	0	0	663
20447	661	0	1	0	0	662
20448	648	0	1	1	0	650
20449	646	0	5	0	0	651
20450	0	659	0	0	0	659
20451	0	0	0	621	0	621
20452	624	0	0	0	0	624
20453	0	1	0	628	0	629
20454	0	1	0	630	0	631
20455	1	0	0	631	0	632
20456	0	631	0	0	0	631
20457	630	0	1	0	0	631
20458	0	0	0	632	0	632
20459	623	0	0	0	0	623
20460	622	0	0	0	0	622
20461	1	628	0	0	0	629
20462	593	0	0	0	0	593
20463	0	0	595	0	0	595
20464	587	0	3	0	0	590
20465	0	1	0	580	0	581
20466	0	0	578	0	0	578
20467	0	581	0	0	0	581
20468	2	0	582	0	0	584
20469	0	580	1	1	0	582
20470	583	0	0	0	0	583
20471	582	0	2	0	0	584
20472	580	1	0	1	0	582
20473	0	579	0	0	0	579
20474	568	0	0	0	0	568
20475	0	0	561	0	0	561
20476	1	0	579	0	0	580
20477	0	1	0	584	0	585
20478	0	1	0	579	0	580
20479	0	576	0	0	0	576
20480	594	0	3	0	0	597
20481	0	3	0	590	0	593
20482	0	596	0	0	0	596
20483	0	1	0	586	0	587
20484	590	0	0	0	0	590
20485	575	0	0	0	0	575
20486	0	0	583	0	0	583
20487	0	2	0	565	0	567
20488	2	0	571	0	0	573
20489	0	4	0	465	0	469
20490	0	0	469	0	0	469
20491	0	3	0	463	0	466
20492	2	0	471	0	0	473
20493	0	0	0	497	0	497
20494	0	0	503	0	0	503
20495	0	0	0	507	0	507
20496	0	1	0	497	0	498
20497	0	498	0	0	0	498
20498	0	0	0	481	0	481
20499	0	0	491	0	0	491
20500	1	1	0	485	0	487
20501	0	1	0	476	0	477
20502	489	0	0	0	0	489
20503	0	0	0	435	0	435
20504	0	1	0	441	0	442
20505	1	0	450	0	0	451
20506	444	0	1	0	0	445
20507	0	0	0	446	0	446
20508	0	0	0	406	0	406
20509	0	0	0	414	0	414
20510	411	0	0	0	0	411
20511	0	0	0	410	0	410
20512	0	1	0	411	0	412
20513	402	0	0	0	0	402
20514	0	409	0	0	0	409
20515	0	0	1	384	0	385
20516	0	0	0	383	0	383
20517	0	0	389	0	0	389
20518	381	0	3	0	0	384
20519	0	0	0	385	0	385
20520	0	0	383	0	0	383
20521	393	0	1	1	0	395
20522	0	0	2	388	0	390
20523	0	2	0	402	0	404
20524	0	0	0	405	0	405
20525	0	0	0	401	0	401
20526	0	0	399	0	0	399
20527	0	1	0	398	0	399
20528	0	1	0	395	0	396
20529	0	0	384	0	0	384
20530	392	0	0	0	0	392
20531	391	0	0	0	0	391
20532	389	0	0	0	0	389
20533	0	0	0	386	0	386
20534	385	0	0	0	0	385
20535	406	0	1	0	0	407
20536	0	0	0	409	0	409
20537	405	0	0	0	0	405
20538	405	0	0	0	0	405
20539	396	0	0	0	0	396
20540	409	0	0	0	0	409
20541	0	0	0	402	0	402
20542	0	397	0	0	0	397
20543	0	393	0	0	0	393
20544	0	391	0	0	0	391
20545	397	0	0	0	0	397
20546	398	0	0	0	0	398
20547	0	0	399	0	0	399
20548	487	0	1	0	0	488
20549	0	0	0	495	0	495
20550	0	1	0	480	0	481
20551	0	0	0	481	0	481
20552	488	0	3	0	0	491
20553	0	2	0	495	0	497
20554	0	485	0	1	0	486
20555	0	1	0	472	0	473
20556	1	0	467	0	0	468
20557	0	13	0	458	0	471
20558	471	0	0	0	0	471
20559	0	0	468	0	0	468
20560	0	3	0	463	0	466
20561	0	1	0	459	0	460
20562	0	2	0	452	0	454
20563	0	464	0	0	0	464
20564	0	1	0	466	0	467
20565	479	0	0	0	0	479
20566	475	0	0	0	0	475
20567	0	0	475	0	0	475
20568	0	0	466	0	0	466
20569	0	5	0	429	0	434
20570	0	0	0	406	0	406
20571	0	0	406	0	0	406
20572	0	1	0	409	0	410
20573	0	400	0	0	0	400
20574	407	0	0	0	0	407
20575	395	0	4	0	0	399
20576	390	0	1	0	0	391
20577	0	0	391	0	0	391
20578	0	0	0	378	0	378
20579	0	0	373	0	0	373
20580	371	0	1	0	0	372
20581	0	352	0	0	0	352
20582	0	0	0	361	0	361
20583	367	0	0	0	0	367
20584	0	0	0	382	0	382
20585	0	0	0	388	0	388
20586	15	0	375	0	0	390
20587	385	0	2	0	0	387
20588	0	384	0	0	0	384
20589	0	3	0	355	0	358
20590	372	0	1	0	0	373
20591	0	0	0	368	0	368
20592	365	0	0	0	0	365
20593	0	363	0	0	0	363
20594	350	0	0	0	0	350
20595	0	0	350	0	0	350
20596	378	0	3	0	0	381
20597	371	0	2	0	0	373
20598	382	0	0	0	0	382
20599	0	1	0	367	0	368
20600	0	0	0	372	0	372
20601	0	2	0	382	0	384
20602	0	384	0	0	0	384
20603	393	0	0	0	0	393
20604	0	1	0	390	0	391
20605	0	0	0	400	0	400
20606	0	0	0	396	0	396
20607	395	0	0	0	0	395
20608	0	0	0	395	0	395
20609	0	0	393	0	0	393
20610	0	393	0	0	0	393
20611	0	2	0	368	0	370
20612	0	1	0	369	0	370
20613	1	0	0	362	0	363
20614	0	0	360	0	0	360
20615	0	0	370	0	0	370
20616	0	0	0	360	0	360
20617	0	1	359	0	0	360
20618	0	0	0	358	0	358
20619	352	0	3	0	0	355
20620	351	0	0	0	0	351
20621	352	0	2	0	0	354
20622	0	0	352	0	0	352
20623	319	0	0	0	0	319
20624	0	0	0	247	0	247
20625	1	0	244	0	0	245
20626	0	0	244	0	0	244
20627	0	238	0	0	0	238
20628	0	228	0	0	0	228
20629	225	0	1	0	0	226
20630	0	0	0	221	0	221
20631	0	0	222	0	0	222
20632	0	0	0	221	0	221
20633	215	0	2	0	0	217
20634	0	0	216	0	0	216
20635	205	0	0	1	0	206
20636	205	0	0	0	0	205
20637	207	0	0	0	0	207
20638	0	205	0	0	0	205
20639	194	0	0	0	0	194
20640	0	2	1	186	0	189
20641	0	0	0	181	0	181
20642	0	0	0	181	0	181
20643	1	0	0	178	0	179
20644	180	0	0	0	0	180
20645	0	177	0	0	0	177
20646	0	177	1	0	0	178
20647	1	173	0	0	0	174
20648	174	0	0	0	0	174
20649	174	0	0	0	0	174
20650	174	0	0	0	0	174
20651	174	0	0	0	0	174
20652	0	0	0	170	0	170
20653	0	0	0	170	0	170
20654	171	0	0	0	0	171
20655	0	169	0	0	0	169
20656	165	0	0	0	0	165
20657	161	0	1	0	0	162
20658	0	0	0	149	0	149
20659	0	147	0	0	0	147
20660	0	0	0	127	0	127
20661	117	0	0	0	0	117
20662	0	0	117	0	0	117
20663	0	0	0	116	0	116
20664	0	114	0	0	0	114
20665	115	0	0	0	0	115
20666	91	0	0	0	0	91
20667	0	0	91	0	0	91
20668	0	81	0	0	0	81
20669	78	0	0	0	0	78
20670	0	0	0	59	0	59
20671	0	0	48	0	0	48
20672	0	0	47	0	0	47
20673	0	46	0	0	0	46
20674	41	0	0	0	0	41
20675	35	1	0	0	0	36
20676	0	32	0	0	0	32
20677	0	22	0	0	0	22
20678	18	0	0	0	0	18
20679	0	0	14	0	0	14
20680	0	0	12	0	0	12
20681	0	0	0	0	0
20682	0	0	0	0	0
20683	0	0	0	0	0
20684	0	0	0	0	0
20685	0	0	0	0	0
20686	0	0	0	0	0
20687	0	0	0	0	0
20688	0	0	0	0	0
20689	0	0	0	0	0
20690	0	0	0	0	0
20691	0	0	0	0	0
20692	0	0	0	0	0
20693	0	0	0	0	0
20694	0	0	0	0	0
20695	0	0	0	0	0
20696	0	0	0	0	0
20697	0	0	0	0	0
20698	0	0	0	0	0
20699	0	0	0	0	0
20700	0	0	0	0	0
20701	0	0	0	0	0
20702	0	0	0	0	0
20703	0	0	0	0	0
20704	0	0	0	0	0
20705	0	0	0	0	0
20706	0	0	0	0	0
20707	0	0	0	0	0
20708	0	0	0	0	0
20709	0	0	0	0	0
20710	0	0	0	0	0
20711	0	0	0	0	0
20712	0	0	0	0	0
20713	0	0	0	0	0
20714	0	0	0	0	0
20715	0	0	0	0	0
20716	0	0	0	0	0
20717	0	0	0	0	0
20718	0	0	0	0	0
20719	0	0	0	0	0
20720	0	0	0	0	0
20721	0	0	0	0	0
20722	0	0	0	0	0
20723	0	0	0	0	0
20724	0	0	0	0	0
20725	0	0	0	0	0
20726	0	0	0	0	0
20727	0	0	0	0	0
20728	0	0	0	0	0
20729	0	0	0	0	0
20730	0	0	0	0	0
20731	0	0	0	0	0
20732	0	0	0	0	0
20733	0	0	0	0	0
20734	0	0	0	0	0
20735	0	0	0	0	0
20736	0	0	0	0	0
20737	0	0	0	0	0
20738	0	0	0	0	0
20739	0	0	0	0	0
20740	0	0	0	0	0
20741	0	0	0	0	0
20742	0	0	0	0	0
20743	0	0	0	0	0
20744	0	0	0	0	0
20745	0	0	0	0	0
20746	0	0	0	0	0
20747	0	0	0	0	0
20748	0	0	0	0	0
20749	0	0	0	0	0
20750	0	0	0	0	0
20751	0	0	0	0	0
20752	0	0	0	0	0
20753	0	0	0	0	0
20754	0	0	0	0	0
20755	0	0	0	0	0
20756	0	0	0	0	0
20757	0	0	0	0	0
20758	0	0	0	0	0
20759	0	0	0	0	0
20760	0	0	0	0	0
20761	0	0	0	0	0
20762	0	0	0	0	0
20763	0	0	0	0	0
20764	0	0	0	0	0
20765	0	0	0	0	0
20766	0	0	0	0	0
20767	0	0	0	0	0
20768	0	0	0	0	0
20769	0	0	0	0	0
20770	0	0	0	0	0
20771	0	0	0	0	0
20772	0	0	0	0	0
20773	0	0	0	0	0
20774	0	0	0	0	0
20775	0	0	0	0	0
20776	0	0	0	0	0
20777	0	0	0	0	0
20778	0	0	0	0	0
20779	0	0	0	0	0
20780	0	0	0	0	0
20781	0	0	0	0	0
20782	0	0	0	0	0
20783	0	0	0	0	0
20784	0	0	0	0	0
20785	0	0	0	0	0
20786	0	0	0	0	0
20787	0	0	0	0	0
20788	0	0	0	0	0
20789	0	0	0	0	0
20790	0	0	0	0	0
20791	0	0	0	0	0
20792	0	0	0	0	0
20793	0	0	0	0	0
20794	0	0	0	0	0
20795	0	0	0	0	0
20796	0	0	0	0	0
20797	0	0	0	0	0
20798	0	0	0	0	0
20799	0	0	0	0	0
20800	0	0	0	0	0
20801	0	0	0	0	0
20802	0	0	0	0	0
20803	0	0	0	0	0
20804	0	0	0	0	0
20805	0	0	0	0	0
20806	0	0	0	0	0
20807	0	0	0	0	0
20808	0	0	0	0	0
20809	0	0	0	0	0
20810	0	0	0	0	0
20811	0	0	0	0	0
20812	0	0	0	0	0
20813	0	0	0	0	0
20814	0	0	0	0	0
20815	0	0	0	0	0
20816	0	0	0	0	0
20817	0	0	0	0	0
20818	0	0	0	0	0
20819	0	0	0	0	0
20820	0	0	0	0	0
20821	0	0	0	0	0
20822	0	0	0	0	0
20823	0	0	0	0	0
20824	0	0	0	0	0
20825	0	0	0	0	0
20826	0	0	0	0	0
20827	0	0	0	0	0
20828	0	0	0	0	0
20829	0	0	0	0	0
20830	0	0	0	0	0
20831	0	0	0	0	0
20832	0	0	0	0	0
20833	0	0	0	0	0
20834	0	0	0	0	0
20835	0	0	0	0	0
20836	0	0	0	0	0
20837	0	0	0	0	0
20838	0	0	0	0	0
20839	0	0	0	0	0
20840	0	0	0	0	0
20841	0	0	0	0	0
20842	0	0	0	0	0
20843	0	0	0	0	0
20844	0	0	0	0	0
20845	0	0	0	0	0
20846	0	0	0	0	0
20847	0	0	0	0	0
20848	0	0	0	0	0
20849	0	0	0	0	0
20850	0	0	0	0	0
20851	0	0	0	0	0
20852	0	0	0	0	0
20853	0	0	0	0	0
20854	0	0	0	0	0
20855	0	0	0	0	0
20856	0	0	0	0	0
20857	0	0	0	0	0
20858	0	0	0	0	0
20859	0	0	0	0	0
20860	0	0	0	0	0
20861	0	0	0	0	0
20862	0	0	0	0	0
20863	0	0	0	0	0
20864	0	0	0	0	0
20865	0	0	0	0	0
20866	0	0	0	0	0
20867	0	0	0	0	0
20868	0	0	0	0	0
20869	0	0	0	0	0
20870	0	0	0	0	0
20871	0	0	0	0	0
20872	0	0	0	0	0
20873	0	0	0	0	0
20874	0	0	0	0	0
20875	0	0	0	0	0
20876	0	0	0	0	0
20877	0	0	0	0	0
20878	0	0	0	0	0
20879	0	0	0	0	0
20880	0	0	0	0	0
20881	0	0	0	0	0
20882	0	0	0	0	0
20883	0	0	0	0	0
20884	0	0	0	0	0
20885	0	0	0	0	0
20886	0	0	0	0	0
20887	0	0	0	0	0
20888	0	0	0	0	0
20889	0	0	0	0	0
20890	0	0	0	0	0
20891	0	0	0	0	0
20892	0	0	0	0	0
20893	0	0	0	0	0
20894	0	0	0	0	0
20895	0	0	0	0	0
20896	0	0	0	0	0
20897	0	0	0	0	0
20898	0	0	0	0	0
20899	0	0	0	0	0
20900	0	0	0	0	0
20901	0	0	0	0	0
20902	0	0	0	0	0
20903	0	0	0	0	0
20904	0	0	0	0	0
20905	0	0	0	0	0
20906	0	0	0	0	0
20907	0	0	0	0	0
20908	0	0	0	0	0
20909	0	0	0	0	0
20910	0	0	0	0	0
20911	0	0	0	0	0
20912	0	0	0	0	0
20913	0	0	0	0	0
20914	0	0	0	0	0
20915	0	0	0	0	0
20916	0	0	0	0	0
20917	0	0	0	0	0
20918	0	0	0	0	0
20919	0	0	0	0	0
20920	0	0	0	0	0
20921	0	0	0	0	0
20922	0	0	0	0	0
20923	0	0	0	0	0
20924	0	0	0	0	0
20925	0	0	0	0	0
20926	0	0	0	0	0
20927	0	0	0	0	0
20928	0	0	0	0	0
20929	0	0	0	0	0
20930	0	0	0	0	0
20931	0	0	0	0	0
20932	0	0	0	0	0
20933	0	0	0	0	0
20934	0	0	0	0	0
20935	0	0	0	0	0
20936	0	0	0	0	0
20937	0	0	0	0	0
20938	0	0	0	0	0
20939	0	0	0	0	0
20940	0	0	0	0	0
20941	0	0	0	0	0
20942	0	0	0	0	0
20943	0	0	0	0	0
20944	0	0	0	0	0
20945	0	0	0	0	0
20946	0	0	0	0	0
20947	0	0	0	0	0
20948	0	0	0	0	0
20949	0	0	0	0	0
20950	0	0	0	0	0
20951	0	0	0	0	0
20952	0	0	0	0	0
20953	0	0	0	0	0
20954	0	0	0	0	0
20955	0	0	0	0	0
20956	0	0	0	0	0
20957	0	0	0	0	0
20958	0	0	0	0	0
20959	0	0	0	0	0
20960	0	0	0	0	0
20961	0	0	0	0	0
20962	0	0	0	0	0
20963	0	0	0	0	0
20964	0	0	0	0	0
20965	0	0	0	0	0
20966	0	0	0	0	0
20967	0	0	0	0	0
20968	0	0	0	0	0
20969	0	0	0	0	0
20970	0	0	0	0	0
20971	0	0	0	0	0
20972	0	0	0	0	0
20973	0	0	0	0	0
20974	0	0	0	0	0
20975	0	0	0	0	0
20976	0	0	0	0	0
20977	0	0	0	0	0
20978	0	0	0	0	0
20979	0	0	0	0	0
20980	0	0	0	0	0
20981	0	0	0	0	0
20982	0	0	0	0	0
20983	0	0	0	0	0
20984	0	0	0	0	0
20985	0	0	0	0	0
20986	0	0	0	0	0
20987	0	0	0	0	0
20988	0	0	0	0	0
20989	0	0	0	0	0
20990	0	0	0	0	0
20991	0	0	0	0	0
20992	0	0	0	0	0
20993	0	0	0	0	0
20994	0	0	0	0	0
20995	0	0	0	0	0
20996	0	0	0	0	0
20997	0	0	0	0	0
20998	0	0	0	0	0
20999	0	0	0	0	0
21000	0	0	0	0	0
21001	0	0	0	0	0
21002	0	0	0	0	0
21003	0	0	0	0	0
21004	0	0	0	0	0
21005	0	0	0	0	0
21006	0	0	0	0	0
21007	0	0	0	0	0
21008	0	0	0	0	0
21009	0	0	0	0	0
21010	0	0	0	0	0
21011	0	0	0	0	0
21012	0	0	0	0	0
21013	0	0	0	0	0
21014	0	0	0	0	0
21015	0	0	0	0	0
21016	0	0	0	0	0
21017	0	0	0	0	0
21018	0	0	0	0	0
21019	0	0	0	0	0
21020	0	0	0	0	0
21021	0	0	0	0	0
21022	0	0	0	0	0
21023	0	0	0	0	0
21024	0	0	0	0	0
21025	0	0	0	0	0
21026	0	0	0	0	0
21027	0	0	0	0	0
21028	0	0	0	0	0
21029	0	0	0	0	0
21030	0	0	0	0	0
21031	0	0	0	0	0
21032	0	0	0	0	0
21033	0	0	0	0	0
21034	0	0	0	0	0
21035	0	0	0	0	0
21036	0	0	0	0	0
21037	0	0	0	0	0
21038	0	0	0	0	0
21039	0	0	0	0	0
21040	0	0	0	0	0
21041	0	0	0	0	0
21042	0	0	0	0	0
21043	0	0	0	0	0
21044	0	0	0	0	0
21045	0	0	0	0	0
21046	0	0	0	0	0
21047	0	0	0	0	0
21048	0	0	0	0	0
21049	0	0	0	0	0
21050	0	0	0	0	0
21051	0	0	0	0	0
21052	0	0	0	0	0
21053	0	0	0	0	0
21054	0	0	0	0	0
21055	0	0	0	0	0
21056	0	0	0	0	0
21057	0	0	0	0	0
21058	0	0	0	0	0
21059	0	0	0	0	0
21060	0	0	0	0	0
21061	0	0	0	0	0
21062	0	0	0	0	0
21063	0	0	0	0	0
21064	0	0	0	0	0
21065	0	0	0	0	0
21066	0	0	0	0	0
21067	0	0	0	0	0
21068	0	0	0	0	0
21069	0	0	0	0	0
21070	0	0	0	0	0
21071	0	0	0	0	0
21072	0	0	0	0	0
21073	0	0	0	0	0
21074	0	0	0	0	0
21075	0	0	0	0	0
21076	0	0	0	0	0
21077	0	0	0	0	0
21078	0	0	0	0	0
21079	0	0	0	0	0
21080	0	0	0	0	0
21081	0	0	0	0	0
21082	0	0	0	0	0
21083	0	0	0	0	0
21084	0	0	0	0	0
21085	0	0	0	0	0
21086	0	0	0	0	0
21087	0	0	0	0	0
21088	0	0	0	0	0
21089	0	0	0	0	0
21090	0	0	0	0	0
21091	0	0	0	0	0
21092	0	0	0	0	0
21093	0	0	0	0	0
21094	0	0	0	0	0
21095	0	0	0	0	0
21096	0	0	0	0	0
21097	0	0	0	0	0
21098	0	0	0	0	0
21099	0	0	0	0	0
21100	0	0	0	0	0
21101	0	0	0	0	0
21102	0	0	0	0	0
21103	0	0	0	0	0
21104	0	0	0	0	0
21105	0	0	0	0	0
21106	0	0	0	0	0
21107	0	0	0	0	0
21108	0	0	0	0	0
21109	0	0	0	0	0
21110	0	0	0	0	0
21111	0	0	0	0	0
21112	0	0	0	0	0
21113	0	0	0	0	0
21114	0	0	0	0	0
21115	0	0	0	0	0
21116	0	0	0	0	0
21117	0	0	0	0	0
21118	0	0	0	0	0
21119	0	0	0	0	0
21120	0	0	0	0	0
21121	0	0	0	0	0
21122	0	0	0	0	0
21123	0	0	0	0	0
21124	0	0	0	0	0
21125	0	0	0	0	0
21126	0	0	0	0	0
21127	0	0	0	0	0
21128	0	0	0	0	0
21129	0	0	0	0	0
21130	0	0	0	0	0
21131	0	0	0	0	0
21132	0	0	0	0	0
21133	0	0	0	0	0
21134	0	0	0	0	0
21135	0	0	0	0	0
21136	0	0	0	0	0
21137	0	0	0	0	0
21138	0	0	0	0	0
21139	0	0	0	0	0
21140	0	0	0	0	0
21141	0	0	0	0	0
21142	0	0	0	0	0
21143	0	0	0	0	0
21144	0	0	0	0	0
21145	0	0	0	0	0
21146	0	0	0	0	0
21147	0	0	0	0	0
21148	0	0	0	0	0
21149	0	0	0	0	0
21150	0	0	0	0	0
21151	0	0	0	0	0
21152	0	0	0	0	0
21153	0	0	0	0	0
21154	0	0	0	0	0
21155	0	0	0	0	0
21156	0	0	0	0	0
21157	0	0	0	0	0
21158	0	0	0	0	0
21159	0	0	0	0	0
21160	0	0	0	0	0
21161	0	0	0	0	0
21162	0	0	0	0	0
21163	0	0	0	0	0
21164	0	0	0	0	0
21165	0	0	0	0	0
21166	0	0	0	0	0
21167	0	0	0	0	0
21168	0	0	0	0	0
21169	0	0	0	0	0
21170	0	0	0	0	0
21171	0	0	0	0	0
21172	0	0	0	0	0
21173	0	0	0	0	0
21174	0	0	0	0	0
21175	0	0	0	0	0
21176	0	0	0	0	0
21177	0	0	0	0	0
21178	0	0	0	0	0
21179	0	0	0	0	0
21180	0	0	0	0	0
21181	0	0	0	0	0
21182	0	0	0	0	0
21183	0	0	0	0	0
21184	0	0	0	0	0
21185	0	0	0	0	0
21186	0	0	0	0	0
21187	0	0	0	0	0
21188	0	0	0	0	0
21189	0	0	0	0	0
21190	0	0	0	0	0
21191	0	0	0	0	0
21192	0	0	0	0	0
21193	0	0	0	0	0
21194	0	0	0	0	0
21195	0	0	0	0	0
21196	0	0	0	0	0
21197	0	0	0	0	0
21198	0	0	0	0	0
21199	0	0	0	0	0
21200	0	0	0	0	0
21201	0	0	0	0	0
21202	0	0	0	0	0
21203	0	0	0	0	0
21204	0	0	0	0	0
21205	0	0	0	0	0
21206	0	0	0	0	0
21207	0	0	0	0	0
21208	0	0	0	0	0
21209	0	0	0	0	0
21210	0	0	0	0	0
21211	0	0	0	0	0
21212	0	0	0	0	0
21213	0	0	0	0	0
21214	0	0	0	0	0
21215	0	0	0	0	0
21216	0	0	0	0	0
21217	0	0	0	0	0
21218	0	0	0	0	0
21219	0	0	0	0	0
21220	0	0	0	0	0
21221	0	0	0	0	0
21222	0	0	0	0	0
21223	0	0	0	0	0
21224	0	0	0	0	0
21225	0	0	0	0	0
21226	0	0	0	0	0
21227	0	0	0	0	0
21228	0	0	0	0	0
21229	0	0	0	0	0
21230	0	0	0	0	0
21231	0	0	0	0	0
21232	0	0	0	0	0
21233	0	0	0	0	0
21234	0	0	0	0	0
21235	0	0	0	0	0
21236	0	0	0	0	0
21237	0	0	0	0	0
21238	0	0	0	0	0
21239	0	0	0	0	0
21240	0	0	0	0	0
21241	0	0	0	0	0
21242	0	0	0	0	0
21243	0	0	0	0	0
21244	0	0	0	0	0
21245	0	0	0	0	0
21246	0	0	0	0	0
21247	0	0	0	0	0
21248	0	0	0	0	0
21249	0	0	0	0	0
21250	0	0	0	0	0
21251	0	0	0	0	0
21252	0	0	0	0	0
21253	0	0	0	0	0
21254	0	0	0	0	0
21255	0	0	0	0	0
21256	0	0	0	0	0
21257	0	0	0	0	0
21258	0	0	0	0	0
21259	0	0	0	0	0
21260	0	0	0	0	0
21261	0	0	0	0	0
21262	0	0	0	0	0
21263	0	0	0	0	0
21264	0	0	0	0	0
21265	0	0	0	0	0
21266	0	0	0	0	0
21267	0	0	0	0	0
21268	0	0	0	0	0
21269	0	0	0	0	0
21270	0	0	0	0	0
21271	0	0	0	0	0
21272	0	0	0	0	0
21273	0	0	0	0	0
21274	0	0	0	0	0
21275	0	0	0	0	0
21276	0	0	0	0	0
21277	0	0	0	0	0
21278	0	0	0	0	0
21279	0	0	0	0	0
21280	0	0	0	0	0
21281	0	0	0	0	0
21282	0	0	0	0	0
21283	0	0	0	0	0
21284	0	0	0	0	0
21285	0	0	0	0	0
21286	0	0	0	0	0
21287	0	0	0	0	0
21288	0	0	0	0	0
21289	0	0	0	0	0
21290	0	0	0	0	0
21291	0	0	0	0	0
21292	0	0	0	0	0
21293	0	0	0	0	0
21294	0	0	0	0	0
21295	0	0	0	0	0
21296	0	0	0	0	0
21297	0	0	0	0	0
21298	0	0	0	0	0
21299	0	0	0	0	0
21300	0	0	0	0	0
21301	0	0	0	0	0
21302	0	0	0	0	0
21303	0	0	0	0	0
21304	0	0	0	0	0
21305	0	0	0	0	0
21306	0	0	0	0	0
21307	0	0	0	0	0
21308	0	0	0	0	0
21309	0	0	0	0	0
21310	0	0	0	0	0
21311	0	0	0	0	0
21312	0	0	0	0	0
21313	0	0	0	0	0
21314	0	0	0	0	0
21315	0	0	0	0	0
21316	0	0	0	0	0
21317	0	0	0	0	0
21318	0	0	0	0	0
21319	0	0	0	0	0
21320	0	0	0	0	0
21321	0	0	0	0	0
21322	0	0	0	0	0
21323	0	0	0	0	0
21324	0	0	0	0	0
21325	0	0	0	0	0
21326	0	0	0	0	0
21327	0	0	0	0	0
21328	0	0	0	0	0
21329	0	0	0	0	0
21330	0	0	0	0	0
21331	3	0	0	0	0	3
21332	0	0	0	3	0	3
21333	0	0	3	0	0	3
21334	0	3	0	0	0	3
21335	4	0	0	0	0	4
21336	6	0	0	0	0	6
21337	24	0	0	0	0	24
21338	0	0	0	55	0	55
21339	0	0	0	55	0	55
21340	125	0	0	0	0	125
21341	0	138	0	0	0	138
21342	143	0	0	0	0	143
21343	0	0	0	156	0	156
21344	194	0	0	0	0	194
21345	0	0	0	326	0	326
21346	0	0	0	332	0	332
21347	0	2	0	333	0	335
21348	0	0	0	336	0	336
21349	0	0	359	0	0	359
21350	0	0	424	0	0	424
21351	418	0	3	0	0	421
21352	0	0	432	0	0	432
21353	0	0	441	0	0	441
21354	442	0	0	0	0	442
21355	571	0	3	2	0	576
21356	0	0	0	613	0	613
21357	611	0	1	1	0	613
21358	0	615	0	0	0	615
21359	618	0	0	0	0	618
21360	619	0	5	0	0	624
21361	703	0	0	1	0	704
21362	0	2	0	706	0	708
21363	0	712	0	0	0	712
21364	0	740	0	1	0	741
21365	747	0	0	0	0	747
21366	793	0	2	0	0	795
21367	0	2	0	802	0	804
21368	0	1	0	799	0	800
21369	0	818	0	0	0	818
21370	816	0	2	0	0	818
21371	1	0	876	0	0	877
21372	0	0	0	883	0	883
21373	0	0	0	881	0	881
21374	0	0	910	0	0	910
21375	0	0	0	915	0	915
21376	0	951	0	0	0	951
21377	0	2	0	1040	0	1042
21378	0	4	0	1062	0	1066
21379	0	1081	0	0	0	1081
21380	0	1086	0	0	0	1086
21381	0	1	1	1087	0	1089
21382	1124	1	2	0	0	1127
21383	0	2	0	1156	0	1158
21384	0	7	0	1166	0	1173
21385	0	1180	0	0	0	1180
21386	0	3	0	1176	0	1179
21387	0	1	1	1207	0	1209
21388	0	0	0	1256	0	1256
21389	1255	0	1	1	0	1257
21390	0	1	0	1265	0	1266
21391	0	1	0	1271	0	1272
21392	0	7	0	1265	0	1272
21393	1	0	1265	0	0	1266
21394	1286	0	0	0	0	1286
21395	0	1292	0	0	0	1292
21396	1295	0	3	1	0	1299
21397	0	3	0	1302	0	1305
21398	0	0	1370	1	0	1371
21399	1370	0	2	0	0	1372
21400	0	0	1399	0	0	1399
21401	1	1	1	1437	0	1440
21402	1452	0	0	0	0	1452
21403	1422	0	31	3	0	1456
21404	1457	0	0	0	0	1457
21405	0	2	0	1476	0	1478
21406	0	0	0	1477	0	1477
21407	0	5	0	1470	0	1475
21408	0	1477	0	1	0	1478
21409	0	1477	0	0	0	1477
21410	0	1519	0	0	0	1519
21411	0	1512	0	0	0	1512
21412	0	0	0	1545	0	1545
21413	0	0	0	1532	0	1532
21414	1561	0	0	0	0	1561
21415	1606	0	1	0	0	1607
21416	1578	0	0	0	0	1578
21417	0	0	0	1583	0	1583
21418	0	0	0	1578	0	1578
21419	1580	0	3	0	0	1583
21420	1539	0	0	0	0	1539
21421	6	0	1420	0	0	1426
21422	1	0	1468	0	0	1469
21423	1	0	1469	0	0	1470
21424	0	2	1540	0	0	1542
21425	0	1	0	1527	0	1528
21426	1475	1	1	1	0	1478
21427	0	1519	0	0	0	1519
21428	0	5	0	1566	0	1571
21429	0	0	1679	0	0	1679
21430	0	1537	0	2	0	1539
21431	0	2	4	1527	0	1533
21432	0	0	1581	0	0	1581
21433	1	2	1	1577	0	1581
21434	0	16	0	1573	0	1589
21435	1580	0	1	0	0	1581
21436	0	5	0	1562	0	1567
21437	0	0	1506	0	0	1506
21438	0	5	0	1504	0	1509
21439	0	1540	0	3	0	1543
21440	0	9	0	1548	0	1557
21441	0	3	0	1561	0	1564
21442	0	1	0	1524	0	1525
21443	1527	0	0	0	0	1527
21444	1528	0	1	0	0	1529
21445	1525	0	3	0	0	1528
21446	1514	0	5	0	0	1519
21447	1	0	1462	0	0	1463
21448	1440	0	3	0	0	1443
21449	1445	0	3	0	0	1448
21450	0	0	1488	0	0	1488
21451	1	0	1498	0	0	1499
21452	0	1	0	1483	0	1484
21453	0	1385	0	0	0	1385
21454	1392	0	2	0	0	1394
21455	1451	0	2	0	0	1453
21456	1439	0	1	0	0	1440
21457	1	2	0	1456	0	1459
21458	0	1434	0	0	0	1434
21459	1405	0	3	0	0	1408
21460	1427	1	1	0	0	1429
21461	0	0	0	1428	0	1428
21462	0	0	1473	0	0	1473
21463	1465	1	4	1	0	1471
21464	0	2	0	1436	0	1438
21465	1451	0	1	0	0	1452
21466	0	2	0	1447	0	1449
21467	1	0	1505	0	0	1506
21468	1573	0	4	1	0	1578
21469	0	6	0	1577	0	1583
21470	0	5	1	1588	0	1594
21471	0	2	0	1587	0	1589
21472	0	3	1	1616	0	1620
21473	1621	0	1	0	0	1622
21474	0	5	0	1555	0	1560
21475	0	1538	0	1	0	1539
21476	0	6	1	1517	0	1524
21477	0	1596	0	0	0	1596
21478	0	7	0	1592	0	1599
21479	0	2	0	1636	0	1638
21480	0	1637	0	1	0	1638
21481	0	11	0	1630	0	1641
21482	0	3	0	1714	0	1717
21483	1747	0	1	0	0	1748
21484	0	0	1773	0	0	1773
21485	2	2	1	1766	0	1771
21486	1725	0	6	0	0	1731
21487	1758	0	2	0	0	1760
21488	1778	0	6	2	0	1786
21489	0	0	1811	0	0	1811
21490	0	0	1755	0	0	1755
21491	0	1	0	1732	0	1733
21492	1686	0	2	0	0	1688
21493	0	0	1722	0	0	1722
21494	1717	0	2	1	0	1720
21495	0	1874	0	0	0	1874
21496	0	4	1	1868	0	1873
21497	0	3	0	1878	0	1881
21498	1857	0	1	0	0	1858
21499	0	0	0	1912	0	1912
21500	1855	0	1	0	0	1856
21501	1862	0	0	0	0	1862
21502	0	0	0	1852	0	1852
21503	0	0	1	1795	0	1796
21504	1756	0	1	1	0	1758
21505	1	0	1641	0	0	1642
21506	1620	0	1	0	0	1621
21507	0	0	1663	0	0	1663
21508	1607	0	4	1	0	1612
21509	1652	0	1	0	0	1653
21510	1668	0	2	0	0	1670
21511	1677	1	3	0	0	1681
21512	0	1728	0	0	0	1728
21513	1726	0	2	1	0	1729
21514	1737	1	2	0	0	1740
21515	0	1659	0	0	0	1659
21516	1645	0	2	0	0	1647
21517	0	0	1694	0	0	1694
21518	1667	0	3	1	0	1671
21519	1	0	1750	0	0	1751
21520	0	1	0	1765	0	1766
21521	0	4	0	1755	0	1759
21522	0	1	1812	0	0	1813
21523	0	4	1	1816	0	1821
21524	0	2	0	1879	0	1881
21525	1900	0	1	0	0	1901
21526	0	1	0	2007	0	2008
21527	0	5	0	2050	0	2055
21528	0	5	0	2042	0	2047
21529	0	2048	1	0	0	2049
21530	0	2	0	2045	0	2047
21531	2029	0	5	0	0	2034
21532	0	0	2073	2	0	2075
21533	1	4	0	2080	0	2085
21534	2	0	2067	1	0	2070
21535	2089	0	1	0	0	2090
21536	0	4	0	2087	0	2091
21537	1	0	2103	0	0	2104
21538	0	14	0	2134	0	2148
21539	0	19	0	2103	0	2122
21540	0	2151	0	2	0	2153
21541	0	1	0	2151	0	2152
21542	0	4	0	2157	0	2161
21543	0	0	2172	0	0	2172
21544	1	4	0	2098	0	2103
21545	0	4	0	2100	0	2104
21546	2112	0	3	1	0	2116
21547	2114	1	3	0	0	2118
21548	0	2138	0	0	0	2138
21549	2123	1	2	0	0	2126
21550	2123	0	3	0	0	2126
21551	0	2077	0	0	0	2077
21552	0	2	0	2051	0	2053
21553	2055	0	1	0	0	2056
21554	2058	0	3	0	0	2061
21555	1998	0	31	0	0	2029
21556	0	2060	0	0	0	2060
21557	0	0	2053	1	0	2054
21558	1971	0	0	2	0	1973
21559	1954	0	6	1	0	1961
21560	0	1942	0	1	0	1943
21561	1994	0	4	0	0	1998
21562	2051	0	4	1	0	2056
21563	0	1	0	2052	0	2053
21564	1	0	2016	0	0	2017
21565	1	4	0	1978	0	1983
21566	1	7	0	1972	0	1980
21567	0	1	0	1981	0	1982
21568	0	0	1990	0	0	1990
21569	0	4	0	1991	0	1995
21570	0	0	0	1973	0	1973
21571	0	6	0	1815	0	1821
21572	0	1	0	1864	0	1865
21573	0	4	0	1929	0	1933
21574	0	1867	0	0	0	1867
21575	0	8	0	1867	0	1875
21576	1	4	0	1864	0	1869
21577	2	0	1923	0	0	1925
21578	0	3	1	2002	0	2006
21579	0	6	0	1994	0	2000
21580	0	2	0	1992	0	1994
21581	0	2	0	2001	0	2003
21582	2004	0	0	0	0	2004
21583	0	3	0	1973	0	1976
21584	0	4	0	1980	0	1984
21585	1	0	1925	0	0	1926
21586	0	2025	0	0	0	2025
21587	2	1976	0	0	0	1978
21588	1984	0	6	0	0	1990
21589	1	1993	0	0	0	1994
21590	0	3	0	2003	0	2006
21591	2109	0	1	0	0	2110
21592	0	0	2164	2	0	2166
21593	0	6	2	2448	0	2456
21594	2	2399	0	1	0	2402
21595	0	9	0	2368	0	2377
21596	1	2382	0	1	0	2384
21597	0	5	0	2394	0	2399
21598	2423	1	6	0	0	2430
21599	2	0	2438	0	0	2440
21600	2	8	0	2598	0	2608
21601	0	2557	0	0	0	2557
21602	2394	2	13	1	0	2410
21603	0	0	2437	0	0	2437
21604	0	15	0	2508	0	2523
21605	1	0	2626	0	0	2627
21606	0	5	0	2620	0	2625
21607	0	0	2617	0	0	2617
21608	0	8	1	2570	0	2579
21609	1	5	0	2573	0	2579
21610	2570	0	4	0	0	2574
21611	2563	0	2	0	0	2565
21612	0	3	0	2616	0	2619
21613	0	2587	0	2	0	2589
21614	1	5	0	2545	0	2551
21615	0	1	0	2548	0	2549
21616	2501	2	2	0	0	2505
21617	0	2517	0	2	0	2519
21618	2546	0	15	0	0	2561
21619	2503	0	0	0	0	2503
21620	0	2496	0	0	0	2496
21621	0	2482	0	1	0	2483
21622	2469	1	1	0	0	2471
21623	0	0	2511	0	0	2511
21624	2458	1	1	0	0	2460
21625	2467	1	7	1	0	2476
21626	0	2453	0	2	0	2455
21627	1	11	0	2429	0	2441
21628	0	2582	0	0	0	2582
21629	2580	1	2	0	0	2583
21630	2597	1	11	1	0	2610
21631	0	2	0	2626	0	2628
21632	0	3	0	2592	0	2595
21633	2656	0	2	0	0	2658
21634	1	2686	0	1	0	2688
21635	0	2685	0	1	0	2686
21636	0	2698	0	0	0	2698
21637	2	2568	0	0	0	2570
21638	1	2672	0	0	0	2673
21639	0	4	0	2678	0	2682
21640	0	0	2808	0	0	2808
21641	0	2820	0	0	0	2820
21642	2811	0	3	1	0	2815
21643	0	4	1	2816	0	2821
21644	2777	0	1	0	0	2778
21645	1	3007	0	0	0	3008
21646	2985	0	17	0	0	3002
21647	0	3020	0	0	0	3020
21648	0	7	0	2948	0	2955
21649	2853	0	3	0	0	2856
21650	2869	1	1	0	0	2871
21651	0	1	1	2959	0	2961
21652	0	9	1	2958	0	2968
21653	0	2953	0	1	0	2954
21654	0	12	0	2860	0	2872
21655	0	5	0	2879	0	2884
21656	0	9	0	2944	0	2953
21657	0	2953	0	2	0	2955
21658	2939	1	6	0	0	2946
21659	0	2967	0	0	0	2967
21660	2965	1	5	0	0	2971
21661	0	2952	0	2	0	2954
21662	2	1	2896	0	0	2899
21663	1	24	0	2888	0	2913
21664	0	0	2889	2	0	2891
21665	0	0	3042	0	0	3042
21666	0	4	0	3044	0	3048
21667	4	0	3125	0	0	3129
21668	0	6	1	3046	0	3053
21669	0	5	1	2876	0	2882
21670	0	2	1	2894	0	2897
21671	2886	1	10	0	0	2897
21672	0	1	1	2850	0	2852
21673	0	5	0	2839	0	2844
21674	2674	0	1	0	0	2675
21675	0	2651	0	3	0	2654
21676	0	2529	0	0	0	2529
21677	1	2479	0	0	0	2480
21678	0	9	8	2390	0	2407
21679	1	0	2408	0	0	2409
21680	2439	0	3	1	0	2443
21681	0	2362	0	0	0	2362
21682	2366	0	3	0	0	2369
21683	2342	0	1	0	0	2343
21684	2307	2	6	0	0	2315
21685	0	0	2377	0	0	2377
21686	1	2	1	2483	0	2487
21687	0	8	1	2474	0	2483
21688	0	2	0	2433	0	2435
21689	1	4	0	2407	0	2412
21690	1	2403	0	1	0	2405
21691	2402	1	5	1	0	2409
21692	0	0	2409	0	0	2409
21693	2552	0	23	0	0	2575
21694	0	7	0	2628	0	2635
21695	0	2616	0	1	0	2617
21696	0	2670	0	0	0	2670
21697	1	9	0	2645	0	2655
21698	0	2653	0	1	0	2654
21699	2626	1	4	0	0	2631
21700	0	0	2725	0	0	2725
21701	0	6	0	2741	0	2747
21702	0	3	0	2730	0	2733
21703	2	2	1	2747	0	2752
21704	0	4	0	2703	0	2707
21705	2741	0	12	1	0	2754
21706	0	2734	0	1	0	2735
21707	2715	0	7	0	0	2722
21708	0	10	0	2719	0	2729
21709	0	3	0	2647	0	2650
21710	0	2631	0	1	0	2632
21711	2623	0	4	0	0	2627
21712	2719	1	13	0	0	2733
21713	0	2680	0	1	0	2681
21714	1	3	0	2654	0	2658
21715	0	2530	0	0	0	2530
21716	2507	0	6	0	0	2513
21717	1	0	2534	0	0	2535
21718	2	0	2619	0	0	2621
21719	2735	2	3	0	0	2740
21720	0	2673	0	3	0	2676
21721	0	4	0	2561	0	2565
21722	1	2	0	2576	0	2579
21723	1	0	2662	0	0	2663
21724	0	5	1	2656	0	2662
21725	1	3	0	2660	0	2664
21726	0	2629	0	0	0	2629
21727	1	6	0	2606	0	2613
21728	0	3	0	2621	0	2624
21729	2628	0	0	0	0	2628
21730	0	2619	0	0	0	2619
21731	0	2655	0	1	0	2656
21732	2	9	0	2571	0	2582
21733	0	6	1	2591	0	2598
21734	0	4	0	2586	0	2590
21735	0	2567	0	0	0	2567
21736	1	12	0	2587	0	2600
21737	0	2	1	2618	0	2621
21738	0	9	0	2609	0	2618
21739	3	5	0	2613	0	2621
21740	0	2457	1	1	0	2459
21741	0	2572	1	4	0	2577
21742	2577	0	5	1	0	2583
21743	2458	1	5	0	0	2464
21744	0	3	0	2475	0	2478
21745	1	0	2406	0	0	2407
21746	2	201	6	2108	0	2317
21747	0	3	0	2326	0	2329
21748	2469	0	0	0	0	2469
21749	0	2575	0	0	0	2575
21750	0	5	0	2569	0	2574
21751	1	4	0	2568	0	2573
21752	0	0	2541	0	0	2541
21753	0	0	2707	1	0	2708
21754	0	4	0	2709	0	2713
21755	0	3	1	2701	0	2705
21756	1	2694	0	1	0	2696
21757	0	2672	0	0	0	2672
21758	2827	0	1	1	0	2829
21759	1	9	0	2859	0	2869
21760	1	0	2865	0	0	2866
21761	0	3002	0	1	0	3003
21762	0	0	0	2884	0	2884
21763	2966	0	5	0	0	2971
21764	1	3	0	2975	0	2979
21765	3001	0	3	1	0	3005
21766	0	3012	0	2	0	3014
21767	2835	0	7	0	0	2842
21768	0	12	0	2819	0	2831
21769	0	0	2790	1	0	2791
21770	0	5	0	2737	0	2742
21771	1	2802	0	0	0	2803
21772	1	3	1	2737	0	2742
21773	0	2673	0	0	0	2673
21774	0	5	0	2656	0	2661
21775	0	0	2659	0	0	2659
21776	1	0	2710	0	0	2711
21777	0	0	2740	1	0	2741
21778	2762	0	8	0	0	2770
21779	0	2841	0	1	0	2842
21780	1	2788	0	2	0	2791
21781	2805	0	1	0	0	2806
21782	2841	0	0	0	0	2841
21783	0	8	0	2828	0	2836
21784	2	1	2821	0	0	2824
21785	0	0	2981	0	0	2981
21786	0	7	0	3116	0	3123
21787	3147	0	3	0	0	3150
21788	0	3050	0	1	0	3051
21789	0	3	0	3022	0	3025
21790	3014	1	3	0	0	3018
21791	2965	1	2	2	0	2970
21792	2	0	2973	0	0	2975
21793	3063	0	9	2	0	3074
21794	1	0	2933	1	0	2935
21795	4	0	3037	1	0	3042
21796	0	4	0	3050	0	3054
21797	0	7	0	3068	0	3075
21798	1	6	1	3144	0	3152
21799	1	0	3059	0	0	3060
21800	3075	1	4	0	0	3080
21801	0	1	0	3079	0	3080
21802	3061	0	1	0	0	3062
21803	3081	0	7	2	0	3090
21804	1	3076	0	2	0	3079
21805	1	3001	0	0	0	3002
21806	0	3035	0	0	0	3035
21807	1	10	0	2975	0	2986
21808	2	0	3101	0	0	3103
21809	0	3	0	3124	0	3127
21810	1	3126	0	0	0	3127
21811	0	3109	0	1	0	3110
21812	0	1	0	3082	0	3083
21813	3107	0	3	0	0	3110
21814	0	3124	0	1	0	3125
21815	0	3113	0	0	0	3113
21816	3162	0	3	1	0	3166
21817	0	12	0	3020	0	3032
21818	0	3	0	3044	0	3047
21819	0	2	0	3113	0	3115
21820	3126	0	0	0	0	3126
21821	3118	1	0	0	0	3119
21822	0	4	0	3077	0	3081
21823	3	0	3057	0	0	3060
21824	2869	1	11	1	0	2882
21825	0	6	1	2759	0	2766
21826	1	0	2767	0	0	2768
21827	1	0	2839	0	0	2840
21828	2	11	0	2822	0	2835
21829	3	0	2759	0	0	2762
21830	0	13	0	2731	0	2744
21831	0	3	1	2746	0	2750
21832	0	4	0	2744	0	2748
21833	2760	0	1	0	0	2761
21834	3	8	0	2683	0	2694
21835	0	11	0	2662	0	2673
21836	0	7	0	2595	0	2602
21837	1	0	1	2472	0	2474
21838	0	0	2447	2	0	2449
21839	1	2538	0	2	0	2541
21840	1	9	2	2601	0	2613
21841	1	8	0	2617	0	2626
21842	1	2684	0	0	0	2685
21843	0	2687	0	0	0	2687
21844	2781	1	3	3	0	2788
21845	1	2765	0	1	0	2767
21846	3	1	1	2748	0	2753
21847	1	0	2774	1	0	2776
21848	2749	1	5	0	0	2755
21849	2	0	2786	0	0	2788
21850	2802	0	4	1	0	2807
21851	2729	0	16	0	0	2745
21852	1	0	2883	0	0	2884
21853	0	2	0	2926	0	2928
21854	0	2931	0	0	0	2931
21855	0	7	0	2918	0	2925
21856	2910	0	4	0	0	2914
21857	2947	0	5	0	0	2952
21858	0	3030	0	0	0	3030
21859	3043	1	2	1	0	3047
21860	1	3	0	3196	0	3200
21861	2870	0	1	0	0	2871
21862	3156	0	4	1	0	3161
21863	1	3	0	3173	0	3177
21864	3153	0	3	0	0	3156
21865	3123	0	1	0	0	3124
21866	1	0	3124	0	0	3125
21867	2972	1	3	0	0	2976
21868	3	0	3005	1	0	3009
21869	1	1	2896	1	0	2899
21870	1	2842	0	1	0	2844
21871	0	5	0	2811	0	2816
21872	3	0	2818	0	0	2821
21873	1	0	2842	1	0	2844
21874	2926	0	5	0	0	2931
21875	0	8	0	2919	0	2927
21876	0	1	0	3003	0	3004
21877	0	2	0	3001	0	3003
21878	0	1	0	3004	0	3005
21879	0	6	1	2967	0	2974
21880	0	0	2942	1	0	2943
21881	0	1	2953	0	0	2954
21882	0	1	0	2964	0	2965
21883	2954	0	3	0	0	2957
21884	0	2840	1	1	0	2842
21885	0	4	0	2828	0	2832
21886	2974	0	2	0	0	2976
21887	0	2979	0	4	0	2983
21888	0	9	0	2956	0	2965
21889	0	3	0	2979	0	2982
21890	0	0	0	2957	0	2957
21891	2911	1	7	2	0	2921
21892	0	0	2869	0	0	2869
21893	2838	0	7	1	0	2846
21894	1	5	0	2872	0	2878
21895	0	2	0	2774	0	2776
21896	0	2820	0	1	0	2821
21897	0	0	2818	0	0	2818
21898	2815	0	4	0	0	2819
21899	2818	0	2	0	0	2820
21900	0	0	2827	1	0	2828
21901	2894	0	2	1	0	2897
21902	2	2828	0	2	0	2832
21903	4	2768	1	3	0	2776
21904	1	2764	0	2	0	2767
21905	2797	1	3	1	0	2802
21906	0	0	2923	0	0	2923
21907	7	4	0	2946	0	2957
21908	0	2965	0	4	0	2969
21909	0	2941	0	2	0	2943
21910	0	2900	0	3	0	2903
21911	0	1	0	3062	0	3063
21912	3159	0	3	0	0	3162
21913	0	3155	0	1	0	3156
21914	0	1	0	3073	0	3074
21915	0	4	1	2973	0	2978
21916	2927	0	3	0	0	2930
21917	1	6	0	2908	0	2915
21918	0	14	0	2864	0	2878
21919	0	0	2963	0	0	2963
21920	0	11	0	2896	0	2907
21921	0	4	1	2976	0	2981
21922	2975	0	2	0	0	2977
21923	2945	0	0	0	0	2945
21924	1	2	0	2964	0	2967
21925	2906	0	1	1	0	2908
21926	2909	0	9	0	0	2918
21927	0	2781	0	0	0	2781
21928	1	0	2696	0	0	2697
21929	0	2930	0	6	0	2936
21930	0	1	0	2953	0	2954
21931	3010	0	4	0	0	3014
21932	0	2901	1	0	0	2902
21933	0	7	0	2893	0	2900
21934	2893	1	6	0	0	2900
21935	2858	1	4	0	0	2863
21936	0	1	0	2726	0	2727
21937	5	0	2741	0	0	2746
21938	1	10	0	2441	0	2452
21939	0	2	0	2415	0	2417
21940	0	0	2484	1	0	2485
21941	0	2	0	2524	0	2526
21942	0	2	0	2519	0	2521
21943	2597	0	1	0	0	2598
21944	1	1	2	2578	0	2582
21945	0	0	0	2580	0	2580
21946	2569	0	4	0	0	2573
21947	2549	0	0	0	0	2549
21948	2547	0	4	1	0	2552
21949	0	0	2567	0	0	2567
21950	0	6	0	2395	0	2401
21951	0	2377	0	0	0	2377
21952	1	5	0	2281	0	2287
21953	1	0	2303	0	0	2304
21954	0	7	0	2320	0	2327
21955	2	0	2326	0	0	2328
21956	2317	0	2	1	0	2320
21957	2291	0	1	1	0	2293
21958	0	1	0	2302	0	2303
21959	0	3	1	2297	0	2301
21960	0	3	1	2294	0	2298
21961	0	2190	1	1	0	2192
21962	2213	0	5	0	0	2218
21963	2217	0	5	1	0	2223
21964	0	4	0	2245	0	2249
21965	0	2	0	2214	0	2216
21966	0	5	0	2212	0	2217
21967	0	6	0	2228	0	2234
21968	1	0	2272	1	0	2274
21969	0	5	0	2482	0	2487
21970	2445	0	2	0	0	2447
21971	2481	0	8	0	0	2489
21972	0	2	0	2385	0	2387
21973	0	0	2397	2	0	2399
21974	2440	0	6	1	0	2447
21975	0	15	0	2440	0	2455
21976	0	2412	0	3	0	2415
21977	0	2379	0	0	0	2379
21978	2536	0	5	1	0	2542
21979	2	2	0	2561	0	2565
21980	0	0	0	2575	0	2575
21981	0	0	0	2567	0	2567
21982	0	1	0	2413	0	2414
21983	1	1	0	2411	0	2413
21984	1	0	2368	1	0	2370
21985	1	0	2372	0	0	2373
21986	1	0	2372	0	0	2373
21987	1	4	0	2292	0	2297
21988	269	0	2044	0	0	2313
21989	0	6	1	2305	0	2312
21990	0	4	1	2296	0	2301
21991	0	2	0	2322	0	2324
21992	2294	0	1	0	0	2295
21993	1	4	0	2284	0	2289
21994	0	0	0	2387	0	2387
21995	2269	0	1	0	0	2270
21996	1	2267	0	4	0	2272
21997	0	2167	0	8	0	2175
21998	2178	0	3	0	0	2181
21999	0	2198	0	1	0	2199
22000	2197	0	3	1	0	2201
22001	2211	0	3	0	0	2214
22002	2180	1	5	0	0	2186
22003	2177	0	7	0	0	2184
22004	2192	0	4	0	0	2196
22005	0	1969	0	0	0	1969
22006	1962	0	2	0	0	1964
22007	1943	0	5	0	0	1948
22008	0	1913	0	1	0	1914
22009	1907	1	8	0	0	1916
22010	1895	0	8	0	0	1903
22011	1896	0	0	0	0	1896
22012	1896	0	3	0	0	1899
22013	0	0	1915	0	0	1915
22014	1	3	1	1993	0	1998
22015	0	1	0	2013	0	2014
22016	1	0	1932	0	0	1933
22017	1	0	1891	0	0	1892
22018	1911	0	3	2	0	1916
22019	0	12	0	1852	0	1864
22020	0	0	1853	0	0	1853
22021	0	0	2107	0	0	2107
22022	2085	0	4	0	0	2089
22023	2057	0	37	0	0	2094
22024	2080	0	4	0	0	2084
22025	0	0	2069	0	0	2069
22026	0	3	0	2044	0	2047
22027	2	0	2046	0	0	2048
22028	2042	0	1	0	0	2043
22029	0	0	2064	0	0	2064
22030	0	2	0	2125	0	2127
22031	0	5	0	2118	0	2123
22032	1	2117	0	0	0	2118
22033	2112	0	6	0	0	2118
22034	1	0	2123	0	0	2124
22035	2178	0	2	1	0	2181
22036	0	0	2260	0	0	2260
22037	0	5	0	2258	0	2263
22038	0	2	0	2290	0	2292
22039	0	2	1	2248	0	2251
22040	2326	0	0	0	0	2326
22041	0	0	0	2317	0	2317
22042	0	18	0	2279	0	2297
22043	0	2269	0	3	0	2272
22044	0	1	1	2237	0	2239
22045	2038	0	27	0	0	2065
22046	0	0	2077	0	0	2077
22047	0	8	0	2026	0	2034
22048	0	0	2019	2	0	2021
22049	0	1930	0	0	0	1930
22050	0	0	1951	0	0	1951
22051	1952	0	3	0	0	1955
22052	1948	0	2	0	0	1950
22053	0	1	0	1975	0	1976
22054	1832	0	1	0	0	1833
22055	1807	0	1	2	0	1810
22056	0	1	1	1808	0	1810
22057	0	2	0	1883	0	1885
22058	0	0	1874	1	0	1875
22059	0	1860	0	0	0	1860
22060	1858	0	8	0	0	1866
22061	0	1884	0	0	0	1884
22062	1	2	0	1831	0	1834
22063	1	1	0	1862	0	1864
22064	0	5	0	1757	0	1762
22065	0	2	0	1785	0	1787
22066	0	0	1815	0	0	1815
22067	1806	0	8	0	0	1814
22068	1823	0	2	0	0	1825
22069	0	0	0	1819	0	1819
22070	1716	0	0	0	0	1716
22071	0	2	0	1776	0	1778
22072	0	0	1708	0	0	1708
22073	0	8	0	1717	0	1725
22074	1	1744	0	1	0	1746
22075	1	3	0	1701	0	1705
22076	1	1748	0	1	0	1750
22077	0	6	0	1716	0	1722
22078	0	1725	0	1	0	1726
22079	1715	0	6	0	0	1721
22080	0	0	1748	0	0	1748
22081	2	1849	0	3	0	1854
22082	0	1869	0	0	0	1869
22083	1	5	0	1849	0	1855
22084	0	4	0	1859	0	1863
22085	0	4	0	1874	0	1878
22086	0	3	0	1868	0	1871
22087	0	1952	0	1	0	1953
22088	1	0	0	1946	0	1947
22089	0	1	0	1874	0	1875
22090	1875	0	6	0	0	1881
22091	0	4	0	1846	0	1850
22092	0	0	1848	1	0	1849
22093	2	1	1824	0	0	1827
22094	1849	0	2	0	0	1851
22095	0	1870	0	3	0	1873
22096	0	1637	0	0	0	1637
22097	0	4	0	1640	0	1644
22098	0	3	0	1648	0	1651
22099	1	0	1672	1	0	1674
22100	1767	0	6	0	0	1773
22101	1765	0	6	0	0	1771
22102	1	0	1761	0	0	1762
22103	1	0	1764	0	0	1765
22104	1693	0	6	1	0	1700
22105	1795	1	7	0	0	1803
22106	1809	0	4	0	0	1813
22107	1793	3	16	0	0	1812
22108	0	1813	0	2	0	1815
22109	1739	0	2	0	0	1741
22110	5	0	1727	0	0	1732
22111	0	0	1729	0	0	1729
22112	0	0	1679	0	0	1679
22113	0	0	0	1729	0	1729
22114	1649	1	2	0	0	1652
22115	1662	0	3	0	0	1665
22116	0	4	0	1591	0	1595
22117	0	4	0	1619	0	1623
22118	0	4	0	1627	0	1631
22119	0	1782	0	1	0	1783
22120	1796	0	3	0	0	1799
22121	1914	0	0	0	0	1914
22122	1901	0	0	0	0	1901
22123	1954	0	0	0	0	1954
22124	2012	0	0	0	0	2012
22125	2	1	1	2043	0	2047
22126	0	2047	0	0	0	2047
22127	1	1	0	2035	0	2037
22128	0	3	0	2051	0	2054
22129	2009	0	3	0	0	2012
22130	1	0	2016	1	0	2018
22131	3	0	2007	0	0	2010
22132	0	1	2043	0	0	2044
22133	1946	0	1	1	0	1948
22134	1961	0	5	0	0	1966
22135	0	6	0	1944	0	1950
22136	0	6	0	1949	0	1955
22137	1	3	0	1926	0	1930
22138	0	0	1994	0	0	1994
22139	0	2	0	1991	0	1993
22140	1	0	1998	0	0	1999
22141	0	5	0	1962	0	1967
22142	1	2	0	1958	0	1961
22143	1	1	0	2011	0	2013
22144	2002	1	5	0	0	2008
22145	2014	0	3	0	0	2017
22146	0	0	2053	0	0	2053
22147	1969	0	8	0	0	1977
22148	2018	0	3	0	0	2021
22149	1	3	0	1992	0	1996
22150	1999	0	6	0	0	2005
22151	1	3	1	2005	0	2010
22152	0	2	0	1966	0	1968
22153	0	0	1963	0	0	1963
22154	1932	0	16	0	0	1948
22155	2	6	0	1864	0	1872
22156	0	0	1851	0	0	1851
22157	0	0	1816	0	0	1816
22158	0	3	0	1793	0	1796
22159	1	2	0	1801	0	1804
22160	1826	0	4	0	0	1830
22161	0	1	0	1865	0	1866
22162	0	2	0	1852	0	1854
22163	0	2	0	1756	0	1758
22164	0	0	0	1757	0	1757
22165	1760	0	0	0	0	1760
22166	1764	0	3	0	0	1767
22167	1847	0	1	0	0	1848
22168	1931	0	4	0	0	1935
22169	0	1	0	1941	0	1942
22170	1949	0	2	1	0	1952
22171	0	1	0	1914	0	1915
22172	2146	0	0	0	0	2146
22173	0	3	0	2164	0	2167
22174	0	3	0	2173	0	2176
22175	0	2142	0	0	0	2142
22176	0	2	0	2071	0	2073
22177	2078	0	2	1	0	2081
22178	2076	0	2	0	0	2078
22179	0	0	2162	1	0	2163
22180	0	2142	0	2	0	2144
22181	2099	0	3	0	0	2102
22182	0	2093	0	2	0	2095
22183	2093	0	5	0	0	2098
22184	0	2130	0	3	0	2133
22185	5	0	2128	1	0	2134
22186	0	2425	1	0	0	2426
22187	0	2440	0	0	0	2440
22188	0	3	0	2678	0	2681
22189	2920	0	3	0	0	2923
22190	0	5	0	2972	0	2977
22191	0	0	0	2981	0	2981
22192	3063	0	0	0	0	3063
22193	3057	0	1	0	0	3058
22194	0	1	1	3057	0	3059
22195	0	2	0	2865	0	2867
22196	0	1	0	2919	0	2920
22197	2797	0	1	0	0	2798
22198	0	0	2838	0	0	2838
22199	1	1	0	2819	0	2821
22200	7	0	2749	0	0	2756
22201	0	2714	0	5	0	2719
22202	2	0	2743	0	0	2745
22203	1	3	0	2746	0	2750
22204	1	2	2728	0	0	2731
22205	2846	0	11	2	0	2859
22206	0	4	1	2858	0	2863
22207	0	2819	0	2	0	2821
22208	0	6	0	2792	0	2798
22209	2	2887	0	2	0	2891
22210	1	2897	0	2	0	2900
22211	0	2918	0	0	0	2918
22212	2	5	0	2912	0	2919
22213	0	2877	0	1	0	2878
22214	2841	0	9	1	0	2851
22215	1	0	2868	0	0	2869
22216	0	0	2895	0	0	2895
22217	0	0	2919	0	0	2919
22218	1	5	0	2857	0	2863
22219	0	12	0	2811	0	2823
22220	0	4	0	2817	0	2821
22221	0	2	0	2965	0	2967
22222	1	1	0	2910	0	2912
22223	1	2867	0	0	0	2868
22224	1	0	2848	0	0	2849
22225	0	0	2858	0	0	2858
22226	0	2996	0	3	0	2999
22227	0	13	0	2968	0	2981
22228	0	9	0	2990	0	2999
22229	0	1	0	2999	0	3000
22230	3005	0	3	0	0	3008
22231	0	0	2978	2	0	2980
22232	3031	0	7	0	0	3038
22233	3039	2	6	0	0	3047
22234	2	3064	0	2	0	3068
22235	0	3039	0	0	0	3039
22236	3037	1	6	0	0	3044
22237	0	1	0	3060	0	3061
22238	0	1	0	3092	0	3093
22239	4	0	3071	0	0	3075
22240	2	0	3075	1	0	3078
22241	0	1	0	3082	0	3083
22242	3041	0	6	1	0	3048
22243	0	0	2985	0	0	2985
22244	2901	0	9	2	0	2912
22245	3	5	0	2895	0	2903
22246	1	2	0	2839	0	2842
22247	1	7	0	2852	0	2860
22248	2	0	2670	0	0	2672
22249	1	2636	0	1	0	2638
22250	0	2636	0	2	0	2638
22251	2634	1	8	0	0	2643
22252	2632	0	3	0	0	2635
22253	1	1	0	2662	0	2664
22254	2660	0	6	0	0	2666
22255	0	0	2632	0	0	2632
22256	0	0	2799	1	0	2800
22257	0	1	0	2771	0	2772
22258	2765	0	2	0	0	2767
22259	0	4	0	2753	0	2757
22260	1	3	0	2719	0	2723
22261	2728	0	2	0	0	2730
22262	2467	1	4	0	0	2472
22263	0	2348	0	1	0	2349
22264	2218	0	4	0	0	2222
22265	0	1	0	2025	0	2026
22266	0	1974	0	3	0	1977
22267	1969	1	5	0	0	1975
22268	0	1896	0	0	0	1896
22269	0	9	0	1870	0	1879
22270	1866	0	2	1	0	1869
22271	0	0	1863	0	0	1863
22272	0	0	1909	0	0	1909
22273	0	2	2	1917	0	1921
22274	0	3	0	1851	0	1854
22275	1	4	0	1844	0	1849
22276	0	1884	0	0	0	1884
22277	1887	1	3	0	0	1891
22278	1879	0	9	0	0	1888
22279	1889	0	1	0	0	1890
22280	0	1859	0	0	0	1859
22281	0	4	0	1793	0	1797
22282	0	2	0	1795	0	1797
22283	0	1	0	1879	0	1880
22284	1905	0	1	0	0	1906
22285	0	1904	0	0	0	1904
22286	0	3	0	1931	0	1934
22287	1	2	1	1926	0	1930
22288	0	2	1993	0	0	1995
22289	0	2021	0	1	0	2022
22290	0	9	0	2003	0	2012
22291	0	3	1	2008	0	2012
22292	0	4	0	2010	0	2014
22293	2091	2	1	1	0	2095
22294	0	2116	0	1	0	2117
22295	2133	0	12	0	0	2145
22296	0	1	0	2167	0	2168
22297	2011	0	3	0	0	2014
22298	2	0	2065	0	0	2067
22299	2065	0	3	1	0	2069
22300	2065	1	6	0	0	2072
22301	0	0	2063	1	0	2064
22302	2	0	1	2085	0	2088
22303	0	3	0	2077	0	2080
22304	2127	1	0	0	0	2128
22305	1	3	3	2121	0	2128
22306	0	4	0	2118	0	2122
22307	0	9	2	2273	0	2284
22308	0	0	2258	2	0	2260
22309	2256	0	4	0	0	2260
22310	0	2234	0	0	0	2234
22311	0	2	1	2179	0	2182
22312	0	2205	0	3	0	2208
22313	0	2169	0	0	0	2169
22314	0	0	0	2165	0	2165
22315	0	0	2165	0	0	2165
22316	0	0	2198	0	0	2198
22317	0	2	0	2190	0	2192
22318	0	0	2181	0	0	2181
22319	2134	0	9	0	0	2143
22320	0	2	0	2176	0	2178
22321	1	8	0	2166	0	2175
22322	0	2140	0	0	0	2140
22323	0	5	0	2151	0	2156
22324	0	3	0	2163	0	2166
22325	0	2185	0	0	0	2185
22326	0	1	0	2168	0	2169
22327	0	4	0	2187	0	2191
22328	0	2205	0	0	0	2205
22329	2158	0	6	0	0	2164
22330	1	0	2160	1	0	2162
22331	0	0	2141	0	0	2141
22332	1	1	0	1969	0	1971
22333	1	5	0	1957	0	1963
22334	1	1	1949	0	0	1951
22335	0	0	1954	1	0	1955
22336	1957	0	0	1	0	1958
22337	0	1944	0	1	0	1945
22338	1911	0	10	0	0	1921
22339	0	0	1886	0	0	1886
22340	0	1904	0	1	0	1905
22341	0	1	0	1903	0	1904
22342	0	1	1894	1	0	1896
22343	0	0	1918	0	0	1918
22344	1	1	0	1947	0	1949
22345	1	0	1936	1	0	1938
22346	0	2027	0	1	0	2028
22347	0	5	0	2032	0	2037
22348	0	0	2018	0	0	2018
22349	0	2034	0	1	0	2035
22350	2037	1	5	0	0	2043
22351	1	0	2074	0	0	2075
22352	0	2031	0	1	0	2032
22353	0	3	0	2042	0	2045
22354	0	3	0	2100	0	2103
22355	2103	0	0	0	0	2103
22356	2	2	0	2681	0	2685
22357	0	0	1	2675	0	2676
22358	2681	0	1	0	0	2682
22359	0	2	1	2597	0	2600
22360	3	1	2573	0	0	2577
22361	0	8	0	2500	0	2508
22362	1	0	2455	0	0	2456
22363	0	0	2474	0	0	2474
22364	0	0	2431	0	0	2431
22365	0	11	0	2382	0	2393
22366	0	3	0	2398	0	2401
22367	2420	0	3	0	0	2423
22368	0	31	0	2410	0	2441
22369	1	2392	0	1	0	2394
22370	0	8	0	2384	0	2392
22371	2	7	0	2361	0	2370
22372	0	2353	0	1	0	2354
22373	2333	1	4	0	0	2338
22374	2357	0	5	0	0	2362
22375	0	2345	0	2	0	2347
22376	0	2223	0	0	0	2223
22377	0	0	0	2217	0	2217
22378	2186	0	1	1	0	2188
22379	0	0	2173	0	0	2173
22380	4	0	2142	0	0	2146
22381	2162	0	2	1	0	2165
22382	0	2198	0	1	0	2199
22383	0	3	1	1969	0	1973
22384	1	1	0	1988	0	1990
22385	0	6	0	1980	0	1986
22386	1	6	0	2020	0	2027
22387	0	2025	0	0	0	2025
22388	0	3	0	1991	0	1994
22389	2003	1	3	0	0	2007
22390	1	2	0	1992	0	1995
22391	0	3	0	1977	0	1980
22392	1980	0	0	1	0	1981
22393	1989	0	1	0	0	1990
22394	2010	0	1	0	0	2011
22395	2041	0	2	0	0	2043
22396	0	0	0	1996	0	1996
22397	1996	0	0	0	0	1996
22398	0	0	0	1974	0	1974
22399	1952	0	0	0	0	1952
22400	1947	0	0	0	0	1947
22401	0	11	1	1936	0	1948
22402	0	0	1944	0	0	1944
22403	1917	0	3	1	0	1921
22404	1903	0	1	0	0	1904
22405	1894	0	3	0	0	1897
22406	1956	0	0	0	0	1956
22407	2	1	0	1948	0	1951
22408	1	0	1941	0	0	1942
22409	0	0	1943	0	0	1943
22410	1948	1	9	0	0	1958
22411	1955	0	9	0	0	1964
22412	0	1984	0	0	0	1984
22413	0	1953	0	1	0	1954
22414	1996	0	2	0	0	1998
22415	0	2	0	1998	0	2000
22416	0	0	0	2060	0	2060
22417	2068	0	2	1	0	2071
22418	1	2034	0	0	0	2035
22419	1992	0	8	0	0	2000
22420	0	0	1995	0	0	1995
22421	1953	0	3	0	0	1956
22422	0	1	0	1910	0	1911
22423	0	0	1894	0	0	1894
22424	0	1826	0	0	0	1826
22425	0	1	0	1822	0	1823
22426	0	0	1819	0	0	1819
22427	0	4	0	1822	0	1826
22428	1822	0	3	0	0	1825
22429	0	0	1805	0	0	1805
22430	1769	0	3	0	0	1772
22431	0	1716	0	0	0	1716
22432	0	2	0	1133	0	1135
22433	0	0	1144	1	0	1145
22434	0	1	0	1143	0	1144
22435	1	0	1135	0	0	1136
22436	0	1423	0	0	0	1423
22437	1933	1	3	1	0	1938
22438	1	4400	0	1	0	4402
22439	17	5	0	4387	0	4409
22440	1	3	0	4754	0	4758
22441	1	0	6132	2	0	6135
22442	7182	0	5	1	0	7188
22443	2	8376	0	0	0	8378
22444	2	8445	0	3	0	8450
22445	0	9192	0	1	0	9193
22446	0	4	0	10001	0	10005
22447	0	11860	0	0	0	11860
22448	0	2	1	11835	0	11838
22449	0	20263	0	1	0	20264
22450	10	86	2	20096	0	20194
22451	0	22281	0	13	0	22294
22452	22243	2	29	5	0	22279
22453	8	0	28345	0	0	28353
22454	28317	1	174	17	0	28509
22455	29470	2	76	4	0	29552
22456	29741	4	63	3	0	29811
22457	0	30463	0	16	0	30479
22458	31152	0	36	3	0	31191
22459	31456	14	88	3	0	31561
22460	31669	2	59	7	0	31737
22461	9	0	34875	7	0	34891
22462	4	78	2	35073	0	35157
22463	16	0	35472	9	0	35497
22464	6	165	3	35608	0	35782
22465	35931	3	46	8	0	35988
22466	2	36709	1	25	0	36737
22467	24	1	38327	2	0	38354
22468	5	116	4	41198	0	41323
22469	4	86	3	41218	0	41311
22470	17	2	41719	11	0	41749
22471	42048	2	96	14	0	42160
22472	42330	2	125	7	0	42464
22473	46323	8	99	3	0	46433
22474	7	134	1	46916	0	47058
22475	5	47656	0	17	0	47678
22476	3	48150	1	8	0	48162
22477	13	253	6	48154	0	48426
22478	15	253	7	48895	0	49170
22479	0	49212	0	22	0	49234
22480	49300	4	67	12	0	49383
22481	1	53245	0	15	0	53261
22482	18	296	9	52879	0	53202
22483	62	4	60036	16	0	60118
22484	19	103	5	60256	0	60383
22485	61803	3	79	22	0	61907
22486	8	3	62016	8	0	62035
22487	61964	10	139	30	0	62143
22488	63223	8	199	18	0	63448
22489	64720	11	147	9	0	64887
22490	64467	6	147	10	0	64630
22491	64256	108	230	12	0	64606
22492	16	1	64774	10	0	64801
22493	15	1	64958	25	0	64999
22494	64424	6	122	25	0	64577
22495	65046	2	107	16	0	65171
22496	12	150	4	65440	0	65606
22497	4	69157	0	29	0	69190
22498	16	125	2	69075	0	69218
22499	70342	6	66	8	0	70422
22500	16	177	11	70114	0	70318
22501	7	70358	1	16	0	70382
22502	70360	7	108	30	0	70505
22503	70434	6	99	11	0	70550
22504	71261	21	379	8	0	71669
22505	0	74737	0	21	0	74758
22506	5	220	3	74546	0	74774
22507	12	166	8	75022	0	75208
22508	1	75532	0	9	0	75542
22509	16	153	13	75619	0	75801
22510	75806	9	63	4	0	75882
22511	77102	3	116	13	0	77234
22512	0	78380	4	24	0	78408
22513	14	388	6	77804	0	78212
22514	20	174	12	78103	0	78309
22515	3	110	3	79200	0	79316
22516	78838	11	106	15	0	78970
22517	32	4	77491	20	0	77547
22518	76796	7	145	29	0	76977
22519	40	3	77229	9	0	77281
22520	21	306	2	77180	0	77509
22521	11	76283	3	35	0	76332
22522	13	74547	5	33	0	74598
22523	77738	8	145	21	0	77912
22524	78047	22	93	29	0	78191
22525	5	70566	2	25	0	70598
22526	8	70992	6	41	0	71047
22527	71354	5	95	15	0	71469
22528	73305	5	165	21	0	73496
22529	2	67909	0	22	0	67933
22530	67525	8	335	20	0	67888
22531	24	1	68999	9	0	69033
22532	71653	7	121	22	0	71803
22533	72497	14	135	5	0	72651
22534	11	225	6	71984	0	72226
22535	3	71518	1	14	0	71536
22536	7	173	5	71050	0	71235
22537	74320	6	113	2	0	74441
22538	14	218	4	75858	0	76094
22539	19	189	4	75467	0	75679
22540	31	0	77392	8	0	77431
22541	27	219	7	78862	0	79115
22542	10	123	1	79552	0	79686
22543	78241	5	131	14	0	78391
22544	21	2	76177	4	0	76204
22545	76159	9	151	9	0	76328
22546	4	214	6	76611	0	76835
22547	4	167	4	76358	0	76533
22548	14	218	10	86698	0	86940
22549	6	83190	4	22	0	83222
22550	0	82106	1	23	0	82130
22551	5	142	4	82577	0	82728
22552	82858	10	62	9	0	82939
22553	84508	3	100	26	0	84637
22554	7	114	0	86568	0	86689
22555	92665	15	76	14	0	92770
22556	9	276	6	104116	0	104407
22557	11	84	0	100894	0	100989
22558	102969	6	159	19	0	103153
22559	5	96831	2	75	0	96913
22560	96709	18	249	24	0	97000
22561	95759	26	210	18	0	96013
22562	95995	26	163	19	0	96203
22563	1	98642	0	27	0	98670
22564	12	273	5	98295	0	98585
22565	12	188	3	97625	0	97828
22566	53	0	97941	15	0	98009
22567	29	528	14	98922	0	99493
22568	49	2	97852	44	0	97947
22569	5	99099	11	108	0	99223
22570	7	99372	2	42	0	99423
22571	9	98679	0	35	0	98723
22572	13	214	13	97877	0	98117
22573	5	278	13	97923	0	98219
22574	19	158	17	99847	0	100041
22575	18	158	16	98911	0	99103
22576	44	1	99317	18	0	99380
22577	3286	2	97180	22	0	100490
22578	13	216	24	100442	0	100695
22579	42	1	100060	22	0	100125
22580	98787	37	179	41	0	99044
22581	96057	18	218	14	0	96307
22582	18	0	99658	7	0	99683
22583	6	244	52	102100	0	102402
22584	5	200	5	102377	0	102587
22585	5	233	8	102565	0	102811
22586	10	64	7	103157	0	103238
22587	31	82	1	102187	0	102301
22588	100719	8	75	12	0	100814
22589	100510	8	123	26	0	100667
22590	0	100374	3	37	0	100414
22591	108	5	99122	10	0	99245
22592	22	99702	5	48	0	99777
22593	15	111682	6	65	0	111768
22594	112599	7	106	26	0	112738
22595	16	112063	1	36	0	112116
22596	5	111218	2	42	0	111267
22597	111712	13	102	20	0	111847
22598	67	0	113399	10	0	113476
22599	118505	11	158	21	0	118695
22600	12	126	8	119158	0	119304
22601	20	276	6	119168	0	119470
22602	13	228	9	116727	0	116977
22603	70	6	116043	36	0	116155
22604	11	115150	5	78	0	115244
22605	114942	20	257	12	0	115231
22606	26	332	9	114883	0	115250
22607	8	107553	9	34	0	107604
22608	19	233	21	107865	0	108138
22609	33	0	113693	4	0	113730
22610	27	377	22	113369	0	113795
22611	56	229	13	113652	0	113950
22612	18	160	7	113745	0	113930
22613	111568	6	112	12	0	111698
22614	20	184	23	110491	0	110718
22615	244	2	111676	7	0	111929
22616	10	110082	3	49	0	110144
22617	12	198	13	107803	0	108026
22618	30	252	15	106084	0	106381
22619	70	1	105688	15	0	105774
22620	63	10	106680	26	0	106779
22621	107911	8	273	22	0	108214
22622	107438	11	236	23	0	107708
22623	12	99484	0	40	0	99536
22624	97747	8	120	17	0	97892
22625	41	4	98415	6	0	98466
22626	38	3	100734	15	0	100790
22627	97874	7	2177	40	0	100098
22628	99819	7	208	19	0	100053
22629	27	1	98726	11	0	98765
22630	98443	5	192	26	0	98666
22631	20	1	95237	22	0	95280
22632	90762	7	249	19	0	91037
22633	92616	14	170	13	0	92813
22634	23	173	11	90445	0	90652
22635	2	91285	1	48	0	91336
22636	91002	13	127	14	0	91156
22637	119	5	90310	3	0	90437
22638	20	89483	1	41	0	89545
22639	89062	5	172	19	0	89258
22640	92788	10	142	29	0	92969
22641	4	92717	2	156	0	92879
22642	26	267	10	91975	0	92278
22643	31	0	93969	2	0	94002
22644	18	200	10	93192	0	93420
22645	49	3	93732	2	0	93786
22646	22	207	4	95723	0	95956
22647	16	351	18	93367	0	93752
22648	69	1	94217	19	0	94306
22649	11	93755	1	35	0	93802
22650	14	202	9	95461	0	95686
22651	59	0	98487	8	0	98554
22652	98719	9	156	24	0	98908
22653	9	594	14	98880	0	99497
22654	5	131	3	99565	0	99704
22655	103116	37	78	13	0	103244
22656	14	169	4	103178	0	103365
22657	17	477	10	101401	0	101905
22658	8	99296	3	26	0	99333
22659	23	259	23	97321	0	97626
22660	37	3	111688	17	0	111745
22661	20	349	9	112189	0	112567
22662	22	112155	7	47	0	112231
22663	12	115373	5	56	0	115446
22664	24	294	6	115983	0	116307
22665	126234	10	156	22	0	126422
22666	23	135	6	128069	0	128233
22667	128386	6	123	20	0	128535
22668	11	153	2	127634	0	127800
22669	115329	9	107	11	0	115456
22670	115752	16	146	18	0	115932
22671	13	490	7	118477	0	118987
22672	27	186	11	114803	0	115027
22673	11	113342	3	40	0	113396
22674	13	107836	1	88	0	107938
22675	123	16	108019	14	0	108172
22676	32	112825	2	134	0	112993
22677	113376	5	173	34	0	113588
22678	30	275	20	114250	0	114575
22679	2	113583	0	26	0	113611
22680	114439	15	128	10	0	114592
22681	21	245	14	115627	0	115907
22682	7	240	3	115389	0	115639
22683	10	232	7	114910	0	115159
22684	18	186	8	113561	0	113773
22685	12	108327	0	57	0	108396
22686	4	108890	0	29	0	108923
22687	109088	17	275	27	0	109407
22688	1	112697	1	24	0	112723
22689	11	462	9	110993	0	111475
22690	17	89	8	114827	0	114941
22691	6	183	12	113369	0	113570
22692	11	59	7	114313	0	114390
22693	113891	12	71	22	0	113996
22694	113159	18	247	65	0	113489
22695	17	2	120078	8	0	120105
22696	23	323	24	118188	0	118558
22697	36	0	129918	11	0	129965
22698	16	472	16	131564	0	132068
22699	181	444	10	130561	0	131196
22700	131624	9	133	24	0	131790
22701	46	258	12	130411	0	130727
22702	64	1	130221	14	0	130300
22703	67	3	131932	44	0	132046
22704	125697	21	294	74	0	126086
22705	47	2	127929	9	0	127987
22706	29	206	7	123067	0	123309
22707	47	3	127572	11	0	127633
22708	51	559	8	127998	0	128616
22709	11	127293	0	36	0	127340
22710	51	387	8	125939	0	126385
22711	16	128050	5	46	0	128117
22712	18	129346	7	72	0	129443
22713	13	391	6	129656	0	130066
22714	130228	4	106	27	0	130365
22715	8	129427	5	24	0	129464
22716	12	169	6	125655	0	125842
22717	128387	4	461	14	0	128866
22718	127516	15	206	19	0	127756
22719	128306	14	159	15	0	128494
22720	16	111	4	128897	0	129028
22721	6	53	2	127777	0	127838
22722	127802	3	92	18	0	127915
22723	127305	14	140	26	0	127485
22724	126273	10	213	12	0	126508
22725	19	277	10	126623	0	126929
22726	494	1	125660	11	0	126166
22727	127172	2	325	37	0	127536
22728	21	289	7	127709	0	128026
22729	7	123936	1	37	0	123981
22730	49	364	20	122560	0	122993
22731	7	131016	1	22	0	131046
22732	24	3239	19	127971	0	131253
22733	74	5	135264	13	0	135356
22734	8	122068	2	69	0	122147
22735	31	637	34	121077	0	121779
22736	17	359	9	126753	0	127138
22737	12	187	2	128318	0	128519
22738	141072	15	153	20	0	141260
22739	8	130288	2	43	0	130341
22740	16	173	10	127395	0	127594
22741	126886	9	117	13	0	127025
22742	125345	17	211	19	0	125592
22743	11	246	6	135607	0	135870
22744	84	2	137391	14	0	137491
22745	34	694	6	137233	0	137967
22746	3	137627	4	38	0	137672
22747	32	211	11	134069	0	134323
22748	137566	9	172	11	0	137758
22749	24	277	7	138418	0	138726
22750	74	3	138423	15	0	138515
22751	5	138264	5	138	0	138412
22752	132503	18	236	37	0	132794
22753	36	2	134526	15	0	134579
22754	141428	3	193	29	0	141653
22755	10	316	6	142161	0	142493
22756	15	324	11	141016	0	141366
22757	9	143747	2	32	0	143790
22758	144810	14	163	10	0	144997
22759	8	200	37	148342	0	148587
22760	21	348	15	148411	0	148795
22761	21	376	10	148807	0	149214
22762	511	2	149155	13	0	149681
22763	19	157	13	152087	0	152276
22764	153428	10	177	14	0	153629
22765	153776	15	287	23	0	154101
22766	10	179	10	151199	0	151398
22767	4	100	3	152005	0	152112
22768	151222	5	133	21	0	151381
22769	31	4	152099	10	0	152144
22770	149939	6	310	34	0	150289
22771	57	2	146723	5	0	146787
22772	44	1	148932	19	0	148996
22773	18	229	10	134033	0	134290
22774	89	3	134766	11	0	134869
22775	135670	9	166	37	0	135882
22776	25	221	10	135652	0	135908
22777	43	7	135718	10	0	135778
22778	141130	5	295	36	0	141466
22779	140242	16	348	38	0	140644
22780	65	3	140730	10	0	140808
22781	52	346	6	139391	0	139795
22782	9	134972	3	40	0	135024
22783	134369	17	226	29	0	134641
22784	72	3	134794	8	0	134877
22785	134492	7	248	94	0	134841
22786	9	134454	1	52	0	134516
22787	135473	9	306	19	0	135807
22788	133193	5	281	17	0	133496
22789	142453	9	221	36	0	142719
22790	34	213	8	143441	0	143696
22791	13	143805	0	47	0	143865
22792	144	4	143364	13	0	143525
22793	18	140684	2	72	0	140776
22794	57	376	15	139018	0	139466
22795	42	140431	1	50	0	140524
22796	24	140201	3	67	0	140295
22797	139630	10	210	40	0	139890
22798	61	3	139591	14	0	139669
22799	103	2	140259	37	0	140401
22800	281	5	140452	35	0	140773
22801	17	138286	6	171	0	138480
22802	134519	9	223	9	0	134760
22803	135441	5	160	68	0	135674
22804	135372	47	341	30	0	135790
22805	12	132604	4	35	0	132655
22806	27	585	23	131618	0	132253
22807	82	4	131479	6	0	131571
22808	50	2	131774	15	0	131841
22809	127826	7	257	35	0	128125
22810	127653	12	182	21	0	127868
22811	126793	10	501	24	0	127328
22812	32	1	122919	4	0	122956
22813	121951	7	219	18	0	122195
22814	18	288	11	110245	0	110562
22815	17	174	19	108818	0	109028
22816	73	2	109382	7	0	109464
22817	18	98011	3	49	0	98081
22818	10	224	7	97499	0	97740
22819	31	1	101511	7	0	101550
22820	107120	6	110	18	0	107254
22821	16	65	17	106748	0	106846
22822	4	59	5	106559	0	106627
22823	106531	6	69	12	0	106618
22824	12	54	3	104944	0	105013
22825	104115	6	64	10	0	104195
22826	107915	4	91	13	0	108023
22827	17	93	3	108533	0	108646
22828	7	47	2	101110	0	101166
22829	100955	6	64	4	0	101029
22830	5	37	8	100158	0	100208
22831	101146	4	70	4	0	101224
22832	101412	12	126	28	0	101578
22833	99555	9	90	10	0	99664
22834	16	142	6	98840	0	99004
22835	10	85	5	97688	0	97788
22836	98886	0	85	13	0	98984
22837	26	98293	4	34	0	98357
22838	4	97101	3	29	0	97137
22839	95199	9	132	30	0	95370
22840	47	0	91276	3	0	91326
22841	100615	8	170	18	0	100811
22842	11	184	10	101675	0	101880
22843	22	0	101406	5	0	101433
22844	108733	7	315	13	0	109068
22845	20	206	5	112748	0	112979
22846	18	132	7	112533	0	112690
22847	24	182	6	117315	0	117527
22848	3	53	2	116564	0	116622
22849	116330	3	88	14	0	116435
22850	9	115094	0	60	0	115163
22851	112988	11	261	21	0	113281
22852	56	2	113861	30	0	113949
22853	43	6	116866	26	0	116941
22854	22	116743	2	43	0	116810
22855	38	273	6	116269	0	116586
22856	50	0	125146	12	0	125208
22857	15	126041	4	100	0	126160
22858	58	1	126988	4	0	127051
22859	20	308	9	129787	0	130124
22860	20	161	10	130805	0	130996
22861	129934	3	156	19	0	130112
22862	19	188	6	129991	0	130204
22863	127407	8	302	16	0	127733
22864	76	1	127980	6	0	128063
22865	8	118159	2	55	0	118224
22866	17	214	14	116180	0	116425
22867	17	176	12	117138	0	117343
22868	71	1	116478	14	0	116564
22869	45	1	117524	29	0	117599
22870	117666	4	169	23	0	117862
22871	118013	6	243	12	0	118274
22872	10	285	15	117716	0	118026
22873	26	248	8	117684	0	117966
22874	3	119065	0	31	0	119099
22875	41	190	16	119652	0	119899
22876	119388	8	132	5	0	119533
22877	119551	5	209	36	0	119801
22878	10	118841	0	41	0	118892
22879	116055	16	432	13	0	116516
22880	117331	23	166	13	0	117533
22881	23	348	15	117985	0	118371
22882	7	118757	3	29	0	118796
22883	20	314	12	118797	0	119143
22884	19	208	9	118859	0	119095
22885	35	1	119200	21	0	119257
22886	124404	7	258	24	0	124693
22887	9	343	9	126292	0	126653
22888	28	429	8	125125	0	125590
22889	7	124501	3	29	0	124540
22890	13	133	5	123641	0	123792
22891	125098	8	77	0	0	125183
22892	123782	18	239	35	0	124074
22893	28	1	125805	4	0	125838
22894	38	0	126971	20	0	127029
22895	20	469	8	118466	0	118963
22896	23	152	7	117487	0	117669
22897	61	2	116547	8	0	116618
22898	78	1	118264	30	0	118373
22899	38	132	10	118814	0	118994
22900	43	2	117349	10	0	117404
22901	52	1	117681	24	0	117758
22902	17	92	8	116245	0	116362
22903	115854	6	136	10	0	116006
22904	116111	7	112	7	0	116237
22905	27	109	5	118723	0	118864
22906	7	87	5	119169	0	119268
22907	126552	5	62	13	0	126632
22908	20	71	12	126439	0	126542
22909	125978	4	73	1	0	126056
22910	126545	5	391	25	0	126966
22911	13	108	7	124977	0	125105
22912	7	193	4	128503	0	128707
22913	127737	4	142	19	0	127902
22914	24	129687	5	35	0	129751
22915	10	127927	2	40	0	127979
22916	28	278	14	122369	0	122689
22917	57	3	134933	12	0	135005
22918	15	111	11	135074	0	135211
22919	136137	3	120	20	0	136280
22920	14	124	5	128165	0	128308
22921	123507	10	157	28	0	123702
22922	35	5	123150	17	0	123207
22923	122694	7	215	18	0	122934
22924	21	175	6	123942	0	124144
22925	13	107	18	121090	0	121228
22926	36	1	123105	5	0	123147
22927	20	199	90	121623	0	121932
22928	30	194	10	121130	0	121364
22929	8	302	2	132391	0	132703
22930	130568	8	167	18	0	130761
22931	59	3	130417	14	0	130493
22932	3314	2	123475	36	0	126827
22933	126079	7	250	39	0	126375
22934	124780	15	467	23	0	125285
22935	25	0	128744	4	0	128773
22936	20	240	7	127588	0	127855
22937	8	127161	0	40	0	127209
22938	27	171	13	127579	0	127790
22939	129980	7	123	16	0	130126
22940	130236	13	335	13	0	130597
22941	22	321	13	132604	0	132960
22942	3	133555	4	182	0	133744
22943	33	319	14	131723	0	132089
22944	16	128920	5	55	0	128996
22945	129043	22	252	15	0	129332
22946	129295	11	260	18	0	129584
22947	130434	55	312	9	0	130810
22948	10	133995	1	60	0	134066
22949	5	132857	3	24	0	132889
22950	20	343	11	131908	0	132282
22951	10	241	6	131995	0	132252
22952	18	198	9	132394	0	132619
22953	16	172	5	133571	0	133764
22954	34	2	133828	13	0	133877
22955	132569	14	415	43	0	133041
22956	29	0	131682	6	0	131717
22957	126344	11	374	40	0	126769
22958	32	0	128621	11	0	128664
22959	128335	4	415	35	0	128789
22960	43	4	129583	26	0	129656
22961	130016	22	287	32	0	130357
22962	13	100	0	125921	0	126034
22963	125819	3	163	11	0	125996
22964	16	252	6	126035	0	126309
22965	16	184	3	129572	0	129775
22966	33	337	17	130952	0	131339
22967	14	129986	6	28	0	130034
22968	129414	6	301	19	0	129740
22969	129385	7	312	10	0	129714
22970	8	128672	2	51	0	128733
22971	12	150	13	128946	0	129121
22972	27	5	129818	7	0	129857
22973	136157	9	374	15	0	136555
22974	135195	5	165	10	0	135375
22975	136089	15	311	14	0	136429
22976	16	562	8	135305	0	135891
22977	10	135977	2	33	0	136022
22978	12	189	6	135579	0	135786
22979	135652	4	151	19	0	135826
22980	30	151	5	134346	0	134532
22981	8	131152	1	68	0	131229
22982	129502	21	303	50	0	129876
22983	34	2	123232	12	0	123280
22984	53	7	126726	41	0	126827
22985	34	126576	2	61	0	126673
22986	26	125121	53	86	0	125286
22987	99	10	125767	16	0	125892
22988	59	3	124739	26	0	124827
22989	19	259	5	126404	0	126687
22990	121656	4	221	10	0	121891
22991	60	6	121372	15	0	121453
22992	18	113328	5	112	0	113463
22993	115712	4	203	24	0	115943
22994	9	115529	0	57	0	115595
22995	115151	10	209	21	0	115391
22996	26	122261	0	121	0	122408
22997	5	117712	0	48	0	117765
22998	18	188	9	121622	0	121837
22999	9	197	6	123666	0	123878
23000	38	1	124407	1	0	124447
23001	17	149	12	124857	0	125035
23002	118542	4	325	4	0	118875
23003	118258	8	279	22	0	118567
23004	18	177	9	117982	0	118186
23005	43	1	106612	12	0	106668
23006	31	0	113263	13	0	113307
23007	22	240	7	108246	0	108515
23008	42	4	108848	9	0	108903
23009	21	287	10	107979	0	108297
23010	10	139	6	113027	0	113182
23011	63	3	107988	14	0	108068
23012	113354	5	235	32	0	113626
23013	113273	33	271	18	0	113595
23014	31	2	114562	3	0	114598
23015	38	0	115279	13	0	115330
23016	34	343	24	117636	0	118037
23017	3	215	7	116232	0	116457
23018	8	169	10	116251	0	116438
23019	16	45	4	116955	0	117020
23020	123455	9	49	19	0	123532
23021	123512	9	131	11	0	123663
23022	10	145	7	124248	0	124410
23023	19	238	11	127958	0	128226
23024	43	0	126208	7	0	126258
23025	32	212	13	126733	0	126990
23026	8	166	2	125882	0	126058
23027	125926	8	186	26	0	126146
23028	4	126907	4	18	0	126933
23029	44	443	13	124964	0	125464
23030	12	298	17	126731	0	127058
23031	43	202	12	126458	0	126715
23032	24	131563	4	46	0	131637
23033	10	130299	1	53	0	130363
23034	28	385	7	128803	0	129223
23035	39	190	14	132202	0	132445
23036	2	146	5	132676	0	132829
23037	132114	8	172	15	0	132309
23038	2	132180	3	52	0	132237
23039	130226	16	325	14	0	130581
23040	138322	18	406	22	0	138768
23041	24	213	11	134720	0	134968
23042	15	134757	3	76	0	134851
23043	139658	16	242	24	0	139940
23044	22	133	5	140237	0	140397
23045	140107	6	184	19	0	140316
23046	39	177	6	140427	0	140649
23047	45	4	138665	16	0	138730
23048	57	2	142517	38	0	142614
23049	21	478	75	135521	0	136095
23050	17	345	8	135928	0	136298
23051	17	225	11	135326	0	135579
23052	24	133018	5	89	0	133136
23053	7	133650	3	82	0	133742
23054	135838	9	258	19	0	136124
23055	136278	6	425	40	0	136749
23056	27	139405	4	43	0	139479
23057	36	136019	2	94	0	136151
23058	25	138255	3	59	0	138342
23059	139319	25	194	40	0	139578
23060	9	141014	4	34	0	141061
23061	11	117	5	141136	0	141269
23062	141964	4	215	12	0	142195
23063	142277	9	260	20	0	142566
23064	20	118	13	139899	0	140050
23065	81	0	138630	12	0	138723
23066	55	3	141179	43	0	141280
23067	19	177	17	135641	0	135854
23068	49	4	135500	25	0	135578
23069	70	217	11	134399	0	134697
23070	29	304	9	133907	0	134249
23071	46	2	134628	21	0	134697
23072	29	2	130142	43	0	130216
23073	27	157	14	133305	0	133503
23074	23	116	5	129739	0	129883
23075	127640	16	238	17	0	127911
23076	31	126497	5	64	0	126597
23077	19	127138	2	177	0	127336
23078	127997	13	241	45	0	128296
23079	131971	8	1620	12	0	133611
23080	30	134173	1	79	0	134283
23081	12	130498	0	45	0	130555
23082	135227	22	240	30	0	135519
23083	9	123	6	137810	0	137948
23084	137679	7	135	25	0	137846
23085	11	137586	4	77	0	137678
23086	131213	16	373	25	0	131627
23087	44	1	137969	16	0	138030
23088	131172	13	392	29	0	131606
23089	30	1	136620	10	0	136661
23090	23	93	18	137229	0	137363
23091	129437	14	179	19	0	129649
23092	26	1	130782	5	0	130814
23093	19	129	9	130397	0	130554
23094	129849	15	196	26	0	130086
23095	29	3	130650	10	0	130692
23096	18	142	6	125234	0	125400
23097	125414	5	160	18	0	125597
23098	10	123231	2	20	0	123263
23099	21	343	12	119906	0	120282
23100	9	269	4	119751	0	120033
23101	23	185	9	117604	0	117821
23102	2	119887	2	33	0	119924
23103	21	271	6	119599	0	119897
23104	11	153	6	118773	0	118943
23105	12	223	8	118644	0	118887
23106	8	183	13	116975	0	117179
23107	47	2	116741	23	0	116813
23108	112416	8	455	29	0	112908
23109	113129	7	468	13	0	113617
23110	3	116366	1	41	0	116411
23111	12	206	8	112788	0	113014
23112	34	197	5	114347	0	114583
23113	16	115044	2	56	0	115118
23114	21	186	6	115747	0	115960
23115	116224	8	243	25	0	116500
23116	10	108095	2	79	0	108186
23117	107944	9	253	15	0	108221
23118	19	133	6	107227	0	107385
23119	326	7	101091	23	0	101447
23120	30	103802	2	229	0	104063
23121	104211	16	330	16	0	104573
23122	36	104807	6	60	0	104909
23123	7	100963	3	74	0	101047
23124	100613	4	305	54	0	100976
23125	249	3	100817	17	0	101086
23126	40	101897	4	133	0	102074
23127	103973	3	594	26	0	104596
23128	107282	8	149	13	0	107452
23129	9	105611	0	40	0	105660
23130	27	174	7	103604	0	103812
23131	36	1	105251	2	0	105290
23132	8	216	30	104171	0	104425
23133	8	165	5	104284	0	104462
23134	12	181	7	100120	0	100320
23135	39	1	99307	8	0	99355
23136	18	215	5	99953	0	100191
23137	55	5	99030	11	0	99101
23138	53	4	100796	47	0	100900
23139	99406	13	458	26	0	99903
23140	39	103730	5	65	0	103839
23141	8	100773	0	44	0	100825
23142	21	124	10	103669	0	103824
23143	103621	5	118	6	0	103750
23144	110221	13	113	12	0	110359
23145	110857	9	131	5	0	111002
23146	117784	4	299	12	0	118099
23147	114739	11	369	10	0	115129
23148	51	3	115532	8	0	115594
23149	26	384	3	112455	0	112868
23150	13	114069	5	46	0	114133
23151	18	183	4	114262	0	114467
23152	114510	9	348	23	0	114890
23153	10	107560	1	29	0	107600
23154	13	123	9	108325	0	108470
23155	109069	4	74	9	0	109156
23156	111980	2	81	8	0	112071
23157	16	133	7	108227	0	108383
23158	23	172	10	103158	0	103363
23159	22	95	7	101209	0	101333
23160	52	2	100857	16	0	100927
23161	34	1	103622	12	0	103669
23162	14	170	4	104033	0	104221
23163	23	70	5	97838	0	97936
23164	96992	2	71	12	0	97077
23165	91784	3	121	12	0	91920
23166	92342	7	183	4	0	92536
23167	92245	12	265	17	0	92539
23168	92778	56	239	10	0	93083
23169	1	93247	0	61	0	93309
23170	90905	10	206	13	0	91134
23171	89920	5	436	9	0	90370
23172	90156	14	216	14	0	90400
23173	12	93	11	89635	0	89751
23174	36	0	90138	4	0	90178
23175	34	448	5	86654	0	87141
23176	33	0	87213	6	0	87252
23177	36	175	8	87939	0	88158
23178	14	86293	0	40	0	86347
23179	86983	13	235	7	0	87238
23180	87895	8	80	8	0	87991
23181	9	202	4	88004	0	88219
23182	12	234	5	87769	0	88020
23183	39	190	6	87429	0	87664
23184	9	88972	3	50	0	89034
23185	88473	13	169	8	0	88663
23186	86946	4	196	12	0	87158
23187	3	86382	0	71	0	86456
23188	17	147	3	85258	0	85425
23189	16	127	5	84608	0	84756
23190	43	86196	1	27	0	86267
23191	87200	11	182	53	0	87446
23192	87538	11	160	8	0	87717
23193	8	73	5	87406	0	87492
23194	56	2	88640	5	0	88703
23195	20	1	90727	13	0	90761
23196	11	216	16	89393	0	89636
23197	28	147	6	89845	0	90026
23198	9	100	4	88813	0	88926
23199	89840	5	139	11	0	89995
23200	89652	11	213	8	0	89884
23201	8	89269	2	49	0	89328
23202	87277	16	575	48	0	87916
23203	31	5	86317	8	0	86361
23204	42	6	87384	11	0	87443
23205	34	87606	3	65	0	87708
23206	88543	10	204	24	0	88781
23207	5	87815	1	51	0	87872
23208	86479	16	198	40	0	86733
23209	35	1	87348	10	0	87394
23210	25	5	100299	11	0	100340
23211	21	137	5	103091	0	103254
23212	51	0	103251	1	0	103303
23213	14	196	8	105043	0	105261
23214	41	295	9	104274	0	104619
23215	6	102555	5	26	0	102592
23216	25	302	6	100070	0	100403
23217	12	120	8	101393	0	101533
23218	99175	7	80	14	0	99276
23219	1	98538	6	101	0	98646
23220	24	160	5	92489	0	92678
23221	27	1	92011	16	0	92055
23222	85354	19	221	35	0	85629
23223	17	2	88032	4	0	88055
23224	18	758	5	85583	0	86364
23225	8	84135	1	25	0	84169
23226	23	83	9	83670	0	83785
23227	86289	3	95	3	0	86390
23228	87534	16	236	18	0	87804
23229	6	88754	3	50	0	88813
23230	88670	9	237	25	0	88941
23231	88495	7	95	12	0	88609
23232	83036	11	326	16	0	83389
23233	83696	6	275	13	0	83990
23234	83879	10	370	5	0	84264
23235	14	2	84993	4	0	85013
23236	4	131	11	87964	0	88110
23237	7	231	10	86716	0	86964
23238	21	1843	3	87501	0	89368
23239	7	88565	3	25	0	88600
23240	60	122	9	88452	0	88643
23241	35	1	88534	7	0	88577
23242	38	88890	2	65	0	88995
23243	4	88649	5	30	0	88688
23244	25	292	5	91017	0	91339
23245	16	241	9	91404	0	91670
23246	33	360	3	91988	0	92384
23247	12	93305	0	25	0	93342
23248	13	92946	1	40	0	93000
23249	93442	12	202	16	0	93672
23250	93325	9	222	14	0	93570
23251	8	104677	1	121	0	104807
23252	104152	20	231	8	0	104411
23253	104692	8	157	9	0	104866
23254	11	234	13	104026	0	104284
23255	19	1865	22	102047	0	103953
23256	45	137	13	105621	0	105816
23257	61	0	105510	13	0	105584
23258	37	11	105964	29	0	106041
23259	4	108986	3	72	0	109065
23260	106903	13	334	31	0	107281
23261	40	1	107107	11	0	107159
23262	111909	14	263	39	0	112225
23263	32	4	112511	2	0	112549
23264	118111	20	259	28	0	118418
23265	8	119034	3	57	0	119102
23266	120404	5	197	17	0	120623
23267	10	277	6	122416	0	122709
23268	14	124	7	122632	0	122777
23269	52	3	122412	12	0	122479
23270	11	118877	11	88	0	118987
23271	33	507	25	118571	0	119136
23272	38	3	118826	11	0	118878
23273	118622	15	278	67	0	118982
23274	22	117732	2	60	0	117816
23275	125409	19	398	35	0	125861
23276	12	123368	2	4112	0	127494
23277	17	167	9	126539	0	126732
23278	126224	2	162	21	0	126409
23279	7	126043	0	46	0	126096
23280	64	206	17	123712	0	123999
23281	63	1	123691	9	0	123764
23282	140130	16	319	46	0	140511
23283	20	168	9	137017	0	137214
23284	71	1	137032	5	0	137109
23285	16	123658	4	74	0	123752
23286	19	178	12	119177	0	119386
23287	53	0	119305	7	0	119365
23288	39	196	15	117689	0	117939
23289	36	117795	5	48	0	117884
23290	14	117077	1	102	0	117194
23291	60	0	116978	4	0	117042
23292	25	166	10	116206	0	116407
23293	75	2	115337	7	0	115421
23294	113039	9	299	69	0	113416
23295	21	231	13	114755	0	115020
23296	53	112452	4	176	0	112685
23297	19	111595	2	84	0	111700
23298	111350	13	324	38	0	111725
23299	6	110046	0	53	0	110105
23300	108333	10	299	41	0	108683
23301	34	3	109032	4	0	109073
23302	108526	25	319	35	0	108905
23303	8	105910	1	65	0	105984
23304	104397	23	282	22	0	104724
23305	14	102998	6	75	0	103093
23306	27	3531	17	98030	0	101605
23307	23	138	13	101172	0	101346
23308	42	2	101414	8	0	101466
23309	98481	22	548	28	0	99079
23310	26	2	101049	0	0	101077
23311	99608	13	362	24	0	100007
23312	9	189	8	94280	0	94486
23313	14	167	4	93821	0	94006
23314	19	91358	4	34	0	91415
23315	26	152	32	90425	0	90635
23316	8	162	6	89890	0	90066
23317	64	1	90067	4	0	90136
23318	89488	5	344	11	0	89848
23319	11	89495	2	50	0	89558
23320	84797	9	280	9	0	85095
23321	9	95	13	84137	0	84254
23322	6	89	6	83688	0	83789
23323	83176	4	109	5	0	83294
23324	9	82844	3	97	0	82953
23325	81824	12	262	29	0	82127
23326	20	82289	1	47	0	82357
23327	11	70036	1	53	0	70101
23328	68846	9	185	13	0	69053
23329	13	85	4	68441	0	68543
23330	24	0	67896	3	0	67923
23331	11	165	2	67579	0	67757
23332	13	124	2	65305	0	65444
23333	3	65142	4	11	0	65160
23334	5	185	12	62309	0	62511
23335	9	341	8	61505	0	61863
23336	13	94	4	61587	0	61698
23337	18	64	8	54614	0	54704
23338	28	2	54204	12	0	54246
23339	37	8	52290	2	0	52337
23340	23	106	4	48553	0	48686
23341	23	1	46959	8	0	46991
23342	21	1	43343	1	0	43366
23343	5	41	19	40342	0	40407
23344	4	0	40256	2	0	40262
23345	6	1	2	39978	0	39987
23346	12	39649	0	9	0	39670
23347	37800	0	9	1	0	37810
23348	4	0	37458	0	0	37462
23349	7	9	3	36934	0	36953
23350	7	1	36237	1	0	36246
23351	1	1	2	28111	0	28115
23352	2	3	0	24212	0	24217
23353	23711	2	3	1	0	23717
23354	1	1	0	23409	0	23411
23355	21403	2	2	1	0	21408
23356	21173	38	6	2	0	21219
23357	5	15037	0	5	0	15047
23358	891	3	0	0	0	894
23359	0	806	0	0	0	806
23360	0	574	0	0	0	574
23361	566	0	1	0	0	567
23362	0	0	555	0	0	555
23363	1	0	567	0	0	568
23364	571	0	0	0	0	571
23365	577	0	0	0	0	577
23366	0	576	0	0	0	576
23367	578	0	0	0	0	578
23368	537	0	1	1	0	539
23369	530	0	1	0	0	531
23370	0	2	0	526	0	528
23371	511	0	0	0	0	511
23372	0	540	0	0	0	540
23373	0	3	0	537	0	540
23374	1	1	0	538	0	540
23375	0	541	0	0	0	541
23376	0	0	0	541	0	541
23377	543	0	1	0	0	544
23378	553	0	0	0	0	553
23379	0	536	0	0	0	536
23380	0	518	0	0	0	518
23381	495	0	2	0	0	497
23382	0	0	496	0	0	496
23383	0	0	509	0	0	509
23384	0	1	0	537	0	538
23385	0	3	0	534	0	537
23386	0	0	537	0	0	537
23387	0	522	0	1	0	523
23388	0	1	0	520	0	521
23389	0	0	558	0	0	558
23390	0	0	0	552	0	552
23391	0	0	0	562	0	562
23392	0	534	0	0	0	534
23393	0	1	0	533	0	534
23394	0	0	0	547	0	547
23395	0	0	0	546	0	546
23396	550	0	0	0	0	550
23397	0	0	0	547	0	547
23398	0	540	0	0	0	540
23399	530	0	0	0	0	530
23400	0	0	557	0	0	557
23401	0	0	565	0	0	565
23402	561	0	1	0	0	562
23403	0	4	0	565	0	569
23404	0	0	559	0	0	559
23405	0	3	0	564	0	567
23406	0	0	0	570	0	570
23407	568	0	0	0	0	568
23408	564	0	1	0	0	565
23409	0	565	0	0	0	565
23410	0	1	0	563	0	564
23411	2	0	583	0	0	585
23412	0	586	0	0	0	586
23413	578	0	1	0	0	579
23414	0	586	0	0	0	586
23415	582	0	0	0	0	582
23416	2	0	584	0	0	586
23417	585	0	0	1	0	586
23418	567	0	1	0	0	568
23419	0	0	571	0	0	571
23420	1	0	0	572	0	573
23421	0	581	0	0	0	581
23422	0	573	0	0	0	573
23423	0	502	0	0	0	502
23424	0	0	0	502	0	502
23425	0	0	517	0	0	517
23426	0	0	0	523	0	523
23427	0	1	0	518	0	519
23428	1	0	514	0	0	515
23429	0	522	0	0	0	522
23430	0	0	0	536	0	536
23431	550	0	1	0	0	551
23432	1	4	0	546	0	551
23433	0	2	0	531	0	533
23434	0	523	0	1	0	524
23435	523	0	0	0	0	523
23436	0	2	0	522	0	524
23437	0	0	516	0	0	516
23438	0	500	0	0	0	500
23439	492	0	0	0	0	492
23440	0	0	502	0	0	502
23441	575	0	0	0	0	575
23442	0	0	0	571	0	571
23443	0	570	0	0	0	570
23444	568	0	0	0	0	568
23445	600	0	1	0	0	601
23446	0	561	0	0	0	561
23447	0	0	0	559	0	559
23448	0	0	0	565	0	565
23449	592	0	0	0	0	592
23450	0	616	0	0	0	616
23451	0	2	0	612	0	614
23452	0	611	0	0	0	611
23453	0	609	0	0	0	609
23454	0	1	0	617	0	618
23455	618	0	1	1	0	620
23456	0	611	0	0	0	611
23457	0	3	0	613	0	616
23458	0	1	0	619	0	620
23459	0	0	588	1	0	589
23460	1	0	585	0	0	586
23461	0	583	0	0	0	583
23462	0	0	585	0	0	585
23463	0	3	0	580	0	583
23464	0	0	593	0	0	593
23465	0	0	0	563	0	563
23466	0	1	0	572	0	573
23467	0	1	0	602	0	603
23468	616	0	1	0	0	617
23469	0	0	0	644	0	644
23470	0	0	0	636	0	636
23471	0	640	0	0	0	640
23472	0	1	1	630	0	632
23473	625	0	0	0	0	625
23474	0	626	0	0	0	626
23475	610	0	0	1	0	611
23476	0	0	604	0	0	604
23477	3	0	635	0	0	638
23478	0	3	0	642	0	645
23479	0	5	0	639	0	644
23480	0	633	0	0	0	633
23481	0	1	0	657	0	658
23482	654	0	1	0	0	655
23483	653	0	0	0	0	653
23484	0	0	1	656	0	657
23485	0	0	645	0	0	645
23486	0	2	1	637	0	640
23487	1	4	0	614	0	619
23488	0	1	0	633	0	634
23489	0	0	0	639	0	639
23490	0	3	0	629	0	632
23491	0	631	0	0	0	631
23492	631	0	2	0	0	633
23493	638	0	4	0	0	642
23494	686	0	0	0	0	686
23495	0	683	0	0	0	683
23496	684	0	0	0	0	684
23497	0	690	0	0	0	690
23498	0	0	692	0	0	692
23499	1	4	0	708	0	713
23500	0	0	703	0	0	703
23501	0	694	0	0	0	694
23502	689	0	3	0	0	692
23503	1	0	689	0	0	690
23504	0	0	691	0	0	691
23505	0	694	0	0	0	694
23506	0	0	0	675	0	675
23507	0	0	747	0	0	747
23508	0	2	0	754	0	756
23509	0	0	0	760	0	760
23510	0	0	0	762	0	762
23511	773	0	0	0	0	773
23512	772	0	0	0	0	772
23513	0	5	0	778	0	783
23514	746	0	2	0	0	748
23515	0	0	751	0	0	751
23516	0	0	703	0	0	703
23517	1	0	694	0	0	695
23518	4	0	701	0	0	705
23519	0	682	0	0	0	682
23520	0	2	0	687	0	689
23521	1	0	693	0	0	694
23522	698	0	0	0	0	698
23523	697	0	0	0	0	697
23524	0	691	0	0	0	691
23525	680	0	1	0	0	681
23526	0	2	0	654	0	656
23527	1	0	661	0	0	662
23528	1	2	0	659	0	662
23529	0	650	0	1	0	651
23530	647	0	2	0	0	649
23531	653	0	0	0	0	653
23532	0	646	0	0	0	646
23533	638	0	2	1	0	641
23534	676	0	0	0	0	676
23535	0	681	0	0	0	681
23536	0	3	0	669	0	672
23537	0	695	0	1	0	696
23538	697	0	3	0	0	700
23539	0	0	0	700	0	700
23540	693	0	2	0	0	695
23541	0	1	0	692	0	693
23542	1	0	707	0	0	708
23543	669	0	0	0	0	669
23544	0	0	668	0	0	668
23545	0	0	0	650	0	650
23546	0	0	657	0	0	657
23547	0	4	0	656	0	660
23548	0	0	683	0	0	683
23549	718	0	2	0	0	720
23550	0	734	0	0	0	734
23551	737	0	3	0	0	740
23552	0	1	0	721	0	722
23553	713	0	2	0	0	715
23554	0	722	0	0	0	722
23555	0	715	0	1	0	716
23556	0	721	0	1	0	722
23557	706	0	0	0	0	706
23558	0	0	0	702	0	702
23559	0	0	0	706	0	706
23560	0	0	713	0	0	713
23561	0	0	747	0	0	747
23562	0	2	0	743	0	745
23563	2	0	726	0	0	728
23564	0	727	0	0	0	727
23565	724	0	2	0	0	726
23566	0	0	769	0	0	769
23567	0	0	811	0	0	811
23568	0	2	0	820	0	822
23569	813	0	0	0	0	813
23570	0	1	1	755	0	757
23571	762	0	0	0	0	762
23572	0	2	0	756	0	758
23573	1	0	712	2	0	715
23574	0	799	0	0	0	799
23575	1	0	778	0	0	779
23576	0	791	0	1	0	792
23577	0	1	0	793	0	794
23578	819	0	0	0	0	819
23579	0	0	823	0	0	823
23580	0	2	0	840	0	842
23581	0	6	0	842	0	848
23582	859	0	0	0	0	859
23583	1	0	0	805	0	806
23584	0	805	0	0	0	805
23585	797	0	1	0	0	798
23586	0	0	806	0	0	806
23587	801	0	2	0	0	803
23588	0	804	0	0	0	804
23589	0	3	0	783	0	786
23590	0	788	0	2	0	790
23591	779	0	5	0	0	784
23592	0	0	776	0	0	776
23593	767	0	14	0	0	781
23594	0	783	0	0	0	783
23595	0	2	0	770	0	772
23596	772	0	0	0	0	772
23597	769	0	0	0	0	769
23598	0	3	0	768	0	771
23599	0	0	1	769	0	770
23600	0	780	0	0	0	780
23601	0	2	0	754	0	756
23602	0	756	0	0	0	756
23603	0	749	0	0	0	749
23604	1	1	0	732	0	734
23605	0	744	0	0	0	744
23606	2	0	738	0	0	740
23607	0	0	736	0	0	736
23608	0	741	0	3	0	744
23609	0	0	742	0	0	742
23610	0	0	727	0	0	727
23611	0	0	724	0	0	724
23612	0	712	0	0	0	712
23613	715	0	2	0	0	717
23614	0	718	0	0	0	718
23615	0	0	722	0	0	722
23616	0	0	0	793	0	793
23617	788	0	1	0	0	789
23618	2	0	775	0	0	777
23619	0	1	0	791	0	792
23620	2	0	783	0	0	785
23621	0	0	0	789	0	789
23622	770	0	0	0	0	770
23623	1	0	765	0	0	766
23624	0	756	0	0	0	756
23625	0	1	0	740	0	741
23626	728	0	1	0	0	729
23627	0	0	711	0	0	711
23628	0	0	0	728	0	728
23629	0	710	0	0	0	710
23630	701	0	0	0	0	701
23631	718	1	0	0	0	719
23632	0	3	0	704	0	707
23633	0	709	0	1	0	710
23634	0	715	0	0	0	715
23635	721	0	0	0	0	721
23636	0	4	0	713	0	717
23637	0	694	0	1	0	695
23638	698	0	0	0	0	698
23639	0	0	0	703	0	703
23640	0	0	0	686	0	686
23641	1	0	693	0	0	694
23642	0	670	0	1	0	671
23643	0	671	0	1	0	672
23644	0	0	0	684	0	684
23645	714	0	0	0	0	714
23646	0	716	0	2	0	718
23647	713	0	1	0	0	714
23648	0	724	0	0	0	724
23649	0	2	0	655	0	657
23650	699	0	1	0	0	700
23651	3	0	0	697	0	700
23652	1	0	681	0	0	682
23653	0	0	0	684	0	684
23654	0	641	0	1	0	642
23655	649	0	1	0	0	650
23656	3	627	0	0	0	630
23657	0	0	0	621	0	621
23658	0	3	0	619	0	622
23659	1	0	599	0	0	600
23660	2	0	607	0	0	609
23661	0	0	0	607	0	607
23662	1	0	596	0	0	597
23663	0	603	0	0	0	603
23664	603	0	2	0	0	605
23665	0	0	605	0	0	605
23666	612	0	0	0	0	612
23667	610	0	0	0	0	610
23668	603	0	3	0	0	606
23669	617	0	0	0	0	617
23670	0	0	0	615	0	615
23671	0	4	0	618	0	622
23672	0	618	0	1	0	619
23673	618	0	0	0	0	618
23674	0	0	617	0	0	617
23675	1	1	1	626	0	629
23676	0	1	0	625	0	626
23677	0	0	629	0	0	629
23678	0	621	0	0	0	621
23679	0	6	0	617	0	623
23680	0	0	0	632	0	632
23681	679	0	1	0	0	680
23682	0	702	0	1	0	703
23683	1	0	0	693	0	694
23684	0	716	0	0	0	716
23685	0	0	0	708	0	708
23686	708	0	1	0	0	709
23687	713	0	0	0	0	713
23688	0	0	0	716	0	716
23689	712	0	0	0	0	712
23690	702	0	1	0	0	703
23691	0	680	0	0	0	680
23692	0	0	0	648	0	648
23693	0	656	0	0	0	656
23694	0	0	0	637	0	637
23695	654	0	1	0	0	655
23696	0	2	0	648	0	650
23697	0	1	0	666	0	667
23698	0	0	664	0	0	664
23699	0	669	0	2	0	671
23700	1	634	0	1	0	636
23701	636	0	2	0	0	638
23702	0	2	0	651	0	653
23703	661	0	0	0	0	661
23704	1	686	0	0	0	687
23705	0	681	0	0	0	681
23706	0	669	0	0	0	669
23707	685	0	2	0	0	687
23708	0	683	0	0	0	683
23709	690	0	0	0	0	690
23710	699	0	1	0	0	700
23711	689	0	1	0	0	690
23712	0	0	0	718	0	718
23713	0	0	0	704	0	704
23714	0	0	0	719	0	719
23715	0	0	0	719	0	719
23716	706	0	0	1	0	707
23717	0	706	0	0	0	706
23718	0	0	0	698	0	698
23719	696	0	2	0	0	698
23720	0	2	0	687	0	689
23721	0	0	0	663	0	663
23722	656	0	0	0	0	656
23723	0	0	667	0	0	667
23724	0	0	0	665	0	665
23725	0	0	665	0	0	665
23726	0	2	0	613	0	615
23727	0	1	0	616	0	617
23728	621	0	1	0	0	622
23729	1	623	0	0	0	624
23730	0	615	0	0	0	615
23731	606	0	2	1	0	609
23732	0	607	0	9	0	616
23733	598	0	4	0	0	602
23734	0	0	599	0	0	599
23735	610	0	0	0	0	610
23736	611	0	3	0	0	614
23737	609	0	0	0	0	609
23738	0	1	0	611	0	612
23739	0	2	0	613	0	615
23740	0	622	0	0	0	622
23741	0	2	0	622	0	624
23742	626	0	1	0	0	627
23743	0	621	0	0	0	621
23744	0	620	0	0	0	620
23745	606	0	1	0	0	607
23746	0	0	607	0	0	607
23747	0	1	0	603	0	604
23748	1	0	647	0	0	648
23749	0	0	0	651	0	651
23750	0	637	0	0	0	637
23751	0	3	0	635	0	638
23752	642	0	0	0	0	642
23753	0	0	0	642	0	642
23754	2	0	640	0	0	642
23755	649	0	2	0	0	651
23756	0	647	0	0	0	647
23757	1	573	0	1	0	575
23758	578	0	0	0	0	578
23759	577	0	1	0	0	578
23760	0	0	553	0	0	553
23761	556	0	0	0	0	556
23762	1	559	0	0	0	560
23763	556	0	5	0	0	561
23764	0	0	0	593	0	593
23765	0	591	0	0	0	591
23766	588	0	1	1	0	590
23767	0	0	566	0	0	566
23768	0	1	0	565	0	566
23769	575	0	0	0	0	575
23770	0	0	576	0	0	576
23771	571	0	2	0	0	573
23772	0	0	0	565	0	565
23773	0	2	0	540	0	542
23774	0	0	557	0	0	557
23775	0	0	0	556	0	556
23776	559	0	1	0	0	560
23777	0	557	1	0	0	558
23778	568	0	1	0	0	569
23779	582	0	3	0	0	585
23780	0	0	0	568	0	568
23781	0	0	602	0	0	602
23782	0	1	0	604	0	605
23783	580	0	0	0	0	580
23784	0	583	0	0	0	583
23785	583	0	1	0	0	584
23786	0	2	0	574	0	576
23787	0	0	0	565	0	565
23788	0	1	0	535	0	536
23789	0	0	536	0	0	536
23790	0	1	0	531	0	532
23791	1	0	526	0	0	527
23792	1	0	529	0	0	530
23793	0	1	0	495	0	496
23794	0	0	495	0	0	495
23795	504	0	1	0	0	505
23796	0	0	0	512	0	512
23797	0	2	0	512	0	514
23798	0	502	0	0	0	502
23799	504	0	1	0	0	505
23800	517	0	2	0	0	519
23801	0	518	0	1	0	519
23802	0	3	0	512	0	515
23803	0	0	514	0	0	514
23804	504	0	0	0	0	504
23805	501	0	3	0	0	504
23806	0	0	0	524	0	524
23807	0	0	516	0	0	516
23808	0	517	0	0	0	517
23809	508	1	2	0	0	511
23810	0	0	512	0	0	512
23811	0	506	0	0	0	506
23812	505	0	1	0	0	506
23813	514	0	0	0	0	514
23814	0	0	0	509	0	509
23815	0	514	0	0	0	514
23816	0	0	0	521	0	521
23817	0	2	0	523	0	525
23818	0	0	0	524	0	524
23819	0	4	0	518	0	522
23820	0	0	527	0	0	527
23821	0	0	0	531	0	531
23822	0	0	0	522	0	522
23823	0	0	521	0	0	521
23824	0	478	0	7	0	485
23825	491	0	0	0	0	491
23826	498	0	0	0	0	498
23827	0	0	0	508	0	508
23828	511	0	0	0	0	511
23829	0	1	0	509	0	510
23830	1	0	497	0	0	498
23831	1	0	496	2	0	499
23832	0	495	0	1	0	496
23833	491	0	1	0	0	492
23834	0	0	500	0	0	500
23835	0	0	1	491	0	492
23836	1	0	0	516	0	517
23837	0	0	0	527	0	527
23838	0	1	0	513	0	514
23839	0	2	0	513	0	515
23840	0	0	476	0	0	476
23841	0	1	0	480	0	481
23842	480	0	0	2	0	482
23843	0	477	0	0	0	477
23844	470	0	0	0	0	470
23845	0	495	0	0	0	495
23846	504	0	1	0	0	505
23847	519	0	1	0	0	520
23848	0	0	0	521	0	521
23849	0	0	0	518	0	518
23850	501	0	2	0	0	503
23851	500	0	0	0	0	500
23852	503	0	0	0	0	503
23853	0	508	0	1	0	509
23854	0	428	0	1	0	429
23855	0	0	439	0	0	439
23856	0	3	0	439	0	442
23857	1	0	408	0	0	409
23858	0	410	0	0	0	410
23859	0	6	0	404	0	410
23860	0	1	0	419	0	420
23861	0	0	0	418	0	418
23862	424	0	1	0	0	425
23863	430	0	3	0	0	433
23864	0	431	0	0	0	431
23865	0	0	0	431	0	431
23866	0	0	433	0	0	433
23867	0	0	437	1	0	438
23868	445	0	0	0	0	445
23869	443	0	1	0	0	444
23870	0	0	0	446	0	446
23871	431	0	1	0	0	432
23872	0	0	433	0	0	433
23873	0	442	0	0	0	442
23874	0	0	0	446	0	446
23875	0	0	446	0	0	446
23876	0	3	0	437	0	440
23877	0	0	0	441	0	441
23878	1	0	444	0	0	445
23879	445	0	0	0	0	445
23880	453	0	0	0	0	453
23881	0	458	0	0	0	458
23882	441	0	0	0	0	441
23883	442	0	3	0	0	445
23884	2	0	448	0	0	450
23885	454	0	0	0	0	454
23886	0	460	0	0	0	460
23887	457	1	0	0	0	458
23888	457	0	0	0	0	457
23889	451	0	0	0	0	451
23890	452	0	1	0	0	453
23891	445	0	1	0	0	446
23892	0	443	0	0	0	443
23893	430	0	0	0	0	430
23894	0	431	0	0	0	431
23895	0	427	0	0	0	427
23896	0	435	0	1	0	436
23897	436	0	0	0	0	436
23898	431	0	0	0	0	431
23899	0	0	425	0	0	425
23900	413	0	3	0	0	416
23901	414	0	0	0	0	414
23902	0	0	422	0	0	422
23903	0	0	0	414	0	414
23904	0	0	0	410	0	410
23905	0	0	0	411	0	411
23906	0	0	0	464	0	464
23907	0	2	0	467	0	469
23908	0	0	468	0	0	468
23909	0	462	0	2	0	464
23910	468	1	1	0	0	470
23911	0	485	0	0	0	485
23912	459	0	1	0	0	460
23913	472	0	3	0	0	475
23914	0	0	478	0	0	478
23915	0	0	0	477	0	477
23916	1	472	0	0	0	473
23917	474	0	1	0	0	475
23918	476	0	0	0	0	476
23919	477	0	1	0	0	478
23920	0	457	0	0	0	457
23921	454	0	1	0	0	455
23922	440	0	0	0	0	440
23923	411	0	0	0	0	411
23924	0	0	0	413	0	413
23925	0	1	0	417	0	418
23926	0	1	0	419	0	420
23927	432	0	0	0	0	432
23928	0	426	0	0	0	426
23929	426	0	2	0	0	428
23930	434	0	0	0	0	434
23931	420	0	0	0	0	420
23932	422	0	1	0	0	423
23933	0	412	0	0	0	412
23934	404	0	0	0	0	404
23935	0	408	0	0	0	408
23936	0	404	0	0	0	404
23937	416	0	1	0	0	417
23938	0	401	0	2	0	403
23939	0	426	0	0	0	426
23940	429	0	0	0	0	429
23941	450	0	0	0	0	450
23942	0	0	0	447	0	447
23943	0	0	0	439	0	439
23944	436	0	1	0	0	437
23945	436	0	0	0	0	436
23946	433	0	1	0	0	434
23947	0	0	442	0	0	442
23948	436	0	0	0	0	436
23949	0	0	0	424	0	424
23950	0	2	0	422	0	424
23951	0	1	1	417	0	419
23952	0	0	0	425	0	425
23953	0	0	430	0	0	430
23954	0	0	432	0	0	432
23955	1	1	0	434	0	436
23956	0	0	472	0	0	472
23957	0	0	531	0	0	531
23958	0	2	0	540	0	542
23959	0	3	0	535	0	538
23960	0	1	0	528	0	529
23961	0	0	0	530	0	530
23962	526	0	0	0	0	526
23963	535	0	1	0	0	536
23964	0	1	0	532	0	533
23965	0	2	0	528	0	530
23966	0	0	1	525	0	526
23967	0	1	0	531	0	532
23968	0	1	0	555	0	556
23969	0	552	0	0	0	552
23970	555	0	3	0	0	558
23971	0	567	0	0	0	567
23972	566	0	1	0	0	567
23973	909	0	5	0	0	914
23974	1041	0	4	0	0	1045
23975	0	0	0	1060	0	1060
23976	1071	0	3	0	0	1074
23977	1	4	0	1132	0	1137
23978	0	2	0	1220	0	1222
23979	1236	0	0	0	0	1236
23980	0	1238	0	0	0	1238
23981	0	1232	0	2	0	1234
23982	1176	0	1	0	0	1177
23983	0	0	1182	0	0	1182
23984	1179	0	3	0	0	1182
23985	0	2	0	1185	0	1187
23986	0	1167	0	4	0	1171
23987	0	1341	0	0	0	1341
23988	1362	0	1	0	0	1363
23989	0	2	0	1338	0	1340
23990	0	1332	0	0	0	1332
23991	1335	0	0	0	0	1335
23992	1376	0	2	0	0	1378
23993	1393	0	1	1	0	1395
23994	1406	0	1	0	0	1407
23995	0	1414	0	2	0	1416
23996	1	1403	0	0	0	1404
23997	1424	0	1	0	0	1425
23998	1459	0	6	0	0	1465
23999	1	0	1479	0	0	1480
24000	0	1515	0	0	0	1515
24001	1512	0	2	0	0	1514
24002	1517	0	3	1	0	1521
24003	2	0	1507	0	0	1509
24004	1556	0	6	0	0	1562
24005	1	1	1576	0	0	1578
24006	0	0	1643	0	0	1643
24007	0	5	1	1648	0	1654
24008	0	1678	0	4	0	1682
24009	1694	0	5	0	0	1699
24010	0	1	0	1708	0	1709
24011	0	2	0	1710	0	1712
24012	0	2	0	1711	0	1713
24013	1793	0	0	0	0	1793
24014	0	0	0	1807	0	1807
24015	0	20	0	1754	0	1774
24016	0	0	1770	0	0	1770
24017	1754	0	1	1	0	1756
24018	1761	0	2	0	0	1763
24019	3	0	1789	1	0	1793
24020	1805	0	15	0	0	1820
24021	0	4	1	1815	0	1820
24022	0	1819	0	2	0	1821
24023	1	1	0	1837	0	1839
24024	1879	2	0	0	0	1881
24025	0	1910	0	0	0	1910
24026	0	14	0	1888	0	1902
24027	0	2	0	1908	0	1910
24028	0	3	0	1964	0	1967
24029	0	5	0	1949	0	1954
24030	0	1984	0	1	0	1985
24031	1998	1	1	2	0	2002
24032	1968	1	4	0	0	1973
24033	0	1912	0	0	0	1912
24034	1832	2	79	0	0	1913
24035	1951	1	5	0	0	1957
24036	1932	2	7	9	0	1950
24037	0	0	1970	0	0	1970
24038	0	4	2	2045	0	2051
24039	1	0	2034	0	0	2035
24040	2035	0	5	0	0	2040
24041	0	2093	0	0	0	2093
24042	2082	0	6	0	0	2088
24043	0	2101	0	0	0	2101
24044	0	5	0	2094	0	2099
24045	0	3	0	2139	0	2142
24046	1	0	2117	2	0	2120
24047	0	2137	0	3	0	2140
24048	2119	0	7	0	0	2126
24049	0	0	1818	0	0	1818
24050	1722	0	1	0	0	1723
24051	0	0	1	1747	0	1748
24052	1	0	1720	0	0	1721
24053	1	1566	0	1	0	1568
24054	2	2	0	1574	0	1578
24055	1	0	1591	0	0	1592
24056	1	0	1584	1	0	1586
24057	0	1592	0	2	0	1594
24058	1	0	0	1583	0	1584
24059	0	4	0	1643	0	1647
24060	2	1654	0	2	0	1658
24061	1686	0	2	0	0	1688
24062	1	3	0	1692	0	1696
24063	0	1516	0	0	0	1516
24064	1592	1	3	0	0	1596
24065	1619	0	2	0	0	1621
24066	1687	0	2	0	0	1689
24067	0	1778	0	0	0	1778
24068	1765	0	1	1	0	1767
24069	1906	0	4	0	0	1910
24070	0	0	0	1923	0	1923
24071	1919	0	0	0	0	1919
24072	0	1	0	1921	0	1922
24073	3	0	1932	1	0	1936
24074	0	0	1970	0	0	1970
24075	0	5	0	1932	0	1937
24076	0	0	1911	1	0	1912
24077	1910	0	4	0	0	1914
24078	0	4	0	1888	0	1892
24079	0	7	0	1872	0	1879
24080	2	0	1945	1	0	1948
24081	1	1880	0	2	0	1883
24082	0	1864	0	1	0	1865
24083	1	8	0	1849	0	1858
24084	0	2	2	1879	0	1883
24085	0	0	1930	1	0	1931
24086	4	0	2001	0	0	2005
24087	2	11	0	2016	0	2029
24088	0	0	2015	1	0	2016
24089	1971	0	5	1	0	1977
24090	1	2	0	1975	0	1978
24091	2047	0	7	0	0	2054
24092	0	5	0	2035	0	2040
24093	0	1	0	2078	0	2079
24094	0	0	2065	1	0	2066
24095	0	2100	0	1	0	2101
24096	1	12	1	2093	0	2107
24097	0	0	2142	0	0	2142
24098	0	2141	0	2	0	2143
24099	0	9	0	2131	0	2140
24100	2142	0	0	0	0	2142
24101	1	0	2104	0	0	2105
24102	2106	0	6	1	0	2113
24103	0	0	2137	0	0	2137
24104	2089	0	4	0	0	2093
24105	0	2236	0	1	0	2237
24106	0	2202	0	1	0	2203
24107	0	3	0	2218	0	2221
24108	0	2273	0	0	0	2273
24109	2264	0	0	0	0	2264
24110	0	3	0	2361	0	2364
24111	0	1	0	2315	0	2316
24112	0	6	0	2269	0	2275
24113	0	0	2271	0	0	2271
24114	0	4	1	2255	0	2260
24115	2	0	2243	0	0	2245
24116	0	2338	0	1	0	2339
24117	2366	1	2	0	0	2369
24118	1	2345	0	0	0	2346
24119	2353	0	1	0	0	2354
24120	2337	0	6	0	0	2343
24121	2294	1	1	0	0	2296
24122	2302	0	13	0	0	2315
24123	0	0	2338	0	0	2338
24124	2	3	0	2373	0	2378
24125	0	9	0	2392	0	2401
24126	1	1	0	2377	0	2379
24127	2360	0	1	0	0	2361
24128	2373	0	1	0	0	2374
24129	0	2372	0	1	0	2373
24130	4	0	2351	0	0	2355
24131	0	0	2426	0	0	2426
24132	1	2441	0	2	0	2444
24133	0	2413	0	4	0	2417
24134	1	6	0	2436	0	2443
24135	1	2	0	2445	0	2448
24136	2437	0	1	0	0	2438
24137	0	2405	0	1	0	2406
24138	0	7	1	2390	0	2398
24139	0	0	2446	0	0	2446
24140	0	1	0	2378	0	2379
24141	0	5	0	2404	0	2409
24142	0	3	2	2366	0	2371
24143	2	4	0	2239	0	2245
24144	0	0	2182	4	0	2186
24145	0	2056	1	0	0	2057
24146	0	2055	0	1	0	2056
24147	2071	0	3	0	0	2074
24148	0	2091	1	0	0	2092
24149	0	2026	0	0	0	2026
24150	0	10	1	2004	0	2015
24151	0	4	0	2021	0	2025
24152	2	7	0	2030	0	2039
24153	1	0	2035	0	0	2036
24154	0	1970	0	0	0	1970
24155	0	6	1	1971	0	1978
24156	0	1976	0	1	0	1977
24157	1942	15	5	1	0	1963
24158	0	2007	0	0	0	2007
24159	1993	0	3	0	0	1996
24160	0	0	2044	0	0	2044
24161	2005	0	5	0	0	2010
24162	0	3	0	1951	0	1954
24163	1	0	1941	0	0	1942
24164	1933	0	18	0	0	1951
24165	1928	0	8	0	0	1936
24166	1964	1	3	1	0	1969
24167	0	0	0	1892	0	1892
24168	0	0	1887	0	0	1887
24169	1845	0	2	1	0	1848
24170	0	4	0	1840	0	1844
24171	0	2	0	1902	0	1904
24172	2	0	2012	0	0	2014
24173	0	1982	0	2	0	1984
24174	2	5	0	1974	0	1981
24175	2	2080	0	1	0	2083
24176	2133	0	2	0	0	2135
24177	2323	0	6	0	0	2329
24178	0	2	0	2340	0	2342
24179	2298	0	5	3	0	2306
24180	0	2286	0	0	0	2286
24181	2187	0	4	1	0	2192
24182	1	2405	0	1	0	2407
24183	0	6	0	2384	0	2390
24184	1	3	0	2456	0	2460
24185	0	2449	0	0	0	2449
24186	4	6	0	2373	0	2383
24187	3	2	2365	0	0	2370
24188	0	2368	0	3	0	2371
24189	2370	0	4	2	0	2376
24190	0	2420	0	1	0	2421
24191	2	3	0	2298	0	2303
24192	1	0	2417	0	0	2418
24193	1	8	0	2420	0	2429
24194	0	0	1	2464	0	2465
24195	2460	0	3	0	0	2463
24196	5	0	2465	0	0	2470
24197	0	2457	0	1	0	2458
24198	1	0	2456	0	0	2457
24199	0	0	2428	0	0	2428
24200	2	0	2454	0	0	2456
24201	0	3	0	2711	0	2714
24202	2729	1	3	1	0	2734
24203	0	2727	0	0	0	2727
24204	2732	0	3	0	0	2735
24205	2738	1	1	0	0	2740
24206	0	5	1	2721	0	2727
24207	0	2647	0	3	0	2650
24208	2659	0	6	0	0	2665
24209	0	2898	0	0	0	2898
24210	0	9	0	2878	0	2887
24211	2	9	0	2876	0	2887
24212	0	2835	0	1	0	2836
24213	0	6	0	2824	0	2830
24214	1	0	2841	0	0	2842
24215	5	0	2850	1	0	2856
24216	1	9	0	2860	0	2870
24217	1	3	0	3063	0	3067
24218	0	0	3026	0	0	3026
24219	2	0	3039	1	0	3042
24220	3052	1	10	1	0	3064
24221	1	3064	0	3	0	3068
24222	1	3031	0	0	0	3032
24223	1	55	1	3105	0	3162
24224	1	2	0	3154	0	3157
24225	0	3	0	3180	0	3183
24226	2	0	3137	0	0	3139
24227	6	0	3194	1	0	3201
24228	0	9	0	3235	0	3244
24229	3	2	3173	1	0	3179
24230	0	3213	0	1	0	3214
24231	3174	1	13	1	0	3189
24232	6	0	3189	1	0	3196
24233	1	0	3252	1	0	3254
24234	0	6	0	3252	0	3258
24235	2	0	3244	0	0	3246
24236	0	3180	1	2	0	3183
24237	2	4	0	3201	0	3207
24238	3	0	3317	0	0	3320
24239	0	3340	0	0	0	3340
24240	3393	0	2	0	0	3395
24241	0	9	1	3431	0	3441
24242	1	9	0	3421	0	3431
24243	3487	0	2	0	0	3489
24244	0	3493	0	1	0	3494
24245	3462	0	1	0	0	3463
24246	3440	0	3	0	0	3443
24247	3292	0	5	0	0	3297
24248	0	7	0	3208	0	3215
24249	3214	0	5	1	0	3220
24250	0	3191	0	20	0	3211
24251	0	3115	0	8	0	3123
24252	3094	1	1	0	0	3096
24253	0	7	0	2893	0	2900
24254	0	6	0	2901	0	2907
24255	0	2	0	2916	0	2918
24256	4	0	2896	0	0	2900
24257	0	2751	0	2	0	2753
24258	2	1	0	2659	0	2662
24259	2667	0	2	0	0	2669
24260	2	5	0	2591	0	2598
24261	6	0	2624	0	0	2630
24262	2	2628	0	2	0	2632
24263	2615	0	8	0	0	2623
24264	2609	0	7	0	0	2616
24265	2592	0	3	2	0	2597
24266	0	4	0	2547	0	2551
24267	0	0	2600	0	0	2600
24268	12	0	2617	2	0	2631
24269	0	2599	0	3	0	2602
24270	1	6	0	2637	0	2644
24271	0	2	0	2649	0	2651
24272	2744	0	3	2	0	2749
24273	0	4	0	2739	0	2743
24274	2735	1	1	0	0	2737
24275	1	0	2771	1	0	2773
24276	3	0	2809	0	0	2812
24277	0	10	0	2573	0	2583
24278	0	4	0	2540	0	2544
24279	0	3	0	2553	0	2556
24280	2549	0	0	0	0	2549
24281	2540	0	4	0	0	2544
24282	0	3	0	2553	0	2556
24283	2	0	2544	0	0	2546
24284	0	0	2729	3	0	2732
24285	1	0	0	2466	0	2467
24286	2449	0	5	0	0	2454
24287	0	8	1	2450	0	2459
24288	0	5	0	2453	0	2458
24289	1	0	2445	0	0	2446
24290	1	0	2519	1	0	2521
24291	2503	0	6	0	0	2509
24292	1	0	2525	0	0	2526
24293	1	8	0	2283	0	2292
24294	0	2	0	2338	0	2340
24295	2390	0	0	0	0	2390
24296	0	2389	0	0	0	2389
24297	2364	1	27	0	0	2392
24298	0	2396	0	1	0	2397
24299	2250	0	2	1	0	2253
24300	1	0	2301	1	0	2303
24301	2307	0	4	0	0	2311
24302	2327	0	3	0	0	2330
24303	0	8	1	2289	0	2298
24304	3	0	2308	1	0	2312
24305	0	6	0	2328	0	2334
24306	0	7	0	2369	0	2376
24307	0	2393	0	2	0	2395
24308	0	7	0	2392	0	2399
24309	0	2426	0	0	0	2426
24310	0	1	0	2390	0	2391
24311	2388	0	3	0	0	2391
24312	0	12	2	2359	0	2373
24313	0	0	2313	4	0	2317
24314	2143	0	5	0	0	2148
24315	0	0	2151	0	0	2151
24316	2092	0	37	0	0	2129
24317	2095	0	3	0	0	2098
24318	1	2039	0	2	0	2042
24319	0	2057	0	0	0	2057
24320	2049	0	4	0	0	2053
24321	2059	0	5	0	0	2064
24322	2064	0	0	0	0	2064
24323	2052	0	3	0	0	2055
24324	2045	0	3	2	0	2050
24325	1	1	1	2013	0	2016
24326	0	1	0	1977	0	1978
24327	1	0	1973	1	0	1975
24328	1984	0	3	0	0	1987
24329	0	1	0	1999	0	2000
24330	0	4	0	1982	0	1986
24331	1	0	1977	0	0	1978
24332	0	1959	1	4	0	1964
24333	0	1973	0	0	0	1973
24334	1973	0	2	0	0	1975
24335	1994	0	3	0	0	1997
24336	2	2042	0	1	0	2045
24337	0	2124	0	0	0	2124
24338	2148	0	1	0	0	2149
24339	2344	0	1	0	0	2345
24340	0	2	1	2351	0	2354
24341	0	3	1	2368	0	2372
24342	0	1	0	2416	0	2417
24343	2345	0	0	0	0	2345
24344	2230	2	5	0	0	2237
24345	0	7	0	2225	0	2232
24346	2125	0	1	0	0	2126
24347	1	0	2149	0	0	2150
24348	1	2	0	2068	0	2071
24349	1	0	2070	0	0	2071
24350	0	1932	0	0	0	1932
24351	0	0	0	1923	0	1923
24352	1960	0	1	0	0	1961
24353	0	2	1	1971	0	1974
24354	0	5	0	1973	0	1978
24355	4	0	1967	0	0	1971
24356	5	0	1982	0	0	1987
24357	0	1978	0	2	0	1980
24358	2003	0	2	0	0	2005
24359	2006	0	2	2	0	2010
24360	1811	0	1	0	0	1812
24361	1872	0	3	0	0	1875
24362	0	0	0	1873	0	1873
24363	0	2	1	1863	0	1866
24364	0	1854	0	0	0	1854
24365	1862	0	5	0	0	1867
24366	1769	0	2	0	0	1771
24367	4	0	1764	0	0	1768
24368	1989	0	3	0	0	1992
24369	0	1920	0	0	0	1920
24370	1	9	0	1853	0	1863
24371	0	1882	0	0	0	1882
24372	1889	0	0	0	0	1889
24373	0	1909	0	0	0	1909
24374	0	9	0	1896	0	1905
24375	0	2	0	1959	0	1961
24376	0	4	0	1900	0	1904
24377	0	1941	0	0	0	1941
24378	0	11	0	1928	0	1939
24379	1	3	0	2018	0	2022
24380	0	1953	0	1	0	1954
24381	0	1923	0	1	0	1924
24382	1886	0	2	0	0	1888
24383	0	1855	0	0	0	1855
24384	1812	0	3	0	0	1815
24385	1	0	1833	0	0	1834
24386	0	1894	0	0	0	1894
24387	1898	0	1	0	0	1899
24388	1900	0	3	0	0	1903
24389	0	0	1913	0	0	1913
24390	2	3	0	1930	0	1935
24391	0	0	1909	0	0	1909
24392	0	1891	0	1	0	1892
24393	1904	0	5	0	0	1909
24394	0	1935	0	1	0	1936
24395	0	6	0	1913	0	1919
24396	0	0	0	1937	0	1937
24397	669	0	1263	0	0	1932
24398	0	0	1925	0	0	1925
24399	1937	0	1	0	0	1938
24400	1926	1	8	0	0	1935
24401	1928	0	4	0	0	1932
24402	1933	3	8	0	0	1944
24403	0	2021	0	0	0	2021
24404	0	7	1	1972	0	1980
24405	0	8	0	1973	0	1981
24406	0	1995	0	1	0	1996
24407	1986	0	3	2	0	1991
24408	2006	0	8	1	0	2015
24409	0	0	2034	0	0	2034
24410	2048	0	3	0	0	2051
24411	0	0	0	2040	0	2040
24412	0	0	1955	0	0	1955
24413	0	2	0	1889	0	1891
24414	3	0	1856	1	0	1860
24415	3	0	1682	1	0	1686
24416	0	2	0	1698	0	1700
24417	0	1645	0	2	0	1647
24418	1637	0	5	1	0	1643
24419	1719	0	3	1	0	1723
24420	0	1847	1	0	0	1848
24421	1	1888	0	2	0	1891
24422	1892	0	11	0	0	1903
24423	1865	0	5	3	0	1873
24424	1848	0	0	1	0	1849
24425	1856	0	1	0	0	1857
24426	1	3	0	1862	0	1866
24427	0	0	1876	0	0	1876
24428	0	1892	0	0	0	1892
24429	1867	0	7	2	0	1876
24430	0	1877	0	2	0	1879
24431	1866	0	4	0	0	1870
24432	1898	0	11	0	0	1909
24433	0	0	2019	0	0	2019
24434	1	2138	0	0	0	2139
24435	0	1	0	2150	0	2151
24436	1	15	1	2135	0	2152
24437	0	0	0	2106	0	2106
24438	2116	0	0	0	0	2116
24439	2109	0	7	0	0	2116
24440	2110	1	10	0	0	2121
24441	1	2153	0	1	0	2155
24442	2025	0	2	1	0	2028
24443	0	1954	0	1	0	1955
24444	0	0	1949	0	0	1949
24445	0	1955	1	0	0	1956
24446	0	3	0	1986	0	1989
24447	0	4	0	2007	0	2011
24448	3	0	2047	0	0	2050
24449	0	8	0	2037	0	2045
24450	0	2	0	2037	0	2039
24451	2014	0	5	0	0	2019
24452	2007	0	3	0	0	2010
24453	1973	1	1	0	0	1975
24454	0	1955	0	0	0	1955
24455	1878	0	4	0	0	1882
24456	1914	0	4	2	0	1920
24457	0	1891	0	1	0	1892
24458	1	1	1	1836	0	1839
24459	0	11	0	1838	0	1849
24460	1814	0	3	0	0	1817
24461	0	0	1789	0	0	1789
24462	0	1793	0	0	0	1793
24463	0	4	0	1760	0	1764
24464	1	1775	0	2	0	1778
24465	1	1775	0	2	0	1778
24466	1796	0	1	0	0	1797
24467	1816	0	1	0	0	1817
24468	0	2	0	1828	0	1830
24469	0	1	0	1820	0	1821
24470	0	5	0	1758	0	1763
24471	0	1	0	1772	0	1773
24472	0	0	1759	0	0	1759
24473	2	0	1906	0	0	1908
24474	3	10	0	1888	0	1901
24475	2	2	1880	0	0	1884
24476	0	1874	0	0	0	1874
24477	1904	1	3	0	0	1908
24478	1926	0	0	1	0	1927
24479	0	3	0	1937	0	1940
24480	0	4	0	1938	0	1942
24481	1	4	0	1928	0	1933
24482	0	1931	1	1	0	1933
24483	2000	0	0	1	0	2001
24484	1975	0	1	0	0	1976
24485	1	0	1970	0	0	1971
24486	0	2	0	1931	0	1933
24487	0	0	2087	0	0	2087
24488	1	10	0	2043	0	2054
24489	0	1	0	2059	0	2060
24490	0	2	0	2053	0	2055
24491	1	2	0	2046	0	2049
24492	2069	0	2	1	0	2072
24493	2079	0	0	1	0	2080
24494	2181	1	3	0	0	2185
24495	1	5	0	2133	0	2139
24496	0	0	1991	0	0	1991
24497	1969	1	0	0	0	1970
24498	1	6	0	1958	0	1965
24499	1966	0	1	1	0	1968
24500	0	8	0	1964	0	1972
24501	0	2019	0	1	0	2020
24502	2	2002	0	1	0	2005
24503	1	12	1	1960	0	1974
24504	1	1	1	1984	0	1987
24505	0	8	1	1978	0	1987
24506	0	1971	0	4	0	1975
24507	1961	0	4	0	0	1965
24508	0	1899	0	0	0	1899
24509	2	0	1875	0	0	1877
24510	0	1	0	1858	0	1859
24511	0	1868	0	1	0	1869
24512	0	3	0	1930	0	1933
24513	0	7	0	1973	0	1980
24514	0	0	1965	0	0	1965
24515	1987	0	6	0	0	1993
24516	0	1987	0	3	0	1990
24517	1952	0	1	1	0	1954
24518	1694	0	265	0	0	1959
24519	1932	0	6	0	0	1938
24520	1	0	1977	0	0	1978
24521	0	1	0	1971	0	1972
24522	0	5	0	1937	0	1942
24523	1	0	1913	0	0	1914
24524	1884	0	6	0	0	1890
24525	2	0	1876	0	0	1878
24526	1	0	1979	0	0	1980
24527	0	1999	0	0	0	1999
24528	0	2	2	1975	0	1979
24529	0	0	1979	0	0	1979
24530	2036	1	2	1	0	2040
24531	2046	0	4	2	0	2052
24532	1	0	2053	0	0	2054
24533	0	2	0	2029	0	2031
24534	0	0	2036	0	0	2036
24535	0	2051	0	0	0	2051
24536	2060	0	5	0	0	2065
24537	2048	0	8	0	0	2056
24538	2060	0	3	0	0	2063
24539	0	1	1	2265	0	2267
24540	0	0	2	2290	0	2292
24541	0	0	2255	0	0	2255
24542	2236	0	2	1	0	2239
24543	1	0	0	2233	0	2234
24544	2208	0	4	1	0	2213
24545	1	0	2215	0	0	2216
24546	0	0	2325	1	0	2326
24547	0	7	0	2309	0	2316
24548	0	0	0	2181	0	2181
24549	1	0	2197	0	0	2198
24550	2272	0	8	1	0	2281
24551	0	4	0	2281	0	2285
24552	0	2279	0	0	0	2279
24553	2267	1	5	0	0	2273
24554	0	2233	0	1	0	2234
24555	2157	0	13	1	0	2171
24556	0	0	2164	0	0	2164
24557	1	0	2242	2	0	2245
24558	0	2262	0	0	0	2262
24559	2199	0	2	0	0	2201
24560	1	0	2217	0	0	2218
24561	2225	0	5	0	0	2230
24562	0	2128	0	0	0	2128
24563	0	4	0	2108	0	2112
24564	1	0	0	2107	0	2108
24565	0	2109	0	0	0	2109
24566	2102	0	10	3	0	2115
24567	2113	0	3	0	0	2116
24568	2083	1	4	0	0	2088
24569	1	0	2096	1	0	2098
24570	0	1	0	2003	0	2004
24571	0	2	0	2036	0	2038
24572	0	1	1	2038	0	2040
24573	0	1	2013	1	0	2015
24574	0	2022	0	0	0	2022
24575	2028	0	5	0	0	2033
24576	3	0	2070	0	0	2073
24577	2012	0	14	2	0	2028
24578	0	2051	0	0	0	2051
24579	2233	0	5	0	0	2238
24580	1	2	0	2289	0	2292
24581	2354	0	1	3	0	2358
24582	0	12	0	2341	0	2353
24583	4	0	2349	0	0	2353
24584	0	2	0	2280	0	2282
24585	6	0	2178	0	0	2184
24586	2234	0	5	2	0	2241
24587	1	2284	0	1	0	2286
24588	1	5	0	2188	0	2194
24589	0	2210	0	0	0	2210
24590	2182	1	2	1	0	2186
24591	2198	0	8	0	0	2206
24592	0	2337	0	0	0	2337
24593	2323	0	2	0	0	2325
24594	2377	0	6	0	0	2383
24595	0	4	0	2336	0	2340
24596	0	0	0	2304	0	2304
24597	2394	0	1	0	0	2395
24598	2364	0	10	1	0	2375
24599	0	11	0	2369	0	2380
24600	0	1	0	2353	0	2354
24601	2252	0	3	0	0	2255
24602	2	0	2272	0	0	2274
24603	2286	0	20	2	0	2308
24604	2	0	2318	0	0	2320
24605	0	2278	0	0	0	2278
24606	0	7	0	2207	0	2214
24607	1	0	2232	0	0	2233
24608	0	2226	0	1	0	2227
24609	2233	0	10	1	0	2244
24610	0	0	2236	0	0	2236
24611	2222	0	4	0	0	2226
24612	2259	0	13	0	0	2272
24613	2256	1	8	0	0	2265
24614	0	1	0	2229	0	2230
24615	0	2044	0	2	0	2046
24616	1975	0	9	1	0	1985
24617	0	0	2017	0	0	2017
24618	1998	0	2	0	0	2000
24619	1	0	2030	0	0	2031
24620	0	1951	0	0	0	1951
24621	1	4	0	1898	0	1903
24622	0	1	1	1910	0	1912
24623	0	1872	0	0	0	1872
24624	0	7	0	1883	0	1890
24625	2	0	1910	0	0	1912
24626	0	1893	0	0	0	1893
24627	0	1	0	1890	0	1891
24628	1892	0	2	0	0	1894
24629	1941	1	4	0	0	1946
24630	0	2	0	1968	0	1970
24631	0	1994	0	0	0	1994
24632	0	3	0	1919	0	1922
24633	0	0	0	1917	0	1917
24634	1	0	1915	0	0	1916
24635	0	1901	0	3	0	1904
24636	0	1	0	1923	0	1924
24637	1	0	1921	0	0	1922
24638	1	2035	1	0	0	2037
24639	0	0	0	2138	0	2138
24640	2172	0	5	0	0	2177
24641	0	2172	0	0	0	2172
24642	0	3	0	2183	0	2186
24643	2194	0	1	0	0	2195
24644	2218	0	4	0	0	2222
24645	2200	0	3	0	0	2203
24646	2289	0	6	2	0	2297
24647	0	6	0	2225	0	2231
24648	2	0	2283	0	0	2285
24649	1	13	0	2241	0	2255
24650	0	2239	0	2	0	2241
24651	2235	0	3	0	0	2238
24652	0	0	2212	0	0	2212
24653	2231	1	7	0	0	2239
24654	1	0	2262	0	0	2263
24655	0	1	1	2106	0	2108
24656	1	0	2075	0	0	2076
24657	0	2	1	2035	0	2038
24658	1	0	2075	0	0	2076
24659	0	2	0	2142	0	2144
24660	2160	0	2	0	0	2162
24661	0	2129	0	0	0	2129
24662	0	3	0	2101	0	2104
24663	0	6	0	2056	0	2062
24664	2	0	2042	0	0	2044
24665	1	0	2044	0	0	2045
24666	2073	0	9	0	0	2082
24667	0	2038	0	5	0	2043
24668	1938	0	5	1	0	1944
24669	2091	0	3	0	0	2094
24670	0	3	0	2071	0	2074
24671	0	2094	0	0	0	2094
24672	2093	0	4	1	0	2098
24673	2004	0	9	0	0	2013
24674	1996	0	7	0	0	2003
24675	2054	0	6	0	0	2060
24676	2058	0	5	0	0	2063
24677	0	0	2084	0	0	2084
24678	1958	0	6	0	0	1964
24679	0	0	1998	0	0	1998
24680	0	3	0	2016	0	2019
24681	0	3	0	1997	0	2000
24682	1	0	2011	1	0	2013
24683	2007	0	1	0	0	2008
24684	1	2	0	2028	0	2031
24685	0	1	0	2040	0	2041
24686	0	1	1	2023	0	2025
24687	0	1	0	2028	0	2029
24688	1	1	0	2009	0	2011
24689	2	0	2013	0	0	2015
24690	0	6	0	2099	0	2105
24691	0	0	2103	1	0	2104
24692	1	0	2129	0	0	2130
24693	2114	1	3	1	0	2119
24694	2094	0	6	0	0	2100
24695	2099	0	1	0	0	2100
24696	0	0	2129	0	0	2129
24697	2	0	2168	0	0	2170
24698	3	1	2217	0	0	2221
24699	2	2159	0	0	0	2161
24700	0	3	0	2163	0	2166
24701	2205	0	5	2	0	2212
24702	1	4	0	2217	0	2222
24703	0	2237	0	2	0	2239
24704	2299	0	8	0	0	2307
24705	2	9	0	2421	0	2432
24706	0	2476	0	4	0	2480
24707	0	5	1	2442	0	2448
24708	1	0	0	2530	0	2531
24709	2525	0	0	1	0	2526
24710	2	13	0	2467	0	2482
24711	1	0	2511	0	0	2512
24712	1	3	0	2500	0	2504
24713	0	2431	0	0	0	2431
24714	0	2344	0	2	0	2346
24715	0	4	0	2249	0	2253
24716	0	3	0	2340	0	2343
24717	1	2394	0	1	0	2396
24718	1	2404	0	0	0	2405
24719	1	2403	0	6	0	2410
24720	0	4	0	2356	0	2360
24721	0	2304	0	2	0	2306
24722	2323	0	7	0	0	2330
24723	0	1	2375	0	0	2376
24724	0	0	0	2352	0	2352
24725	1	2354	0	0	0	2355
24726	2315	0	1	0	0	2316
24727	0	0	2331	0	0	2331
24728	0	2277	0	8	0	2285
24729	2331	0	7	0	0	2338
24730	0	2351	0	1	0	2352
24731	0	2312	0	2	0	2314
24732	0	7	0	2326	0	2333
24733	0	2326	0	2	0	2328
24734	2344	2	5	0	0	2351
24735	0	1	0	2303	0	2304
24736	0	0	2269	1	0	2270
24737	4	0	2388	1	0	2393
24738	1	7	0	2380	0	2388
24739	1	0	2351	0	0	2352
24740	2	2	0	2353	0	2357
24741	2330	0	2	0	0	2332
24742	0	0	2417	0	0	2417
24743	0	5	0	2401	0	2406
24744	0	2319	0	0	0	2319
24745	1	7	0	2285	0	2293
24746	0	20	0	2250	0	2270
24747	0	2249	0	1	0	2250
24748	1	3	0	2275	0	2279
24749	0	3	0	2282	0	2285
24750	4	0	2280	0	0	2284
24751	1	2270	0	0	0	2271
24752	2277	0	3	0	0	2280
24753	0	2	0	2227	0	2229
24754	0	0	2221	0	0	2221
24755	0	6	0	2222	0	2228
24756	1	1	2223	0	0	2225
24757	2329	0	4	0	0	2333
24758	0	2372	0	1	0	2373
24759	2	2	0	2358	0	2362
24760	0	2	0	2366	0	2368
24761	2369	0	6	0	0	2375
24762	2	2	0	2374	0	2378
24763	1	0	2373	0	0	2374
24764	0	2	0	2399	0	2401
24765	0	2381	0	3	0	2384
24766	0	2297	0	1	0	2298
24767	0	2288	0	0	0	2288
24768	0	5	0	2290	0	2295
24769	893	0	1413	2	0	2308
24770	0	2303	0	2	0	2305
24771	2312	0	4	0	0	2316
24772	0	2280	0	2	0	2282
24773	2218	0	6	0	0	2224
24774	2233	0	6	0	0	2239
24775	2	0	2295	0	0	2297
24776	2306	0	2	0	0	2308
24777	2275	0	6	0	0	2281
24778	2261	0	8	0	0	2269
24779	2237	0	4	0	0	2241
24780	2	0	2182	0	0	2184
24781	2047	0	3	0	0	2050
24782	1979	0	4	0	0	1983
24783	0	2035	0	0	0	2035
24784	0	2	0	1940	0	1942
24785	0	3	0	1968	0	1971
24786	0	1930	0	1	0	1931
24787	1933	0	8	0	0	1941
24788	0	1962	0	2	0	1964
24789	2021	0	1	0	0	2022
24790	2023	0	10	3	0	2036
24791	0	1951	0	0	0	1951
24792	0	4	0	1874	0	1878
24793	3	0	1902	0	0	1905
24794	0	1964	0	0	0	1964
24795	2	6	0	1974	0	1982
24796	1	1992	0	2	0	1995
24797	0	1911	0	0	0	1911
24798	0	6	0	1916	0	1922
24799	2	0	1955	0	0	1957
24800	1	2104	0	0	0	2105
24801	0	2111	0	2	0	2113
24802	2181	0	7	1	0	2189
24803	0	1	0	2146	0	2147
24804	0	4	0	2150	0	2154
24805	0	1	4	2143	0	2148
24806	0	0	2096	0	0	2096
24807	0	4	0	2102	0	2106
24808	0	2033	0	0	0	2033
24809	2032	0	2	1	0	2035
24810	0	5	1	2001	0	2007
24811	0	0	2003	0	0	2003
24812	1989	0	4	2	0	1995
24813	0	4	0	1893	0	1897
24814	4	0	1877	0	0	1881
24815	0	0	1894	0	0	1894
24816	1942	1	8	0	0	1951
24817	1956	0	2	0	0	1958
24818	1861	0	7	0	0	1868
24819	1852	0	7	0	0	1859
24820	3	0	1833	0	0	1836
24821	0	1835	0	0	0	1835
24822	1830	0	7	1	0	1838
24823	0	1856	0	1	0	1857
24824	1814	0	2	2	0	1818
24825	0	1814	0	1	0	1815
24826	0	3	0	1794	0	1797
24827	0	3	0	1819	0	1822
24828	1	4	0	1883	0	1888
24829	0	1896	0	0	0	1896
24830	0	1846	0	2	0	1848
24831	0	6	0	1868	0	1874
24832	0	1796	0	1	0	1797
24833	0	0	1804	0	0	1804
24834	0	2	0	1821	0	1823
24835	1	0	1818	1	0	1820
24836	1948	0	0	0	0	1948
24837	1928	0	4	0	0	1932
24838	2	0	1926	0	0	1928
24839	0	0	2013	0	0	2013
24840	0	2	0	2094	0	2096
24841	2	0	2106	0	0	2108
24842	0	2	2	2102	0	2106
24843	0	2105	0	2	0	2107
24844	0	2	0	2104	0	2106
24845	0	0	0	2160	0	2160
24846	1	0	0	2165	0	2166
24847	0	0	2189	0	0	2189
24848	0	10	0	2159	0	2169
24849	0	1	0	2156	0	2157
24850	0	10	0	2188	0	2198
24851	0	2120	0	0	0	2120
24852	2150	0	2	0	0	2152
24853	2185	0	0	1	0	2186
24854	2192	0	2	1	0	2195
24855	0	5	0	2192	0	2197
24856	3	0	2157	0	0	2160
24857	1	0	2156	0	0	2157
24858	0	2123	0	2	0	2125
24859	2144	0	6	1	0	2151
24860	0	2129	0	6	0	2135
24861	2160	0	5	0	0	2165
24862	0	2190	0	1	0	2191
24863	2236	0	4	2	0	2242
24864	0	2231	0	2	0	2233
24865	0	10	0	2137	0	2147
24866	2	0	2200	0	0	2202
24867	0	0	2223	0	0	2223
24868	0	5	2	2214	0	2221
24869	0	5	0	2291	0	2296
24870	0	10	0	2223	0	2233
24871	1	0	2182	0	0	2183
24872	1	2	0	2219	0	2222
24873	2182	0	1	0	0	2183
24874	2210	0	1	0	0	2211
24875	0	2079	0	0	0	2079
24876	2045	0	4	1	0	2050
24877	1	2070	0	1	0	2072
24878	2000	0	4	0	0	2004
24879	2086	0	4	0	0	2090
24880	2082	0	3	0	0	2085
24881	0	0	2076	0	0	2076
24882	1	0	2117	0	0	2118
24883	2071	0	15	0	0	2086
24884	2081	0	4	0	0	2085
24885	1	1	2	2074	0	2078
24886	0	0	0	2083	0	2083
24887	0	2	0	2083	0	2085
24888	0	0	3	2086	0	2089
24889	1	3	1	2080	0	2085
24890	2072	0	2	1	0	2075
24891	0	4	0	2060	0	2064
24892	1	0	2048	0	0	2049
24893	2072	0	6	1	0	2079
24894	2074	0	4	0	0	2078
24895	1	2131	0	0	0	2132
24896	0	2117	0	0	0	2117
24897	2124	0	0	2	0	2126
24898	1	2132	0	1	0	2134
24899	2145	0	4	0	0	2149
24900	2176	0	4	0	0	2180
24901	2168	0	9	0	0	2177
24902	0	3	0	2208	0	2211
24903	0	2401	0	0	0	2401
24904	2390	0	5	0	0	2395
24905	0	0	1	2485	0	2486
24906	1	2	0	2490	0	2493
24907	2546	0	1	0	0	2547
24908	0	2534	0	5	0	2539
24909	0	1	0	2464	0	2465
24910	2476	0	5	0	0	2481
24911	0	2445	0	0	0	2445
24912	2333	0	2	0	0	2335
24913	5	0	2338	0	0	2343
24914	2303	0	9	0	0	2312
24915	1	2292	0	2	0	2295
24916	2190	0	2	0	0	2192
24917	2202	0	8	0	0	2210
24918	0	2199	0	1	0	2200
24919	2190	0	1	2	0	2193
24920	0	2251	0	1	0	2252
24921	2199	0	10	0	0	2209
24922	0	3	0	2187	0	2190
24923	1	3	0	2151	0	2155
24924	1	36	0	2236	0	2273
24925	0	0	2284	0	0	2284
24926	0	5	0	2218	0	2223
24927	1	0	2219	0	0	2220
24928	1	0	0	2188	0	2189
24929	0	2130	0	0	0	2130
24930	0	17	1	2136	0	2154
24931	0	0	2146	0	0	2146
24932	3	0	2156	0	0	2159
24933	0	0	0	2156	0	2156
24934	2277	0	2	0	0	2279
24935	2286	0	8	0	0	2294
24936	1	2252	0	1	0	2254
24937	1	1	0	2253	0	2255
24938	0	0	2264	0	0	2264
24939	0	7	0	2203	0	2210
24940	3	0	2220	0	0	2223
24941	2231	0	3	1	0	2235
24942	2	2	0	2174	0	2178
24943	0	48	2147	0	0	2195
24944	0	1	1	2193	0	2195
24945	0	2	0	2204	0	2206
24946	0	0	2241	0	0	2241
24947	0	3	0	2222	0	2225
24948	2225	0	2	0	0	2227
24949	2225	0	2	0	0	2227
24950	0	0	0	2205	0	2205
24951	2193	0	6	0	0	2199
24952	0	0	2166	0	0	2166
24953	0	0	2190	0	0	2190
24954	2157	0	6	1	0	2164
24955	2069	0	6	0	0	2075
24956	0	6	0	2048	0	2054
24957	0	4	0	2060	0	2064
24958	2	0	2066	0	0	2068
24959	1	3	0	2077	0	2081
24960	1	2060	0	2	0	2063
24961	2089	0	0	0	0	2089
24962	2081	0	2	0	0	2083
24963	0	2066	0	2	0	2068
24964	2049	0	5	0	0	2054
24965	2161	0	2	1	0	2164
24966	0	2174	0	0	0	2174
24967	2114	0	5	2	0	2121
24968	0	2180	0	0	0	2180
24969	2135	0	5	0	0	2140
24970	0	0	2673	0	0	2673
24971	2	6	3	2728	0	2739
24972	0	2	1	2880	0	2883
24973	0	3	0	2921	0	2924
24974	2896	0	5	0	0	2901
24975	0	3	0	2940	0	2943
24976	1	0	2893	0	0	2894
24977	2964	0	2	0	0	2966
24978	0	4	0	2887	0	2891
24979	0	2731	0	1	0	2732
24980	0	2658	0	0	0	2658
24981	0	8	0	2649	0	2657
24982	5	6	0	2707	0	2718
24983	0	2	0	2673	0	2675
24984	1	0	2656	1	0	2658
24985	1	2642	0	4	0	2647
24986	2626	0	5	0	0	2631
24987	2732	0	9	0	0	2741
24988	0	2730	0	4	0	2734
24989	1	2710	0	14	0	2725
24990	1	9	1	2705	0	2716
24991	0	0	3065	0	0	3065
24992	3070	0	7	3	0	3080
24993	3091	0	3	0	0	3094
24994	0	7	0	3082	0	3089
24995	0	1	0	3093	0	3094
24996	3022	0	6	1	0	3029
24997	1	0	3065	0	0	3066
24998	3070	1	7	2	0	3080
24999	0	3088	0	2	0	3090
25000	2	8	1	2958	0	2969
25001	1	3244	2	5	0	3252
25002	3298	0	10	0	0	3308
25003	0	11	0	3341	0	3352
25004	2	7	0	3350	0	3359
25005	1	3372	0	0	0	3373
25006	3379	0	12	0	0	3391
25007	3382	0	8	1	0	3391
25008	0	0	3401	1	0	3402
25009	1	0	3455	0	0	3456
25010	3242	1	5	1	0	3249
25011	0	0	3290	0	0	3290
25012	0	0	3405	0	0	3405
25013	3353	0	6	1	0	3360
25014	0	0	3417	0	0	3417
25015	1	3	0	3443	0	3447
25016	0	2	1	3435	0	3438
25017	3444	0	5	0	0	3449
25018	1	0	3537	0	0	3538
25019	3506	0	8	1	0	3515
25020	0	0	0	3627	0	3627
25021	3506	0	3	0	0	3509
25022	3458	0	2	1	0	3461
25023	3528	0	1	2	0	3531
25024	0	4	0	3573	0	3577
25025	3574	0	2	0	0	3576
25026	0	2	0	3575	0	3577
25027	0	2	0	3520	0	3522
25028	2	4	0	3552	0	3558
25029	0	2	0	3564	0	3566
25030	3573	0	1	1	0	3575
25031	3560	0	6	1	0	3567
25032	0	0	3700	0	0	3700
25033	3651	0	14	1	0	3666
25034	3765	0	7	1	0	3773
25035	1	6	1	3804	0	3812
25036	0	3829	0	0	0	3829
25037	3934	0	9	1	0	3944
25038	0	15	0	4048	0	4063
25039	4073	0	2	1	0	4076
25040	0	4066	0	10	0	4076
25041	4010	1	2	2	0	4015
25042	2	4	0	4096	0	4102
25043	0	4053	0	1	0	4054
25044	4104	1	10	1	0	4116
25045	1	3629	0	0	0	3630
25046	1	3592	0	3	0	3596
25047	3542	0	13	1	0	3556
25048	1	0	3440	0	0	3441
25049	3741	0	28	2	0	3771
25050	0	5	0	3785	0	3790
25051	0	0	3775	0	0	3775
25052	1	10	0	3840	0	3851
25053	0	6	0	3770	0	3776
25054	1	0	3861	0	0	3862
25055	3819	0	7	0	0	3826
25056	0	5	0	3812	0	3817
25057	1	9	0	3756	0	3766
25058	0	6	0	3728	0	3734
25059	3737	1	8	0	0	3746
25060	1	0	3815	0	0	3816
25061	0	0	3852	2	0	3854
25062	0	10	0	3880	0	3890
25063	1	0	3773	0	0	3774
25064	3751	0	8	3	0	3762
25065	0	3803	0	1	0	3804
25066	3807	0	2	0	0	3809
25067	1	8	1	3633	0	3643
25068	1	3704	0	8	0	3713
25069	0	20	3	3682	0	3705
25070	1	3686	0	1	0	3688
25071	1	5	0	3678	0	3684
25072	6	0	3691	0	0	3697
25073	4	0	3745	3	0	3752
25074	1	3792	0	1	0	3794
25075	3794	1	15	1	0	3811
25076	1	10	0	3763	0	3774
25077	0	2	0	3529	0	3531
25078	3486	0	2	0	0	3488
25079	3458	0	5	1	0	3464
25080	0	8	0	3540	0	3548
25081	2	0	3501	1	0	3504
25082	0	3492	0	0	0	3492
25083	0	8	0	3484	0	3492
25084	3	12	0	3478	0	3493
25085	0	3473	0	2	0	3475
25086	3459	0	3	1	0	3463
25087	1	0	3692	0	0	3693
25088	1	8	0	3529	0	3538
25089	1	8	0	3505	0	3514
25090	3	0	3507	0	0	3510
25091	1	4	0	3567	0	3572
25092	3589	0	4	3	0	3596
25093	3666	0	16	1	0	3683
25094	3568	6	7	1	0	3582
25095	2	3593	0	2	0	3597
25096	3382	0	3	0	0	3385
25097	0	6	0	3390	0	3396
25098	0	55	2	3311	0	3368
25099	1	3317	0	2	0	3320
25100	3322	0	9	2	0	3333
25101	3362	2	1	2	0	3367
25102	3336	1	8	0	0	3345
25103	3339	1	7	0	0	3347
25104	3300	0	18	0	0	3318
25105	0	0	3386	1	0	3387
25106	3391	0	4	0	0	3395
25107	3395	0	5	0	0	3400
25108	3378	0	5	0	0	3383
25109	1	0	1	3387	0	3389
25110	0	3	0	3324	0	3327
25111	1	0	3297	0	0	3298
25112	3279	2	10	1	0	3292
25113	2	3144	0	0	0	3146
25114	0	3096	0	2	0	3098
25115	3	1	3151	0	0	3155
25116	0	3292	0	1	0	3293
25117	1	3193	0	1	0	3195
25118	1	11	0	3659	0	3671
25119	0	4079	1	6	0	4086
25120	4199	0	8	1	0	4208
25121	4197	1	9	0	0	4207
25122	1	3	1	4212	0	4217
25123	5	0	4218	1	0	4224
25124	4020	0	6	0	0	4026
25125	1	0	3785	1	0	3787
25126	2	0	3814	0	0	3816
25127	1	33	0	3749	0	3783
25128	0	4	2	3718	0	3724
25129	0	0	3715	0	0	3715
25130	4	3611	0	5	0	3620
25131	1	3621	0	1	0	3623
25132	3647	0	2	0	0	3649
25133	3629	0	6	1	0	3636
25134	0	0	3705	1	0	3706
25135	3733	0	4	0	0	3737
25136	3722	0	6	2	0	3730
25137	0	2	0	3705	0	3707
25138	0	6	1	3675	0	3682
25139	1	1	1	3705	0	3708
25140	3724	0	0	0	0	3724
25141	3677	1	8	0	0	3686
25142	3685	0	7	0	0	3692
25143	0	5	1	3493	0	3499
25144	0	0	3445	0	0	3445
25145	3377	1	9	1	0	3388
25146	3406	0	6	0	0	3412
25147	1	11	0	3436	0	3448
25148	0	3353	0	2	0	3355
25149	0	10	0	3300	0	3310
25150	1	3516	0	1	0	3518
25151	4	9	0	3538	0	3551
25152	0	3584	0	0	0	3584
25153	3577	0	0	0	0	3577
25154	0	6	0	3553	0	3559
25155	0	3511	0	3	0	3514
25156	1	0	3455	0	0	3456
25157	3448	1	5	2	0	3456
25158	0	5	0	3426	0	3431
25159	0	3404	0	3	0	3407
25160	5	7	0	3387	0	3399
25161	1	3452	0	1	0	3454
25162	0	3247	0	0	0	3247
25163	3245	0	8	0	0	3253
25164	3243	0	1	1	0	3245
25165	1	0	3229	0	0	3230
25166	3089	35	25	0	0	3149
25167	3145	0	7	1	0	3153
25168	0	3141	0	1	0	3142
25169	0	4	0	3004	0	3008
25170	0	3	1	3031	0	3035
25171	4	0	3019	0	0	3023
25172	0	0	3148	0	0	3148
25173	3122	0	3	0	0	3125
25174	3196	0	6	1	0	3203
25175	3172	0	6	0	0	3178
25176	1	0	3312	0	0	3313
25177	0	0	0	3304	0	3304
25178	3312	0	5	0	0	3317
25179	0	2	0	3292	0	3294
25180	2	0	3296	0	0	3298
25181	3189	0	2	2	0	3193
25182	1	0	3261	0	0	3262
25183	0	3317	0	1	0	3318
25184	3200	0	0	0	0	3200
25185	0	0	3963	0	0	3963
25186	1	4	0	4036	0	4041
25187	4252	1	2	0	0	4255
25188	0	5	0	4273	0	4278
25189	4273	0	2	0	0	4275
25190	3	3	3	4266	0	4275
25191	4178	0	2	0	0	4180
25192	4044	0	6	1	0	4051
25193	4028	1	3	0	0	4032
25194	3482	0	11	1	0	3494
25195	1	3	1	3025	0	3030
25196	2	0	2911	0	0	2913
25197	6	0	2912	2	0	2920
25198	0	2933	0	5	0	2938
25199	0	2947	1	2	0	2950
25200	2998	0	4	0	0	3002
25201	0	6	0	3033	0	3039
25202	1	0	3046	0	0	3047
25203	1	0	3159	0	0	3160
25204	0	3	1	3172	0	3176
25205	3168	0	6	1	0	3175
25206	0	3182	0	2	0	3184
25207	3169	2	3	1	0	3175
25208	0	7	0	3154	0	3161
25209	0	2	0	3155	0	3157
25210	1	0	0	3060	0	3061
25211	1	0	3050	1	0	3052
25212	3	0	3079	0	0	3082
25213	0	3072	0	1	0	3073
25214	0	3	1	3109	0	3113
25215	3100	0	0	0	0	3100
25216	3	1	3159	0	0	3163
25217	3	0	3444	0	0	3447
25218	0	6	1	3449	0	3456
25219	0	6	0	3431	0	3437
25220	0	5	1	3424	0	3430
25221	0	1	0	3447	0	3448
25222	3435	1	2	1	0	3439
25223	0	3	0	3431	0	3434
25224	3396	0	6	0	0	3402
25225	3	0	3390	0	0	3393
25226	0	3239	0	1	0	3240
25227	1	4	0	3169	0	3174
25228	1	0	3215	0	0	3216
25229	4	0	3203	1	0	3208
25230	0	3238	1	0	0	3239
25231	0	16	0	3239	0	3255
25232	0	5	0	3281	0	3286
25233	1	0	3260	0	0	3261
25234	3254	1	4	0	0	3259
25235	0	8	0	3286	0	3294
25236	2	13	1	3257	0	3273
25237	2	1	3266	0	0	3269
25238	0	3402	0	1	0	3403
25239	0	3408	0	3	0	3411
25240	3467	1	2	1	0	3471
25241	0	2	0	3624	0	3626
25242	3604	1	2	1	0	3608
25243	0	1	3667	0	0	3668
25244	0	2	0	3683	0	3685
25245	3675	0	1	0	0	3676
25246	3638	1	10	0	0	3649
25247	0	4	2	3538	0	3544
25248	7	0	3558	2	0	3567
25249	4	0	3568	0	0	3572
25250	0	12	0	3520	0	3532
25251	1	0	3448	1	0	3450
25252	3296	2	6	1	0	3305
25253	0	3425	0	4	0	3429
25254	3409	0	10	0	0	3419
25255	3457	0	3	0	0	3460
25256	0	7	0	3443	0	3450
25257	3	2	0	3409	0	3414
25258	3442	0	2	0	0	3444
25259	0	9	0	3430	0	3439
25260	1	0	3460	0	0	3461
25261	0	2501	0	2	0	2503
25262	0	5	0	2396	0	2401
25263	0	6	0	2452	0	2458
25264	1	4	0	2441	0	2446
25265	1	0	2445	1	0	2447
25266	1	2517	0	0	0	2518
25267	1	9	0	2495	0	2505
25268	0	0	2610	0	0	2610
25269	1	4	1	2635	0	2641
25270	2643	0	2	0	0	2645
25271	1	4	2	2645	0	2652
25272	3	0	2624	0	0	2627
25273	2717	1	4	1	0	2723
25274	2	2800	0	2	0	2804
25275	2	2745	0	3	0	2750
25276	2715	1	1	2	0	2719
25277	4	0	2787	0	0	2791
25278	0	5	1	2825	0	2831
25279	0	3	0	2729	0	2732
25280	1	0	2739	0	0	2740
25281	0	2758	0	1	0	2759
25282	0	5	0	2758	0	2763
25283	0	0	2808	0	0	2808
25284	0	6	0	2859	0	2865
25285	2840	0	5	0	0	2845
25286	2	0	2839	1	0	2842
25287	1	3	1	3001	0	3006
25288	0	14	0	2987	0	3001
25289	0	0	3047	1	0	3048
25290	0	5	0	3052	0	3057
25291	0	2747	0	2	0	2749
25292	3	15	0	2712	0	2730
25293	1	2731	1	1	0	2734
25294	2734	0	4	0	0	2738
25295	2713	0	6	0	0	2719
25296	0	0	2741	0	0	2741
25297	5	0	2794	0	0	2799
25298	4	0	2815	3	0	2822
25299	0	2992	0	1	0	2993
25300	2	5	0	2948	0	2955
25301	2	0	2991	0	0	2993
25302	1	11	1	3054	0	3067
25303	0	8	1	3056	0	3065
25304	0	0	3094	1	0	3095
25305	1	13	0	3229	0	3243
25306	2	18	0	3198	0	3218
25307	0	3288	0	1	0	3289
25308	1	9	0	3252	0	3262
25309	0	12	1	3369	0	3382
25310	0	0	3389	1	0	3390
25311	2	7	0	3415	0	3424
25312	0	0	3395	0	0	3395
25313	0	0	3355	3	0	3358
25314	3232	0	55	1	0	3288
25315	2	12	0	3320	0	3334
25316	0	3162	0	0	0	3162
25317	0	3120	0	0	0	3120
25318	1	11	0	3088	0	3100
25319	1	0	3111	1	0	3113
25320	0	3170	0	4	0	3174
25321	5	7	0	3181	0	3193
25322	1	1	3191	1	0	3194
25323	0	3255	0	5	0	3260
25324	3264	0	5	0	0	3269
25325	3268	0	7	0	0	3275
25326	3258	1	1	0	0	3260
25327	0	3	0	3279	0	3282
25328	0	7	2	3277	0	3286
25329	0	2	0	3162	0	3164
25330	0	0	3195	0	0	3195
25331	3161	0	5	0	0	3166
25332	0	6	0	3172	0	3178
25333	3	0	3168	0	0	3171
25334	3315	0	4	1	0	3320
25335	3348	0	12	0	0	3360
25336	1	0	3317	3	0	3321
25337	3335	1	3	0	0	3339
25338	0	3320	0	4	0	3324
25339	1	0	3287	0	0	3288
25340	3418	0	4	0	0	3422
25341	0	3389	0	0	0	3389
25342	2	8	0	3371	0	3381
25343	0	3318	1	1	0	3320
25344	1	7	1	3285	0	3294
25345	1	0	3297	0	0	3298
25346	3280	0	7	2	0	3289
25347	2	0	3351	0	0	3353
25348	1	3316	0	0	0	3317
25349	0	3222	0	2	0	3224
25350	3138	0	1	0	0	3139
25351	0	0	3183	0	0	3183
25352	0	6	0	3321	0	3327
25353	0	0	3394	0	0	3394
25354	1	3307	0	0	0	3308
25355	1	7	0	3288	0	3296
25356	1	3278	0	3	0	3282
25357	3303	0	0	1	0	3304
25358	3307	0	5	0	0	3312
25359	3261	0	2	0	0	3263
25360	0	0	3217	1	0	3218
25361	1	0	3228	0	0	3229
25362	2953	0	10	1	0	2964
25363	1	0	3031	0	0	3032
25364	0	4	0	3024	0	3028
25365	0	2985	0	1	0	2986
25366	3041	2	3	0	0	3046
25367	3004	0	6	0	0	3010
25368	3007	0	4	0	0	3011
25369	1	6	0	3045	0	3052
25370	0	5	0	3030	0	3035
25371	3140	0	3	2	0	3145
25372	0	3092	0	1	0	3093
25373	3038	0	3	0	0	3041
25374	0	20	0	3020	0	3040
25375	0	5	0	2891	0	2896
25376	3053	0	1	0	0	3054
25377	1	3073	0	1	0	3075
25378	3035	0	13	0	0	3048
25379	0	2994	0	2	0	2996
25380	2851	0	14	1	0	2866
25381	0	3	0	3007	0	3010
25382	3029	0	2	2	0	3033
25383	2943	1	3	0	0	2947
25384	2950	0	9	0	0	2959
25385	0	2818	0	1	0	2819
25386	0	0	2760	0	0	2760
25387	2792	0	5	0	0	2797
25388	2819	0	5	0	0	2824
25389	0	2958	0	1	0	2959
25390	1	4	0	2887	0	2892
25391	0	4	0	2889	0	2893
25392	2891	0	2	0	0	2893
25393	0	1	0	2907	0	2908
25394	0	0	2915	0	0	2915
25395	0	0	2923	0	0	2923
25396	2825	0	3	2	0	2830
25397	0	10	0	2886	0	2896
25398	0	10	2	2790	0	2802
25399	0	5	0	2799	0	2804
25400	0	0	3037	0	0	3037
25401	0	12	0	2993	0	3005
25402	0	26	0	2972	0	2998
25403	1	3	0	3021	0	3025
25404	3020	0	2	0	0	3022
25405	0	9	0	3014	0	3023
25406	0	0	2983	0	0	2983
25407	2939	2	5	4	0	2950
25408	1	0	2962	1	0	2964
25409	2749	0	6	1	0	2756
25410	2779	0	2	0	0	2781
25411	1	5	0	2730	0	2736
25412	0	2769	0	1	0	2770
25413	0	4	0	2762	0	2766
25414	1	9	1	2838	0	2849
25415	0	2721	0	1	0	2722
25416	2807	10	4	2	0	2823
25417	0	2891	0	3	0	2894
25418	2902	0	16	1	0	2919
25419	2921	0	8	0	0	2929
25420	0	4	0	2943	0	2947
25421	0	7	0	2876	0	2883
25422	0	0	2858	1	0	2859
25423	2	0	2938	1	0	2941
25424	2932	0	4	1	0	2937
25425	2966	0	9	1	0	2976
25426	0	2821	0	0	0	2821
25427	0	6	0	2698	0	2704
25428	2	1	2712	1	0	2716
25429	0	9	0	2756	0	2765
25430	2760	0	5	0	0	2765
25431	2786	0	0	0	0	2786
25432	0	2803	0	1	0	2804
25433	0	4	0	2858	0	2862
25434	0	5	0	2857	0	2862
25435	0	3	0	2836	0	2839
25436	0	0	2791	2	0	2793
25437	2805	0	7	1	0	2813
25438	2805	0	4	0	0	2809
25439	3	0	2738	0	0	2741
25440	0	2783	0	0	0	2783
25441	2750	0	3	0	0	2753
25442	2740	0	7	1	0	2748
25443	1	0	2797	0	0	2798
25444	1	0	2822	0	0	2823
25445	0	5	1	2825	0	2831
25446	1	0	2815	0	0	2816
25447	2745	0	7	0	0	2752
25448	2796	0	29	0	0	2825
25449	2955	0	4	0	0	2959
25450	0	6	0	2941	0	2947
25451	0	2810	0	1	0	2811
25452	2769	0	7	0	0	2776
25453	2703	0	6	3	0	2712
25454	0	0	2715	0	0	2715
25455	0	0	2706	0	0	2706
25456	2719	0	5	1	0	2725
25457	0	7	0	2600	0	2607
25458	3	0	2560	0	0	2563
25459	0	2812	0	1	0	2813
25460	0	2	1	2834	0	2837
25461	2848	0	6	1	0	2855
25462	0	2774	0	1	0	2775
25463	0	5	2	2759	0	2766
25464	0	2795	0	0	0	2795
25465	0	2759	0	0	0	2759
25466	0	6	0	2741	0	2747
25467	1	5	2	2751	0	2759
25468	0	2750	0	0	0	2750
25469	2729	1	5	0	0	2735
25470	0	0	2743	0	0	2743
25471	2770	0	4	0	0	2774
25472	2	8	0	2752	0	2762
25473	0	5	0	2709	0	2714
25474	1	43	0	2663	0	2707
25475	0	3	0	2714	0	2717
25476	1	0	2507	1	0	2509
25477	0	6	0	2518	0	2524
25478	0	3	0	2524	0	2527
25479	0	2485	0	4	0	2489
25480	3	0	2483	1	0	2487
25481	0	2511	0	2	0	2513
25482	1	0	2518	1	0	2520
25483	1	2563	0	1	0	2565
25484	0	4	0	2574	0	2578
25485	2707	0	2	0	0	2709
25486	0	2661	0	2	0	2663
25487	1	8	0	2717	0	2726
25488	4	1	2720	0	0	2725
25489	0	2734	0	1	0	2735
25490	2715	0	5	2	0	2722
25491	2731	2	3	0	0	2736
25492	0	2502	0	4	0	2506
25493	3	0	2519	0	0	2522
25494	2518	1	6	1	0	2526
25495	0	25	0	2499	0	2524
25496	2519	0	6	0	0	2525
25497	0	2527	0	4	0	2531
25498	0	2442	0	2	0	2444
25499	2	0	2461	1	0	2464
25500	2677	1	1	0	0	2679
25501	1	1	1	2726	0	2729
25502	2682	0	3	0	0	2685
25503	1	2636	0	1	0	2638
25504	2576	0	1	1	0	2578
25505	2563	0	12	0	0	2575
25506	3	0	2599	1	0	2603
25507	2	2569	0	15	0	2586
25508	0	2618	0	2	0	2620
25509	0	4	0	2561	0	2565
25510	0	2573	0	0	0	2573
25511	2579	0	3	0	0	2582
25512	0	2608	0	0	0	2608
25513	2	5	0	2561	0	2568
25514	0	2617	1	0	0	2618
25515	0	2618	0	0	0	2618
25516	0	2628	0	0	0	2628
25517	0	12	0	2676	0	2688
25518	0	1	1	2662	0	2664
25519	0	8	0	2680	0	2688
25520	0	2678	0	2	0	2680
25521	1	0	2627	0	0	2628
25522	0	0	2611	0	0	2611
25523	2540	0	3	0	0	2543
25524	0	0	1	2479	0	2480
25525	0	0	2452	1	0	2453
25526	2	0	2502	0	0	2504
25527	1	2491	0	1	0	2493
25528	3	5	1	2483	0	2492
25529	0	0	0	2503	0	2503
25530	2535	0	5	0	0	2540
25531	0	0	0	2578	0	2578
25532	0	1	0	2539	0	2540
25533	1	0	2510	0	0	2511
25534	0	0	0	2393	0	2393
25535	0	6	0	2306	0	2312
25536	1	0	2280	2	0	2283
25537	0	0	2308	0	0	2308
25538	0	2316	0	5	0	2321
25539	1	0	2281	0	0	2282
25540	0	7	1	2195	0	2203
25541	0	5	0	2239	0	2244
25542	1	0	2239	0	0	2240
25543	1	2699	0	3	0	2703
25544	2728	0	8	0	0	2736
25545	0	2747	0	0	0	2747
25546	0	4	0	2683	0	2687
25547	0	4	2	2690	0	2696
25548	0	2720	0	2	0	2722
25549	0	2	1	2686	0	2689
25550	0	5	0	2735	0	2740
25551	4	0	2737	0	0	2741
25552	0	2807	0	0	0	2807
25553	0	13	1	2787	0	2801
25554	3	0	2838	0	0	2841
25555	0	6	5	2822	0	2833
25556	0	9	0	2853	0	2862
25557	0	6	0	2845	0	2851
25558	0	5	0	2845	0	2850
25559	0	15	1	2758	0	2774
25560	0	2703	0	0	0	2703
25561	2646	0	11	0	0	2657
25562	0	0	2644	0	0	2644
25563	2572	1	4	0	0	2577
25564	2	0	2602	0	0	2604
25565	0	2544	1	2	0	2547
25566	0	0	2525	0	0	2525
25567	1	2581	0	0	0	2582
25568	0	13	1	2585	0	2599
25569	0	4	0	2623	0	2627
25570	1	2530	0	2	0	2533
25571	0	2548	1	2	0	2551
25572	2569	1	5	0	0	2575
25573	2541	0	2	1	0	2544
25574	2599	0	7	0	0	2606
25575	2650	0	8	0	0	2658
25576	0	6	0	2484	0	2490
25577	1	2472	0	1	0	2474
25578	2460	0	3	0	0	2463
25579	1	6	0	2453	0	2460
25580	2449	0	1	1	0	2451
25581	2444	0	4	0	0	2448
25582	1	2501	0	0	0	2502
25583	1	2491	0	1	0	2493
25584	0	2563	0	0	0	2563
25585	0	10	0	2487	0	2497
25586	0	2593	0	3	0	2596
25587	2590	0	2	0	0	2592
25588	2565	0	0	0	0	2565
25589	2567	0	8	0	0	2575
25590	2538	0	4	0	0	2542
25591	2504	0	19	0	0	2523
25592	0	0	2473	0	0	2473
25593	2441	1	8	1	0	2451
25594	0	0	2485	0	0	2485
25595	2439	0	5	0	0	2444
25596	0	2	0	2481	0	2483
25597	3	0	2470	0	0	2473
25598	1	0	2503	0	0	2504
25599	1	2526	0	0	0	2527
25600	2583	0	4	2	0	2589
25601	2523	0	7	1	0	2531
25602	0	2517	0	0	0	2517
25603	1	4	1	2547	0	2553
25604	2553	0	5	0	0	2558
25605	3	0	2554	0	0	2557
25606	0	2483	0	2	0	2485
25607	2384	0	90	1	0	2475
25608	1	2513	0	1	0	2515
25609	0	5	0	2428	0	2433
25610	1	3093	0	1	0	3095
25611	2	12	0	3063	0	3077
25612	0	3105	0	0	0	3105
25613	0	3081	0	3	0	3084
25614	3098	0	9	0	0	3107
25615	3112	0	4	0	0	3116
25616	1	0	3114	0	0	3115
25617	1	0	3072	1	0	3074
25618	1	0	3117	2	0	3120
25619	1	3	0	2591	0	2595
25620	1	0	2632	0	0	2633
25621	0	14	0	2592	0	2606
25622	0	5	0	2597	0	2602
25623	0	2510	0	101	0	2611
25624	2606	0	9	3	0	2618
25625	0	2655	0	2	0	2657
25626	0	4	0	2590	0	2594
25627	0	8	0	2560	0	2568
25628	0	3	0	2531	0	2534
25629	1	0	2586	0	0	2587
25630	1	5	3	2522	0	2531
25631	0	4	0	2525	0	2529
25632	0	6	0	2528	0	2534
25633	0	0	2518	1	0	2519
25634	0	2583	0	2	0	2585
25635	2597	0	5	1	0	2603
25636	2602	0	7	0	0	2609
25637	0	2623	0	3	0	2626
25638	0	10	0	2661	0	2671
25639	0	3	0	2710	0	2713
25640	1	0	2719	0	0	2720
25641	0	2713	0	0	0	2713
25642	0	2	0	2717	0	2719
25643	0	0	2756	0	0	2756
25644	0	2	0	2798	0	2800
25645	0	8	0	2958	0	2966
25646	2	0	2959	0	0	2961
25647	0	8	0	2949	0	2957
25648	0	5	0	2952	0	2957
25649	1	0	3015	0	0	3016
25650	2	3	1	2952	0	2958
25651	0	15	1	2920	0	2936
25652	0	2	0	2934	0	2936
25653	0	0	2941	0	0	2941
25654	1	2	0	2993	0	2996
25655	3010	0	2	0	0	3012
25656	3015	0	4	0	0	3019
25657	0	3039	0	1	0	3040
25658	2942	0	0	1	0	2943
25659	3	0	2966	0	0	2969
25660	1	2	1	2977	0	2981
25661	0	5	0	2979	0	2984
25662	0	2	1	3068	0	3071
25663	3074	0	29	1	0	3104
25664	1	3179	0	1	0	3181
25665	1	6	0	3166	0	3173
25666	0	3169	0	1	0	3170
25667	3089	0	11	0	0	3100
25668	0	3104	0	1	0	3105
25669	3096	1	7	0	0	3104
25670	0	3156	0	4	0	3160
25671	0	3122	1	0	0	3123
25672	3	7	0	3078	0	3088
25673	0	7	1	3356	0	3364
25674	0	6	0	3481	0	3487
25675	0	4	0	3499	0	3503
25676	7	0	3405	3	0	3415
25677	0	3344	0	1	0	3345
25678	0	10	0	3319	0	3329
25679	1	3301	0	3	0	3305
25680	1	0	3289	0	0	3290
25681	0	5	0	3395	0	3400
25682	0	5	0	3381	0	3386
25683	4	0	3372	0	0	3376
25684	0	2738	1	1	0	2740
25685	0	1	0	2738	0	2739
25686	2	0	2718	0	0	2720
25687	0	2702	0	1	0	2703
25688	0	4	0	2697	0	2701
25689	1	0	2699	3	0	2703
25690	307	0	2633	1	0	2941
25691	1	2948	0	1	0	2950
25692	0	2906	0	0	0	2906
25693	3	3	0	2874	0	2880
25694	1	3	0	2915	0	2919
25695	0	0	2923	0	0	2923
25696	2925	0	7	1	0	2933
25697	2915	0	10	0	0	2925
25698	5	1	2924	0	0	2930
25699	0	2923	0	0	0	2923
25700	1	2878	0	3	0	2882
25701	0	2987	0	0	0	2987
25702	0	3017	0	1	0	3018
25703	0	11	0	3011	0	3022
25704	1	4	0	3020	0	3025
25705	0	6	2	2986	0	2994
25706	2	3	0	3045	0	3050
25707	0	3122	0	0	0	3122
25708	3	7	0	3043	0	3053
25709	0	3091	0	1	0	3092
25710	3	4	0	3010	0	3017
25711	3122	0	3	0	0	3125
25712	0	9	1	3171	0	3181
25713	0	3186	0	2	0	3188
25714	0	7	0	3123	0	3130
25715	1	3	0	3081	0	3085
25716	0	1	0	3080	0	3081
25717	3071	0	2	0	0	3073
25718	0	5	0	3061	0	3066
25719	211	0	2870	0	0	3081
25720	1	3072	0	2	0	3075
25721	0	6	0	2889	0	2895
25722	0	7	0	2878	0	2885
25723	0	2	0	2900	0	2902
25724	2969	0	2	0	0	2971
25725	1	0	2976	0	0	2977
25726	3	10	0	2966	0	2979
25727	1	2916	0	0	0	2917
25728	1	3	0	2880	0	2884
25729	2925	0	16	0	0	2941
25730	0	2944	0	0	0	2944
25731	1	6	1	2954	0	2962
25732	1	9	0	2953	0	2963
25733	0	2802	0	3	0	2805
25734	1	10	0	2834	0	2845
25735	0	4	0	2852	0	2856
25736	2	0	2847	0	0	2849
25737	0	2835	0	1	0	2836
25738	2696	0	10	0	0	2706
25739	6	0	2716	1	0	2723
25740	2636	0	5	0	0	2641
25741	0	0	3086	0	0	3086
25742	0	5	0	3231	0	3236
25743	3218	0	10	0	0	3228
25744	0	7	1	3214	0	3222
25745	3205	0	3	0	0	3208
25746	3136	0	7	0	0	3143
25747	3151	0	6	0	0	3157
25748	0	3208	0	0	0	3208
25749	0	8	0	2860	0	2868
25750	0	2	1	2788	0	2791
25751	1	3	0	2773	0	2777
25752	0	0	2771	0	0	2771
25753	0	0	0	2785	0	2785
25754	2764	0	2	0	0	2766
25755	2748	1	8	0	0	2757
25756	0	1	2950	0	0	2951
25757	2918	0	7	1	0	2926
25758	2995	0	5	0	0	3000
25759	0	1	0	3001	0	3002
25760	2990	0	3	0	0	2993
25761	3068	0	5	0	0	3073
25762	0	2	0	3181	0	3183
25763	3183	0	2	0	0	3185
25764	3174	1	2	0	0	3177
25765	1	5	0	2899	0	2905
25766	3	0	2878	0	0	2881
25767	2811	1	5	0	0	2817
25768	1	0	2923	0	0	2924
25769	1	0	2976	0	0	2977
25770	0	2995	0	1	0	2996
25771	0	15	0	2961	0	2976
25772	0	4	0	2992	0	2996
25773	0	2	0	3007	0	3009
25774	0	0	2983	0	0	2983
25775	3	0	3055	2	0	3060
25776	1	3019	0	1	0	3021
25777	2	8	1	2950	0	2961
25778	1	2	0	2977	0	2980
25779	0	2	0	2974	0	2976
25780	3	0	2963	0	0	2966
25781	0	2882	0	13	0	2895
25782	0	4	0	2941	0	2945
25783	2	0	2970	0	0	2972
25784	4	0	2957	1	0	2962
25785	2938	1	8	0	0	2947
25786	3051	0	2	0	0	3053
25787	2938	0	11	1	0	2950
25788	0	4	0	2881	0	2885
25789	2	0	2840	0	0	2842
25790	1	2962	0	5	0	2968
25791	1	3333	0	0	0	3334
25792	4	1	3313	1	0	3319
25793	0	7	1	3347	0	3355
25794	0	87	0	3333	0	3420
25795	0	3381	0	2	0	3383
25796	1	3430	0	2	0	3433
25797	3427	0	8	2	0	3437
25798	3416	0	1	2	0	3419
25799	3870	0	66	0	0	3936
25800	3852	0	9	0	0	3861
25801	4002	2	4	1	0	4009
25802	0	4072	0	0	0	4072
25803	1	4073	0	3	0	4077
25804	1	4036	0	7	0	4044
25805	4040	0	9	0	0	4049
25806	0	9	0	4071	0	4080
25807	0	5	0	4069	0	4074
25808	4281	0	7	0	0	4288
25809	0	4345	0	1	0	4346
25810	0	9	0	4255	0	4264
25811	0	8	1	4249	0	4258
25812	0	1	0	4280	0	4281
25813	4287	0	5	2	0	4294
25814	0	6	0	4287	0	4293
25815	7	0	4208	0	0	4215
25816	4197	0	22	2	0	4221
25817	2	12	0	3703	0	3717
25818	24	0	3668	1	0	3693
25819	2	3726	0	0	0	3728
25820	0	3721	1	4	0	3726
25821	3750	0	6	0	0	3756
25822	3799	0	4	0	0	3803
25823	0	3818	1	1	0	3820
25824	0	6	1	3812	0	3819
25825	3861	0	2	0	0	3863
25826	0	3	0	3820	0	3823
25827	0	7	0	3841	0	3848
25828	1	9	0	3846	0	3856
25829	3	8	0	3833	0	3844
25830	0	3674	0	2	0	3676
25831	0	14	0	3639	0	3653
25832	2	4	0	3659	0	3665
25833	0	4	0	3739	0	3743
25834	0	0	3694	2	0	3696
25835	1	3495	0	0	0	3496
25836	3	3	0	3494	0	3500
25837	3	0	3528	0	0	3531
25838	1	0	3545	0	0	3546
25839	2	3608	0	2	0	3612
25840	3623	0	8	0	0	3631
25841	1	6	0	3916	0	3923
25842	4041	0	8	0	0	4049
25843	0	4187	0	1	0	4188
25844	0	5	0	4242	0	4247
25845	4362	0	2	0	0	4364
25846	4312	1	5	0	0	4318
25847	0	4	0	4507	0	4511
25848	1	10	0	4619	0	4630
25849	2	0	5781	0	0	5783
25850	0	36	0	5686	0	5722
25851	0	2	1	5752	0	5755
25852	5781	1	3	0	0	5785
25853	0	4334	0	2030	0	6364
25854	0	0	6524	0	0	6524
25855	6694	0	14	2	0	6710
25856	0	7632	0	1	0	7633
25857	0	12	0	7617	0	7629
25858	11169	1	5	0	0	11175
25859	1	15	1	11664	0	11681
25860	3	9	0	11787	0	11799
25861	3	0	12032	5	0	12040
25862	2	17	0	12045	0	12064
25863	12181	0	19	1	0	12201
25864	4	12	0	12202	0	12218
25865	12155	0	6	1	0	12162
25866	1	15373	0	10	0	15384
25867	1	14982	0	1	0	14984
25868	1	46	0	16033	0	16080
25869	0	24	0	16133	0	16157
25870	16175	0	16	3	0	16194
25871	1	16547	0	6	0	16554
25872	16579	3	19	3	0	16604
25873	16890	1	25	7	0	16923
25874	1	50	2	17076	0	17129
25875	16710	1	18	0	0	16729
25876	13	0	17416	3	0	17432
25877	5	38	3	17336	0	17382
25878	19	0	17266	1	0	17286
25879	2	21	0	17499	0	17522
25880	17472	2	23	1	0	17498
25881	17469	2	15	2	0	17488
25882	0	17402	0	0	0	17402
25883	3	44	7	17402	0	17456
25884	0	43	1	17404	0	17448
25885	0	18005	0	4	0	18009
25886	1	60	4	17984	0	18049
25887	5	51	4	18047	0	18107
25888	1	18104	0	1	0	18106
25889	18074	3	24	2	0	18103
25890	18147	4	30	1	0	18182
25891	6	36	3	18197	0	18242
25892	7	29	0	18300	0	18336
25893	17	0	18368	5	0	18390
25894	5	38	4	18574	0	18621
25895	2	18702	2	6	0	18712
25896	18680	5	56	6	0	18747
25897	0	32	2	18759	0	18793
25898	0	18	2	18918	0	18938
25899	19147	0	21	2	0	19170
25900	0	20042	0	23	0	20065
25901	2	49	0	19980	0	20031
25902	4	77	0	19870	0	19951
25903	3	19900	0	13	0	19916
25904	19802	2	38	3	0	19845
25905	10	0	19998	0	0	20008
25906	7	0	19936	10	0	19953
25907	2	49	2	20005	0	20058
25908	7	0	19753	6	0	19766
25909	19505	0	37	8	0	19550
25910	5	36	1	19789	0	19831
25911	9	0	19722	4	0	19735
25912	12	2	19750	13	0	19777
25913	6	20101	2	22	0	20131
25914	20013	5	22	3	0	20043
25915	0	20350	0	5	0	20355
25916	20295	2	25	6	0	20328
25917	20070	2	48	4	0	20124
25918	0	19886	0	6	0	19892
25919	19712	2	28	0	0	19742
25920	19588	2	30	2	0	19622
25921	15	0	19759	1	0	19775
25922	8	51	0	19993	0	20052
25923	0	20478	0	8	0	20486
25924	0	19381	0	68	0	19449
25925	2	44	0	19485	0	19531
25926	19641	0	18	0	0	19659
25927	4	59	0	19753	0	19816
25928	0	36	0	21244	0	21280
25929	7	35	1	20643	0	20686
25930	3	19739	0	6	0	19748
25931	3	108	3	19403	0	19517
25932	10	0	19566	4	0	19580
25933	19572	1	35	4	0	19612
25934	16479	2	80	0	0	16561
25935	0	16123	0	18	0	16141
25936	16068	1	45	5	0	16119
25937	2	46	0	15937	0	15985
25938	8	0	15982	2	0	15992
25939	16165	2	39	2	0	16208
25940	1	13640	0	4	0	13645
25941	4	25	1	13613	0	13643
25942	13867	1	11	3	0	13882
25943	1	12938	0	2	0	12941
25944	1	12902	0	5	0	12908
25945	12843	4	25	1	0	12873
25946	5	0	13070	2	0	13077
25947	12827	1	18	7	0	12853
25948	2	18	3	12834	0	12857
25949	2	33	4	12533	0	12572
25950	9	0	12512	1	0	12522
25951	6	0	12453	3	0	12462
25952	0	30	1	12132	0	12163
25953	5	0	12211	2	0	12218
25954	9	0	12503	3	0	12515
25955	2	22	2	12404	0	12430
25956	1	19	0	12681	0	12701
25957	12816	2	11	2	0	12831
25958	1	17	0	12789	0	12807
25959	12755	1	24	0	0	12780
25960	2	12310	0	8	0	12320
25961	1	33	0	12144	0	12178
25962	2	0	12317	1	0	12320
25963	12761	1	17	4	0	12783
25964	12794	0	30	2	0	12826
25965	12824	0	23	0	0	12847
25966	12924	0	23	0	0	12947
25967	12953	2	27	1	0	12983
25968	0	20	0	12929	0	12949
25969	7	0	12716	0	0	12723
25970	10	0	12558	4	0	12572
25971	3	0	12453	3	0	12459
25972	12561	3	23	4	0	12591
25973	12871	0	21	1	0	12893
25974	3	18	0	12699	0	12720
25975	1	11552	0	3	0	11556
25976	1	16	0	11641	0	11658
25977	10	0	11700	0	0	11710
25978	5	1	11954	3	0	11963
25979	12258	0	24	2	0	12284
25980	4	0	13064	2	0	13070
25981	0	11	0	12946	0	12957
25982	13257	0	12	0	0	13269
25983	13408	0	22	5	0	13435
25984	13794	0	22	2	0	13818
25985	13888	1	40	0	0	13929
25986	4	0	13826	0	0	13830
25987	13773	3	59	1	0	13836
25988	1	13676	1	3	0	13681
25989	3	35	2	13372	0	13412
25990	7	0	14292	1	0	14300
25991	2	22	3	14587	0	14614
25992	4	2	14762	0	0	14768
25993	3	42	0	14886	0	14931
25994	5	32	1	14789	0	14827
25995	4	0	16278	0	0	16282
25996	3	19	0	17026	0	17048
25997	17008	0	26	1	0	17035
25998	4	48	1	16895	0	16948
25999	0	25	4	16131	0	16160
26000	16331	0	17	5	0	16353
26001	3	16218	1	4	0	16226
26002	16083	1	23	3	0	16110
26003	1	16047	0	3	0	16051
26004	14514	0	31	5	0	14550
26005	7	0	14913	2	0	14922
26006	1	44	2	15295	0	15342
26007	2	32	1	15315	0	15350
26008	15271	0	9	3	0	15283
26009	1	15378	0	10	0	15389
26010	0	61	2	15313	0	15376
26011	2	46	1	15354	0	15403
26012	2	15269	2	9	0	15282
26013	15330	2	29	4	0	15365
26014	0	15139	0	2	0	15141
26015	2	97	2	14895	0	14996
26016	2	33	0	14913	0	14948
26017	1	14971	1	6	0	14979
26018	14663	1	56	2	0	14722
26019	3	1	14958	2	0	14964
26020	15096	1	30	3	0	15130
26021	1	15031	0	2	0	15034
26022	1	31	1	14921	0	14954
26023	15958	1	8	1	0	15968
26024	5	45	0	15930	0	15980
26025	1	31	0	16170	0	16202
26026	16147	1	12	1	0	16161
26027	3	15840	1	2	0	15846
26028	0	15563	0	9	0	15572
26029	15385	1	19	3	0	15408
26030	11	0	15532	3	0	15546
26031	1	15653	1	17	0	15672
26032	2	46	1	15294	0	15343
26033	19	1	15508	2	0	15530
26034	1	42	0	15605	0	15648
26035	15718	1	15	1	0	15735
26036	1	15535	0	6	0	15542
26037	2	18	2	15305	0	15327
26038	3	15433	0	5	0	15441
26039	14869	2	28	2	0	14901
26040	15512	2	14	3	0	15531
26041	0	15691	0	11	0	15702
26042	3	40	1	15382	0	15426
26043	3	15584	1	13	0	15601
26044	15526	0	21	1	0	15548
26045	15854	2	19	1	0	15876
26046	1	17	1	15901	0	15920
26047	5	20	1	15707	0	15733
26048	2	2	15760	4	0	15768
26049	15589	1	21	4	0	15615
26050	8	0	16212	1	0	16221
26051	5	22	0	16297	0	16324
26052	16168	1	20	1	0	16190
26053	0	15841	0	11	0	15852
26054	15503	1	45	4	0	15553
26055	2	0	15517	2	0	15521
26056	15093	2	58	4	0	15157
26057	3	15247	0	12	0	15262
26058	14969	1	26	4	0	15000
26059	2	14936	0	6	0	14944
26060	4	39	1	14410	0	14454
26061	15	0	14501	1	0	14517
26062	2	0	15025	3	0	15030
26063	4	86	0	14799	0	14889
26064	8	0	14843	1	0	14852
26065	4	33	0	14810	0	14847
26066	1	45	0	13715	0	13761
26067	19	2	13666	4	0	13691
26068	13516	0	25	4	0	13545
26069	13828	1	84	6	0	13919
26070	0	12711	2	10	0	12723
26071	12097	1	17	4	0	12119
26072	1	25	2	12145	0	12173
26073	21	0	11927	2	0	11950
26074	4	22	1	11933	0	11960
26075	2	11	1	11992	0	12006
26076	12008	0	16	0	0	12024
26077	0	12082	0	1	0	12083
26078	8	11821	2	2	0	11833
26079	4	60	1	11771	0	11836
26080	2	19	1	12097	0	12119
26081	1	11906	0	8	0	11915
26082	1	52	1	11799	0	11853
26083	22	24	0	11796	0	11842
26084	1	11649	0	8	0	11658
26085	11727	3	17	2	0	11749
26086	5	42	0	11673	0	11720
26087	0	11864	0	7	0	11871
26088	3	31	0	11845	0	11879
26089	12245	2	16	3	0	12266
26090	2	12387	0	1	0	12390
26091	12187	0	31	1	0	12219
26092	12336	2	23	3	0	12364
26093	1	1	2	12397	0	12401
26094	12675	0	13	0	0	12688
26095	12389	2	19	1	0	12411
26096	12446	2	24	1	0	12473
26097	12469	0	18	2	0	12489
26098	0	12	0	12619	0	12631
26099	1	41	0	11563	0	11605
26100	6	0	11731	2	0	11739
26101	5	14	0	11822	0	11841
26102	15	22	1	11804	0	11842
26103	5	0	11789	1	0	11795
26104	11657	1	27	2	0	11687
26105	2	25	0	11870	0	11897
26106	4	0	11444	2	0	11450
26107	11365	3	34	3	0	11405
26108	1	0	11851	1	0	11853
26109	6	11629	1	9	0	11645
26110	2	12260	1	8	0	12271
26111	5	33	2	12429	0	12469
26112	1	0	12643	1	0	12645
26113	12619	0	17	7	0	12643
26114	12545	0	23	1	0	12569
26115	9	0	12670	0	0	12679
26116	12212	0	15	6	0	12233
26117	12021	0	31	2	0	12054
26118	1	11872	2	3	0	11878
26119	11791	1	24	3	0	11819
26120	0	27	2	11829	0	11858
26121	5	0	11747	3	0	11755
26122	3	30	2	11774	0	11809
26123	5	11661	1	5	0	11672
26124	3	11505	2	8	0	11518
26125	11669	0	12	4	0	11685
26126	11402	0	12	1	0	11415
26127	11382	0	22	0	0	11404
26128	2	16	0	11408	0	11426
26129	4	34	3	11372	0	11413
26130	0	11106	1	2	0	11109
26131	11502	2	38	1	0	11543
26132	0	11358	0	1	0	11359
26133	11704	1	13	2	0	11720
26134	1	11678	0	25	0	11704
26135	11491	4	11	3	0	11509
26136	12001	0	18	0	0	12019
26137	1	10	2	11904	0	11917
26138	4	11494	0	6	0	11504
26139	8	0	11424	3	0	11435
26140	11403	2	17	2	0	11424
26141	1	11483	0	8	0	11492
26142	8	0	11438	1	0	11447
26143	12	0	11519	6	0	11537
26144	0	44	0	11634	0	11678
26145	3	24	0	11310	0	11337
26146	1	11185	1	0	0	11187
26147	11360	2	46	0	0	11408
26148	2	80	2	11322	0	11406
26149	1	11333	0	4	0	11338
26150	0	11321	0	6	0	11327
26151	6	0	11256	3	0	11265
26152	2	0	11121	2	0	11125
26153	10922	2	23	1	0	10948
26154	2	0	11321	3	0	11326
26155	4	18	1	11246	0	11269
26156	0	17	0	11082	0	11099
26157	4	0	11050	2	0	11056
26158	2	21	1	11294	0	11318
26159	2	21	1	11526	0	11550
26160	11472	3	8	2	0	11485
26161	11522	2	22	0	0	11546
26162	4	19	0	11659	0	11682
26163	4	11440	0	8	0	11452
26164	1	11427	1	6	0	11435
26165	10972	3	32	2	0	11009
26166	2	0	10940	1	0	10943
26167	1	23	0	11584	0	11608
26168	11477	0	15	1	0	11493
26169	11464	0	20	0	0	11484
26170	1	18	0	10990	0	11009
26171	12	0	10884	0	0	10896
26172	3	1	11097	0	0	11101
26173	10995	0	27	4	0	11026
26174	11723	0	65	4	0	11792
26175	1	11528	2	8	0	11539
26176	3	11555	0	5	0	11563
26177	11688	0	11	0	0	11699
26178	12040	0	4	0	0	12044
26179	2	21	0	12108	0	12131
26180	2	26	2	12041	0	12071
26181	3	23	0	11940	0	11966
26182	12216	1	9	0	0	12226
26183	2	30	1	11891	0	11924
26184	5	0	11650	0	0	11655
26185	11529	3	20	2	0	11554
26186	0	25	0	10891	0	10916
26187	5	0	10669	1	0	10675
26188	10545	0	16	1	0	10562
26189	10590	0	25	0	0	10615
26190	2	10673	0	2	0	10677
26191	0	10425	0	1	0	10426
26192	439	0	10125	0	0	10564
26193	10541	0	8	4	0	10553
26194	1	10673	0	2	0	10676
26195	5	0	10684	3	0	10692
26196	10720	0	18	1	0	10739
26197	1	10468	0	5	0	10474
26198	8	1	10712	7	0	10728
26199	10962	0	23	3	0	10988
26200	1	11381	0	3	0	11385
26201	1	13	0	11292	0	11306
26202	11405	0	24	1	0	11430
26203	1	11444	1	2	0	11448
26204	1	18	1	11635	0	11655
26205	11522	1	14	5	0	11542
26206	21	0	11530	1	0	11552
26207	1	11374	0	8	0	11383
26208	6	2	11407	1	0	11416
26209	0	25	1	12029	0	12055
26210	6	0	11964	1	0	11971
26211	6	11656	0	22	0	11684
26212	5	11693	0	4	0	11702
26213	1	47	1	12134	0	12183
26214	3	26	1	12228	0	12258
26215	2	53	0	13348	0	13403
26216	1	1	13401	0	0	13403
26217	4	38	0	13482	0	13524
26218	13475	0	16	0	0	13491
26219	13228	1	44	2	0	13275
26220	4	0	13285	1	0	13290
26221	2	13233	1	3	0	13239
26222	13243	0	14	4	0	13261
26223	2	13244	0	4	0	13250
26224	13241	0	12	5	0	13258
26225	13277	4	25	1	0	13307
26226	4	0	13403	0	0	13407
26227	0	13067	0	2	0	13069
26228	1	44	0	13151	0	13196
26229	6	0	13274	0	0	13280
26230	13388	2	23	3	0	13416
26231	2	21	3	13377	0	13403
26232	13	0	13137	1	0	13151
26233	12779	1	51	6	0	12837
26234	7	0	13378	1	0	13386
26235	4	12	0	13179	0	13195
26236	13175	0	11	2	0	13188
26237	0	12862	1	8	0	12871
26238	11	0	12752	1	0	12764
26239	12788	0	23	4	0	12815
26240	12660	0	99	1	0	12760
26241	1	13259	0	7	0	13267
26242	0	17	2	13144	0	13163
26243	1	7	0	12743	0	12751
26244	12720	1	16	1	0	12738
26245	4	48	3	12673	0	12728
26246	51	0	12811	2	0	12864
26247	2	12	0	12943	0	12957
26248	12616	0	24	2	0	12642
26249	1	12720	0	7	0	12728
26250	6	85	2	11685	0	11778
26251	0	11944	0	2	0	11946
26252	11815	1	4	0	0	11820
26253	1	25	0	11587	0	11613
26254	5	19	0	11274	0	11298
26255	3	11212	1	5	0	11221
26256	4	0	11212	0	0	11216
26257	1	40	4	11329	0	11374
26258	2	24	3	11044	0	11073
26259	1	14	1	11381	0	11397
26260	1	11416	0	2	0	11419
26261	13	0	11430	1	0	11444
26262	3	1	11484	1	0	11489
26263	11371	2	15	7	0	11395
26264	11359	2	29	6	0	11396
26265	3	0	11381	2	0	11386
26266	11204	0	25	2	0	11231
26267	1	2	11346	1	0	11350
26268	11234	1	59	5	0	11299
26269	1	11309	0	5	0	11315
26270	11184	1	27	3	0	11215
26271	4	0	11242	0	0	11246
26272	2	0	12023	1	0	12026
26273	2	11	0	12114	0	12127
26274	12308	0	12	2	0	12322
26275	2	12194	0	12	0	12208
26276	5	0	12139	0	0	12144
26277	2	29	1	12201	0	12233
26278	1	42	0	12045	0	12088
26279	12012	3	7	1	0	12023
26280	12013	0	19	1	0	12033
26281	0	9	0	12114	0	12123
26282	12344	0	16	1	0	12361
26283	5	0	12657	1	0	12663
26284	7	24	0	11689	0	11720
26285	2	10	0	11854	0	11866
26286	11764	1	5	0	0	11770
26287	11783	1	9	2	0	11795
26288	2	9	0	11811	0	11822
26289	11156	1	14	0	0	11171
26290	3	0	11256	3	0	11262
26291	1	10171	0	5	0	10177
26292	1	0	10132	1	0	10134
26293	1	10	0	10106	0	10117
26294	10374	4	10	2	0	10390
26295	1	10515	0	3	0	10519
26296	3	41	0	10382	0	10426
26297	0	31	0	10601	0	10632
26298	0	10477	0	3	0	10480
26299	0	33	4	10310	0	10347
26300	0	9	0	10382	0	10391
26301	0	38	0	10245	0	10283
26302	2	15	2	10432	0	10451
26303	1	40	0	10403	0	10444
26304	0	10213	0	3	0	10216
26305	2	67	2	10502	0	10573
26306	0	15	1	10462	0	10478
26307	6	0	10437	0	0	10443
26308	0	10239	0	4	0	10243
26309	0	18	0	10295	0	10313
26310	0	15	0	10403	0	10418
26311	2	26	2	10397	0	10427
26312	0	10493	0	7	0	10500
26313	12	0	10682	0	0	10694
26314	4	16	3	11008	0	11031
26315	11	0	10833	0	0	10844
26316	4	0	11323	4	0	11331
26317	4	12	1	10639	0	10656
26318	10832	2	20	2	0	10856
26319	1	27	2	10747	0	10777
26320	3	33	2	10805	0	10843
26321	1	10755	0	3	0	10759
26322	1	29	1	10588	0	10619
26323	0	39	1	10622	0	10662
26324	7	1	10559	3	0	10570
26325	0	10684	0	3	0	10687
26326	0	13	1	10840	0	10854
26327	10916	1	14	2	0	10933
26328	0	0	10925	0	0	10925
26329	3	27	1	11353	0	11384
26330	0	14	0	11364	0	11378
26331	11635	1	11	1	0	11648
26332	0	11569	0	8	0	11577
26333	11548	2	20	1	0	11571
26334	0	11667	0	2	0	11669
26335	1	19	1	11399	0	11420
26336	11490	0	26	1	0	11517
26337	6	0	11469	0	0	11475
26338	3	11421	1	4	0	11429
26339	3	11448	0	10	0	11461
26340	11524	0	13	0	0	11537
26341	1	23	0	12323	0	12347
26342	2	12183	0	8	0	12193
26343	1	12108	0	3	0	12112
26344	0	32	0	12126	0	12158
26345	0	18	0	12046	0	12064
26346	11998	1	17	0	0	12016
26347	0	11875	0	3	0	11878
26348	2	29	1	11914	0	11946
26349	5	0	11914	4	0	11923
26350	0	11028	3	15	0	11046
26351	8	0	10982	2	0	10992
26352	0	11110	0	5	0	11115
26353	1	23	0	11042	0	11066
26354	1	25	0	11193	0	11219
26355	0	10949	0	3	0	10952
26356	3	2	11021	0	0	11026
26357	10916	1	10	4	0	10931
26358	3	24	3	10376	0	10406
26359	2	21	2	10004	0	10029
26360	4	0	10342	2	0	10348
26361	1	9	1	10251	0	10262
26362	4	0	10325	1	0	10330
26363	5	20	1	10154	0	10180
26364	8	0	10146	7	0	10161
26365	4	9978	4	21	0	10007
26366	7	0	9969	1	0	9977
26367	0	24	2	10120	0	10146
26368	10105	4	10	0	0	10119
26369	0	10075	0	6	0	10081
26370	0	15	1	9732	0	9748
26371	4	0	9792	2	0	9798
26372	0	9808	1	7	0	9816
26373	3	23	3	9715	0	9744
26374	24	0	9899	0	0	9923
26375	4	9929	0	13	0	9946
26376	10699	1	21	1	0	10722
26377	10791	0	15	4	0	10810
26378	1	8	0	10525	0	10534
26379	10580	0	7	0	0	10587
26380	0	18	0	10705	0	10723
26381	2	17	1	10267	0	10287
26382	7	0	10419	1	0	10427
26383	4	27	1	10217	0	10249
26384	0	17	0	10290	0	10307
26385	10347	0	16	1	0	10364
26386	10276	1	34	3	0	10314
26387	1	10346	0	7	0	10354
26388	6	0	10294	0	0	10300
26389	1	6	2	9794	0	9803
26390	5	1	9713	2	0	9721
26391	9348	2	25	4	0	9379
26392	0	0	9432	0	0	9432
26393	1	48	6	9637	0	9692
26394	0	9474	0	0	0	9474
26395	2	26	3	9550	0	9581
26396	2	26	0	9565	0	9593
26397	7	0	9522	3	0	9532
26398	1	29	1	10185	0	10216
26399	10185	0	13	0	0	10198
26400	10011	7	66	3	0	10087
26401	9729	1	14	1	0	9745
26402	9651	5	39	1	0	9696
26403	0	9656	0	3	0	9659
26404	0	9233	0	3	0	9236
26405	1	34	1	9139	0	9175
26406	3	21	1	9175	0	9200
26407	0	9296	0	4	0	9300
26408	1	32	1	9482	0	9516
26409	1	29	2	9701	0	9733
26410	0	15	0	9680	0	9695
26411	4	29	0	9584	0	9617
26412	0	7	1	9822	0	9830
26413	9854	0	12	0	0	9866
26414	0	10632	0	7	0	10639
26415	5	0	10753	0	0	10758
26416	1	34	6	10563	0	10604
26417	1	31	0	9979	0	10011
26418	0	13	3	9963	0	9979
26419	10410	0	6	1	0	10417
26420	0	10316	0	5	0	10321
26421	7	18	0	10279	0	10304
26422	1	10228	1	4	0	10234
26423	5	29	1	9946	0	9981
26424	1	9849	0	6	0	9856
26425	5	0	9895	1	0	9901
26426	5	15	0	9975	0	9995
26427	7	1	10021	1	0	10030
26428	3	20	0	9888	0	9911
26429	0	6	0	9844	0	9850
26430	9673	0	13	1	0	9687
26431	9607	1	6	1	0	9615
26432	9536	1	8	1	0	9546
26433	9579	0	11	0	0	9590
26434	9595	0	14	0	0	9609
26435	1	15	0	9584	0	9600
26436	1	9214	0	6	0	9221
26437	0	13	1	9125	0	9139
26438	3	0	9163	0	0	9166
26439	9162	3	14	2	0	9181
26440	9130	1	16	1	0	9148
26441	2	8	1	9370	0	9381
26442	1	16	2	9208	0	9227
26443	0	9718	0	0	0	9718
26444	2	21	1	9677	0	9701
26445	2	23	1	9666	0	9692
26446	1	9614	0	6	0	9621
26447	1	14	1	9583	0	9599
26448	9599	0	20	2	0	9621
26449	6	1	9595	2	0	9604
26450	9294	0	28	3	0	9325
26451	1	0	9496	0	0	9497
26452	2	13	2	8830	0	8847
26453	5	13	1	8695	0	8714
26454	3	8711	0	7	0	8721
26455	1	8307	0	2	0	8310
26456	2	13	0	8343	0	8358
26457	3	0	8361	1	0	8365
26458	8360	1	15	2	0	8378
26459	2	28	2	8364	0	8396
26460	0	8310	0	1	0	8311
26461	4	107	2	8151	0	8264
26462	3	12	0	8279	0	8294
26463	2	8394	0	3	0	8399
26464	4	9	0	8269	0	8282
26465	5	0	8710	1	0	8716
26466	5	0	8750	5	0	8760
26467	2	12	0	8801	0	8815
26468	2	8668	1	0	0	8671
26469	2	58	1	8508	0	8569
26470	8656	0	7	2	0	8665
26471	8649	0	17	2	0	8668
26472	9244	2	25	2	0	9273
26473	1	9246	0	65	0	9312
26474	0	0	8828	0	0	8828
26475	9098	1	25	2	0	9126
26476	9288	0	52	1	0	9341
26477	0	9301	0	2	0	9303
26478	2	9	0	9273	0	9284
26479	9552	1	12	0	0	9565
26480	9778	1	8	0	0	9787
26481	10378	0	16	0	0	10394
26482	0	4	1	10438	0	10443
26483	10010	0	3	1	0	10014
26484	1	2	0	9986	0	9989
26485	3	7	1	9801	0	9812
26486	10440	0	3	0	0	10443
26487	3	3	1	10431	0	10438
26488	10005	0	0	0	0	10005
26489	0	7	0	10024	0	10031
26490	1	6	2	9359	0	9368
26491	9197	1	0	0	0	9198
26492	2	0	9419	1	0	9422
26493	0	48	1	9254	0	9303
26494	0	17	1	9275	0	9293
26495	0	23	0	8815	0	8838
26496	0	18	1	8805	0	8824
26497	1	13	0	8801	0	8815
26498	0	8767	0	1	0	8768
26499	0	13	1	8714	0	8728
26500	3	0	8908	0	0	8911
26501	1	15	0	9135	0	9151
26502	2	22	1	9115	0	9140
26503	0	14	1	9097	0	9112
26504	9	0	9069	2	0	9080
26505	4	0	9081	1	0	9086
26506	9148	0	11	1	0	9160
26507	9280	1	26	0	0	9307
26508	1	9390	0	5	0	9396
26509	2	15	1	9498	0	9516
26510	2	12	0	9484	0	9498
26511	1	9	0	9611	0	9621
26512	9629	1	13	3	0	9646
26513	9908	0	7	4	0	9919
26514	2	10	0	9952	0	9964
26515	2	19	0	9929	0	9950
26516	4	4	0	10040	0	10048
26517	1	4	0	9922	0	9927
26518	9997	1	9	2	0	10009
26519	3	1	9447	0	0	9451
26520	4	10127	0	11	0	10142
26521	4	10404	0	4	0	10412
26522	10243	0	20	2	0	10265
26523	3	7	1	10337	0	10348
26524	11	1	10359	1	0	10372
26525	2	0	10391	2	0	10395
26526	2	10283	0	10	0	10295
26527	10206	0	25	2	0	10233
26528	3	0	10326	1	0	10330
26529	10515	1	19	6	0	10541
26530	1	28	0	11011	0	11040
26531	2	19	1	11083	0	11105
26532	3	11091	0	4	0	11098
26533	2	11081	1	1	0	11085
26534	11096	1	25	1	0	11123
26535	11218	0	38	1	0	11257
26536	0	11161	0	13	0	11174
26537	8	0	11054	2	0	11064
26538	3	0	12100	6	0	12109
26539	0	10	1	12201	0	12212
26540	12390	0	15	5	0	12410
26541	1	12169	0	4	0	12174
26542	5	12	0	12151	0	12168
26543	12205	0	20	1	0	12226
26544	1	25	3	12118	0	12147
26545	0	20	1	12060	0	12081
26546	12016	0	13	0	0	12029
26547	0	12193	0	2	0	12195
26548	3	11395	0	10	0	11408
26549	6	2	11447	0	0	11455
26550	1	13	0	11162	0	11176
26551	1	16	0	10867	0	10884
26552	0	0	10650	1	0	10651
26553	11070	0	12	4	0	11086
26554	11064	0	40	0	0	11104
26555	1	0	10727	1	0	10729
26556	10397	1	34	4	0	10436
26557	2	0	10193	0	0	10195
26558	1	9966	1	10	0	9978
26559	4	14	0	10025	0	10043
26560	5	6	0	10324	0	10335
26561	10351	0	8	1	0	10360
26562	9732	1	9	2	0	9744
26563	9731	1	16	1	0	9749
26564	9734	1	15	1	0	9751
26565	9644	1	21	3	0	9669
26566	3	0	9473	2	0	9478
26567	1	9455	0	3	0	9459
26568	2	8	2	9472	0	9484
26569	8	9671	0	1	0	9680
26570	0	9692	0	5	0	9697
26571	1	41	3	9812	0	9857
26572	5	23	1	9940	0	9969
26573	3	0	10054	3	0	10060
26574	10081	0	29	1	0	10111
26575	10227	0	24	1	0	10252
26576	2	10285	0	6	0	10293
26577	9916	1	22	3	0	9942
26578	10162	2	28	2	0	10194
26579	4	9	1	10438	0	10452
26580	9	0	10441	2	0	10452
26581	3	1	10844	3	0	10851
26582	10665	0	21	5	0	10691
26583	10708	0	31	4	0	10743
26584	4	10711	0	3	0	10718
26585	1	10713	0	5	0	10719
26586	2	7	0	10972	0	10981
26587	11239	0	5	1	0	11245
26588	2	0	11585	0	0	11587
26589	2	4	0	11532	0	11538
26590	11326	0	10	0	0	11336
26591	11302	1	31	0	0	11334
26592	3	13	1	12057	0	12074
26593	12012	0	9	2	0	12023
26594	3	0	11929	0	0	11932
26595	2	0	11890	2	0	11894
26596	1	18	7	11444	0	11470
26597	1	20	3	11620	0	11644
26598	2	28	2	11737	0	11769
26599	2	11682	0	2	0	11686
26600	0	11667	0	2	0	11669
26601	5	7	0	11678	0	11690
26602	11736	0	6	3	0	11745
26603	1	22	1	11609	0	11633
26604	2	22	0	11581	0	11605
26605	2	11516	0	5	0	11523
26606	0	11075	2	4	0	11081
26607	6	24	3	11021	0	11054
26608	0	13	0	11171	0	11184
26609	11176	0	16	1	0	11193
26610	0	11178	0	2	0	11180
26611	10970	0	43	5	0	11018
26612	1	20	0	10986	0	11007
26613	1	0	10808	1	0	10810
26614	4	0	10137	0	0	10141
26615	10101	1	15	4	0	10121
26616	0	15	0	9939	0	9954
26617	2	19	0	9696	0	9717
26618	4	13	1	9729	0	9747
26619	7	0	9993	1	0	10001
26620	9	5	0	10074	0	10088
26621	1	9883	0	1	0	9885
26622	4	13	1	10211	0	10229
26623	0	20	1	10071	0	10092
26624	0	10082	0	1	0	10083
26625	3	10	1	10082	0	10096
26626	10117	1	15	0	0	10133
26627	1	10262	0	6	0	10269
26628	9850	1	14	1	0	9866
26629	9875	1	8	2	0	9886
26630	2	5	0	9764	0	9771
26631	2	17	0	9755	0	9774
26632	1	20	0	9710	0	9731
26633	2	1	9812	0	0	9815
26634	3	9759	0	15	0	9777
26635	2	9888	0	6	0	9896
26636	1	36	1	9664	0	9702
26637	9746	0	18	1	0	9765
26638	0	19	0	9847	0	9866
26639	7	0	9925	1	0	9933
26640	3	9950	2	45	0	10000
26641	1	9976	0	9	0	9986
26642	9804	2	20	5	0	9831
26643	9813	0	13	3	0	9829
26644	1	9636	0	6	0	9643
26645	9584	1	28	3	0	9616
26646	3	0	9905	0	0	9908
26647	2	0	10147	0	0	10149
26648	9867	1	14	1	0	9883
26649	9776	0	35	1	0	9812
26650	1	6	0	9881	0	9888
26651	9835	0	20	1	0	9856
26652	2	0	9795	0	0	9797
26653	4	0	9828	0	0	9832
26654	1	31	3	9518	0	9553
26655	0	12	0	9217	0	9229
26656	1	21	1	8854	0	8877
26657	1	4	1	8937	0	8943
26658	2	13	0	8925	0	8940
26659	9	1	9563	1	0	9574
26660	4	4	2	9618	0	9628
26661	9532	0	10	1	0	9543
26662	1	7	0	9298	0	9306
26663	8878	1	1	0	0	8880
26664	1	57	2	8943	0	9003
26665	8920	0	0	0	0	8920
26666	8919	0	3	0	0	8922
26667	0	13	1	8924	0	8938
26668	3	9	1	8096	0	8109
26669	8269	0	4	2	0	8275
26670	8175	2	6	1	0	8184
26671	1	0	8209	0	0	8210
26672	0	14	0	8257	0	8271
26673	0	8	0	7872	0	7880
26674	7796	2	5	0	0	7803
26675	7886	0	1	3	0	7890
26676	3	15	2	7929	0	7949
26677	0	18	1	7910	0	7929
26678	1	19	2	7868	0	7890
26679	1	11	0	7925	0	7937
26680	1	7819	0	2	0	7822
26681	2	7722	0	1	0	7725
26682	3	26	0	7682	0	7711
26683	1	7643	0	3	0	7647
26684	6	12	3	7640	0	7661
26685	9	0	7801	1	0	7811
26686	3	1	7810	3	0	7817
26687	0	7880	0	4	0	7884
26688	2	10	0	7873	0	7885
26689	3	0	8392	0	0	8395
26690	1	11	0	8428	0	8440
26691	1	4	0	8440	0	8445
26692	8420	1	24	0	0	8445
26693	1	8	0	8422	0	8431
26694	6	0	8380	0	0	8386
26695	5	1	8203	2	0	8211
26696	2	8118	2	6	0	8128
26697	2	8148	0	5	0	8155
26698	7816	1	14	1	0	7832
26699	6	0	7857	0	0	7863
26700	1	4	0	7941	0	7946
26701	8036	2	4	1	0	8043
26702	8247	0	19	0	0	8266
26703	0	8213	0	1	0	8214
26704	3	17	3	8024	0	8047
26705	1	12	0	8050	0	8063
26706	0	8	0	8290	0	8298
26707	8401	0	15	1	0	8417
26708	4	1	8412	2	0	8419
26709	1	8151	0	6	0	8158
26710	1	9	0	8128	0	8138
26711	0	14	0	8352	0	8366
26712	2	0	8620	0	0	8622
26713	5	21	0	8719	0	8745
26714	3	15	0	8638	0	8656
26715	2	14	0	8600	0	8616
26716	0	18	2	8501	0	8521
26717	5	0	8437	7	0	8449
26718	3	17	0	8505	0	8525
26719	1	0	8468	1	0	8470
26720	0	8357	0	3	0	8360
26721	1	14	0	8284	0	8299
26722	2	6	0	8302	0	8310
26723	1	0	8031	1	0	8033
26724	1	8110	1	4	0	8116
26725	0	14	1	8233	0	8248
26726	9	0	8384	2	0	8395
26727	2	8115	0	7	0	8124
26728	0	10	0	8173	0	8183
26729	4	0	8293	0	0	8297
26730	3	12	249	8182	0	8446
26731	4	7	1	8647	0	8659
26732	0	9	0	8638	0	8647
26733	8516	0	12	0	0	8528
26734	0	7831	2	8	0	7841
26735	7614	0	15	0	0	7629
26736	9	0	8003	1	0	8013
26737	8203	0	17	1	0	8221
26738	8272	0	34	1	0	8307
26739	1	9	0	8368	0	8378
26740	8079	0	2	0	0	8081
26741	8176	0	14	2	0	8192
26742	8202	0	13	2	0	8217
26743	0	30	0	8225	0	8255
26744	3	10	1	8233	0	8247
26745	2	1	7980	1	0	7984
26746	0	1	7923	0	0	7924
26747	7978	1	7	4	0	7990
26748	5	10	1	7943	0	7959
26749	0	7894	0	9	0	7903
26750	8453	1	18	2	0	8474
26751	5	8484	0	6	0	8495
26752	3	8504	0	56	0	8563
26753	5	0	8556	0	0	8561
26754	0	0	8773	2	0	8775
26755	1	16	0	8625	0	8642
26756	1	1	8485	0	0	8487
26757	3	0	8570	0	0	8573
26758	8665	0	20	3	0	8688
26759	8684	2	21	1	0	8708
26760	0	17	0	8739	0	8756
26761	1	20	1	8566	0	8588
26762	3	0	8593	0	0	8596
26763	1	7845	0	13	0	7859
26764	0	4	0	7870	0	7874
26765	7942	0	7	3	0	7952
26766	1	13	2	7929	0	7945
26767	2	8077	0	1	0	8080
26768	9	1	8115	0	0	8125
26769	0	8184	0	9	0	8193
26770	8185	1	9	4	0	8199
26771	8094	0	13	0	0	8107
26772	0	5	0	8055	0	8060
26773	6	0	8308	1	0	8315
26774	5	0	8715	2	0	8722
26775	0	8611	0	7	0	8618
26776	0	9	0	8634	0	8643
26777	2	22	0	8851	0	8875
26778	2	0	9140	2	0	9144
26779	1	17	2	9072	0	9092
26780	0	9178	0	1	0	9179
26781	2	14	1	9242	0	9259
26782	0	19	0	9198	0	9217
26783	3	0	9013	1	0	9017
26784	4	6	0	9053	0	9063
26785	8991	1	19	1	0	9012
26786	11	9	9148	2	0	9170
26787	4	0	8802	4	0	8810
26788	2	8614	0	5	0	8621
26789	1	15	4	8485	0	8505
26790	1	15	0	8475	0	8491
26791	4	0	8529	0	0	8533
26792	8813	1	15	1	0	8830
26793	3	13	1	8856	0	8873
26794	2	0	8862	0	0	8864
26795	3	12	2	8567	0	8584
26796	4	0	8515	0	0	8519
26797	7	0	8538	2	0	8547
26798	2	8514	0	5	0	8521
26799	4	10	0	8582	0	8596
26800	0	8718	1	3	0	8722
26801	8619	0	28	3	0	8650
26802	2	0	8580	0	0	8582
26803	2	8686	0	8	0	8696
26804	2	9	3	8743	0	8757
26805	8685	0	8	1	0	8694
26806	1	8579	1	10	0	8591
26807	1	35	2	8514	0	8552
26808	3	44	0	8607	0	8654
26809	0	8799	1	3	0	8803
26810	8615	1	5	4	0	8625
26811	1	13	2	8599	0	8615
26812	1	16	1	8182	0	8200
26813	4	0	8246	2	0	8252
26814	1	8124	0	1	0	8126
26815	2	12	1	8000	0	8015
26816	2	19	0	8062	0	8083
26817	0	8302	0	1	0	8303
26818	0	45	0	8566	0	8611
26819	0	16	0	8751	0	8767
26820	0	8	0	8728	0	8736
26821	0	8668	0	4	0	8672
26822	8419	2	20	0	0	8441
26823	4	1	8644	0	0	8649
26824	8804	1	242	3	0	9050
26825	0	9328	0	3	0	9331
26826	0	4	1	8883	0	8888
26827	3	0	9487	0	0	9490
26828	1	9	7	9399	0	9416
26829	2	8	1	9442	0	9453
26830	0	5	1	9268	0	9274
26831	14	0	9620	1	0	9635
26832	3	10277	1	7	0	10288
26833	5	3	8702	1624	0	10334
26834	0	10228	3	3	0	10234
26835	6	0	10286	0	0	10292
26836	2	26	1	11781	0	11810
26837	11775	1	26	0	0	11802
26838	0	11726	0	2	0	11728
26839	9	0	11736	0	0	11745
26840	0	12153	0	5	0	12158
26841	4	1	12162	1	0	12168
26842	0	29	3	12373	0	12405
26843	1	16	0	12300	0	12317
26844	2	12799	1	12	0	12814
26845	2	12685	0	5	0	12692
26846	12773	9	22	5	0	12809
26847	1	21	0	12760	0	12782
26848	6	0	12845	3	0	12854
26849	3	10	0	12373	0	12386
26850	9	0	12312	2	0	12323
26851	5	0	12399	3	0	12407
26852	5	48	1	13294	0	13348
26853	0	12734	0	8	0	12742
26854	12945	0	12	4	0	12961
26855	1	22	0	12967	0	12990
26856	0	9	0	12840	0	12849
26857	2	12787	0	4	0	12793
26858	12650	0	24	3	0	12677
26859	13114	2	33	5	0	13154
26860	0	18	1	13217	0	13236
26861	1	13171	0	6	0	13178
26862	1	13099	0	9	0	13109
26863	12970	0	17	2	0	12989
26864	1	2	13031	3	0	13037
26865	12976	7	55	7	0	13045
26866	13540	1	25	2	0	13568
26867	13564	1	34	1	0	13600
26868	0	13636	0	3	0	13639
26869	3	31	0	13531	0	13565
26870	13576	1	16	1	0	13594
26871	13736	2	19	1	0	13758
26872	1	13729	0	7	0	13737
26873	13722	1	32	1	0	13756
26874	0	19	3	13722	0	13744
26875	3	12	0	13446	0	13461
26876	1	14326	0	4	0	14331
26877	3	43	0	14037	0	14083
26878	0	36	1	14184	0	14221
26879	0	14326	1	1	0	14328
26880	3	35	0	14021	0	14059
26881	2	14429	0	5	0	14436
26882	14350	3	52	0	0	14405
26883	14515	1	21	0	0	14537
26884	0	14445	0	8	0	14453
26885	7	1	14387	2	0	14397
26886	4	16	1	14493	0	14514
26887	11	1	14354	7	0	14373
26888	2	14923	1	11	0	14937
26889	1	14943	0	13	0	14957
26890	14970	16	25	5	0	15016
26891	2	15148	0	4	0	15154
26892	3	42	1	14871	0	14917
26893	3	15564	0	7	0	15574
26894	2	15179	0	10	0	15191
26895	15069	0	81	7	0	15157
26896	6	19	2	15272	0	15299
26897	13	0	15162	1	0	15176
26898	6	2	15472	9	0	15489
26899	9	15805	2	26	0	15842
26900	15629	1	21	2	0	15653
26901	1	14945	0	2	0	14948
26902	4	10	0	14660	0	14674
26903	16674	4	14	1	0	16693
26904	0	41	0	16637	0	16678
26905	2	26	0	16626	0	16654
26906	2	16264	0	2	0	16268
26907	12	44	2	15656	0	15714
26908	14	1	15958	2	0	15975
26909	16390	1	61	6	0	16458
26910	0	16339	0	4	0	16343
26911	3	15606	0	8	0	15617
26912	14518	4	22	5	0	14549
26913	1	0	14583	2	0	14586
26914	14819	1	24	1	0	14845
26915	1	14459	0	3	0	14463
26916	1	14680	0	6	0	14687
26917	15	2	14557	3	0	14577
26918	1	16631	0	2	0	16634
26919	3	50	1	16588	0	16642
26920	5	64	2	16869	0	16940
26921	0	17017	1	5	0	17023
26922	2	24	0	16988	0	17014
26923	16960	4	23	2	0	16989
26924	4	0	16901	3	0	16908
26925	16729	5	30	2	0	16766
26926	16706	4	47	2	0	16759
26927	15528	1	41	1	0	15571
26928	1	0	15631	0	0	15632
26929	4	27	1	15977	0	16009
26930	11	1	15780	1	0	15793
26931	15763	0	38	4	0	15805
26932	15850	0	41	4	0	15895
26933	1	15654	1	4	0	15660
26934	5	119	0	15608	0	15732
26935	0	16263	1	10	0	16274
26936	7	2	16258	1	0	16268
26937	4	20	0	16488	0	16512
26938	16523	0	25	2	0	16550
26939	16516	0	18	3	0	16537
26940	2	12	0	16605	0	16619
26941	0	16471	0	6	0	16477
26942	12	0	16120	3	0	16135
26943	1	0	16299	3	0	16303
26944	15765	3	36	8	0	15812
26945	13	0	16062	1	0	16076
26946	2	18019	1	43	0	18065
26947	0	36	6	18007	0	18049
26948	4	0	18233	3	0	18240
26949	2	42	3	18099	0	18146
26950	10	1	18043	2	0	18056
26951	18210	1	42	4	0	18257
26952	5	55	2	17405	0	17467
26953	2	17487	0	10	0	17499
26954	2	17556	0	9	0	17567
26955	1	40	2	17842	0	17885
26956	2	34	2	17911	0	17949
26957	1	17729	1	6	0	17737
26958	16	1	17770	1	0	17788
26959	1	20	3	17769	0	17793
26960	19	0	17635	3	0	17657
26961	15	1	17641	4	0	17661
26962	17879	0	219	9	0	18107
26963	2	18380	2	4	0	18388
26964	17946	1	29	0	0	17976
26965	1	35	2	18431	0	18469
26966	1	18353	0	8	0	18362
26967	3	72	4	18268	0	18347
26968	5	35	0	18537	0	18577
26969	0	18319	0	12	0	18331
26970	9	1	18379	0	0	18389
26971	0	15	1	18640	0	18656
26972	18542	1	25	0	0	18568
26973	7	28	1	18736	0	18772
26974	5	46	7	17534	0	17592
26975	32	0	17703	1	0	17736
26976	0	16125	1	10	0	16136
26977	4	19	2	15931	0	15956
26978	13	2	15864	0	0	15879
26979	11	1	15872	6	0	15890
26980	16082	0	71	2	0	16155
26981	2	16103	0	19	0	16124
26982	15842	3	58	2	0	15905
26983	2	15846	2	9	0	15859
26984	1	15446	0	10	0	15457
26985	16820	2	30	1	0	16853
26986	8	41	3	16731	0	16783
26987	2	16841	0	5	0	16848
26988	2	17	3	16782	0	16804
26989	16705	0	28	2	0	16735
26990	3	0	16681	2	0	16686
26991	9	0	16640	5	0	16654
26992	16371	3	19	5	0	16398
26993	2	15486	1	4	0	15493
26994	11	2	13544	3	0	13560
26995	2	13602	0	4	0	13608
26996	0	23	2	13498	0	13523
26997	7	0	13568	1	0	13576
26998	3	35	2	13524	0	13564
26999	10	1	13506	1	0	13518
27000	13582	3	49	3	0	13637
27001	3	13781	0	6	0	13790
27002	14024	0	25	1	0	14050
27003	10	32	2	14136	0	14180
27004	2	13533	0	7	0	13542
27005	13468	6	50	4	0	13528
27006	13445	1	13	3	0	13462
27007	3	0	13435	0	0	13438
27008	4	0	13419	3	0	13426
27009	13217	2	43	3	0	13265
27010	5	12746	0	5	0	12756
27011	1	12556	0	3	0	12560
27012	2	23	1	12410	0	12436
27013	8	1	13282	1	0	13292
27014	0	13289	1	9	0	13299
27015	3	13300	0	3	0	13306
27016	2	4	0	13272	0	13278
27017	13291	0	11	1	0	13303
27018	13259	1	26	1	0	13287
27019	13064	0	39	1	0	13104
27020	2	1	13143	2	0	13148
27021	12659	1	21	2	0	12683
27022	10681	0	29	0	0	10710
27023	10707	0	12	3	0	10722
27024	2	23	1	10626	0	10652
27025	0	10659	0	3	0	10662
27026	10489	4	17	2	0	10512
27027	0	10496	0	2	0	10498
27028	1	23	0	10273	0	10297
27029	6	0	10325	1	0	10332
27030	9	31	3	10398	0	10441
27031	1	13	0	10281	0	10295
27032	6	0	10300	2	0	10308
27033	4	10341	2	2	0	10349
27034	4	22	2	10582	0	10610
27035	10603	0	16	0	0	10619
27036	0	10350	0	3	0	10353
27037	10202	0	18	0	0	10220
27038	2	29	2	9893	0	9926
27039	0	9728	1	7	0	9736
27040	9605	3	10	1	0	9619
27041	0	9140	1	3	0	9144
27042	3	0	8842	4	0	8849
27043	8849	2	15	2	0	8868
27044	8731	1	20	1	0	8753
27045	0	8733	1	2	0	8736
27046	1	1	8510	1	0	8513
27047	1	8555	0	6	0	8562
27048	2	30	0	9123	0	9155
27049	1	13	0	9276	0	9290
27050	3	27	0	9336	0	9366
27051	0	9163	0	1	0	9164
27052	0	11	2	9115	0	9128
27053	1	4	1	9292	0	9298
27054	9229	0	8	0	0	9237
27055	0	7	0	9271	0	9278
27056	0	5	0	9171	0	9176
27057	9182	0	6	0	0	9188
27058	0	9124	0	2	0	9126
27059	9002	0	9	2	0	9013
27060	9033	0	5	1	0	9039
27061	8010	0	5	1	0	8016
27062	0	2	1	8086	0	8089
27063	0	8	0	8157	0	8165
27064	6	0	8153	1	0	8160
27065	0	0	8129	3	0	8132
27066	8	0	8130	2	0	8140
27067	7960	0	9	1	0	7970
27068	2	0	8261	0	0	8263
27069	0	8672	0	2	0	8674
27070	1	1688	2	6908	0	8599
27071	1	16	1	8689	0	8707
27072	3	8603	1	38	0	8645
27073	6	0	8622	3	0	8631
27074	0	8766	0	2	0	8768
27075	8685	2	16	6	0	8709
27076	4	0	8948	0	0	8952
27077	0	8711	1	2	0	8714
27078	3	0	9223	0	0	9226
27079	0	11	1	9279	0	9291
27080	2	0	9333	1	0	9336
27081	3	72	0	9419	0	9494
27082	9443	0	6	0	0	9449
27083	3	0	9459	2	0	9464
27084	1	9493	0	2	0	9496
27085	9379	2	10	2	0	9393
27086	3	0	9386	1	0	9390
27087	5	0	9770	1	0	9776
27088	7	111	1	9669	0	9788
27089	3	0	8984	0	0	8987
27090	8997	1	18	3	0	9019
27091	1	9008	0	3	0	9012
27092	5	11	2	8898	0	8916
27093	0	8973	0	2	0	8975
27094	8919	0	8	1	0	8928
27095	0	0	9016	0	0	9016
27096	2	0	9091	0	0	9093
27097	1	36	0	9164	0	9201
27098	3	13	0	9106	0	9122
27099	1	12	1	9417	0	9431
27100	3	9	0	9366	0	9378
27101	6	0	9465	0	0	9471
27102	0	9276	0	4	0	9280
27103	0	23	0	9227	0	9250
27104	9	1	9449	0	0	9459
27105	0	9332	0	25	0	9357
27106	9449	0	17	2	0	9468
27107	0	8	0	9439	0	9447
27108	9335	0	11	2	0	9348
27109	0	9290	0	0	0	9290
27110	8968	1	6	1	0	8976
27111	6	0	9020	0	0	9026
27112	1	24	0	9390	0	9415
27113	1	9149	0	4	0	9154
27114	7	1	9159	0	0	9167
27115	1	9847	0	0	0	9848
27116	1	13	8	9928	0	9950
27117	9939	2	47	3	0	9991
27118	0	9911	0	2	0	9913
27119	9829	0	16	4	0	9849
27120	6	0	9922	1	0	9929
27121	4	0	10157	1	0	10162
27122	10024	1	12	1	0	10038
27123	1	7	0	10019	0	10027
27124	3	9	0	9288	0	9300
27125	5	1	9196	1	0	9203
27126	7	1	9210	2	0	9220
27127	2	9187	0	6	0	9195
27128	9262	0	23	1	0	9286
27129	9292	0	12	1	0	9305
27130	0	9476	0	1	0	9477
27131	1	2	0	9481	0	9484
27132	9525	1	9	1	0	9536
27133	2	8	0	9502	0	9512
27134	9450	0	5	0	0	9455
27135	9478	1	14	0	0	9493
27136	10017	2	16	0	0	10035
27137	0	8	2	9844	0	9854
27138	0	2	0	9728	0	9730
27139	9492	0	6	1	0	9499
27140	9511	1	12	0	0	9524
27141	9686	2	26	2	0	9716
27142	0	9715	0	3	0	9718
27143	9603	1	14	2	0	9620
27144	0	9464	0	4	0	9468
27145	8760	0	24	1	0	8785
27146	1	0	8867	0	0	8868
27147	8873	0	16	1	0	8890
27148	1	8952	0	3	0	8956
27149	0	8818	0	4	0	8822
27150	8736	0	7	1	0	8744
27151	1	22	1	9179	0	9203
27152	1	20	1	8981	0	9003
27153	0	8672	0	0	0	8672
27154	1	8699	0	6	0	8706
27155	8492	0	5	1	0	8498
27156	4	0	8436	0	0	8440
27157	0	20	0	8717	0	8737
27158	8700	3	9	0	0	8712
27159	3	0	8615	1	0	8619
27160	2	8228	2	3	0	8235
27161	8125	0	8	2	0	8135
27162	2	0	8187	1	0	8190
27163	1	19	1	9375	0	9396
27164	4	0	9310	3	0	9317
27165	9424	1	33	4	0	9462
27166	1	9531	0	0	0	9532
27167	9702	0	15	3	0	9720
27168	9840	0	13	0	0	9853
27169	0	12	1	9781	0	9794
27170	9777	0	5	1	0	9783
27171	2	34	1	10174	0	10211
27172	4	30	1	10203	0	10238
27173	6	0	10250	2	0	10258
27174	1	10356	1	5	0	10363
27175	8	36	2	10047	0	10093
27176	1	17	0	10278	0	10296
27177	0	12	1	10138	0	10151
27178	5	0	10150	5	0	10160
27179	2	10140	1	2	0	10145
27180	5	15	0	10247	0	10267
27181	1	25	0	10207	0	10233
27182	4	1	10282	0	0	10287
27183	2	14	0	10562	0	10578
27184	10577	0	10	2	0	10589
27185	2	10549	0	5	0	10556
27186	10254	1	26	6	0	10287
27187	7	0	10382	1	0	10390
27188	1	13	0	10413	0	10427
27189	10327	0	3	1	0	10331
27190	10286	2	12	1	0	10301
27191	2	0	9684	0	0	9686
27192	4	29	2	9565	0	9600
27193	3	1	9542	1	0	9547
27194	9462	0	24	11	0	9497
27195	0	9833	0	6	0	9839
27196	9467	0	12	2	0	9481
27197	9482	0	37	0	0	9519
27198	0	9521	0	1	0	9522
27199	9346	0	21	2	0	9369
27200	1	0	9332	2	0	9335
27201	9191	1	12	2	0	9206
27202	1	19	1	9211	0	9232
27203	4	0	9319	0	0	9323
27204	2	34	1	9234	0	9271
27205	7	34	1	9105	0	9147
27206	0	22	1	8849	0	8872
27207	1	8770	0	8	0	8779
27208	8817	2	8	2	0	8829
27209	10	28	0	8784	0	8822
27210	0	8382	0	2	0	8384
27211	2	97	1	8216	0	8316
27212	1	8233	0	2	0	8236
27213	4	0	8234	0	0	8238
27214	4	17	2	8254	0	8277
27215	1	18	0	8239	0	8258
27216	1	0	8145	4	0	8150
27217	8178	2	11	2	0	8193
27218	2	8365	0	4	0	8371
27219	0	34	1	8331	0	8366
27220	0	14	1	8504	0	8519
27221	1	25	1	8504	0	8531
27222	2	8415	0	2	0	8419
27223	8424	0	9	3	0	8436
27224	5	0	8452	1	0	8458
27225	3	0	8451	0	0	8454
27226	1	20	0	8326	0	8347
27227	0	5	0	8247	0	8252
27228	8781	1	8	0	0	8790
27229	1	9138	0	6	0	9145
27230	1	13	1	9189	0	9204
27231	9252	0	9	2	0	9263
27232	2	11	2	9247	0	9262
27233	8853	0	23	0	0	8876
27234	1	0	8898	0	0	8899
27235	1	8868	0	0	0	8869
27236	8762	2	8	0	0	8772
27237	2	0	8789	0	0	8791
27238	7656	2	15	1	0	7674
27239	0	0	8003	0	0	8003
27240	7886	1	13	4	0	7904
27241	1	6	0	7944	0	7951
27242	7882	2	6	0	0	7890
27243	1	15	1	7801	0	7818
27244	1	7	1	7679	0	7688
27245	7771	0	2	1	0	7774
27246	2	7694	0	1	0	7697
27247	1	10	1	7186	0	7198
27248	7037	0	6	0	0	7043
27249	6895	1	3	1	0	6900
27250	0	4	0	6979	0	6983
27251	0	1	2	6965	0	6968
27252	6923	0	1	1	0	6925
27253	0	4	0	6845	0	6849
27254	0	4	0	6661	0	6665
27255	6598	0	3	0	0	6601
27256	0	16	0	6497	0	6513
27257	0	0	6471	0	0	6471
27258	6153	0	7	1	0	6161
27259	2	1	5995	0	0	5998
27260	5	1	6170	2	0	6178
27261	6079	0	7	1	0	6087
27262	0	6210	0	1	0	6211
27263	0	21	0	6152	0	6173
27264	0	3	0	6184	0	6187
27265	0	11	0	6184	0	6195
27266	1	6	0	6213	0	6220
27267	6184	4	1	0	0	6189
27268	6149	1	11	2	0	6163
27269	6135	1	18	0	0	6154
27270	0	0	6172	0	0	6172
27271	0	24	1	5953	0	5978
27272	0	15	1	5984	0	6000
27273	3	12	0	5970	0	5985
27274	2	5989	0	2	0	5993
27275	0	6005	0	3	0	6008
27276	6089	0	2	0	0	6091
27277	0	15	0	6074	0	6089
27278	0	17	0	6060	0	6077
27279	0	7	1	5990	0	5998
27280	2	0	5962	0	0	5964
27281	3	0	6015	1	0	6019
27282	6000	0	7	1	0	6008
27283	6066	1	10	0	0	6077
27284	0	24	0	6100	0	6124
27285	0	6189	0	0	0	6189
27286	7	17	0	6239	0	6263
27287	1	6	0	6385	0	6392
27288	2	0	6363	3	0	6368
27289	6388	1	9	1	0	6399
27290	1	16	1	6527	0	6545
27291	0	6	0	6540	0	6546
27292	6450	0	6	0	0	6456
27293	0	6475	0	1	0	6476
27294	6470	0	6	0	0	6476
27295	2	14	1	6927	0	6944
27296	0	6793	0	0	0	6793
27297	6799	1	11	0	0	6811
27298	1	7	0	6814	0	6822
27299	6795	1	2	0	0	6798
27300	6849	0	13	1	0	6863
27301	6830	1	22	0	0	6853
27302	1	6998	0	1	0	7000
27303	0	6172	0	1	0	6173
27304	3	17	0	5742	0	5762
27305	0	5781	0	2	0	5783
27306	5756	2	5	1	0	5764
27307	4	2	0	5719	0	5725
27308	5745	1	7	0	0	5753
27309	5868	0	5	1	0	5874
27310	0	5	0	5817	0	5822
27311	0	1	0	5609	0	5610
27312	5595	0	0	1	0	5596
27313	5526	2	6	2	0	5536
27314	5618	0	4	0	0	5622
27315	5415	1	1	0	0	5417
27316	5341	1	9	1	0	5352
27317	1	2	1	5328	0	5332
27318	2	1	1	5184	0	5188
27319	0	4	0	5133	0	5137
27320	5276	1	4	0	0	5281
27321	0	8	0	5199	0	5207
27322	0	5131	0	0	0	5131
27323	1	10	0	5076	0	5087
27324	5088	0	3	0	0	5091
27325	5000	0	9	1	0	5010
27326	3	0	5273	0	0	5276
27327	0	14	0	5351	0	5365
27328	1	5472	0	2	0	5475
27329	5420	1	18	1	0	5440
27330	0	5515	0	1	0	5516
27331	1	6	0	5518	0	5525
27332	5582	0	5	0	0	5587
27333	5609	0	8	1	0	5618
27334	0	5607	0	1	0	5608
27335	2	6	1	5483	0	5492
27336	344	0	5180	1	0	5525
27337	5335	1	34	5	0	5375
27338	1	0	5586	1	0	5588
27339	5523	0	68	0	0	5591
27340	5621	0	12	3	0	5636
27341	1	7	0	5764	0	5772
27342	5876	0	3	0	0	5879
27343	5860	1	7	0	0	5868
27344	5876	0	1	0	0	5877
27345	1	7	0	5860	0	5868
27346	5856	0	2	0	0	5858
27347	0	14	0	5688	0	5702
27348	0	18	1	5623	0	5642
27349	0	5659	0	3	0	5662
27350	2	17	1	5520	0	5540
27351	1	6083	0	2	0	6086
27352	6196	0	4	1	0	6201
27353	6328	0	10	1	0	6339
27354	1	14	1	6316	0	6332
27355	0	2	0	6332	0	6334
27356	6322	1	4	0	0	6327
27357	1	2	6671	1	0	6675
27358	6751	0	10	0	0	6761
27359	1	12	0	6740	0	6753
27360	3	0	6617	1	0	6621
27361	6588	1	9	4	0	6602
27362	6570	0	10	1	0	6581
27363	2	0	6509	0	0	6511
27364	6515	0	14	0	0	6529
27365	2	0	6563	3	0	6568
27366	0	6551	1	1	0	6553
27367	6758	0	14	1	0	6773
27368	6848	1	51	0	0	6900
27369	1	6773	0	4	0	6778
27370	0	6383	0	2	0	6385
27371	6421	0	14	0	0	6435
27372	6467	0	6	0	0	6473
27373	0	23	1	6505	0	6529
27374	9	0	6546	0	0	6555
27375	3	0	6688	2	0	6693
27376	6388	0	17	2	0	6407
27377	4	0	6513	2	0	6519
27378	6218	0	11	3	0	6232
27379	0	16	0	6294	0	6310
27380	0	19	0	6199	0	6218
27381	0	0	6490	0	0	6490
27382	6513	0	10	1	0	6524
27383	3	7	0	7158	0	7168
27384	3	10	0	7104	0	7117
27385	6993	0	7	2	0	7002
27386	6955	1	10	0	0	6966
27387	6969	1	26	0	0	6996
27388	0	6988	0	6	0	6994
27389	4	1	6973	0	0	6978
27390	6836	0	14	1	0	6851
27391	6908	0	13	2	0	6923
27392	0	6997	0	1	0	6998
27393	7193	0	23	1	0	7217
27394	0	6	0	7346	0	7352
27395	2	1	7321	0	0	7324
27396	7192	1	11	1	0	7205
27397	7254	0	9	0	0	7263
27398	7234	1	18	3	0	7256
27399	7280	1	5	2	0	7288
27400	1	3	0	7555	0	7559
27401	0	10	0	7467	0	7477
27402	7414	0	2	1	0	7417
27403	0	8	0	7418	0	7426
27404	1	15	1	7169	0	7186
27405	0	7329	0	0	0	7329
27406	0	28	0	7239	0	7267
27407	1	52	0	7286	0	7339
27408	2	28	1	7257	0	7288
27409	0	16	1	7415	0	7432
27410	0	7447	1	1	0	7449
27411	0	17	0	7381	0	7398
27412	2	11	0	7433	0	7446
27413	3	0	7405	2	0	7410
27414	2	0	7019	2	0	7023
27415	3	7086	0	8	0	7097
27416	7112	1	19	3	0	7135
27417	0	7238	0	4	0	7242
27418	2	27	2	7234	0	7265
27419	2	0	7731	0	0	7733
27420	7741	0	14	2	0	7757
27421	0	8	2	7784	0	7794
27422	7753	1	6	0	0	7760
27423	7687	1	8	2	0	7698
27424	0	7824	0	1	0	7825
27425	7842	0	8	1	0	7851
27426	0	7630	0	2	0	7632
27427	3	8	0	7311	0	7322
27428	3	7241	0	3	0	7247
27429	3	0	7239	1	0	7243
27430	1	7428	0	6	0	7435
27431	0	7	0	7439	0	7446
27432	7765	0	8	1	0	7774
27433	1	7520	0	3	0	7524
27434	1	10	0	7517	0	7528
27435	0	23	0	7461	0	7484
27436	4	0	7453	0	0	7457
27437	1	7	0	7412	0	7420
27438	3	0	7320	3	0	7326
27439	7232	2	27	2	0	7263
27440	4	0	7460	0	0	7464
27441	1	7316	0	1	0	7318
27442	1	19	0	7277	0	7297
27443	0	8	2	7484	0	7494
27444	1	7	0	7408	0	7416
27445	7265	2	9	1	0	7277
27446	2	14	1	7250	0	7267
27447	0	7147	0	1	0	7148
27448	7185	1	34	2	0	7222
27449	0	7838	0	5	0	7843
27450	1	20	1	7854	0	7876
27451	8080	4	18	2	0	8104
27452	1	8054	0	1	0	8056
27453	0	8138	0	9	0	8147
27454	8130	1	9	2	0	8142
27455	8093	2	11	0	0	8106
27456	3	0	8242	3	0	8248
27457	7902	1	42	0	0	7945
27458	7	0	8130	0	0	8137
27459	1	10	1	7482	0	7494
27460	10	0	8049	1	0	8060
27461	1	29	1	8141	0	8172
27462	2	0	8242	1	0	8245
27463	1	63	0	8217	0	8281
27464	0	4	0	8267	0	8271
27465	8139	1	7	0	0	8147
27466	1	0	8152	0	0	8153
27467	8406	0	27	2	0	8435
27468	1	0	8515	1	0	8517
27469	1	1	8787	3	0	8792
27470	0	11	1	8686	0	8698
27471	8601	2	18	3	0	8624
27472	2	8658	0	2	0	8662
27473	8688	2	25	3	0	8718
27474	8763	0	32	2	0	8797
27475	2	8773	0	3	0	8778
27476	8080	0	428	2	0	8510
27477	8	0	8588	0	0	8596
27478	0	11	0	8404	0	8415
27479	8478	0	11	0	0	8489
27480	1	8554	0	1	0	8556
27481	3	22	0	8435	0	8460
27482	4	7	2	8444	0	8457
27483	1	11	0	8523	0	8535
27484	1	3	0	8688	0	8692
27485	8515	2	1	0	0	8518
27486	8449	1	20	1	0	8471
27487	8475	1	6	0	0	8482
27488	8415	0	20	4	0	8439
27489	1	1	8404	0	0	8406
27490	8343	0	17	1	0	8361
27491	8459	1	23	1	0	8484
27492	0	8369	0	4	0	8373
27493	1	7927	0	5	0	7933
27494	3	26	2	8035	0	8066
27495	0	12	0	8004	0	8016
27496	8	0	7981	1	0	7990
27497	0	8069	0	6	0	8075
27498	2	13	0	7989	0	8004
27499	1	8612	1	0	0	8614
27500	3	17	0	8525	0	8545
27501	6	22	0	8528	0	8556
27502	0	8367	0	2	0	8369
27503	2	50	3	8297	0	8352
27504	3	1	8380	0	0	8384
27505	2	0	8517	4	0	8523
27506	8306	0	15	4	0	8325
27507	8389	1	34	1	0	8425
27508	0	7996	0	3	0	7999
27509	8193	3	9	0	0	8205
27510	0	2	0	8493	0	8495
27511	8539	0	6	0	0	8545
27512	0	8530	0	6	0	8536
27513	2	0	8478	1	0	8481
27514	8100	2	160	4	0	8266
27515	5	0	8291	2	0	8298
27516	2	0	8329	1	0	8332
27517	5	0	8279	2	0	8286
27518	3	8230	0	4	0	8237
27519	8111	0	11	3	0	8125
27520	8333	0	6	2	0	8341
27521	1	16	1	8323	0	8341
27522	2	15	1	8310	0	8328
27523	4	8300	0	9	0	8313
27524	8382	2	22	1	0	8407
27525	2	7718	0	2	0	7722
27526	1	7595	0	8	0	7604
27527	7718	0	8	1	0	7727
27528	1	24	1	7705	0	7731
27529	0	11	3	7596	0	7610
27530	4	9	1	7614	0	7628
27531	1	7457	0	1	0	7459
27532	7434	0	7	0	0	7441
27533	2	21	1	7568	0	7592
27534	1	7894	0	0	0	7895
27535	1	7437	0	3	0	7441
27536	1	18	0	7302	0	7321
27537	0	7275	0	5	0	7280
27538	2	13	0	7263	0	7278
27539	7273	0	4	0	0	7277
27540	3	0	7286	0	0	7289
27541	0	6921	0	6	0	6927
27542	2	4	0	6790	0	6796
27543	0	0	6831	0	0	6831
27544	6806	0	17	2	0	6825
27545	1	4	1	6719	0	6725
27546	6812	0	15	1	0	6828
27547	6823	1	19	0	0	6843
27548	0	6887	0	2	0	6889
27549	6870	1	9	2	0	6882
27550	6969	0	12	0	0	6981
27551	6954	1	13	1	0	6969
27552	0	7	4	6865	0	6876
27553	0	3	0	6918	0	6921
27554	0	16	1	6935	0	6952
27555	5	0	6932	0	0	6937
27556	0	6805	0	5	0	6810
27557	6804	1	13	1	0	6819
27558	1	6657	0	3	0	6661
27559	2	11	3	6687	0	6703
27560	3	1	7071	2	0	7077
27561	7103	0	17	0	0	7120
27562	1	7102	1	2	0	7106
27563	0	12	0	7114	0	7126
27564	2	12	0	7120	0	7134
27565	1	0	7230	1	0	7232
27566	1	7297	0	4	0	7302
27567	2	14	1	7281	0	7298
27568	1	16	0	7341	0	7358
27569	0	11	0	7283	0	7294
27570	7136	1	7	0	0	7144
27571	6	1	7150	2	0	7159
27572	0	7112	0	9	0	7121
27573	7626	0	13	3	0	7642
27574	1	7283	0	3	0	7287
27575	0	10	0	7006	0	7016
27576	0	7234	0	3	0	7237
27577	7191	0	13	1	0	7205
27578	7310	1	6	1	0	7318
27579	0	7	4	7307	0	7318
27580	1	18	0	7229	0	7248
27581	1	9	0	7272	0	7282
27582	0	0	7393	1	0	7394
27583	0	7368	0	1	0	7369
27584	4	12	1	7300	0	7317
27585	0	3	0	7209	0	7212
27586	0	4	1	7000	0	7005
27587	2	5	0	7065	0	7072
27588	0	0	7057	1	0	7058
27589	0	7025	0	5	0	7030
27590	0	6	0	7097	0	7103
27591	3	19	1	7223	0	7246
27592	3	0	7288	1	0	7292
27593	2	10	1	7373	0	7386
27594	1	7372	2	5	0	7380
27595	0	7202	0	3	0	7205
27596	0	5	0	7118	0	7123
27597	2	0	7081	0	0	7083
27598	7080	1	31	1	0	7113
27599	1	7107	0	4	0	7112
27600	5	0	6926	2	0	6933
27601	1	0	6956	2	0	6959
27602	2	6794	1	48	0	6845
27603	1	0	6895	0	0	6896
27604	1	3	0	7087	0	7091
27605	7059	0	1	1	0	7061
27606	7084	12	4	2	0	7102
27607	7081	0	19	0	0	7100
27608	7324	5	18	1	0	7348
27609	0	7103	0	4	0	7107
27610	6855	1	19	3	0	6878
27611	0	6862	0	3	0	6865
27612	1	0	6899	0	0	6900
27613	2	12	0	6999	0	7013
27614	0	6947	0	3	0	6950
27615	0	11	0	7012	0	7023
27616	7083	0	5	3	0	7091
27617	2	6	0	7056	0	7064
27618	0	7004	0	1	0	7005
27619	6898	1	25	1	0	6925
27620	2	0	7003	0	0	7005
27621	1	7	1	7063	0	7072
27622	0	4	0	6919	0	6923
27623	6971	1	3	0	0	6975
27624	0	6721	0	2	0	6723
27625	1	0	6689	2	0	6692
27626	2	43	0	6579	0	6624
27627	9	0	6532	2	0	6543
27628	1	6673	0	7	0	6681
27629	0	6593	0	7	0	6600
27630	6501	0	8	4	0	6513
27631	4	0	6464	1	0	6469
27632	6475	1	8	1	0	6485
27633	10	10	2	6499	0	6521
27634	0	6529	0	5	0	6534
27635	6331	2	14	0	0	6347
27636	0	0	6062	0	0	6062
27637	0	9	1	6084	0	6094
27638	0	16	1	6033	0	6050
27639	2	9	0	6336	0	6347
27640	1	6364	0	1	0	6366
27641	6568	1	17	3	0	6589
27642	1	6526	0	0	0	6527
27643	0	6496	0	1	0	6497
27644	0	11	2	6494	0	6507
27645	6399	1	5	2	0	6407
27646	6422	3	27	1	0	6453
27647	6518	0	8	1	0	6527
27648	0	6393	0	2	0	6395
27649	0	5	0	6348	0	6353
27650	2	0	6475	0	0	6477
27651	4	16	1	7161	0	7182
27652	4	13	2	7172	0	7191
27653	0	7208	0	6	0	7214
27654	7180	0	6	0	0	7186
27655	0	19	1	7164	0	7184
27656	1	7203	0	2	0	7206
27657	7068	1	15	3	0	7087
27658	0	0	7118	0	0	7118
27659	7133	3	30	1	0	7167
27660	1	7168	0	3	0	7172
27661	7191	3	31	2	0	7227
27662	7165	1	14	0	0	7180
27663	1	0	7102	0	0	7103
27664	7152	1	25	1	0	7179
27665	0	0	7203	0	0	7203
27666	1	0	7138	1	0	7140
27667	6810	2	7	0	0	6819
27668	6700	0	14	3	0	6717
27669	2	0	6744	0	0	6746
27670	0	18	1	6814	0	6833
27671	0	19	0	6968	0	6987
27672	2	7004	0	1	0	7007
27673	7010	1	19	0	0	7030
27674	6918	0	109	0	0	7027
27675	1	1	7106	0	0	7108
27676	7411	0	17	0	0	7428
27677	7317	1	20	0	0	7338
27678	0	7276	0	1	0	7277
27679	0	21	0	7012	0	7033
27680	2	14	2	7046	0	7064
27681	0	8	0	7146	0	7154
27682	7152	0	3	0	0	7155
27683	1	7131	1	0	0	7133
27684	3	10	0	6859	0	6872
27685	1	6848	0	0	0	6849
27686	1	9	1	6735	0	6746
27687	0	6771	0	4	0	6775
27688	0	6667	0	3	0	6670
27689	6756	0	8	2	0	6766
27690	6808	0	1	0	0	6809
27691	0	7	0	6713	0	6720
27692	0	8	1	6633	0	6642
27693	2	9	0	6652	0	6663
27694	1	17	0	6558	0	6576
27695	0	5	1	6613	0	6619
27696	0	6541	0	17	0	6558
27697	2	11	0	6468	0	6481
27698	1	7	1	6491	0	6500
27699	6627	1	8	1	0	6637
27700	0	6	0	6638	0	6644
27701	0	8	3	6743	0	6754
27702	1	0	6652	0	0	6653
27703	0	11	0	6624	0	6635
27704	0	5	1	6550	0	6556
27705	3	0	6533	2	0	6538
27706	1	6632	1	4	0	6638
27707	6	0	6643	1	0	6650
27708	5	0	6721	3	0	6729
27709	7	6696	0	5	0	6708
27710	6906	1	11	0	0	6918
27711	7028	0	24	2	0	7054
27712	0	6	0	7014	0	7020
27713	7015	0	11	0	0	7026
27714	1	0	7111	0	0	7112
27715	0	16	0	7021	0	7037
27716	2	0	7042	0	0	7044
27717	2	11	4	6826	0	6843
27718	3	9	0	7273	0	7285
27719	0	10	0	7293	0	7303
27720	7251	0	3	0	0	7254
27721	0	19	0	7167	0	7186
27722	7097	0	35	0	0	7132
27723	7091	3	20	1	0	7115
27724	0	7183	0	4	0	7187
27725	6624	0	16	1	0	6641
27726	0	6509	0	0	0	6509
27727	1	11	3	5711	0	5726
27728	1	8	0	5745	0	5754
27729	2	7	0	5672	0	5681
27730	2	1	5702	0	0	5705
27731	2	5797	0	2	0	5801
27732	2	12	1	5726	0	5741
27733	6	10	1	5732	0	5749
27734	3	5574	0	2	0	5579
27735	5544	3	16	0	0	5563
27736	0	6047	0	2	0	6049
27737	6020	0	24	1	0	6045
27738	0	6159	0	2	0	6161
27739	1	11	0	5930	0	5942
27740	1	5996	0	3	0	6000
27741	6073	0	5	2	0	6080
27742	6169	1	16	1	0	6187
27743	6292	1	4	0	0	6297
27744	6268	0	19	3	0	6290
27745	1	1	6183	0	0	6185
27746	6097	0	23	0	0	6120
27747	5958	0	27	1	0	5986
27748	5903	0	20	0	0	5923
27749	3	0	5885	0	0	5888
27750	5841	6	17	1	0	5865
27751	0	5787	0	0	0	5787
27752	5375	0	26	7	0	5408
27753	0	0	5399	0	0	5399
27754	6228	0	12	0	0	6240
27755	6262	0	22	1	0	6285
27756	0	5	0	6247	0	6252
27757	1	0	6220	0	0	6221
27758	6219	0	9	0	0	6228
27759	0	3	2	6449	0	6454
27760	1	40	0	6677	0	6718
27761	2	0	6611	1	0	6614
27762	6589	0	19	1	0	6609
27763	6589	1	8	0	0	6598
27764	0	6597	0	1	0	6598
27765	1	34	0	6464	0	6499
27766	0	33	0	6656	0	6689
27767	1	7	1	6653	0	6662
27768	0	6739	0	2	0	6741
27769	6825	0	7	1	0	6833
27770	1	7	0	6784	0	6792
27771	1	3	0	6718	0	6722
27772	6641	0	8	0	0	6649
27773	6638	0	14	1	0	6653
27774	1	12	0	6765	0	6778
27775	1	11	0	6608	0	6620
27776	4	0	6589	1	0	6594
27777	6492	0	7	2	0	6501
27778	0	6519	0	1	0	6520
27779	1	7	0	6861	0	6869
27780	2	16	0	6807	0	6825
27781	0	6893	0	2	0	6895
27782	1	4	1	6842	0	6848
27783	6860	1	4	0	0	6865
27784	1	5	0	6792	0	6798
27785	0	7	0	6704	0	6711
27786	0	11	0	6594	0	6605
27787	1	0	6446	2	0	6449
27788	0	9	0	6588	0	6597
27789	3	0	6559	2	0	6564
27790	0	6248	0	2	0	6250
27791	5	24	0	6048	0	6077
27792	1	5	0	6147	0	6153
27793	1	11	0	6221	0	6233
27794	2	8	3	5915	0	5928
27795	0	9	1	5935	0	5945
27796	5828	0	6	0	0	5834
27797	3	0	5868	0	0	5871
27798	0	6150	0	1	0	6151
27799	0	6075	0	2	0	6077
27800	0	13	2	5934	0	5949
27801	1	8	1	5963	0	5973
27802	4	5	1	5926	0	5936
27803	0	6055	0	1	0	6056
27804	0	17	0	6091	0	6108
27805	3	0	6134	0	0	6137
27806	0	6136	1	0	0	6137
27807	2	3	2	5969	0	5976
27808	6056	0	9	2	0	6067
27809	2	9	0	6014	0	6025
27810	3	8	0	6033	0	6044
27811	2	6015	0	1	0	6018
27812	0	5391	0	1	0	5392
27813	1	10	0	5594	0	5605
27814	0	5	0	5606	0	5611
27815	1	0	5751	0	0	5752
27816	1	7	1	5751	0	5760
27817	0	7	0	5682	0	5689
27818	0	11	1	5577	0	5589
27819	1	4	0	5542	0	5547
27820	5521	0	2	2	0	5525
27821	5534	0	2	0	0	5536
27822	1	2	0	5542	0	5545
27823	0	5	1	5491	0	5497
27824	5250	0	4	0	0	5254
27825	1	7	0	4913	0	4921
27826	8	0	4976	0	0	4984
27827	1	5036	0	1	0	5038
27828	3	8	0	4816	0	4827
27829	0	1	0	4818	0	4819
27830	4837	0	6	0	0	4843
27831	4	14	0	4820	0	4838
27832	2	6	0	4813	0	4821
27833	4875	0	3	2	0	4880
27834	3	15	0	4800	0	4818
27835	0	4680	0	1	0	4681
27836	0	9	1	4359	0	4369
27837	1	6	1	4312	0	4320
27838	0	8	0	4306	0	4314
27839	2	2	0	4285	0	4289
27840	4	0	4266	1	0	4271
27841	0	0	4283	1	0	4284
27842	0	7	0	4132	0	4139
27843	0	6	1	4174	0	4181
27844	0	4088	0	0	0	4088
27845	4	7	0	3991	0	4002
27846	1	4043	0	1	0	4045
27847	4086	0	8	0	0	4094
27848	0	4110	0	0	0	4110
27849	0	5	2	4117	0	4124
27850	1	6	1	4023	0	4031
27851	1	0	4018	0	0	4019
27852	4479	1	8	2	0	4490
27853	4465	0	8	0	0	4473
27854	1	4505	0	1	0	4507
27855	0	9	0	4134	0	4143
27856	8	1	4105	0	0	4114
27857	2	4297	0	4	0	4303
27858	4430	0	7	0	0	4437
27859	4421	0	12	3	0	4436
27860	64	0	4350	0	0	4414
27861	4658	0	5	2	0	4665
27862	2	2	2	4689	0	4695
27863	1	4617	0	1	0	4619
27864	4603	0	7	0	0	4610
27865	0	9	0	4581	0	4590
27866	4559	0	13	0	0	4572
27867	4516	0	23	0	0	4539
27868	0	5	1	4722	0	4728
27869	0	0	4664	0	0	4664
27870	4542	0	12	2	0	4556
27871	4507	0	7	0	0	4514
27872	4535	0	10	2	0	4547
27873	1	4523	0	0	0	4524
27874	0	8	0	4377	0	4385
27875	1	6	0	4402	0	4409
27876	1	0	4370	0	0	4371
27877	0	3	1	4442	0	4446
27878	0	4297	1	6	0	4304
27879	4621	1	12	1	0	4635
27880	1	4892	0	12	0	4905
27881	5	1	4877	0	0	4883
27882	4	5057	0	3	0	5064
27883	0	5084	0	2	0	5086
27884	1	3	0	5339	0	5343
27885	5317	1	7	0	0	5325
27886	5409	2	11	0	0	5422
27887	5507	1	9	0	0	5517
27888	1	5529	0	2	0	5532
27889	1	1	5265	0	0	5267
27890	5146	1	18	1	0	5166
27891	4974	0	17	2	0	4993
27892	1	4957	0	6	0	4964
27893	4974	0	2	0	0	4976
27894	0	8	0	4955	0	4963
27895	0	0	4887	0	0	4887
27896	4837	1	13	1	0	4852
27897	4806	0	5	1	0	4812
27898	4820	0	17	0	0	4837
27899	0	5	0	4775	0	4780
27900	0	2	0	4749	0	4751
27901	0	6	0	4698	0	4704
27902	0	4562	0	1	0	4563
27903	1	10	0	4571	0	4582
27904	0	4	0	4574	0	4578
27905	3	0	4577	0	0	4580
27906	2	3	8	4498	0	4511
27907	0	14	0	4494	0	4508
27908	0	9	0	4483	0	4492
27909	1	6	1	4376	0	4384
27910	1	4347	0	0	0	4348
27911	2	5	0	4312	0	4319
27912	2	76	1	4246	0	4325
27913	4325	1	5	3	0	4334
27914	0	0	4298	0	0	4298
27915	5	0	4284	0	0	4289
27916	4296	0	10	1	0	4307
27917	4282	0	13	0	0	4295
27918	1	5	2	4193	0	4201
27919	0	4076	0	1	0	4077
27920	4095	1	11	1	0	4108
27921	2	5	1	4081	0	4089
27922	0	4096	0	1	0	4097
27923	4071	0	17	2	0	4090
27924	0	4022	0	2	0	4024
27925	3970	0	20	0	0	3990
27926	3966	0	14	0	0	3980
27927	1	3979	0	2	0	3982
27928	0	5	2	3444	0	3451
27929	2	0	3470	0	0	3472
27930	0	3	4	3290	0	3297
27931	3281	0	7	1	0	3289
27932	1	0	3266	0	0	3267
27933	1	3010	0	5	0	3016
27934	0	2	1	2916	0	2919
27935	4	0	2852	0	0	2856
27936	0	2574	0	2	0	2576
27937	2591	1	2	0	0	2594
27938	0	6	1	2566	0	2573
27939	1	9	1	2454	0	2465
27940	1	7	1	2445	0	2454
27941	3	2416	0	2	0	2421
27942	2396	0	8	1	0	2405
27943	0	2395	0	1	0	2396
27944	3	2121	0	1	0	2125
27945	2042	0	5	2	0	2049
27946	2021	1	2	2	0	2026
27947	0	0	2031	0	0	2031
27948	2005	0	0	1	0	2006
27949	1992	0	0	0	0	1992
27950	0	0	0	1805	0	1805
27951	0	0	1784	0	0	1784
27952	0	0	0	1751	0	1751
27953	1669	0	0	0	0	1669
27954	0	0	1661	0	0	1661
27955	0	0	0	1269	0	1269
27956	0	0	0	898	0	898
27957	0	0	0	860	0	860
27958	604	0	0	0	0	604
27959	0	600	0	0	0	600
27960	276	0	0	0	0	276
27961	0	0	247	0	0	247
27962	0	0	0	70	0	70
27963	0	3	0	0	0	3
27964	3	0	0	0	0	3
27965	0	0	0	3	0	3
27966	0	0	3	0	0	3
27967	0	0	0	3	0	3
27968	2	0	0	0	0	2
27969	0	0	0	0	0
27970	0	0	0	0	0
27971	0	0	0	0	0
27972	0	0	0	0	0
27973	0	0	0	0	0
27974	0	0	0	0	0
27975	0	0	0	0	0
27976	0	0	0	0	0
27977	0	0	0	0	0
27978	0	0	0	0	0
27979	0	0	0	0	0
27980	0	0	0	0	0
27981	0	0	0	0	0
27982	0	0	0	0	0
27983	0	0	0	0	0
27984	0	0	0	0	0
27985	0	0	0	0	0
27986	0	0	0	0	0
27987	0	0	0	0	0
27988	0	0	0	0	0
27989	0	0	0	0	0
27990	0	0	0	0	0
27991	0	0	0	0	0
27992	0	0	0	0	0
27993	0	0	0	0	0
27994	0	0	0	0	0
27995	0	0	0	0	0
27996	0	0	0	0	0
27997	0	0	0	0	0
27998	0	0	0	0	0
27999	0	0	0	0	0
28000	0	0	0	0	0
28001	0	0	0	0	0
28002	0	0	0	0	0
28003	0	0	0	0	0
28004	0	0	0	0	0
28005	0	0	0	0	0
28006	0	0	0	0	0
28007	0	0	0	0	0
28008	0	0	0	0	0
28009	0	0	0	0	0
28010	0	0	0	0	0
28011	0	0	0	0	0
28012	0	0	0	0	0
28013	0	0	0	0	0
28014	0	0	0	0	0
28015	0	0	0	0	0
28016	0	0	0	0	0
28017	0	0	0	0	0
28018	0	0	0	0	0
28019	0	0	0	0	0
28020	0	0	0	0	0
28021	0	0	0	0	0
28022	0	0	0	0	0
28023	0	0	0	0	0
28024	0	0	0	0	0
28025	0	0	0	0	0
28026	0	0	0	0	0
28027	0	0	0	0	0
28028	0	0	0	0	0
28029	0	0	0	0	0
28030	0	0	0	0	0
28031	0	0	0	0	0
28032	0	0	0	0	0
28033	0	0	0	0	0
28034	0	0	0	0	0
28035	0	0	0	0	0
28036	0	0	0	0	0
28037	0	0	0	0	0
28038	0	0	0	0	0
28039	0	0	0	0	0
28040	0	0	0	0	0
28041	0	0	0	0	0
28042	0	0	0	0	0
28043	0	0	0	0	0
28044	0	0	0	0	0
28045	0	0	0	0	0
28046	0	0	0	0	0
28047	0	0	0	0	0
28048	0	0	0	0	0
28049	0	0	0	0	0
28050	0	0	0	0	0
28051	0	0	0	0	0
28052	0	0	0	0	0
28053	0	0	0	0	0
28054	0	0	0	0	0
28055	0	0	0	0	0
28056	0	0	0	0	0
28057	0	0	0	0	0
28058	0	0	0	0	0
28059	0	0	0	0	0
28060	0	0	0	0	0
28061	0	0	0	0	0
28062	0	0	0	0	0
28063	0	0	0	0	0
28064	0	0	0	0	0
28065	0	0	0	0	0
28066	0	0	0	0	0
28067	0	0	0	0	0
28068	0	0	0	0	0
28069	0	0	0	0	0
28070	0	0	0	0	0
28071	0	0	0	0	0
28072	0	0	0	0	0
28073	0	0	0	0	0
28074	0	0	0	0	0
28075	0	0	0	0	0
28076	0	0	0	0	0
28077	0	0	0	0	0
28078	0	0	0	0	0
28079	0	0	0	0	0
28080	0	0	0	0	0
28081	0	0	0	0	0
28082	0	0	0	0	0
28083	0	0	0	0	0
28084	0	0	0	0	0
28085	0	0	0	0	0
28086	0	0	0	0	0
28087	0	0	0	0	0
28088	0	0	0	0	0
28089	0	0	0	0	0
28090	0	0	0	0	0
28091	0	0	0	0	0
28092	0	0	0	0	0
28093	0	0	0	0	0
28094	0	0	0	0	0
28095	0	0	0	0	0
28096	0	0	0	0	0
28097	0	0	0	0	0
28098	0	0	0	0	0
28099	0	0	0	0	0
28100	0	0	0	0	0
28101	0	0	0	0	0
28102	0	0	0	0	0
28103	0	0	0	0	0
28104	0	0	0	0	0
28105	0	0	0	0	0
28106	0	0	0	0	0
28107	0	0	0	0	0
28108	0	0	0	0	0
28109	0	0	0	0	0
28110	0	0	0	0	0
28111	0	0	0	0	0
28112	0	0	0	0	0
28113	0	0	0	0	0
28114	0	0	0	0	0
28115	0	0	0	0	0
28116	0	0	0	0	0
28117	0	0	0	0	0
28118	0	0	0	0	0
28119	0	0	0	0	0
28120	0	0	0	0	0
28121	0	0	0	0	0
28122	0	0	0	0	0
28123	0	0	0	0	0
28124	0	0	0	0	0
28125	0	0	0	0	0
28126	0	0	0	0	0
28127	0	0	0	0	0
28128	0	0	0	0	0
28129	0	0	0	0	0
28130	0	0	0	0	0
28131	0	0	0	0	0
28132	0	0	0	0	0
28133	0	0	0	0	0
28134	0	0	0	0	0
28135	0	0	0	0	0
28136	0	0	0	0	0
28137	0	0	0	0	0
28138	0	0	0	0	0
28139	0	0	0	0	0
28140	0	0	0	0	0
28141	0	0	0	0	0
28142	0	0	0	0	0
28143	0	0	0	0	0
28144	0	0	0	0	0
28145	0	0	0	0	0
28146	0	0	0	0	0
28147	0	0	0	0	0
28148	0	0	0	0	0
28149	0	0	0	0	0
28150	0	0	0	0	0
28151	0	0	0	0	0
28152	0	0	0	0	0
28153	0	0	0	0	0
28154	0	0	0	0	0
28155	0	0	0	0	0
28156	0	0	0	0	0
28157	0	0	0	0	0
28158	0	0	0	0	0
28159	0	0	0	0	0
28160	0	0	0	0	0
28161	0	0	0	0	0
28162	0	0	0	0	0
28163	0	0	0	0	0
28164	0	0	0	0	0
28165	0	0	0	0	0
28166	0	0	0	0	0
28167	0	0	0	0	0
28168	0	0	0	0	0
28169	0	0	0	0	0
28170	0	0	0	0	0
28171	0	0	0	0	0
28172	0	0	0	0	0
28173	0	0	0	0	0
28174	0	0	0	0	0
28175	0	0	0	0	0
28176	0	0	0	0	0
28177	0	0	0	0	0
28178	0	0	0	0	0
28179	0	0	0	0	0
28180	0	0	0	0	0
28181	0	0	0	0	0
28182	0	0	0	0	0
28183	0	0	0	0	0
28184	0	0	0	0	0
28185	0	0	0	0	0
28186	0	0	0	0	0
28187	0	0	0	0	0
28188	0	0	0	0	0
28189	0	0	0	0	0
28190	0	0	0	0	0
28191	0	0	0	0	0
28192	0	0	0	0	0
28193	0	0	0	0	0
28194	0	0	0	0	0
28195	0	0	0	0	0
28196	0	0	0	0	0
28197	0	0	0	0	0
28198	0	0	0	0	0
28199	0	0	0	0	0
28200	0	0	0	0	0
28201	0	0	0	0	0
28202	0	0	0	0	0
28203	0	0	0	0	0
28204	0	0	0	0	0
28205	0	0	0	0	0
28206	0	0	0	0	0
28207	0	0	0	0	0
28208	0	0	0	0	0
28209	0	0	0	0	0
28210	0	0	0	0	0
28211	0	0	0	0	0
28212	0	0	0	0	0
28213	0	0	0	0	0
28214	0	0	0	0	0
28215	0	0	0	0	0
28216	0	0	0	0	0
28217	0	0	0	0	0
28218	0	0	0	0	0
28219	0	0	0	0	0
28220	0	0	0	0	0
28221	0	0	0	0	0
28222	0	0	0	0	0
28223	0	0	0	0	0
28224	0	0	0	0	0
28225	0	0	0	0	0
28226	0	0	0	0	0
28227	0	0	0	0	0
28228	0	0	0	0	0
28229	0	0	0	0	0
28230	0	0	0	0	0
28231	0	0	0	0	0
28232	0	0	0	0	0
28233	0	0	0	0	0
28234	0	0	0	0	0
28235	0	0	0	0	0
28236	0	0	0	0	0
28237	0	0	0	0	0
28238	0	0	0	0	0
28239	0	0	0	0	0
28240	0	0	0	0	0
28241	0	0	0	0	0
28242	0	0	0	0	0
28243	0	0	0	0	0
28244	0	0	0	0	0
28245	0	0	0	0	0
28246	0	0	0	0	0
28247	0	0	0	0	0
28248	0	0	0	0	0
28249	0	0	0	0	0
28250	0	0	0	0	0
28251	0	0	0	0	0
28252	0	0	0	0	0
28253	0	0	0	0	0
28254	0	0	0	0	0
28255	0	0	0	0	0
28256	0	0	0	0	0
28257	0	0	0	0	0
28258	0	0	0	0	0
28259	0	0	0	0	0
28260	0	0	0	0	0
28261	0	0	0	0	0
28262	0	0	0	0	0
28263	0	0	0	0	0
28264	0	0	0	0	0
28265	0	0	0	0	0
28266	0	0	0	0	0
28267	0	0	0	0	0
28268	0	0	0	0	0
28269	0	0	0	0	0
28270	0	0	0	0	0
28271	0	0	0	0	0
28272	0	0	0	0	0
28273	0	0	0	0	0
28274	0	0	0	0	0
28275	0	0	0	0	0
28276	0	0	0	0	0
28277	0	0	0	0	0
28278	0	0	0	0	0
28279	0	0	0	0	0
28280	0	0	0	0	0
28281	0	0	0	0	0
28282	0	0	0	0	0
28283	0	0	0	0	0
28284	0	0	0	0	0
28285	0	0	0	0	0
28286	0	0	0	0	0
28287	0	0	0	0	0
28288	0	0	0	0	0
28289	0	0	0	0	0
28290	0	0	0	0	0
28291	0	0	0	0	0
28292	0	0	0	0	0
28293	0	0	0	0	0
28294	0	0	0	0	0
28295	0	0	0	0	0
28296	0	0	0	0	0
28297	0	0	0	0	0
28298	0	0	0	0	0
28299	0	0	0	0	0
28300	0	0	0	0	0
28301	0	0	0	0	0
28302	0	0	0	0	0
28303	0	0	0	0	0
28304	0	0	0	0	0
28305	0	0	0	0	0
28306	0	0	0	0	0
28307	0	0	0	0	0
28308	0	0	0	0	0
28309	0	0	0	0	0
28310	0	0	0	0	0
28311	0	0	0	0	0
28312	0	0	0	0	0
28313	0	0	0	0	0
28314	0	0	0	0	0
28315	0	0	0	0	0
28316	0	0	0	0	0
28317	0	0	0	0	0
28318	0	0	0	0	0
28319	0	0	0	0	0
28320	0	0	1	0	0	1
28321	0	0	0	1	0	1
28322	0	0	0	1	0	1
28323	0	0	0	1	0	1
28324	0	0	1	0	0	1
28325	0	0	1	0	0	1
28326	0	0	0	1	0	1
28327	0	0	3	0	0	3
28328	0	0	15	0	0	15
28329	38	0	0	0	0	38
28330	0	193	0	0	0	193
28331	0	280	0	0	0	280
28332	0	370	0	0	0	370
28333	0	0	0	366	0	366
28334	0	386	0	0	0	386
28335	417	0	0	0	0	417
28336	0	0	506	0	0	506
28337	536	0	0	0	0	536
28338	0	0	0	542	0	542
28339	0	0	0	543	0	543
28340	0	579	0	0	0	579
28341	621	0	0	0	0	621
28342	627	0	0	0	0	627
28343	0	648	0	1	0	649
28344	1	0	0	654	0	655
28345	0	0	698	0	0	698
28346	0	0	786	0	0	786
28347	0	793	0	0	0	793
28348	793	0	2	1	0	796
28349	0	0	795	0	0	795
28350	1	0	1	808	0	810
28351	937	0	0	0	0	937
28352	942	0	2	0	0	944
28353	1	1029	0	0	0	1030
28354	0	1041	0	0	0	1041
28355	1109	0	1	0	0	1110
28356	0	0	1162	0	0	1162
28357	1171	0	1	0	0	1172
28358	1202	0	3	0	0	1205
28359	0	1	0	1213	0	1214
28360	0	0	1329	0	0	1329
28361	0	0	1346	2	0	1348
28362	1345	0	1	0	0	1346
28363	0	1	1359	0	0	1360
28364	1360	0	0	0	0	1360
28365	1419	0	12	0	0	1431
28366	0	1434	1	0	0	1435
28367	2	0	1459	0	0	1461
28368	0	1478	0	4	0	1482
28369	1481	0	4	0	0	1485
28370	0	0	1545	0	0	1545
28371	0	6	0	1563	0	1569
28372	0	0	1555	0	0	1555
28373	0	0	1571	0	0	1571
28374	0	0	1592	0	0	1592
28375	0	0	1586	0	0	1586
28376	0	1582	0	3	0	1585
28377	0	0	1585	0	0	1585
28378	0	1622	0	0	0	1622
28379	16	0	1638	0	0	1654
28380	1658	1	10	0	0	1669
28381	0	8	0	1641	0	1649
28382	1	1695	0	0	0	1696
28383	1697	0	2	0	0	1699
28384	1777	0	3	0	0	1780
28385	1777	0	1	0	0	1778
28386	1777	0	3	4	0	1784
28387	0	1786	0	0	0	1786
28388	1792	0	1	0	0	1793
28389	1793	0	5	0	0	1798
28390	0	1811	1	2	0	1814
28391	0	0	1809	0	0	1809
28392	2	3	0	1808	0	1813
28393	0	1816	0	0	0	1816
28394	3	0	1800	1	0	1804
28395	0	0	1900	0	0	1900
28396	0	1941	0	0	0	1941
28397	0	1932	0	0	0	1932
28398	0	1960	0	3	0	1963
28399	0	1953	0	1	0	1954
28400	1964	0	1	0	0	1965
28401	1975	0	2	0	0	1977
28402	1	0	2065	0	0	2066
28403	0	0	2053	2	0	2055
28404	1	9	0	2028	0	2038
28405	0	5	0	2057	0	2062
28406	0	2	0	1927	0	1929
28407	1909	0	0	0	0	1909
28408	1	1914	0	4	0	1919
28409	0	1902	0	2	0	1904
28410	1	2105	0	2	0	2108
28411	2121	0	1	0	0	2122
28412	2259	0	7	0	0	2266
28413	0	0	0	2253	0	2253
28414	2232	0	14	0	0	2246
28415	2314	0	4	2	0	2320
28416	0	1	0	2300	0	2301
28417	2267	0	1	1	0	2269
28418	0	2239	0	1	0	2240
28419	4	132	0	2065	0	2201
28420	1	0	2204	2	0	2207
28421	0	2163	0	0	0	2163
28422	3	0	2226	1	0	2230
28423	0	2	0	2277	0	2279
28424	0	2325	0	1	0	2326
28425	0	9	0	2336	0	2345
28426	1	3	0	2347	0	2351
28427	0	0	2251	0	0	2251
28428	1	0	2289	2	0	2292
28429	1	6	0	2203	0	2210
28430	0	5	0	2257	0	2262
28431	0	2195	0	0	0	2195
28432	2190	0	10	1	0	2201
28433	0	2175	0	1	0	2176
28434	0	2162	0	0	0	2162
28435	0	0	2179	0	0	2179
28436	0	2144	2	0	0	2146
28437	0	10	0	2099	0	2109
28438	0	2163	0	1	0	2164
28439	1	4	0	2181	0	2186
28440	0	2254	0	2	0	2256
28441	2284	0	2	1	0	2287
28442	0	2255	0	0	0	2255
28443	1	8	1	2223	0	2233
28444	0	2314	0	0	0	2314
28445	2287	0	4	2	0	2293
28446	2321	0	7	0	0	2328
28447	0	2317	0	3	0	2320
28448	2312	0	1	0	0	2313
28449	0	2	0	2356	0	2358
28450	0	0	2349	1	0	2350
28451	0	2	2376	0	0	2378
28452	0	2398	0	2	0	2400
28453	2380	0	8	0	0	2388
28454	2379	0	5	1	0	2385
28455	0	0	2349	0	0	2349
28456	0	0	2328	1	0	2329
28457	2319	0	8	3	0	2330
28458	2301	0	1	0	0	2302
28459	1	0	2304	1	0	2306
28460	2303	1	1	1	0	2306
28461	0	2399	0	1	0	2400
28462	0	2412	0	0	0	2412
28463	0	7	0	2443	0	2450
28464	0	0	0	2457	0	2457
28465	2492	0	1	0	0	2493
28466	2479	0	0	0	0	2479
28467	2491	0	3	0	0	2494
28468	0	1	0	2495	0	2496
28469	0	9	0	2462	0	2471
28470	0	2411	0	0	0	2411
28471	0	2382	0	6	0	2388
28472	0	2466	0	2	0	2468
28473	0	5	4	2443	0	2452
28474	0	2497	0	1	0	2498
28475	3	0	2495	0	0	2498
28476	2499	0	10	0	0	2509
28477	0	0	2580	0	0	2580
28478	4	0	2508	0	0	2512
28479	2504	1	2	0	0	2507
28480	1	2518	0	0	0	2519
28481	2474	0	2	0	0	2476
28482	2495	0	3	0	0	2498
28483	0	0	2461	1	0	2462
28484	1	0	2390	0	0	2391
28485	1	2226	0	0	0	2227
28486	0	0	2231	0	0	2231
28487	0	11	0	2230	0	2241
28488	1	5	0	2039	0	2045
28489	1	2080	0	1	0	2082
28490	0	2052	0	0	0	2052
28491	2197	1	22	0	0	2220
28492	2245	0	0	0	0	2245
28493	0	5	0	2231	0	2236
28494	2	0	0	2241	0	2243
28495	2232	1	1	1	0	2235
28496	2181	0	2	0	0	2183
28497	0	2338	0	0	0	2338
28498	2375	0	2	1	0	2378
28499	0	2502	0	0	0	2502
28500	0	2467	0	0	0	2467
28501	2487	0	2	0	0	2489
28502	2497	0	0	0	0	2497
28503	0	9	0	2524	0	2533
28504	2497	0	4	0	0	2501
28505	1	0	2484	0	0	2485
28506	1	2472	0	3	0	2476
28507	2423	0	1	0	0	2424
28508	0	0	2520	0	0	2520
28509	0	2	1	2548	0	2551
28510	1	2562	0	1	0	2564
28511	1	2502	0	0	0	2503
28512	2492	1	3	2	0	2498
28513	0	0	2484	1	0	2485
28514	2464	0	18	0	0	2482
28515	0	5	0	2473	0	2478
28516	0	0	2377	0	0	2377
28517	2390	1	0	3	0	2394
28518	1	2388	0	1	0	2390
28519	0	2469	0	1	0	2470
28520	2488	0	1	1	0	2490
28521	2500	0	2	0	0	2502
28522	2444	0	7	0	0	2451
28523	0	1	0	2466	0	2467
28524	0	6	0	2465	0	2471
28525	2	0	2488	0	0	2490
28526	2	0	2471	0	0	2473
28527	2	2477	0	1	0	2480
28528	0	1	0	2479	0	2480
28529	2488	0	5	0	0	2493
28530	1	2691	0	0	0	2692
28531	0	6	0	2684	0	2690
28532	2843	0	3	0	0	2846
28533	1	2924	0	1	0	2926
28534	0	2877	0	2	0	2879
28535	4	0	2885	0	0	2889
28536	2865	0	4	0	0	2869
28537	2792	0	6	0	0	2798
28538	0	0	2798	1	0	2799
28539	2729	0	4	4	0	2737
28540	0	0	2784	2	0	2786
28541	0	2955	0	2	0	2957
28542	0	4	1	2971	0	2976
28543	2982	0	2	1	0	2985
28544	1	2952	0	2	0	2955
28545	0	2934	0	4	0	2938
28546	2916	0	10	0	0	2926
28547	0	0	2936	0	0	2936
28548	2883	0	4	0	0	2887
28549	1	2889	0	0	0	2890
28550	1	0	2855	0	0	2856
28551	2880	1	9	1	0	2891
28552	2900	0	3	0	0	2903
28553	0	1	0	2867	0	2868
28554	2	6	1	2861	0	2870
28555	0	2856	0	3	0	2859
28556	1	0	2854	2	0	2857
28557	0	3	0	2855	0	2858
28558	2	0	2816	1	0	2819
28559	4	2	2873	1	0	2880
28560	0	25	1	2797	0	2823
28561	19	0	2812	0	0	2831
28562	3	1	2812	0	0	2816
28563	4	6	1	2794	0	2805
28564	1	0	2800	0	0	2801
28565	2769	0	12	0	0	2781
28566	0	2698	0	1	0	2699
28567	4	0	2700	0	0	2704
28568	3	0	2691	0	0	2694
28569	0	2	0	2960	0	2962
28570	2952	0	6	0	0	2958
28571	2987	0	6	0	0	2993
28572	2984	1	7	2	0	2994
28573	2839	0	1	0	0	2840
28574	0	5	0	2790	0	2795
28575	0	0	2642	0	0	2642
28576	2667	0	2	1	0	2670
28577	2688	0	7	0	0	2695
28578	2666	0	17	1	0	2684
28579	1	0	2638	0	0	2639
28580	2679	0	8	1	0	2688
28581	0	8	0	2735	0	2743
28582	0	2645	0	0	0	2645
28583	0	5	0	2602	0	2607
28584	0	2649	0	3	0	2652
28585	2614	1	2	16	0	2633
28586	1	0	2809	0	0	2810
28587	0	5	1	2821	0	2827
28588	0	2827	0	0	0	2827
28589	1	2811	0	0	0	2812
28590	2810	0	2	1	0	2813
28591	2820	0	0	0	0	2820
28592	2	0	2824	0	0	2826
28593	2960	0	3	1	0	2964
28594	0	5	1	3026	0	3032
28595	1	0	2876	2	0	2879
28596	2	0	3132	0	0	3134
28597	0	6	1	3138	0	3145
28598	3126	0	1	0	0	3127
28599	0	7	0	3114	0	3121
28600	0	3	0	3244	0	3247
28601	0	9	0	3246	0	3255
28602	1	3296	0	0	0	3297
28603	1	9	0	3289	0	3299
28604	3311	0	1	2	0	3314
28605	0	3203	0	0	0	3203
28606	0	7	1	3104	0	3112
28607	3375	1	4	1	0	3381
28608	0	3416	0	0	0	3416
28609	0	3336	0	0	0	3336
28610	0	2	0	3328	0	3330
28611	3276	0	1	0	0	3277
28612	0	0	3280	1	0	3281
28613	2	0	3313	2	0	3317
28614	3295	0	5	4	0	3304
28615	3305	0	3	0	0	3308
28616	0	3227	0	1	0	3228
28617	0	2	0	3197	0	3199
28618	7	0	3203	0	0	3210
28619	5	0	3225	1	0	3231
28620	2	0	3315	2	0	3319
28621	1	3336	0	1	0	3338
28622	0	3282	0	6	0	3288
28623	3290	0	2	2	0	3294
28624	0	0	3307	0	0	3307
28625	3407	0	11	0	0	3418
28626	3425	0	7	0	0	3432
28627	0	0	3377	0	0	3377
28628	0	3407	0	0	0	3407
28629	0	8	0	3435	0	3443
28630	2	0	3444	0	0	3446
28631	0	0	3446	1	0	3447
28632	3471	0	2	1	0	3474
28633	0	3506	0	6	0	3512
28634	1	14	1	3491	0	3507
28635	1	16	0	3887	0	3904
28636	1	3902	0	0	0	3903
28637	0	3917	0	1	0	3918
28638	0	3970	0	6	0	3976
28639	1	3	0	3955	0	3959
28640	4013	0	3	1	0	4017
28641	2	2	0	4008	0	4012
28642	3	0	3933	0	0	3936
28643	0	0	4015	0	0	4015
28644	0	19	0	3721	0	3740
28645	2	0	3662	3	0	3667
28646	0	3686	0	0	0	3686
28647	1	4	0	3675	0	3680
28648	3811	0	5	0	0	3816
28649	3864	0	3	2	0	3869
28650	0	3819	0	28	0	3847
28651	3806	2	4	0	0	3812
28652	3745	0	7	0	0	3752
28653	3706	0	3	0	0	3709
28654	3	0	3705	0	0	3708
28655	3724	0	2	0	0	3726
28656	1	3774	0	3	0	3778
28657	2	0	3674	0	0	3676
28658	7	0	3748	1	0	3756
28659	0	3798	1	2	0	3801
28660	3856	0	3	0	0	3859
28661	2	11	0	3971	0	3984
28662	0	3927	0	0	0	3927
28663	3953	0	1	0	0	3954
28664	0	3	1	3966	0	3970
28665	3949	1	1	1	0	3952
28666	2	3	2	3974	0	3981
28667	3	0	3838	1	0	3842
28668	7	0	3950	1	0	3958
28669	2	0	3893	1	0	3896
28670	5	8	1	3889	0	3903
28671	0	6	0	3783	0	3789
28672	3	0	3626	0	0	3629
28673	0	3653	0	4	0	3657
28674	3675	0	14	0	0	3689
28675	3706	0	3	1	0	3710
28676	0	3519	0	1	0	3520
28677	2	2	0	3428	0	3432
28678	1	0	3455	0	0	3456
28679	3466	0	5	0	0	3471
28680	1	0	3499	0	0	3500
28681	1	0	3475	0	0	3476
28682	8	0	3437	0	0	3445
28683	3162	1	8	2	0	3173
28684	1	0	3121	1	0	3123
28685	1	3150	0	0	0	3151
28686	0	3194	0	8	0	3202
28687	1	5	1	3189	0	3196
28688	0	4	0	3216	0	3220
28689	1	0	3229	2	0	3232
28690	3284	0	7	1	0	3292
28691	3310	0	8	1	0	3319
28692	1	7	0	3313	0	3321
28693	3135	0	3	0	0	3138
28694	0	3235	1	0	0	3236
28695	3171	0	15	1	0	3187
28696	0	3301	0	1	0	3302
28697	0	3264	0	3	0	3267
28698	3200	0	6	1	0	3207
28699	3229	0	7	0	0	3236
28700	3253	1	3	0	0	3257
28701	3223	0	6	0	0	3229
28702	2	0	3249	0	0	3251
28703	3198	0	5	0	0	3203
28704	1	6	0	3206	0	3213
28705	1	3173	0	1	0	3175
28706	3234	0	9	1	0	3244
28707	0	3339	1	1	0	3341
28708	3315	0	3	1	0	3319
28709	1	1	0	3253	0	3255
28710	0	6	0	3237	0	3243
28711	0	0	2859	2	0	2861
28712	0	0	2823	0	0	2823
28713	0	2845	0	2	0	2847
28714	2848	1	4	0	0	2853
28715	0	2928	0	0	0	2928
28716	0	2907	0	0	0	2907
28717	1	2898	0	2	0	2901
28718	2	0	2910	0	0	2912
28719	0	2821	0	0	0	2821
28720	2991	0	0	0	0	2991
28721	3010	0	6	0	0	3016
28722	1	11	0	3027	0	3039
28723	0	3025	0	0	0	3025
28724	1	3018	0	0	0	3019
28725	0	9	0	3014	0	3023
28726	3	0	3092	0	0	3095
28727	0	3114	0	3	0	3117
28728	0	5	1	3129	0	3135
28729	3159	0	7	0	0	3166
28730	3185	0	4	0	0	3189
28731	1	3205	0	0	0	3206
28732	3088	1	5	3	0	3097
28733	3154	0	4	0	0	3158
28734	0	3	0	3097	0	3100
28735	3	0	3057	0	0	3060
28736	1	2828	0	1	0	2830
28737	2	14	0	2789	0	2805
28738	2	0	2803	0	0	2805
28739	0	2808	0	0	0	2808
28740	2782	0	6	1	0	2789
28741	2800	0	2	0	0	2802
28742	1	5	0	2761	0	2767
28743	0	2639	0	2	0	2641
28744	1	1	2672	0	0	2674
28745	0	2	0	2761	0	2763
28746	4	0	2744	0	0	2748
28747	0	2717	0	2	0	2719
28748	1	1	1	2771	0	2774
28749	2802	0	2	2	0	2806
28750	0	2780	0	0	0	2780
28751	2796	1	0	0	0	2797
28752	2795	0	7	1	0	2803
28753	0	2783	0	0	0	2783
28754	0	3	2	2713	0	2718
28755	1	0	0	2752	0	2753
28756	1	2822	0	1	0	2824
28757	0	2839	0	1	0	2840
28758	0	12	0	2771	0	2783
28759	1	2786	0	2	0	2789
28760	2767	0	6	0	0	2773
28761	2812	1	5	0	0	2818
28762	0	0	2783	1	0	2784
28763	2	0	2876	0	0	2878
28764	2908	0	4	0	0	2912
28765	2802	0	10	2	0	2814
28766	0	2833	0	0	0	2833
28767	2857	0	5	0	0	2862
28768	2915	0	5	0	0	2920
28769	0	2839	0	1	0	2840
28770	2753	2	1	1	0	2757
28771	0	1	0	2746	0	2747
28772	0	7	0	2616	0	2623
28773	2	1	2735	2	0	2740
28774	1	2855	1	26	0	2883
28775	1	2913	0	3	0	2917
28776	2892	0	8	0	0	2900
28777	2851	0	1	1	0	2853
28778	2836	0	1	1	0	2838
28779	2808	0	11	0	0	2819
28780	0	0	2836	1	0	2837
28781	2	0	2832	1	0	2835
28782	0	2773	0	2	0	2775
28783	0	16	2	2830	0	2848
28784	2	9	0	2854	0	2865
28785	0	2845	0	0	0	2845
28786	0	5	0	2857	0	2862
28787	3025	0	5	0	0	3030
28788	0	3024	0	1	0	3025
28789	0	0	2997	0	0	2997
28790	0	2963	0	1	0	2964
28791	2868	0	6	1	0	2875
28792	0	0	2949	0	0	2949
28793	2989	0	2	1	0	2992
28794	2999	0	9	0	0	3008
28795	0	0	2997	1	0	2998
28796	2	0	2833	0	0	2835
28797	0	0	2848	0	0	2848
28798	2816	0	2	1	0	2819
28799	1	0	2783	0	0	2784
28800	0	2788	1	2	0	2791
28801	2708	0	3	0	0	2711
28802	0	0	2641	0	0	2641
28803	2624	1	6	5	0	2636
28804	3	0	2630	0	0	2633
28805	1	0	2630	1	0	2632
28806	0	2567	0	7	0	2574
28807	5	0	2571	0	0	2576
28808	2	0	2637	2	0	2641
28809	0	2604	1	3	0	2608
28810	2630	0	4	0	0	2634
28811	0	0	2646	0	0	2646
28812	1	8	0	2725	0	2734
28813	0	2728	0	2	0	2730
28814	2745	0	9	0	0	2754
28815	2750	0	9	0	0	2759
28816	1	0	2774	0	0	2775
28817	0	2803	1	0	0	2804
28818	1	2774	0	0	0	2775
28819	1	5	0	2756	0	2762
28820	0	2721	0	1	0	2722
28821	0	4	0	2732	0	2736
28822	0	5	0	2801	0	2806
28823	0	2797	0	0	0	2797
28824	1	4	2	2718	0	2725
28825	0	2737	0	0	0	2737
28826	2	0	2722	0	0	2724
28827	0	13	0	2766	0	2779
28828	2	7	0	2791	0	2800
28829	0	2821	0	1	0	2822
28830	0	2771	0	1	0	2772
28831	1	10	0	2740	0	2751
28832	0	2777	0	3	0	2780
28833	2759	1	7	1	0	2768
28834	0	11	0	2761	0	2772
28835	0	2798	0	3	0	2801
28836	2802	0	3	0	0	2805
28837	0	2774	0	1	0	2775
28838	1	0	2710	0	0	2711
28839	0	23	0	2659	0	2682
28840	2706	1	0	0	0	2707
28841	1	0	2765	0	0	2766
28842	0	6	0	2772	0	2778
28843	1	2677	0	0	0	2678
28844	4	0	2674	0	0	2678
28845	0	2706	0	2	0	2708
28846	2721	1	4	0	0	2726
28847	2727	0	2	0	0	2729
28848	0	2604	0	0	0	2604
28849	2462	0	0	0	0	2462
28850	1	0	2551	0	0	2552
28851	2	13	1	2516	0	2532
28852	0	4	0	2569	0	2573
28853	0	2574	0	0	0	2574
28854	2551	0	3	1	0	2555
28855	2558	0	3	0	0	2561
28856	0	0	2530	0	0	2530
28857	2610	0	8	0	0	2618
28858	2545	0	4	0	0	2549
28859	2477	0	9	0	0	2486
28860	0	2	0	2473	0	2475
28861	0	7	0	2468	0	2475
28862	0	2349	0	0	0	2349
28863	2319	1	13	0	0	2333
28864	2407	0	1	0	0	2408
28865	0	2385	0	0	0	2385
28866	1	3	1	2327	0	2332
28867	0	2273	0	9	0	2282
28868	0	2240	0	2	0	2242
28869	2239	1	4	1	0	2245
28870	1	0	2216	0	0	2217
28871	1	0	2224	2	0	2227
28872	0	2181	0	6	0	2187
28873	2136	0	2	0	0	2138
28874	2	0	2207	0	0	2209
28875	0	2354	0	4	0	2358
28876	2346	0	2	0	0	2348
28877	0	0	2489	0	0	2489
28878	0	5	0	2472	0	2477
28879	2454	0	2	0	0	2456
28880	0	0	2454	2	0	2456
28881	3	0	2395	1	0	2399
28882	0	0	2401	0	0	2401
28883	1	0	2441	0	0	2442
28884	2367	1	13	0	0	2381
28885	2402	0	2	0	0	2404
28886	0	2406	0	2	0	2408
28887	0	3	0	2292	0	2295
28888	1	6	0	2314	0	2321
28889	0	2297	0	0	0	2297
28890	0	6	1	2273	0	2280
28891	0	2302	0	0	0	2302
28892	0	2319	0	0	0	2319
28893	2	7	0	2349	0	2358
28894	2	0	2385	0	0	2387
28895	1	2326	0	0	0	2327
28896	0	1	0	2313	0	2314
28897	2300	0	5	0	0	2305
28898	0	0	2239	0	0	2239
28899	2299	0	4	0	0	2303
28900	2319	0	2	1	0	2322
28901	0	4	1	2308	0	2313
28902	0	0	2287	0	0	2287
28903	1	0	2240	0	0	2241
28904	0	2121	0	2	0	2123
28905	0	5	1	2146	0	2152
28906	1	0	2168	0	0	2169
28907	2	1	2174	0	0	2177
28908	0	2268	0	0	0	2268
28909	2281	0	3	0	0	2284
28910	2255	0	8	1	0	2264
28911	0	5	1	2273	0	2279
28912	6	0	2264	0	0	2270
28913	1	0	2279	0	0	2280
28914	1	2290	0	1	0	2292
28915	1	0	2275	1	0	2277
28916	0	0	2208	0	0	2208
28917	0	8	0	2142	0	2150
28918	0	0	2160	0	0	2160
28919	2217	0	2	0	0	2219
28920	0	1	0	2222	0	2223
28921	1	0	2167	0	0	2168
28922	0	2203	0	2	0	2205
28923	1	1	0	2209	0	2211
28924	2	0	2272	1	0	2275
28925	0	2183	0	1	0	2184
28926	3	6	0	2199	0	2208
28927	0	2237	0	0	0	2237
28928	0	14	0	2185	0	2199
28929	0	1	0	2231	0	2232
28930	2	0	2244	0	0	2246
28931	0	2283	0	0	0	2283
28932	0	4	0	2271	0	2275
28933	0	14	0	2262	0	2276
28934	0	3	0	2257	0	2260
28935	2	0	2197	5	0	2204
28936	0	2228	0	0	0	2228
28937	1	5	0	2240	0	2246
28938	0	0	2252	1	0	2253
28939	0	2224	0	3	0	2227
28940	0	3	3	2211	0	2217
28941	4	0	2226	0	0	2230
28942	0	2282	0	0	0	2282
28943	1	3	0	2296	0	2300
28944	0	6	0	2306	0	2312
28945	1	0	2297	1	0	2299
28946	2276	0	7	1	0	2284
28947	0	2279	0	2	0	2281
28948	2206	0	5	0	0	2211
28949	1	0	2299	0	0	2300
28950	2301	0	4	0	0	2305
28951	0	1	0	2271	0	2272
28952	0	3	1	2283	0	2287
28953	1	1	2194	0	0	2196
28954	2226	1	4	2	0	2233
28955	2234	0	2	0	0	2236
28956	0	2233	0	0	0	2233
28957	1	2227	1	0	0	2229
28958	2145	0	0	0	0	2145
28959	1	0	2166	0	0	2167
28960	0	2192	0	0	0	2192
28961	1	1	0	2176	0	2178
28962	0	2	0	2132	0	2134
28963	0	0	2140	0	0	2140
28964	2091	0	3	1	0	2095
28965	0	0	2115	0	0	2115
28966	2177	1	9	0	0	2187
28967	4	0	2197	0	0	2201
28968	2	2264	0	1	0	2267
28969	2285	0	4	0	0	2289
28970	2285	0	3	0	0	2288
28971	2262	0	4	0	0	2266
28972	2290	1	4	0	0	2295
28973	0	0	0	2296	0	2296
28974	0	0	2331	0	0	2331
28975	0	1	1	2306	0	2308
28976	0	2265	2	0	0	2267
28977	1	3	0	2260	0	2264
28978	0	0	2344	1	0	2345
28979	2	0	2391	1	0	2394
28980	0	5	0	2419	0	2424
28981	2418	0	1	0	0	2419
28982	2396	0	4	0	0	2400
28983	2295	0	2	0	0	2297
28984	3	0	2307	0	0	2310
28985	4	0	2309	1	0	2314
28986	1	2329	0	2	0	2332
28987	0	2293	0	4	0	2297
28988	2324	0	7	1	0	2332
28989	2357	0	4	0	0	2361
28990	0	2390	0	0	0	2390
28991	2394	0	5	0	0	2399
28992	2387	0	2	0	0	2389
28993	0	2405	0	2	0	2407
28994	2370	0	2	0	0	2372
28995	2341	0	2	1	0	2344
28996	0	2431	0	0	0	2431
28997	2430	1	1	0	0	2432
28998	2423	0	7	1	0	2431
28999	3	0	2417	1	0	2421
29000	1	0	2424	2	0	2427
29001	2	2609	1	3	0	2615
29002	0	2557	0	3	0	2560
29003	2643	0	2	0	0	2645
29004	2726	0	1	1	0	2728
29005	2717	0	7	0	0	2724
29006	0	2737	0	1	0	2738
29007	0	5	0	2678	0	2683
29008	4	0	2737	0	0	2741
29009	2	1	0	2825	0	2828
29010	0	2818	0	2	0	2820
29011	3081	0	9	0	0	3090
29012	0	3110	0	0	0	3110
29013	0	8	0	3109	0	3117
29014	3178	0	2	0	0	3180
29015	3129	0	5	1	0	3135
29016	0	0	3176	0	0	3176
29017	3103	1	5	1	0	3110
29018	3081	0	0	0	0	3081
29019	3112	0	7	0	0	3119
29020	1	4	0	3089	0	3094
29021	1	3096	0	2	0	3099
29022	0	7	0	3079	0	3086
29023	1	0	3086	0	0	3087
29024	0	3024	0	1	0	3025
29025	0	31	0	2968	0	2999
29026	1	0	3023	0	0	3024
29027	1	3004	0	0	0	3005
29028	1	4	0	2957	0	2962
29029	3	0	3016	0	0	3019
29030	2997	0	5	0	0	3002
29031	4	0	3025	0	0	3029
29032	3	0	3049	0	0	3052
29033	1	3054	0	0	0	3055
29034	0	4	1	3033	0	3038
29035	0	12	1	3062	0	3075
29036	0	3138	0	2	0	3140
29037	2	4	0	3174	0	3180
29038	3374	0	3	41	0	3418
29039	3398	2	9	2	0	3411
29040	1	0	3348	0	0	3349
29041	3256	0	11	0	0	3267
29042	3103	1	8	1	0	3113
29043	1	0	3121	0	0	3122
29044	1	3196	0	0	0	3197
29045	0	3140	0	0	0	3140
29046	1	4	0	3116	0	3121
29047	0	3124	0	1	0	3125
29048	8	0	3063	0	0	3071
29049	2	0	3098	0	0	3100
29050	3	3046	0	1	0	3050
29051	3074	0	4	0	0	3078
29052	3084	1	2	0	0	3087
29053	3062	1	10	0	0	3073
29054	2995	0	8	0	0	3003
29055	2980	2	4	0	0	2986
29056	0	2971	0	6	0	2977
29057	1	0	2944	0	0	2945
29058	1	1	1	2934	0	2937
29059	2945	0	0	0	0	2945
29060	0	2885	0	0	0	2885
29061	0	5	1	2838	0	2844
29062	0	0	2899	2	0	2901
29063	2	2936	0	6	0	2944
29064	0	2928	0	0	0	2928
29065	2950	0	9	0	0	2959
29066	1	2934	0	1	0	2936
29067	0	1	0	2945	0	2946
29068	3173	0	1	0	0	3174
29069	3111	0	6	0	0	3117
29070	3142	1	13	0	0	3156
29071	1	0	3223	0	0	3224
29072	0	3135	0	2	0	3137
29073	3248	0	4	0	0	3252
29074	0	1	0	3216	0	3217
29075	3170	0	0	0	0	3170
29076	0	3223	0	1	0	3224
29077	3059	1	10	0	0	3070
29078	3305	0	12	0	0	3317
29079	0	3	0	3228	0	3231
29080	3	0	3153	1	0	3157
29081	0	4	2	3151	0	3157
29082	3074	0	1	0	0	3075
29083	3103	0	9	0	0	3112
29084	1	3147	0	1	0	3149
29085	2987	0	9	0	0	2996
29086	0	2984	0	0	0	2984
29087	2745	0	5	0	0	2750
29088	2708	0	10	0	0	2718
29089	1	0	2731	1	0	2733
29090	1	2704	0	1	0	2706
29091	1	35	0	2649	0	2685
29092	0	6	1	2659	0	2666
29093	1	0	0	2675	0	2676
29094	0	2697	0	2	0	2699
29095	0	0	2704	1	0	2705
29096	1	2	2777	0	0	2780
29097	0	2788	0	1	0	2789
29098	2733	0	9	0	0	2742
29099	0	0	2742	0	0	2742
29100	2761	0	18	0	0	2779
29101	0	2753	0	0	0	2753
29102	2	0	2757	0	0	2759
29103	1	6	0	2718	0	2725
29104	0	0	2692	0	0	2692
29105	1	0	2977	1	0	2979
29106	0	5	3	2963	0	2971
29107	2	2887	0	0	0	2889
29108	0	2844	0	1	0	2845
29109	2815	0	8	1	0	2824
29110	0	0	2891	0	0	2891
29111	2857	0	11	1	0	2869
29112	2820	0	10	1	0	2831
29113	0	2815	1	1	0	2817
29114	2540	1	4	1	0	2546
29115	2553	0	6	1	0	2560
29116	2584	1	2	0	0	2587
29117	2	2586	0	1	0	2589
29118	2	2584	0	1	0	2587
29119	0	2522	0	0	0	2522
29120	2467	0	7	0	0	2474
29121	2475	0	5	1	0	2481
29122	0	0	2512	0	0	2512
29123	0	0	2550	0	0	2550
29124	2571	0	0	0	0	2571
29125	2543	0	5	0	0	2548
29126	2533	0	5	0	0	2538
29127	0	2	0	2557	0	2559
29128	0	1	0	2532	0	2533
29129	0	3	2	2546	0	2551
29130	0	1	0	2535	0	2536
29131	0	0	2488	2	0	2490
29132	12	0	2474	0	0	2486
29133	0	0	2483	1	0	2484
29134	0	0	2531	1	0	2532
29135	2576	0	5	0	0	2581
29136	1	2595	0	5	0	2601
29137	1	2549	0	5	0	2555
29138	2558	0	9	0	0	2567
29139	0	0	2495	0	0	2495
29140	5	0	2589	1	0	2595
29141	2605	0	7	4	0	2616
29142	2610	0	3	0	0	2613
29143	0	2442	0	0	0	2442
29144	0	3	2	2448	0	2453
29145	2512	0	4	1	0	2517
29146	2478	0	7	0	0	2485
29147	0	6	0	2478	0	2484
29148	0	2429	1	0	0	2430
29149	2328	0	4	0	0	2332
29150	0	0	2476	0	0	2476
29151	2520	0	8	3	0	2531
29152	0	2436	0	4	0	2440
29153	2381	0	7	0	0	2388
29154	2157	0	6	0	0	2163
29155	0	0	2161	0	0	2161
29156	1	0	2199	0	0	2200
29157	2199	1	22	1	0	2223
29158	2228	0	1	0	0	2229
29159	1	2211	0	1	0	2213
29160	0	9	0	2093	0	2102
29161	0	0	2271	1	0	2272
29162	2325	0	1	0	0	2326
29163	0	2	0	2375	0	2377
29164	0	12	0	2362	0	2374
29165	2308	0	7	0	0	2315
29166	0	2387	0	12	0	2399
29167	2429	0	8	0	0	2437
29168	2450	1	2	0	0	2453
29169	2425	0	31	1	0	2457
29170	0	2420	0	0	0	2420
29171	2318	0	6	0	0	2324
29172	0	3	0	2301	0	2304
29173	0	1	0	2341	0	2342
29174	0	0	2314	4	0	2318
29175	1	0	2328	2	0	2331
29176	0	2342	0	0	0	2342
29177	0	2334	0	4	0	2338
29178	1	0	2344	0	0	2345
29179	0	2346	0	3	0	2349
29180	2422	0	1	0	0	2423
29181	2226	0	6	0	0	2232
29182	2252	0	4	1	0	2257
29183	0	3	0	2300	0	2303
29184	0	3	0	2288	0	2291
29185	0	0	2306	0	0	2306
29186	0	2222	0	2	0	2224
29187	2240	0	3	0	0	2243
29188	0	2314	0	3	0	2317
29189	2288	0	2	1	0	2291
29190	2362	2	2	0	0	2366
29191	0	0	1	2345	0	2346
29192	0	36	0	2293	0	2329
29193	1	2	0	2377	0	2380
29194	0	0	2378	0	0	2378
29195	1	2378	0	1	0	2380
29196	0	2343	0	0	0	2343
29197	2	2351	0	0	0	2353
29198	0	2743	0	1	0	2744
29199	1	2749	0	0	0	2750
29200	2723	1	0	0	0	2724
29201	0	0	2764	0	0	2764
29202	0	2823	0	0	0	2823
29203	3	0	2820	0	0	2823
29204	0	2927	0	0	0	2927
29205	2	4	1	2905	0	2912
29206	1	3	0	2929	0	2933
29207	0	2951	0	0	0	2951
29208	2924	0	7	0	0	2931
29209	0	0	2942	0	0	2942
29210	0	2900	0	0	0	2900
29211	0	0	2912	0	0	2912
29212	0	12	0	2905	0	2917
29213	1	6	0	2872	0	2879
29214	0	2898	0	1	0	2899
29215	0	5	0	2905	0	2910
29216	0	4	0	2958	0	2962
29217	0	2989	0	5	0	2994
29218	2	0	2974	0	0	2976
29219	0	0	2976	0	0	2976
29220	2916	0	11	0	0	2927
29221	2866	2	1	0	0	2869
29222	0	6	0	2914	0	2920
29223	2	0	2847	0	0	2849
29224	1	4	0	2857	0	2862
29225	0	2673	0	0	0	2673
29226	1	0	2671	1	0	2673
29227	0	2671	0	0	0	2671
29228	0	0	2668	1	0	2669
29229	0	2679	0	1	0	2680
29230	2670	0	6	2	0	2678
29231	0	3	0	2676	0	2679
29232	1	1	0	2636	0	2638
29233	1	0	2666	0	0	2667
29234	2	0	2710	0	0	2712
29235	2	2674	0	3	0	2679
29236	2695	1	4	0	0	2700
29237	2	6	1	2542	0	2551
29238	0	0	2475	0	0	2475
29239	0	0	2448	1	0	2449
29240	2469	0	5	1	0	2475
29241	2456	0	10	0	0	2466
29242	0	0	2379	0	0	2379
29243	0	7	0	2333	0	2340
29244	0	2312	0	3	0	2315
29245	2313	0	3	2	0	2318
29246	0	2298	0	0	0	2298
29247	2323	0	19	0	0	2342
29248	0	2381	0	0	0	2381
29249	1	2300	0	2	0	2303
29250	0	4	0	2267	0	2271
29251	0	14	0	2280	0	2294
29252	0	2306	0	3	0	2309
29253	2	0	2302	0	0	2304
29254	1	0	2303	0	0	2304
29255	1	0	2322	1	0	2324
29256	2260	1	1	1	0	2263
29257	2204	0	5	0	0	2209
29258	0	2146	0	0	0	2146
29259	3	0	2137	0	0	2140
29260	1	2	0	2165	0	2168
29261	1	0	2149	0	0	2150
29262	1	0	2165	0	0	2166
29263	1	3	0	2173	0	2177
29264	1	6	0	2217	0	2224
29265	0	0	2401	0	0	2401
29266	2367	0	6	0	0	2373
29267	0	2398	0	0	0	2398
29268	0	2411	0	0	0	2411
29269	0	5	0	2372	0	2377
29270	2635	0	2	1	0	2638
29271	0	2622	0	0	0	2622
29272	2622	0	8	0	0	2630
29273	0	2628	0	1	0	2629
29274	2128	0	7	0	0	2135
29275	0	0	2133	0	0	2133
29276	1	0	2179	0	0	2180
29277	0	3	0	2148	0	2151
29278	1	0	2135	0	0	2136
29279	1	2060	0	2	0	2063
29280	0	2068	0	1	0	2069
29281	2104	0	5	0	0	2109
29282	0	8	0	2272	0	2280
29283	0	2295	0	1	0	2296
29284	2257	1	2	0	0	2260
29285	2267	0	1	0	0	2268
29286	2308	0	2	0	0	2310
29287	0	5	0	2316	0	2321
29288	2	2	0	2285	0	2289
29289	2	0	2271	1	0	2274
29290	1	0	2201	0	0	2202
29291	2229	1	11	1	0	2242
29292	0	3	0	2190	0	2193
29293	2	0	2151	0	0	2153
29294	2270	0	11	1	0	2282
29295	1	2264	0	0	0	2265
29296	2341	1	11	0	0	2353
29297	2334	1	2	0	0	2337
29298	2260	0	11	1	0	2272
29299	2	0	2248	0	0	2250
29300	2254	1	1	0	0	2256
29301	0	10	0	2234	0	2244
29302	0	2271	0	1	0	2272
29303	1	2263	0	1	0	2265
29304	2264	0	2	2	0	2268
29305	2304	0	0	0	0	2304
29306	2404	0	2	0	0	2406
29307	0	4	0	2409	0	2413
29308	0	2	0	2390	0	2392
29309	4	3	0	2329	0	2336
29310	1	2285	0	0	0	2286
29311	2314	0	5	1	0	2320
29312	2328	0	0	0	0	2328
29313	2304	0	6	0	0	2310
29314	1	0	2342	0	0	2343
29315	2298	0	2	1	0	2301
29316	3	4	0	2264	0	2271
29317	0	2279	0	1	0	2280
29318	2274	0	8	1	0	2283
29319	2277	0	9	1	0	2287
29320	0	0	2285	1	0	2286
29321	0	0	0	2334	0	2334
29322	0	2350	1	3	0	2354
29323	2326	0	6	0	0	2332
29324	0	2	0	2332	0	2334
29325	0	4	0	2311	0	2315
29326	0	1	1	2319	0	2321
29327	0	5	0	2300	0	2305
29328	1	0	2289	1	0	2291
29329	0	2301	0	0	0	2301
29330	0	1	1	2302	0	2304
29331	1	0	2390	1	0	2392
29332	2362	0	8	0	0	2370
29333	2381	0	8	0	0	2389
29334	0	3	0	2421	0	2424
29335	2440	0	2	0	0	2442
29336	2410	0	5	0	0	2415
29337	2	0	2458	1	0	2461
29338	0	2430	0	1	0	2431
29339	2479	0	3	0	0	2482
29340	0	5	0	2432	0	2437
29341	2245	0	2	0	0	2247
29342	0	1	0	2196	0	2197
29343	2	1	0	2152	0	2155
29344	0	0	2131	0	0	2131
29345	2134	1	7	0	0	2142
29346	1	1871	0	1	0	1873
29347	4	0	1850	1	0	1855
29348	1	1855	0	3	0	1859
29349	1971	0	3	1	0	1975
29350	0	1	0	1983	0	1984
29351	1983	0	1	0	0	1984
29352	1	1988	0	0	0	1989
29353	1991	1	3	1	0	1996
29354	2008	1	4	0	0	2013
29355	1971	0	4	0	0	1975
29356	1976	2	11	0	0	1989
29357	0	1980	0	1	0	1981
29358	1798	0	1	0	0	1799
29359	0	2	0	1800	0	1802
29360	1	7	0	1751	0	1759
29361	2	1880	0	1	0	1883
29362	0	1872	0	1	0	1873
29363	0	1915	0	4	0	1919
29364	1940	0	2	0	0	1942
29365	1	1926	0	2	0	1929
29366	0	1910	0	0	0	1910
29367	1938	0	1	1	0	1940
29368	1924	0	5	0	0	1929
29369	0	1931	0	1	0	1932
29370	1808	0	5	0	0	1813
29371	1	0	1808	0	0	1809
29372	1755	0	7	0	0	1762
29373	0	0	1845	1	0	1846
29374	0	1823	0	1	0	1824
29375	1	1839	0	1	0	1841
29376	0	2	0	1835	0	1837
29377	1882	0	3	0	0	1885
29378	1882	0	2	0	0	1884
29379	1883	0	2	0	0	1885
29380	1894	0	7	0	0	1901
29381	1855	0	2	0	0	1857
29382	2	0	1766	0	0	1768
29383	0	0	1734	0	0	1734
29384	1793	0	6	0	0	1799
29385	1	1819	0	1	0	1821
29386	1811	0	7	0	0	1818
29387	1844	0	3	1	0	1848
29388	1847	0	3	0	0	1850
29389	1848	0	3	0	0	1851
29390	1808	0	11	0	0	1819
29391	0	0	1830	0	0	1830
29392	1829	0	9	1	0	1839
29393	1817	0	11	1	0	1829
29394	0	0	1813	0	0	1813
29395	1852	0	2	1	0	1855
29396	1801	0	4	0	0	1805
29397	0	0	1789	0	0	1789
29398	0	0	1782	1	0	1783
29399	1	1765	0	0	0	1766
29400	0	2	0	1768	0	1770
29401	0	0	1791	0	0	1791
29402	1795	0	4	3	0	1802
29403	0	3	0	1788	0	1791
29404	0	0	1787	0	0	1787
29405	1778	0	5	2	0	1785
29406	1756	0	7	0	0	1763
29407	1699	1	5	0	0	1705
29408	0	1689	0	0	0	1689
29409	0	9	0	1666	0	1675
29410	0	1660	0	0	0	1660
29411	1629	1	2	1	0	1633
29412	1622	0	4	0	0	1626
29413	1	0	1572	0	0	1573
29414	0	1628	0	1	0	1629
29415	0	1620	0	0	0	1620
29416	0	2	0	1543	0	1545
29417	0	0	0	1545	0	1545
29418	1572	0	3	0	0	1575
29419	0	1552	0	0	0	1552
29420	1	1549	0	3	0	1553
29421	3	0	1530	2	0	1535
29422	0	1551	0	0	0	1551
29423	1493	0	1	0	0	1494
29424	1	0	1487	0	0	1488
29425	1403	1	6	0	0	1410
29426	0	0	1410	0	0	1410
29427	1405	0	2	0	0	1407
29428	0	1380	0	0	0	1380
29429	1341	0	6	0	0	1347
29430	1	0	1330	0	0	1331
29431	1414	0	2	1	0	1417
29432	1405	0	4	1	0	1410
29433	1	0	1402	0	0	1403
29434	1587	0	6	0	0	1593
29435	1571	0	2	0	0	1573
29436	1560	0	3	0	0	1563
29437	0	1501	0	0	0	1501
29438	1459	0	3	0	0	1462
29439	0	0	1405	0	0	1405
29440	0	1424	0	1	0	1425
29441	1405	0	5	0	0	1410
29442	1416	1	0	0	0	1417
29443	1496	0	2	2	0	1500
29444	0	1530	0	0	0	1530
29445	0	4	0	1499	0	1503
29446	0	0	1500	0	0	1500
29447	1	2	0	1460	0	1463
29448	0	0	1462	0	0	1462
29449	1518	0	3	0	0	1521
29450	1	1509	0	0	0	1510
29451	0	1	0	1472	0	1473
29452	0	1489	0	0	0	1489
29453	0	2	0	1443	0	1445
29454	0	5	0	1489	0	1494
29455	0	1509	0	0	0	1509
29456	0	1	0	1480	0	1481
29457	0	3	0	1470	0	1473
29458	1	1456	0	1	0	1458
29459	0	1609	0	0	0	1609
29460	0	1	0	1630	0	1631
29461	2	0	1605	0	0	1607
29462	0	1594	0	0	0	1594
29463	0	2	2	1573	0	1577
29464	0	0	1584	0	0	1584
29465	0	1580	0	6	0	1586
29466	1578	0	7	0	0	1585
29467	0	0	1565	0	0	1565
29468	1728	0	4	0	0	1732
29469	0	3	0	1793	0	1796
29470	0	7	0	1817	0	1824
29471	1	3	0	1803	0	1807
29472	0	0	1806	0	0	1806
29473	1	0	1802	0	0	1803
29474	1937	0	7	0	0	1944
29475	0	1	0	2020	0	2021
29476	1	0	1956	0	0	1957
29477	2104	0	2	0	0	2106
29478	0	5	0	2090	0	2095
29479	1	3	0	2330	0	2334
29480	0	9	1	2308	0	2318
29481	1	2322	0	0	0	2323
29482	0	6	0	2287	0	2293
29483	2	2305	0	0	0	2307
29484	0	2303	0	1	0	2304
29485	2295	0	5	1	0	2301
29486	2287	0	5	1	0	2293
29487	2298	0	1	4	0	2303
29488	0	2279	0	1	0	2280
29489	2244	0	4	0	0	2248
29490	2183	0	4	1	0	2188
29491	0	4	1	2173	0	2178
29492	0	7	0	2149	0	2156
29493	1	0	2169	0	0	2170
29494	1	2134	0	2	0	2137
29495	2159	0	9	0	0	2168
29496	2159	0	6	0	0	2165
29497	0	2113	0	1	0	2114
29498	2045	0	2	1	0	2048
29499	2035	0	5	0	0	2040
29500	2	3	1	1984	0	1990
29501	0	2029	0	2	0	2031
29502	0	2019	0	1	0	2020
29503	1973	0	3	1	0	1977
29504	1	13	2	1949	0	1965
29505	1	0	1978	0	0	1979
29506	1922	0	4	0	0	1926
29507	4	0	1956	0	0	1960
29508	0	1931	0	0	0	1931
29509	1707	0	5	0	0	1712
29510	0	0	1714	0	0	1714
29511	0	2	0	1697	0	1699
29512	1	0	1703	0	0	1704
29513	0	1694	0	1	0	1695
29514	0	1	1	1652	0	1654
29515	6	0	1638	0	0	1644
29516	1643	0	2	1	0	1646
29517	0	1615	0	3	0	1618
29518	1	3	0	1617	0	1621
29519	0	1497	0	0	0	1497
29520	1462	3	3	0	0	1468
29521	1469	0	7	0	0	1476
29522	0	1470	0	0	0	1470
29523	1	3	1	1443	0	1448
29524	0	1445	0	2	0	1447
29525	1351	0	3	1	0	1355
29526	0	0	1352	0	0	1352
29527	2	0	1350	0	0	1352
29528	0	1331	0	2	0	1333
29529	1	1340	0	0	0	1341
29530	0	3	0	1280	0	1283
29531	1282	0	1	0	0	1283
29532	1279	0	3	0	0	1282
29533	1276	0	2	0	0	1278
29534	0	1280	0	1	0	1281
29535	0	1	0	1058	0	1059
29536	0	1026	0	0	0	1026
29537	1020	0	1	0	0	1021
29538	0	1	0	1017	0	1018
29539	1	0	1016	0	0	1017
29540	0	1011	0	0	0	1011
29541	865	0	3	0	0	868
29542	0	0	868	0	0	868
29543	818	0	0	0	0	818
29544	0	815	0	0	0	815
29545	0	718	0	1	0	719
29546	684	0	0	0	0	684
29547	0	683	0	0	0	683
29548	668	0	0	0	0	668
29549	0	672	0	1	0	673
29550	529	0	0	0	0	529
29551	442	0	0	0	0	442
29552	0	0	442	0	0	442
29553	0	0	271	0	0	271
29554	0	263	0	0	0	263
29555	6	0	0	0	0	6
29556	0	0	1	0	0	1
29557	1	0	0	0	0	1
29558	0	0	0	1	0	1
29559	0	0	1	0	0	1
29560	0	0	1	0	0	1
29561	0	0	1	0	0	1
29562	0	1	0	0	0	1
29563	0	0	0	1	0	1
29564	1	0	0	0	0	1
29565	0	0	0	1	0	1
29566	1	0	0	0	0	1
29567	0	0	0	1	0	1
29568	1	0	0	0	0	1
29569	1	0	0	0	0	1
29570	1	0	0	0	0	1
29571	0	1	0	0	0	1
29572	0	0	1	0	0	1
29573	0	0	0	1	0	1
29574	0	0	0	1	0	1
29575	0	0	0	1	0	1
29576	0	0	0	1	0	1
29577	0	1	0	0	0	1
29578	0	0	1	0	0	1
29579	0	1	0	0	0	1
29580	0	0	0	1	0	1
29581	0	0	0	1	0	1
29582	0	0	0	1	0	1
29583	0	0	0	1	0	1
29584	0	1	0	0	0	1
29585	0	1	0	0	0	1
29586	0	0	1	0	0	1
29587	0	0	0	1	0	1
29588	0	0	0	1	0	1
29589	0	0	0	1	0	1
29590	1	0	0	0	0	1
29591	0	1	0	0	0	1
29592	0	0	1	0	0	1
29593	1	0	0	0	0	1
29594	0	0	0	1	0	1
29595	1	0	0	0	0	1
29596	0	0	0	1	0	1
29597	1	0	0	0	0	1
29598	0	0	0	1	0	1
29599	1	0	0	0	0	1
29600	0	0	1	0	0	1
29601	0	0	0	1	0	1
